,dteday,hr,casual,registered,cnt
0,2011-01-01,0,3,13,16
1,2011-01-01,1,8,30,38
2,2011-01-01,2,5,26,31
3,2011-01-01,3,3,9,12
4,2011-01-01,4,0,1,1
5,2011-01-01,5,0,1,1
6,2011-01-01,6,2,0,2
7,2011-01-01,7,1,2,3
8,2011-01-01,8,1,7,8
9,2011-01-01,9,8,6,14
10,2011-01-01,10,12,22,34
11,2011-01-01,11,26,30,56
12,2011-01-01,12,29,54,83
13,2011-01-01,13,47,47,94
14,2011-01-01,14,34,69,103
15,2011-01-01,15,40,67,107
16,2011-01-01,16,41,50,91
17,2011-01-01,17,15,51,66
18,2011-01-01,18,9,22,31
19,2011-01-01,19,6,27,33
20,2011-01-01,20,11,23,34
21,2011-01-01,21,3,31,34
22,2011-01-01,22,11,17,28
23,2011-01-01,23,15,24,39
24,2011-01-02,0,4,13,17
25,2011-01-02,1,1,15,16
26,2011-01-02,2,1,8,9
27,2011-01-02,3,2,4,6
28,2011-01-02,4,2,1,3
29,2011-01-02,6,0,2,2
30,2011-01-02,7,0,1,1
31,2011-01-02,8,0,8,8
32,2011-01-02,9,1,18,19
33,2011-01-02,10,7,46,53
34,2011-01-02,11,16,52,68
35,2011-01-02,12,20,69,89
36,2011-01-02,13,10,63,73
37,2011-01-02,14,4,53,57
38,2011-01-02,15,19,54,73
39,2011-01-02,16,9,65,74
40,2011-01-02,17,7,57,64
41,2011-01-02,18,10,41,51
42,2011-01-02,19,1,28,29
43,2011-01-02,20,5,17,22
44,2011-01-02,21,11,20,31
45,2011-01-02,22,0,9,9
46,2011-01-02,23,0,7,7
47,2011-01-03,0,0,5,5
48,2011-01-03,1,0,2,2
49,2011-01-03,4,0,1,1
50,2011-01-03,5,0,3,3
51,2011-01-03,6,0,28,28
52,2011-01-03,7,1,62,63
53,2011-01-03,8,1,151,152
54,2011-01-03,9,7,79,86
55,2011-01-03,10,11,27,38
56,2011-01-03,11,10,35,45
57,2011-01-03,12,13,40,53
58,2011-01-03,13,8,50,58
59,2011-01-03,14,11,59,70
60,2011-01-03,15,14,58,72
61,2011-01-03,16,9,66,75
62,2011-01-03,17,11,143,154
63,2011-01-03,18,9,147,156
64,2011-01-03,19,8,99,107
65,2011-01-03,20,3,48,51
66,2011-01-03,21,3,48,51
67,2011-01-03,22,0,19,19
68,2011-01-03,23,1,11,12
69,2011-01-04,0,0,5,5
70,2011-01-04,1,0,2,2
71,2011-01-04,2,0,1,1
72,2011-01-04,4,0,2,2
73,2011-01-04,5,0,4,4
74,2011-01-04,6,0,36,36
75,2011-01-04,7,2,91,93
76,2011-01-04,8,2,175,177
77,2011-01-04,9,2,98,100
78,2011-01-04,10,5,35,40
79,2011-01-04,11,7,49,56
80,2011-01-04,12,12,62,74
81,2011-01-04,13,18,78,96
82,2011-01-04,14,9,53,62
83,2011-01-04,15,17,47,64
84,2011-01-04,16,15,67,82
85,2011-01-04,17,10,200,210
86,2011-01-04,18,3,179,182
87,2011-01-04,19,2,104,106
88,2011-01-04,20,0,52,52
89,2011-01-04,21,0,46,46
90,2011-01-04,22,1,34,35
91,2011-01-04,23,2,9,11
92,2011-01-05,0,0,6,6
93,2011-01-05,1,0,6,6
94,2011-01-05,2,0,2,2
95,2011-01-05,4,0,2,2
96,2011-01-05,5,0,3,3
97,2011-01-05,6,0,33,33
98,2011-01-05,7,1,86,87
99,2011-01-05,8,3,189,192
100,2011-01-05,9,6,107,113
101,2011-01-05,10,4,51,55
102,2011-01-05,11,12,34,46
103,2011-01-05,12,5,73,78
104,2011-01-05,13,6,64,70
105,2011-01-05,14,10,49,59
106,2011-01-05,15,7,52,59
107,2011-01-05,16,4,83,87
108,2011-01-05,17,4,183,187
109,2011-01-05,18,3,165,168
110,2011-01-05,19,5,125,130
111,2011-01-05,20,7,79,86
112,2011-01-05,21,3,40,43
113,2011-01-05,22,1,39,40
114,2011-01-05,23,1,18,19
115,2011-01-06,0,0,11,11
116,2011-01-06,1,0,4,4
117,2011-01-06,2,0,2,2
118,2011-01-06,4,0,1,1
119,2011-01-06,5,0,4,4
120,2011-01-06,6,0,36,36
121,2011-01-06,7,0,93,93
122,2011-01-06,8,3,208,211
123,2011-01-06,9,6,111,117
124,2011-01-06,10,3,42,45
125,2011-01-06,11,2,56,58
126,2011-01-06,12,6,77,83
127,2011-01-06,13,12,55,67
128,2011-01-06,14,11,56,67
129,2011-01-06,15,8,53,61
130,2011-01-06,16,12,73,85
131,2011-01-06,17,9,162,171
132,2011-01-06,18,5,153,158
133,2011-01-06,19,3,108,111
134,2011-01-06,20,3,64,67
135,2011-01-06,21,0,47,47
136,2011-01-06,22,1,50,51
137,2011-01-06,23,4,19,23
138,2011-01-07,0,4,12,16
139,2011-01-07,1,2,5,7
140,2011-01-07,2,0,1,1
141,2011-01-07,4,0,1,1
142,2011-01-07,5,0,5,5
143,2011-01-07,6,8,26,34
144,2011-01-07,7,8,74,82
145,2011-01-07,8,20,189,209
146,2011-01-07,9,9,123,132
147,2011-01-07,10,16,47,63
148,2011-01-07,11,19,47,66
149,2011-01-07,12,9,50,59
150,2011-01-07,13,9,63,72
151,2011-01-07,14,7,42,49
152,2011-01-07,15,9,62,71
153,2011-01-07,16,5,81,86
154,2011-01-07,17,9,177,186
155,2011-01-07,18,7,115,122
156,2011-01-07,19,3,91,94
157,2011-01-07,20,1,48,49
158,2011-01-07,21,0,38,38
159,2011-01-07,22,2,34,36
160,2011-01-07,23,1,14,15
161,2011-01-08,0,1,24,25
162,2011-01-08,1,1,15,16
163,2011-01-08,2,3,13,16
164,2011-01-08,3,0,7,7
165,2011-01-08,4,0,1,1
166,2011-01-08,5,0,5,5
167,2011-01-08,6,0,2,2
168,2011-01-08,7,1,8,9
169,2011-01-08,8,0,15,15
170,2011-01-08,9,0,19,19
171,2011-01-08,10,5,54,59
172,2011-01-08,11,2,60,62
173,2011-01-08,12,8,88,96
174,2011-01-08,13,7,93,100
175,2011-01-08,14,12,82,94
176,2011-01-08,15,5,63,68
177,2011-01-08,16,8,65,73
178,2011-01-08,17,5,62,67
179,2011-01-08,18,3,52,55
180,2011-01-08,19,4,26,30
181,2011-01-08,20,0,27,27
182,2011-01-08,21,2,35,37
183,2011-01-08,22,1,33,34
184,2011-01-08,23,0,22,22
185,2011-01-09,0,1,24,25
186,2011-01-09,1,0,12,12
187,2011-01-09,2,0,11,11
188,2011-01-09,3,0,4,4
189,2011-01-09,4,0,1,1
190,2011-01-09,5,0,1,1
191,2011-01-09,6,0,1,1
192,2011-01-09,7,1,5,6
193,2011-01-09,8,0,10,10
194,2011-01-09,9,0,19,19
195,2011-01-09,10,0,48,48
196,2011-01-09,11,2,45,47
197,2011-01-09,12,4,76,80
198,2011-01-09,13,6,68,74
199,2011-01-09,14,8,60,68
200,2011-01-09,15,5,76,81
201,2011-01-09,16,13,75,88
202,2011-01-09,17,3,59,62
203,2011-01-09,18,4,43,47
204,2011-01-09,19,1,39,40
205,2011-01-09,20,0,37,37
206,2011-01-09,21,1,18,19
207,2011-01-09,22,5,10,15
208,2011-01-09,23,0,6,6
209,2011-01-10,0,2,2,4
210,2011-01-10,1,1,0,1
211,2011-01-10,2,0,3,3
212,2011-01-10,3,0,1,1
213,2011-01-10,4,1,2,3
214,2011-01-10,5,0,3,3
215,2011-01-10,6,0,29,29
216,2011-01-10,7,2,73,75
217,2011-01-10,8,4,180,184
218,2011-01-10,9,2,91,93
219,2011-01-10,10,0,29,29
220,2011-01-10,11,2,28,30
221,2011-01-10,12,5,47,52
222,2011-01-10,13,4,49,53
223,2011-01-10,14,0,47,47
224,2011-01-10,15,2,42,44
225,2011-01-10,16,4,70,74
226,2011-01-10,17,4,173,177
227,2011-01-10,18,1,153,154
228,2011-01-10,19,3,88,91
229,2011-01-10,20,1,70,71
230,2011-01-10,21,1,37,38
231,2011-01-10,22,2,22,24
232,2011-01-10,23,0,18,18
233,2011-01-11,0,2,10,12
234,2011-01-11,1,0,3,3
235,2011-01-11,2,0,2,2
236,2011-01-11,5,0,6,6
237,2011-01-11,6,0,26,26
238,2011-01-11,7,2,95,97
239,2011-01-11,8,3,207,210
240,2011-01-11,9,3,123,126
241,2011-01-11,10,3,50,53
242,2011-01-11,11,4,31,35
243,2011-01-11,12,2,54,56
244,2011-01-11,13,6,42,48
245,2011-01-11,14,3,59,62
246,2011-01-11,15,2,43,45
247,2011-01-11,16,4,70,74
248,2011-01-11,17,6,128,134
249,2011-01-11,18,1,90,91
250,2011-01-11,19,0,51,51
251,2011-01-11,20,0,32,32
252,2011-01-11,21,0,20,20
253,2011-01-11,22,1,28,29
254,2011-01-11,23,1,18,19
255,2011-01-12,0,0,7,7
256,2011-01-12,1,0,6,6
257,2011-01-12,2,0,1,1
258,2011-01-12,5,0,5,5
259,2011-01-12,6,0,16,16
260,2011-01-12,7,0,54,54
261,2011-01-12,8,3,125,128
262,2011-01-12,9,3,76,79
263,2011-01-12,10,0,39,39
264,2011-01-12,11,3,32,35
265,2011-01-12,12,3,50,53
266,2011-01-12,13,0,46,46
267,2011-01-12,14,0,43,43
268,2011-01-12,15,1,47,48
269,2011-01-12,16,5,61,66
270,2011-01-12,17,0,137,137
271,2011-01-12,18,2,135,137
272,2011-01-12,19,1,76,77
273,2011-01-12,20,2,54,56
274,2011-01-12,21,0,56,56
275,2011-01-12,22,1,31,32
276,2011-01-12,23,1,19,20
277,2011-01-13,0,1,6,7
278,2011-01-13,1,0,2,2
279,2011-01-13,2,0,2,2
280,2011-01-13,3,0,2,2
281,2011-01-13,4,0,4,4
282,2011-01-13,5,0,3,3
283,2011-01-13,6,0,28,28
284,2011-01-13,7,0,70,70
285,2011-01-13,8,5,196,201
286,2011-01-13,9,2,135,137
287,2011-01-13,10,2,36,38
288,2011-01-13,11,4,32,36
289,2011-01-13,12,3,49,52
290,2011-01-13,13,2,80,82
291,2011-01-13,14,3,39,42
292,2011-01-13,15,5,54,59
293,2011-01-13,16,2,74,76
294,2011-01-13,17,3,156,159
295,2011-01-13,18,3,139,142
296,2011-01-13,19,1,94,95
297,2011-01-13,20,0,64,64
298,2011-01-13,21,0,37,37
299,2011-01-13,22,0,30,30
300,2011-01-13,23,1,14,15
301,2011-01-14,0,0,13,13
302,2011-01-14,1,0,5,5
303,2011-01-14,2,0,1,1
304,2011-01-14,3,0,1,1
305,2011-01-14,5,0,8,8
306,2011-01-14,6,0,17,17
307,2011-01-14,7,0,69,69
308,2011-01-14,8,2,153,155
309,2011-01-14,9,0,111,111
310,2011-01-14,10,4,39,43
311,2011-01-14,11,6,45,51
312,2011-01-14,12,2,57,59
313,2011-01-14,13,4,73,77
314,2011-01-14,14,5,57,62
315,2011-01-14,15,9,58,67
316,2011-01-14,16,3,84,87
317,2011-01-14,17,4,154,158
318,2011-01-14,18,5,131,136
319,2011-01-14,19,3,85,88
320,2011-01-14,20,0,66,66
321,2011-01-14,21,4,48,52
322,2011-01-14,22,2,30,32
323,2011-01-14,23,1,25,26
324,2011-01-15,0,3,25,28
325,2011-01-15,1,2,18,20
326,2011-01-15,2,0,12,12
327,2011-01-15,3,1,7,8
328,2011-01-15,4,0,5,5
329,2011-01-15,5,0,1,1
330,2011-01-15,6,1,2,3
331,2011-01-15,7,1,9,10
332,2011-01-15,8,1,21,22
333,2011-01-15,9,2,31,33
334,2011-01-15,10,2,57,59
335,2011-01-15,11,18,54,72
336,2011-01-15,12,15,74,89
337,2011-01-15,13,21,80,101
338,2011-01-15,14,26,91,117
339,2011-01-15,15,21,107,128
340,2011-01-15,16,33,94,127
341,2011-01-15,17,29,53,82
342,2011-01-15,18,15,69,84
343,2011-01-15,19,14,59,73
344,2011-01-15,20,6,34,40
345,2011-01-15,21,6,51,57
346,2011-01-15,22,0,26,26
347,2011-01-15,23,5,38,43
348,2011-01-16,0,6,32,38
349,2011-01-16,1,4,19,23
350,2011-01-16,2,3,12,15
351,2011-01-16,3,9,6,15
352,2011-01-16,4,0,1,1
353,2011-01-16,5,1,1,2
354,2011-01-16,6,0,1,1
355,2011-01-16,7,0,3,3
356,2011-01-16,8,0,17,17
357,2011-01-16,9,3,29,32
358,2011-01-16,10,8,70,78
359,2011-01-16,11,23,68,91
360,2011-01-16,12,29,74,103
361,2011-01-16,13,23,94,117
362,2011-01-16,14,22,67,89
363,2011-01-16,15,35,75,110
364,2011-01-16,16,22,77,99
365,2011-01-16,17,23,81,104
366,2011-01-16,18,11,56,67
367,2011-01-16,19,14,46,60
368,2011-01-16,20,7,50,57
369,2011-01-16,21,6,21,27
370,2011-01-16,22,2,19,21
371,2011-01-16,23,0,18,18
372,2011-01-17,0,1,16,17
373,2011-01-17,1,1,15,16
374,2011-01-17,2,0,8,8
375,2011-01-17,3,0,2,2
376,2011-01-17,4,1,2,3
377,2011-01-17,5,0,1,1
378,2011-01-17,6,0,5,5
379,2011-01-17,7,4,9,13
380,2011-01-17,8,3,30,33
381,2011-01-17,9,8,39,47
382,2011-01-17,10,7,49,56
383,2011-01-17,11,9,55,64
384,2011-01-17,12,10,69,79
385,2011-01-17,13,13,79,92
386,2011-01-17,14,12,74,86
387,2011-01-17,15,21,72,93
388,2011-01-17,16,6,75,81
389,2011-01-17,17,4,67,71
390,2011-01-17,18,7,83,90
391,2011-01-17,19,2,58,60
392,2011-01-17,20,4,29,33
393,2011-01-17,21,3,23,26
394,2011-01-17,22,0,13,13
395,2011-01-17,23,1,3,4
396,2011-01-18,12,0,3,3
397,2011-01-18,13,0,20,20
398,2011-01-18,14,2,25,27
399,2011-01-18,15,3,32,35
400,2011-01-18,16,0,61,61
401,2011-01-18,17,1,121,122
402,2011-01-18,18,1,131,132
403,2011-01-18,19,1,97,98
404,2011-01-18,20,0,80,80
405,2011-01-18,21,0,41,41
406,2011-01-18,22,0,33,33
407,2011-01-18,23,1,19,20
408,2011-01-19,0,0,3,3
409,2011-01-19,1,1,6,7
410,2011-01-19,2,0,3,3
411,2011-01-19,4,1,1,2
412,2011-01-19,5,0,7,7
413,2011-01-19,6,0,32,32
414,2011-01-19,7,1,89,90
415,2011-01-19,8,1,196,197
416,2011-01-19,9,2,107,109
417,2011-01-19,10,1,42,43
418,2011-01-19,11,5,46,51
419,2011-01-19,12,5,63,68
420,2011-01-19,13,11,67,78
421,2011-01-19,14,7,68,75
422,2011-01-19,15,4,78,82
423,2011-01-19,16,10,88,98
424,2011-01-19,17,7,190,197
425,2011-01-19,18,5,155,160
426,2011-01-19,19,4,107,111
427,2011-01-19,20,2,73,75
428,2011-01-19,21,4,54,58
429,2011-01-19,22,6,51,57
430,2011-01-19,23,1,27,28
431,2011-01-20,0,5,8,13
432,2011-01-20,1,2,3,5
433,2011-01-20,2,0,2,2
434,2011-01-20,3,0,1,1
435,2011-01-20,4,0,1,1
436,2011-01-20,5,0,6,6
437,2011-01-20,6,0,35,35
438,2011-01-20,7,1,99,100
439,2011-01-20,8,2,243,245
440,2011-01-20,9,3,140,143
441,2011-01-20,10,1,55,56
442,2011-01-20,11,5,63,68
443,2011-01-20,12,7,74,81
444,2011-01-20,13,12,76,88
445,2011-01-20,14,6,74,80
446,2011-01-20,15,8,62,70
447,2011-01-20,16,7,81,88
448,2011-01-20,17,8,206,214
449,2011-01-20,18,1,183,184
450,2011-01-20,19,5,144,149
451,2011-01-20,20,2,122,124
452,2011-01-20,21,3,53,56
453,2011-01-20,22,0,56,56
454,2011-01-20,23,3,28,31
455,2011-01-21,0,1,20,21
456,2011-01-21,1,0,6,6
457,2011-01-21,2,0,2,2
458,2011-01-21,3,0,1,1
459,2011-01-21,4,0,1,1
460,2011-01-21,5,1,4,5
461,2011-01-21,6,0,27,27
462,2011-01-21,7,2,66,68
463,2011-01-21,8,7,207,214
464,2011-01-21,9,7,158,165
465,2011-01-21,10,6,56,62
466,2011-01-21,11,6,53,59
467,2011-01-21,12,10,65,75
468,2011-01-21,13,8,65,73
469,2011-01-21,14,5,55,60
470,2011-01-21,15,4,60,64
471,2011-01-21,16,0,97,97
472,2011-01-21,17,10,151,161
473,2011-01-21,18,1,116,117
474,2011-01-21,19,3,89,92
475,2011-01-21,20,1,51,52
476,2011-01-21,21,0,40,40
477,2011-01-21,22,1,33,34
478,2011-01-21,23,0,26,26
479,2011-01-22,0,0,13,13
480,2011-01-22,1,3,9,12
481,2011-01-22,2,0,11,11
482,2011-01-22,3,1,6,7
483,2011-01-22,4,0,3,3
484,2011-01-22,6,0,2,2
485,2011-01-22,7,0,8,8
486,2011-01-22,8,1,26,27
487,2011-01-22,9,3,35,38
488,2011-01-22,10,3,49,52
489,2011-01-22,11,4,58,62
490,2011-01-22,12,10,60,70
491,2011-01-22,13,12,71,83
492,2011-01-22,14,11,64,75
493,2011-01-22,15,10,91,101
494,2011-01-22,16,11,71,82
495,2011-01-22,17,8,57,65
496,2011-01-22,18,0,54,54
497,2011-01-22,19,6,52,58
498,2011-01-22,20,1,44,45
499,2011-01-22,21,0,39,39
500,2011-01-22,22,7,23,30
501,2011-01-22,23,2,30,32
502,2011-01-23,0,2,20,22
503,2011-01-23,1,1,12,13
504,2011-01-23,2,3,14,17
505,2011-01-23,3,1,4,5
506,2011-01-23,5,0,3,3
507,2011-01-23,6,0,1,1
508,2011-01-23,7,1,1,2
509,2011-01-23,8,2,17,19
510,2011-01-23,9,3,25,28
511,2011-01-23,10,7,50,57
512,2011-01-23,11,22,75,97
513,2011-01-23,12,24,90,114
514,2011-01-23,13,12,75,87
515,2011-01-23,14,17,93,110
516,2011-01-23,15,13,63,76
517,2011-01-23,16,9,56,65
518,2011-01-23,17,5,50,55
519,2011-01-23,18,5,43,48
520,2011-01-23,19,5,45,50
521,2011-01-23,20,4,31,35
522,2011-01-23,21,5,20,25
523,2011-01-23,22,5,23,28
524,2011-01-23,23,4,16,20
525,2011-01-24,0,0,7,7
526,2011-01-24,1,0,1,1
527,2011-01-24,3,0,1,1
528,2011-01-24,4,0,1,1
529,2011-01-24,5,0,5,5
530,2011-01-24,6,0,15,15
531,2011-01-24,7,5,78,83
532,2011-01-24,8,6,171,177
533,2011-01-24,9,4,98,102
534,2011-01-24,10,6,34,40
535,2011-01-24,11,3,43,46
536,2011-01-24,12,11,52,63
537,2011-01-24,13,6,54,60
538,2011-01-24,14,2,43,45
539,2011-01-24,15,7,49,56
540,2011-01-24,16,4,66,70
541,2011-01-24,17,6,176,182
542,2011-01-24,18,8,145,153
543,2011-01-24,19,5,98,103
544,2011-01-24,20,1,78,79
545,2011-01-24,21,6,52,58
546,2011-01-24,22,3,31,34
547,2011-01-24,23,3,21,24
548,2011-01-25,0,3,6,9
549,2011-01-25,1,0,5,5
550,2011-01-25,2,0,2,2
551,2011-01-25,4,0,1,1
552,2011-01-25,5,0,8,8
553,2011-01-25,6,1,34,35
554,2011-01-25,7,5,103,108
555,2011-01-25,8,5,231,236
556,2011-01-25,9,10,134,144
557,2011-01-25,10,6,47,53
558,2011-01-25,11,6,54,60
559,2011-01-25,12,21,84,105
560,2011-01-25,13,21,72,93
561,2011-01-25,14,11,57,68
562,2011-01-25,15,21,63,84
563,2011-01-25,16,14,102,116
564,2011-01-25,17,14,207,221
565,2011-01-25,18,7,217,224
566,2011-01-25,19,13,132,145
567,2011-01-25,20,16,101,117
568,2011-01-25,21,5,40,45
569,2011-01-25,22,4,48,52
570,2011-01-25,23,3,37,40
571,2011-01-26,0,3,14,17
572,2011-01-26,1,0,5,5
573,2011-01-26,2,3,7,10
574,2011-01-26,5,0,1,1
575,2011-01-26,6,0,8,8
576,2011-01-26,7,1,29,30
577,2011-01-26,8,3,69,72
578,2011-01-26,9,3,54,57
579,2011-01-26,10,2,26,28
580,2011-01-26,11,6,35,41
581,2011-01-26,12,7,39,46
582,2011-01-26,13,4,42,46
583,2011-01-26,14,0,36,36
584,2011-01-26,15,1,41,42
585,2011-01-26,16,1,34,35
586,2011-01-26,17,0,26,26
587,2011-01-27,16,1,21,22
588,2011-01-27,17,2,79,81
589,2011-01-27,18,3,101,104
590,2011-01-27,19,3,76,79
591,2011-01-27,20,4,54,58
592,2011-01-27,21,2,35,37
593,2011-01-27,22,0,27,27
594,2011-01-27,23,0,16,16
595,2011-01-28,0,0,9,9
596,2011-01-28,1,1,2,3
597,2011-01-28,2,0,2,2
598,2011-01-28,3,1,0,1
599,2011-01-28,5,0,4,4
600,2011-01-28,6,0,16,16
601,2011-01-28,7,2,58,60
602,2011-01-28,8,2,150,152
603,2011-01-28,9,6,94,100
604,2011-01-28,10,0,48,48
605,2011-01-28,11,0,30,30
606,2011-01-28,12,1,27,28
607,2011-01-28,13,0,29,29
608,2011-01-28,14,2,36,38
609,2011-01-28,15,1,39,40
610,2011-01-28,16,10,69,79
611,2011-01-28,17,2,147,149
612,2011-01-28,18,2,105,107
613,2011-01-28,19,5,83,88
614,2011-01-28,20,1,60,61
615,2011-01-28,21,1,57,58
616,2011-01-28,22,0,26,26
617,2011-01-28,23,1,22,23
618,2011-01-29,0,2,25,27
619,2011-01-29,1,0,18,18
620,2011-01-29,2,0,14,14
621,2011-01-29,3,3,5,8
622,2011-01-29,4,1,2,3
623,2011-01-29,6,0,2,2
624,2011-01-29,7,1,4,5
625,2011-01-29,8,3,31,34
626,2011-01-29,9,0,34,34
627,2011-01-29,10,4,47,51
628,2011-01-29,11,4,55,59
629,2011-01-29,12,12,62,74
630,2011-01-29,13,9,55,64
631,2011-01-29,14,10,84,94
632,2011-01-29,15,22,97,119
633,2011-01-29,16,19,87,106
634,2011-01-29,17,9,81,90
635,2011-01-29,18,9,58,67
636,2011-01-29,19,6,52,58
637,2011-01-29,20,1,41,42
638,2011-01-29,21,1,35,36
639,2011-01-29,22,4,28,32
640,2011-01-29,23,3,30,33
641,2011-01-30,0,0,32,32
642,2011-01-30,1,7,21,28
643,2011-01-30,2,1,10,11
644,2011-01-30,3,1,7,8
645,2011-01-30,4,0,1,1
646,2011-01-30,5,0,3,3
647,2011-01-30,7,0,3,3
648,2011-01-30,8,1,11,12
649,2011-01-30,9,4,33,37
650,2011-01-30,10,7,57,64
651,2011-01-30,11,9,50,59
652,2011-01-30,12,10,85,95
653,2011-01-30,13,13,71,84
654,2011-01-30,14,18,103,121
655,2011-01-30,15,14,94,108
656,2011-01-30,16,19,103,122
657,2011-01-30,17,6,69,75
658,2011-01-30,18,8,56,64
659,2011-01-30,19,9,46,55
660,2011-01-30,20,3,30,33
661,2011-01-30,21,3,24,27
662,2011-01-30,22,2,19,21
663,2011-01-30,23,5,16,21
664,2011-01-31,0,1,6,7
665,2011-01-31,1,2,5,7
666,2011-01-31,2,0,1,1
667,2011-01-31,3,0,2,2
668,2011-01-31,4,0,2,2
669,2011-01-31,5,0,8,8
670,2011-01-31,6,0,37,37
671,2011-01-31,7,1,71,72
672,2011-01-31,8,3,180,183
673,2011-01-31,9,0,109,109
674,2011-01-31,10,1,47,48
675,2011-01-31,11,2,41,43
676,2011-01-31,12,6,53,59
677,2011-01-31,13,2,41,43
678,2011-01-31,14,1,63,64
679,2011-01-31,15,3,40,43
680,2011-01-31,16,3,79,82
681,2011-01-31,17,6,154,160
682,2011-01-31,18,3,151,154
683,2011-01-31,19,3,107,110
684,2011-01-31,20,0,78,78
685,2011-01-31,21,3,52,55
686,2011-01-31,22,0,34,34
687,2011-01-31,23,2,15,17
688,2011-02-01,0,2,6,8
689,2011-02-01,1,0,3,3
690,2011-02-01,2,0,2,2
691,2011-02-01,3,0,2,2
692,2011-02-01,5,0,3,3
693,2011-02-01,6,0,22,22
694,2011-02-01,7,0,51,51
695,2011-02-01,8,3,129,132
696,2011-02-01,9,2,113,115
697,2011-02-01,10,0,38,38
698,2011-02-01,11,2,44,46
699,2011-02-01,12,2,53,55
700,2011-02-01,13,3,47,50
701,2011-02-01,14,5,48,53
702,2011-02-01,15,7,45,52
703,2011-02-01,16,3,61,64
704,2011-02-01,17,4,171,175
705,2011-02-01,18,3,163,166
706,2011-02-01,19,3,102,105
707,2011-02-01,20,5,68,73
708,2011-02-01,21,0,64,64
709,2011-02-01,22,2,34,36
710,2011-02-01,23,1,15,16
711,2011-02-02,0,0,2,2
712,2011-02-02,1,0,3,3
713,2011-02-02,2,4,0,4
714,2011-02-02,3,0,1,1
715,2011-02-02,4,0,1,1
716,2011-02-02,5,0,3,3
717,2011-02-02,6,1,17,18
718,2011-02-02,7,1,47,48
719,2011-02-02,8,1,154,155
720,2011-02-02,9,4,118,122
721,2011-02-02,10,2,56,58
722,2011-02-02,11,5,43,48
723,2011-02-02,12,3,59,62
724,2011-02-02,13,1,73,74
725,2011-02-02,14,2,60,62
726,2011-02-02,15,10,63,73
727,2011-02-02,16,8,94,102
728,2011-02-02,17,7,183,190
729,2011-02-02,18,7,172,179
730,2011-02-02,19,3,87,90
731,2011-02-02,20,4,71,75
732,2011-02-02,21,1,61,62
733,2011-02-02,22,5,35,40
734,2011-02-02,23,3,27,30
735,2011-02-03,0,1,11,12
736,2011-02-03,1,0,5,5
737,2011-02-03,2,0,2,2
738,2011-02-03,3,0,1,1
739,2011-02-03,5,0,2,2
740,2011-02-03,6,0,38,38
741,2011-02-03,7,1,85,86
742,2011-02-03,8,4,183,187
743,2011-02-03,9,6,127,133
744,2011-02-03,10,2,50,52
745,2011-02-03,11,9,52,61
746,2011-02-03,12,2,65,67
747,2011-02-03,13,4,46,50
748,2011-02-03,14,4,42,46
749,2011-02-03,15,4,55,59
750,2011-02-03,16,5,73,78
751,2011-02-03,17,5,170,175
752,2011-02-03,18,2,141,143
753,2011-02-03,19,4,91,95
754,2011-02-03,20,1,108,109
755,2011-02-03,21,1,53,54
756,2011-02-03,22,2,39,41
757,2011-02-03,23,4,34,38
758,2011-02-04,0,3,10,13
759,2011-02-04,1,0,7,7
760,2011-02-04,2,0,1,1
761,2011-02-04,3,0,1,1
762,2011-02-04,5,0,7,7
763,2011-02-04,6,2,26,28
764,2011-02-04,7,0,86,86
765,2011-02-04,8,3,214,217
766,2011-02-04,9,3,120,123
767,2011-02-04,10,5,46,51
768,2011-02-04,11,3,61,64
769,2011-02-04,12,8,77,85
770,2011-02-04,13,9,73,82
771,2011-02-04,14,15,76,91
772,2011-02-04,15,9,79,88
773,2011-02-04,16,8,90,98
774,2011-02-04,17,10,194,204
775,2011-02-04,18,3,151,154
776,2011-02-04,19,1,100,101
777,2011-02-04,20,2,69,71
778,2011-02-04,21,2,41,43
779,2011-02-04,22,1,45,46
780,2011-02-04,23,1,29,30
781,2011-02-05,0,3,36,39
782,2011-02-05,1,1,17,18
783,2011-02-05,2,5,11,16
784,2011-02-05,3,1,10,11
785,2011-02-05,4,0,8,8
786,2011-02-05,5,0,9,9
787,2011-02-05,6,0,4,4
788,2011-02-05,7,0,4,4
789,2011-02-05,8,0,10,10
790,2011-02-05,9,3,17,20
791,2011-02-05,10,3,31,34
792,2011-02-05,11,1,46,47
793,2011-02-05,12,10,40,50
794,2011-02-05,13,10,61,71
795,2011-02-05,14,5,48,53
796,2011-02-05,15,11,49,60
797,2011-02-05,16,8,62,70
798,2011-02-05,17,14,64,78
799,2011-02-05,18,2,79,81
800,2011-02-05,19,6,78,84
801,2011-02-05,20,5,62,67
802,2011-02-05,21,3,52,55
803,2011-02-05,22,2,42,44
804,2011-02-05,23,7,52,59
805,2011-02-06,0,2,36,38
806,2011-02-06,1,4,40,44
807,2011-02-06,2,0,19,19
808,2011-02-06,3,3,10,13
809,2011-02-06,4,0,2,2
810,2011-02-06,5,0,1,1
811,2011-02-06,6,0,1,1
812,2011-02-06,7,0,8,8
813,2011-02-06,8,2,21,23
814,2011-02-06,9,7,38,45
815,2011-02-06,10,15,74,89
816,2011-02-06,11,27,85,112
817,2011-02-06,12,49,124,173
818,2011-02-06,13,47,133,180
819,2011-02-06,14,47,110,157
820,2011-02-06,15,52,126,178
821,2011-02-06,16,42,115,157
822,2011-02-06,17,24,96,120
823,2011-02-06,18,13,65,78
824,2011-02-06,19,1,19,20
825,2011-02-06,20,5,21,26
826,2011-02-06,21,5,22,27
827,2011-02-06,22,5,56,61
828,2011-02-06,23,4,26,30
829,2011-02-07,0,1,14,15
830,2011-02-07,1,1,4,5
831,2011-02-07,2,0,3,3
832,2011-02-07,3,0,1,1
833,2011-02-07,4,1,1,2
834,2011-02-07,5,1,9,10
835,2011-02-07,6,1,29,30
836,2011-02-07,7,6,89,95
837,2011-02-07,8,7,221,228
838,2011-02-07,9,3,114,117
839,2011-02-07,10,5,45,50
840,2011-02-07,11,11,34,45
841,2011-02-07,12,7,57,64
842,2011-02-07,13,10,54,64
843,2011-02-07,14,8,45,53
844,2011-02-07,15,4,45,49
845,2011-02-07,16,16,98,114
846,2011-02-07,17,9,205,214
847,2011-02-07,18,5,170,175
848,2011-02-07,19,5,120,125
849,2011-02-07,20,6,82,88
850,2011-02-07,21,3,75,78
851,2011-02-07,22,3,34,37
852,2011-02-07,23,6,19,25
853,2011-02-08,0,4,6,10
854,2011-02-08,1,0,4,4
855,2011-02-08,2,1,1,2
856,2011-02-08,3,0,1,1
857,2011-02-08,4,0,3,3
858,2011-02-08,5,0,2,2
859,2011-02-08,6,0,39,39
860,2011-02-08,7,3,96,99
861,2011-02-08,8,7,232,239
862,2011-02-08,9,7,127,134
863,2011-02-08,10,4,43,47
864,2011-02-08,11,1,48,49
865,2011-02-08,12,2,60,62
866,2011-02-08,13,2,48,50
867,2011-02-08,14,3,61,64
868,2011-02-08,15,6,44,50
869,2011-02-08,16,4,79,83
870,2011-02-08,17,4,171,175
871,2011-02-08,18,1,148,149
872,2011-02-08,19,1,98,99
873,2011-02-08,20,3,52,55
874,2011-02-08,21,8,45,53
875,2011-02-08,22,0,29,29
876,2011-02-08,23,3,9,12
877,2011-02-09,0,0,17,17
878,2011-02-09,1,0,7,7
879,2011-02-09,2,1,2,3
880,2011-02-09,3,0,2,2
881,2011-02-09,5,0,7,7
882,2011-02-09,6,0,43,43
883,2011-02-09,7,4,94,98
884,2011-02-09,8,1,196,197
885,2011-02-09,9,3,117,120
886,2011-02-09,10,8,51,59
887,2011-02-09,11,1,40,41
888,2011-02-09,12,4,57,61
889,2011-02-09,13,2,67,69
890,2011-02-09,14,2,56,58
891,2011-02-09,15,3,60,63
892,2011-02-09,16,7,69,76
893,2011-02-09,17,9,157,166
894,2011-02-09,18,2,165,167
895,2011-02-09,19,1,87,88
896,2011-02-09,20,0,84,84
897,2011-02-09,21,0,83,83
898,2011-02-09,22,4,42,46
899,2011-02-09,23,0,37,37
900,2011-02-10,0,0,16,16
901,2011-02-10,1,0,7,7
902,2011-02-10,2,0,3,3
903,2011-02-10,4,0,1,1
904,2011-02-10,5,0,6,6
905,2011-02-10,6,0,26,26
906,2011-02-10,7,0,96,96
907,2011-02-10,8,4,173,177
908,2011-02-10,9,1,121,122
909,2011-02-10,10,1,34,35
910,2011-02-10,11,1,44,45
911,2011-02-10,12,4,65,69
912,2011-02-10,13,3,56,59
913,2011-02-10,14,6,41,47
914,2011-02-10,15,0,50,50
915,2011-02-10,16,4,76,80
916,2011-02-10,17,6,157,163
917,2011-02-10,18,3,154,157
918,2011-02-10,19,2,110,112
919,2011-02-10,20,4,91,95
920,2011-02-10,21,2,70,72
921,2011-02-10,22,4,46,50
922,2011-02-10,23,1,31,32
923,2011-02-11,0,2,11,13
924,2011-02-11,1,1,6,7
925,2011-02-11,2,0,3,3
926,2011-02-11,5,0,4,4
927,2011-02-11,6,1,23,24
928,2011-02-11,7,1,73,74
929,2011-02-11,8,4,211,215
930,2011-02-11,9,7,131,138
931,2011-02-11,10,5,38,43
932,2011-02-11,11,12,52,64
933,2011-02-11,12,7,61,68
934,2011-02-11,13,21,88,109
935,2011-02-11,14,17,65,82
936,2011-02-11,15,12,62,74
937,2011-02-11,16,14,111,125
938,2011-02-11,17,18,187,205
939,2011-02-11,18,9,163,172
940,2011-02-11,19,6,94,100
941,2011-02-11,20,2,59,61
942,2011-02-11,21,1,46,47
943,2011-02-11,22,2,41,43
944,2011-02-11,23,5,47,52
945,2011-02-12,0,3,26,29
946,2011-02-12,1,2,22,24
947,2011-02-12,2,2,12,14
948,2011-02-12,3,3,7,10
949,2011-02-12,4,0,4,4
950,2011-02-12,5,0,1,1
951,2011-02-12,6,1,1,2
952,2011-02-12,7,2,9,11
953,2011-02-12,8,2,28,30
954,2011-02-12,9,5,38,43
955,2011-02-12,10,13,69,82
956,2011-02-12,11,30,84,114
957,2011-02-12,12,27,92,119
958,2011-02-12,13,32,100,132
959,2011-02-12,14,30,90,120
960,2011-02-12,15,47,126,173
961,2011-02-12,16,42,100,142
962,2011-02-12,17,24,112,136
963,2011-02-12,18,4,60,64
964,2011-02-12,19,2,39,41
965,2011-02-12,20,1,37,38
966,2011-02-12,21,9,42,51
967,2011-02-12,22,6,37,43
968,2011-02-12,23,1,31,32
969,2011-02-13,0,5,33,38
970,2011-02-13,1,0,22,22
971,2011-02-13,2,1,18,19
972,2011-02-13,3,4,8,12
973,2011-02-13,4,0,2,2
974,2011-02-13,6,2,3,5
975,2011-02-13,7,0,3,3
976,2011-02-13,8,1,11,12
977,2011-02-13,9,12,34,46
978,2011-02-13,10,19,85,104
979,2011-02-13,11,26,83,109
980,2011-02-13,12,58,92,150
981,2011-02-13,13,62,90,152
982,2011-02-13,14,51,102,153
983,2011-02-13,15,40,121,161
984,2011-02-13,16,28,105,133
985,2011-02-13,17,30,95,125
986,2011-02-13,18,17,76,93
987,2011-02-13,19,11,49,60
988,2011-02-13,20,15,32,47
989,2011-02-13,21,6,44,50
990,2011-02-13,22,5,28,33
991,2011-02-13,23,3,25,28
992,2011-02-14,0,3,8,11
993,2011-02-14,1,1,6,7
994,2011-02-14,2,0,2,2
995,2011-02-14,3,1,1,2
996,2011-02-14,4,0,2,2
997,2011-02-14,5,0,3,3
998,2011-02-14,6,1,25,26
999,2011-02-14,7,2,95,97
1000,2011-02-14,8,7,243,250
1001,2011-02-14,9,8,121,129
1002,2011-02-14,10,9,45,54
1003,2011-02-14,11,10,43,53
1004,2011-02-14,12,26,97,123
1005,2011-02-14,13,27,92,119
1006,2011-02-14,14,14,76,90
1007,2011-02-14,15,19,70,89
1008,2011-02-14,16,16,100,116
1009,2011-02-14,17,25,214,239
1010,2011-02-14,18,11,193,204
1011,2011-02-14,19,12,86,98
1012,2011-02-14,20,5,65,70
1013,2011-02-14,21,8,35,43
1014,2011-02-14,22,1,44,45
1015,2011-02-14,23,1,19,20
1016,2011-02-15,0,7,12,19
1017,2011-02-15,1,0,5,5
1018,2011-02-15,2,1,2,3
1019,2011-02-15,4,0,1,1
1020,2011-02-15,5,0,4,4
1021,2011-02-15,6,0,29,29
1022,2011-02-15,7,2,101,103
1023,2011-02-15,8,10,212,222
1024,2011-02-15,9,2,106,108
1025,2011-02-15,10,5,46,51
1026,2011-02-15,11,11,46,57
1027,2011-02-15,12,6,65,71
1028,2011-02-15,13,14,67,81
1029,2011-02-15,14,10,61,71
1030,2011-02-15,15,11,73,84
1031,2011-02-15,16,21,76,97
1032,2011-02-15,17,14,186,200
1033,2011-02-15,18,14,197,211
1034,2011-02-15,19,3,139,142
1035,2011-02-15,20,3,93,96
1036,2011-02-15,21,5,60,65
1037,2011-02-15,22,0,40,40
1038,2011-02-15,23,0,20,20
1039,2011-02-16,0,0,15,15
1040,2011-02-16,1,0,9,9
1041,2011-02-16,3,0,1,1
1042,2011-02-16,4,0,1,1
1043,2011-02-16,5,0,5,5
1044,2011-02-16,6,1,31,32
1045,2011-02-16,7,5,103,108
1046,2011-02-16,8,6,220,226
1047,2011-02-16,9,2,119,121
1048,2011-02-16,10,14,54,68
1049,2011-02-16,11,7,57,64
1050,2011-02-16,12,14,71,85
1051,2011-02-16,13,13,76,89
1052,2011-02-16,14,17,62,79
1053,2011-02-16,15,35,82,117
1054,2011-02-16,16,26,96,122
1055,2011-02-16,17,11,240,251
1056,2011-02-16,18,20,196,216
1057,2011-02-16,19,18,142,160
1058,2011-02-16,20,10,106,116
1059,2011-02-16,21,5,84,89
1060,2011-02-16,22,12,60,72
1061,2011-02-16,23,2,31,33
1062,2011-02-17,0,1,16,17
1063,2011-02-17,1,0,6,6
1064,2011-02-17,2,2,3,5
1065,2011-02-17,3,3,1,4
1066,2011-02-17,4,3,1,4
1067,2011-02-17,5,1,11,12
1068,2011-02-17,6,3,44,47
1069,2011-02-17,7,7,119,126
1070,2011-02-17,8,18,265,283
1071,2011-02-17,9,16,162,178
1072,2011-02-17,10,18,70,88
1073,2011-02-17,11,19,69,88
1074,2011-02-17,12,15,86,101
1075,2011-02-17,13,15,105,120
1076,2011-02-17,14,26,54,80
1077,2011-02-17,15,14,89,103
1078,2011-02-17,16,29,114,143
1079,2011-02-17,17,18,251,269
1080,2011-02-17,18,11,209,220
1081,2011-02-17,19,14,160,174
1082,2011-02-17,20,8,127,135
1083,2011-02-17,21,5,117,122
1084,2011-02-17,22,8,67,75
1085,2011-02-17,23,4,39,43
1086,2011-02-18,0,12,20,32
1087,2011-02-18,1,1,7,8
1088,2011-02-18,2,2,5,7
1089,2011-02-18,3,2,6,8
1090,2011-02-18,4,0,1,1
1091,2011-02-18,5,1,6,7
1092,2011-02-18,6,2,48,50
1093,2011-02-18,7,8,106,114
1094,2011-02-18,8,25,241,266
1095,2011-02-18,9,15,153,168
1096,2011-02-18,10,17,77,94
1097,2011-02-18,11,31,78,109
1098,2011-02-18,12,59,125,184
1099,2011-02-18,13,45,128,173
1100,2011-02-18,14,73,117,190
1101,2011-02-18,15,55,113,168
1102,2011-02-18,16,68,163,231
1103,2011-02-18,17,52,272,324
1104,2011-02-18,18,29,191,220
1105,2011-02-18,19,16,144,160
1106,2011-02-18,20,19,102,121
1107,2011-02-18,21,11,61,72
1108,2011-02-18,22,19,88,107
1109,2011-02-18,23,16,61,77
1110,2011-02-19,0,6,22,28
1111,2011-02-19,1,10,21,31
1112,2011-02-19,2,3,14,17
1113,2011-02-19,3,0,7,7
1114,2011-02-19,4,0,3,3
1115,2011-02-19,5,0,3,3
1116,2011-02-19,6,3,3,6
1117,2011-02-19,7,6,16,22
1118,2011-02-19,8,9,34,43
1119,2011-02-19,9,18,37,55
1120,2011-02-19,10,34,71,105
1121,2011-02-19,11,47,76,123
1122,2011-02-19,12,38,78,116
1123,2011-02-19,13,52,99,151
1124,2011-02-19,14,102,93,195
1125,2011-02-19,15,84,83,167
1126,2011-02-19,16,39,80,119
1127,2011-02-19,17,36,88,124
1128,2011-02-19,18,21,63,84
1129,2011-02-19,19,5,53,58
1130,2011-02-19,20,9,38,47
1131,2011-02-19,21,4,29,33
1132,2011-02-19,22,2,41,43
1133,2011-02-19,23,4,25,29
1134,2011-02-20,0,3,14,17
1135,2011-02-20,1,5,11,16
1136,2011-02-20,2,0,16,16
1137,2011-02-20,3,9,8,17
1138,2011-02-20,4,0,1,1
1139,2011-02-20,6,1,1,2
1140,2011-02-20,7,0,2,2
1141,2011-02-20,8,2,22,24
1142,2011-02-20,9,7,47,54
1143,2011-02-20,10,34,69,103
1144,2011-02-20,11,72,89,161
1145,2011-02-20,12,62,116,178
1146,2011-02-20,13,76,119,195
1147,2011-02-20,14,108,103,211
1148,2011-02-20,15,66,102,168
1149,2011-02-20,16,59,83,142
1150,2011-02-20,17,60,83,143
1151,2011-02-20,18,30,71,101
1152,2011-02-20,19,3,37,40
1153,2011-02-20,20,12,28,40
1154,2011-02-20,21,17,39,56
1155,2011-02-20,22,4,42,46
1156,2011-02-20,23,9,45,54
1157,2011-02-21,0,7,30,37
1158,2011-02-21,1,2,11,13
1159,2011-02-21,2,1,3,4
1160,2011-02-21,3,2,3,5
1161,2011-02-21,4,1,0,1
1162,2011-02-21,5,1,2,3
1163,2011-02-21,6,2,6,8
1164,2011-02-21,7,3,16,19
1165,2011-02-21,8,7,56,63
1166,2011-02-21,9,11,44,55
1167,2011-02-21,10,29,51,80
1168,2011-02-21,11,20,69,89
1169,2011-02-21,12,26,65,91
1170,2011-02-21,13,28,73,101
1171,2011-02-21,14,15,100,115
1172,2011-02-21,15,11,76,87
1173,2011-02-21,16,8,47,55
1174,2011-02-21,17,18,61,79
1175,2011-02-21,18,2,62,64
1176,2011-02-21,19,0,49,49
1177,2011-02-21,20,0,28,28
1178,2011-02-21,21,1,33,34
1179,2011-02-21,22,0,11,11
1180,2011-02-21,23,0,2,2
1181,2011-02-22,6,0,7,7
1182,2011-02-22,7,0,40,40
1183,2011-02-22,8,7,105,112
1184,2011-02-22,9,5,98,103
1185,2011-02-22,10,0,43,43
1186,2011-02-22,11,7,43,50
1187,2011-02-22,12,7,47,54
1188,2011-02-22,13,3,50,53
1189,2011-02-22,14,9,49,58
1190,2011-02-22,15,2,67,69
1191,2011-02-22,16,7,79,86
1192,2011-02-22,17,8,187,195
1193,2011-02-22,18,6,158,164
1194,2011-02-22,19,4,113,117
1195,2011-02-22,20,3,100,103
1196,2011-02-22,21,2,79,81
1197,2011-02-22,22,1,75,76
1198,2011-02-22,23,3,18,21
1199,2011-02-23,0,0,6,6
1200,2011-02-23,1,0,4,4
1201,2011-02-23,2,0,1,1
1202,2011-02-23,3,0,2,2
1203,2011-02-23,5,0,8,8
1204,2011-02-23,6,0,35,35
1205,2011-02-23,7,2,90,92
1206,2011-02-23,8,8,225,233
1207,2011-02-23,9,9,128,137
1208,2011-02-23,10,4,43,47
1209,2011-02-23,11,16,52,68
1210,2011-02-23,12,11,56,67
1211,2011-02-23,13,9,73,82
1212,2011-02-23,14,17,61,78
1213,2011-02-23,15,18,51,69
1214,2011-02-23,16,15,78,93
1215,2011-02-23,17,15,207,222
1216,2011-02-23,18,3,201,204
1217,2011-02-23,19,6,132,138
1218,2011-02-23,20,2,103,105
1219,2011-02-23,21,2,87,89
1220,2011-02-23,22,1,59,60
1221,2011-02-23,23,1,38,39
1222,2011-02-24,0,0,11,11
1223,2011-02-24,1,0,7,7
1224,2011-02-24,2,0,4,4
1225,2011-02-24,3,0,2,2
1226,2011-02-24,5,1,3,4
1227,2011-02-24,6,0,58,58
1228,2011-02-24,7,0,103,103
1229,2011-02-24,8,8,239,247
1230,2011-02-24,9,4,130,134
1231,2011-02-24,10,8,47,55
1232,2011-02-24,11,8,71,79
1233,2011-02-24,12,10,85,95
1234,2011-02-24,13,16,72,88
1235,2011-02-24,14,2,67,69
1236,2011-02-24,15,5,57,62
1237,2011-02-24,16,4,67,71
1238,2011-02-24,17,9,167,176
1239,2011-02-24,18,5,130,135
1240,2011-02-24,19,3,110,113
1241,2011-02-24,20,2,85,87
1242,2011-02-24,21,7,75,82
1243,2011-02-24,22,5,49,54
1244,2011-02-24,23,3,47,50
1245,2011-02-25,0,1,8,9
1246,2011-02-25,1,1,9,10
1247,2011-02-25,2,0,3,3
1248,2011-02-25,3,1,1,2
1249,2011-02-25,5,1,5,6
1250,2011-02-25,6,0,11,11
1251,2011-02-25,7,1,34,35
1252,2011-02-25,8,3,70,73
1253,2011-02-25,9,3,111,114
1254,2011-02-25,10,7,42,49
1255,2011-02-25,11,9,50,59
1256,2011-02-25,12,19,93,112
1257,2011-02-25,13,6,75,81
1258,2011-02-25,14,15,68,83
1259,2011-02-25,15,5,49,54
1260,2011-02-25,16,11,89,100
1261,2011-02-25,17,8,179,187
1262,2011-02-25,18,7,150,157
1263,2011-02-25,19,4,84,88
1264,2011-02-25,20,2,60,62
1265,2011-02-25,21,7,53,60
1266,2011-02-25,22,7,43,50
1267,2011-02-25,23,2,36,38
1268,2011-02-26,0,3,25,28
1269,2011-02-26,1,2,25,27
1270,2011-02-26,2,3,9,12
1271,2011-02-26,3,1,7,8
1272,2011-02-26,4,1,1,2
1273,2011-02-26,5,1,9,10
1274,2011-02-26,6,1,6,7
1275,2011-02-26,7,1,21,22
1276,2011-02-26,8,2,54,56
1277,2011-02-26,9,9,64,73
1278,2011-02-26,10,14,70,84
1279,2011-02-26,11,26,99,125
1280,2011-02-26,12,45,115,160
1281,2011-02-26,13,38,133,171
1282,2011-02-26,14,57,151,208
1283,2011-02-26,15,40,123,163
1284,2011-02-26,16,41,128,169
1285,2011-02-26,17,53,125,178
1286,2011-02-26,18,26,111,137
1287,2011-02-26,19,30,62,92
1288,2011-02-26,20,8,59,67
1289,2011-02-26,21,9,58,67
1290,2011-02-26,22,8,36,44
1291,2011-02-26,23,5,28,33
1292,2011-02-27,0,8,26,34
1293,2011-02-27,1,7,30,37
1294,2011-02-27,2,2,20,22
1295,2011-02-27,3,3,8,11
1296,2011-02-27,4,0,2,2
1297,2011-02-27,6,2,1,3
1298,2011-02-27,7,6,8,14
1299,2011-02-27,8,9,26,35
1300,2011-02-27,9,16,42,58
1301,2011-02-27,10,25,78,103
1302,2011-02-27,11,33,89,122
1303,2011-02-27,12,61,130,191
1304,2011-02-27,13,90,167,257
1305,2011-02-27,14,105,171,276
1306,2011-02-27,15,98,160,258
1307,2011-02-27,16,98,170,268
1308,2011-02-27,17,66,118,184
1309,2011-02-27,18,24,100,124
1310,2011-02-27,19,16,83,99
1311,2011-02-27,20,9,71,80
1312,2011-02-27,21,8,56,64
1313,2011-02-27,22,2,67,69
1314,2011-02-27,23,6,53,59
1315,2011-02-28,0,5,24,29
1316,2011-02-28,1,1,7,8
1317,2011-02-28,3,0,1,1
1318,2011-02-28,5,1,4,5
1319,2011-02-28,6,1,27,28
1320,2011-02-28,7,2,90,92
1321,2011-02-28,8,13,242,255
1322,2011-02-28,9,15,125,140
1323,2011-02-28,10,13,76,89
1324,2011-02-28,11,13,74,87
1325,2011-02-28,12,0,36,36
1326,2011-02-28,13,1,30,31
1327,2011-02-28,14,0,24,24
1328,2011-02-28,15,0,31,31
1329,2011-02-28,16,2,40,42
1330,2011-02-28,17,2,77,79
1331,2011-02-28,18,4,127,131
1332,2011-02-28,19,1,77,78
1333,2011-02-28,20,0,45,45
1334,2011-02-28,21,2,78,80
1335,2011-02-28,22,4,71,75
1336,2011-02-28,23,0,44,44
1337,2011-03-01,0,0,7,7
1338,2011-03-01,1,0,3,3
1339,2011-03-01,2,0,4,4
1340,2011-03-01,3,0,2,2
1341,2011-03-01,4,0,1,1
1342,2011-03-01,5,1,1,2
1343,2011-03-01,6,0,46,46
1344,2011-03-01,7,2,105,107
1345,2011-03-01,8,10,201,211
1346,2011-03-01,9,8,115,123
1347,2011-03-01,10,13,54,67
1348,2011-03-01,11,8,47,55
1349,2011-03-01,12,6,79,85
1350,2011-03-01,13,13,65,78
1351,2011-03-01,14,18,59,77
1352,2011-03-01,15,7,56,63
1353,2011-03-01,16,10,92,102
1354,2011-03-01,17,12,227,239
1355,2011-03-01,18,10,213,223
1356,2011-03-01,19,4,115,119
1357,2011-03-01,20,2,85,87
1358,2011-03-01,21,8,53,61
1359,2011-03-01,22,3,42,45
1360,2011-03-01,23,2,23,25
1361,2011-03-02,0,3,4,7
1362,2011-03-02,1,0,4,4
1363,2011-03-02,2,0,2,2
1364,2011-03-02,3,3,1,4
1365,2011-03-02,4,1,0,1
1366,2011-03-02,5,0,5,5
1367,2011-03-02,6,1,39,40
1368,2011-03-02,7,2,107,109
1369,2011-03-02,8,13,242,255
1370,2011-03-02,9,7,140,147
1371,2011-03-02,10,11,64,75
1372,2011-03-02,11,8,64,72
1373,2011-03-02,12,20,61,81
1374,2011-03-02,13,35,90,125
1375,2011-03-02,14,21,75,96
1376,2011-03-02,15,19,90,109
1377,2011-03-02,16,27,111,138
1378,2011-03-02,17,30,235,265
1379,2011-03-02,18,8,192,200
1380,2011-03-02,19,6,141,147
1381,2011-03-02,20,9,82,91
1382,2011-03-02,21,3,67,70
1383,2011-03-02,22,4,42,46
1384,2011-03-02,23,0,20,20
1385,2011-03-03,0,3,10,13
1386,2011-03-03,1,0,1,1
1387,2011-03-03,2,1,2,3
1388,2011-03-03,3,0,1,1
1389,2011-03-03,4,0,1,1
1390,2011-03-03,5,1,7,8
1391,2011-03-03,6,1,34,35
1392,2011-03-03,7,1,107,108
1393,2011-03-03,8,4,215,219
1394,2011-03-03,9,10,133,143
1395,2011-03-03,10,7,46,53
1396,2011-03-03,11,10,40,50
1397,2011-03-03,12,7,65,72
1398,2011-03-03,13,13,66,79
1399,2011-03-03,14,18,57,75
1400,2011-03-03,15,6,59,65
1401,2011-03-03,16,6,65,71
1402,2011-03-03,17,17,181,198
1403,2011-03-03,18,6,160,166
1404,2011-03-03,19,5,99,104
1405,2011-03-03,20,1,69,70
1406,2011-03-03,21,3,47,50
1407,2011-03-03,22,3,49,52
1408,2011-03-03,23,0,22,22
1409,2011-03-04,0,0,12,12
1410,2011-03-04,1,0,4,4
1411,2011-03-04,2,0,2,2
1412,2011-03-04,3,0,1,1
1413,2011-03-04,4,1,0,1
1414,2011-03-04,5,0,7,7
1415,2011-03-04,6,1,28,29
1416,2011-03-04,7,0,80,80
1417,2011-03-04,8,6,222,228
1418,2011-03-04,9,12,137,149
1419,2011-03-04,10,10,56,66
1420,2011-03-04,11,16,73,89
1421,2011-03-04,12,10,84,94
1422,2011-03-04,13,13,74,87
1423,2011-03-04,14,30,65,95
1424,2011-03-04,15,31,74,105
1425,2011-03-04,16,17,101,118
1426,2011-03-04,17,22,204,226
1427,2011-03-04,18,15,168,183
1428,2011-03-04,19,5,99,104
1429,2011-03-04,20,9,77,86
1430,2011-03-04,21,6,62,68
1431,2011-03-04,22,4,40,44
1432,2011-03-04,23,6,39,45
1433,2011-03-05,0,4,15,19
1434,2011-03-05,1,5,20,25
1435,2011-03-05,2,5,15,20
1436,2011-03-05,3,0,2,2
1437,2011-03-05,4,0,1,1
1438,2011-03-05,5,0,3,3
1439,2011-03-05,6,1,3,4
1440,2011-03-05,7,5,10,15
1441,2011-03-05,8,11,34,45
1442,2011-03-05,9,15,48,63
1443,2011-03-05,10,34,68,102
1444,2011-03-05,11,43,116,159
1445,2011-03-05,12,45,115,160
1446,2011-03-05,13,60,129,189
1447,2011-03-05,14,80,116,196
1448,2011-03-05,15,83,122,205
1449,2011-03-05,16,74,129,203
1450,2011-03-05,17,60,103,163
1451,2011-03-05,18,37,111,148
1452,2011-03-05,19,27,62,89
1453,2011-03-05,20,12,58,70
1454,2011-03-05,21,12,56,68
1455,2011-03-05,22,16,44,60
1456,2011-03-05,23,10,34,44
1457,2011-03-06,0,11,40,51
1458,2011-03-06,1,12,27,39
1459,2011-03-06,2,5,27,32
1460,2011-03-06,3,2,9,11
1461,2011-03-06,4,0,3,3
1462,2011-03-06,6,1,1,2
1463,2011-03-06,7,0,4,4
1464,2011-03-06,8,1,8,9
1465,2011-03-06,9,4,18,22
1466,2011-03-06,10,4,27,31
1467,2011-03-06,11,18,44,62
1468,2011-03-06,12,10,58,68
1469,2011-03-06,13,22,81,103
1470,2011-03-06,14,12,27,39
1471,2011-03-06,15,2,4,6
1472,2011-03-06,16,3,8,11
1473,2011-03-06,17,2,21,23
1474,2011-03-06,18,0,20,20
1475,2011-03-06,19,0,11,11
1476,2011-03-06,20,3,7,10
1477,2011-03-06,21,1,6,7
1478,2011-03-06,22,0,9,9
1479,2011-03-06,23,0,9,9
1480,2011-03-07,0,0,4,4
1481,2011-03-07,1,0,2,2
1482,2011-03-07,3,0,1,1
1483,2011-03-07,4,1,0,1
1484,2011-03-07,5,0,1,1
1485,2011-03-07,6,3,30,33
1486,2011-03-07,7,3,87,90
1487,2011-03-07,8,11,194,205
1488,2011-03-07,9,5,125,130
1489,2011-03-07,10,14,43,57
1490,2011-03-07,11,19,41,60
1491,2011-03-07,12,28,68,96
1492,2011-03-07,13,16,54,70
1493,2011-03-07,14,21,55,76
1494,2011-03-07,15,32,63,95
1495,2011-03-07,16,26,94,120
1496,2011-03-07,17,27,203,230
1497,2011-03-07,18,19,213,232
1498,2011-03-07,19,11,131,142
1499,2011-03-07,20,5,85,90
1500,2011-03-07,21,1,51,52
1501,2011-03-07,22,1,34,35
1502,2011-03-07,23,0,20,20
1503,2011-03-08,0,1,9,10
1504,2011-03-08,1,0,3,3
1505,2011-03-08,2,1,0,1
1506,2011-03-08,3,5,2,7
1507,2011-03-08,4,0,2,2
1508,2011-03-08,5,2,8,10
1509,2011-03-08,6,3,42,45
1510,2011-03-08,7,9,116,125
1511,2011-03-08,8,10,244,254
1512,2011-03-08,9,11,138,149
1513,2011-03-08,10,25,46,71
1514,2011-03-08,11,26,51,77
1515,2011-03-08,12,29,70,99
1516,2011-03-08,13,25,71,96
1517,2011-03-08,14,16,55,71
1518,2011-03-08,15,35,74,109
1519,2011-03-08,16,26,81,107
1520,2011-03-08,17,39,206,245
1521,2011-03-08,18,21,208,229
1522,2011-03-08,19,9,138,147
1523,2011-03-08,20,2,72,74
1524,2011-03-08,21,7,65,72
1525,2011-03-08,22,11,44,55
1526,2011-03-08,23,3,36,39
1527,2011-03-09,0,0,9,9
1528,2011-03-09,1,0,4,4
1529,2011-03-09,2,1,1,2
1530,2011-03-09,3,1,2,3
1531,2011-03-09,4,0,2,2
1532,2011-03-09,5,1,7,8
1533,2011-03-09,6,5,44,49
1534,2011-03-09,7,18,120,138
1535,2011-03-09,8,11,234,245
1536,2011-03-09,9,5,134,139
1537,2011-03-09,10,8,48,56
1538,2011-03-09,11,15,44,59
1539,2011-03-09,12,14,83,97
1540,2011-03-09,13,17,81,98
1541,2011-03-09,14,10,60,70
1542,2011-03-09,15,15,64,79
1543,2011-03-09,16,10,98,108
1544,2011-03-09,17,18,176,194
1545,2011-03-09,18,12,175,187
1546,2011-03-09,19,11,121,132
1547,2011-03-09,20,4,87,91
1548,2011-03-09,21,10,51,61
1549,2011-03-09,22,4,16,20
1550,2011-03-09,23,1,16,17
1551,2011-03-10,0,3,0,3
1552,2011-03-10,1,0,2,2
1553,2011-03-10,2,0,1,1
1554,2011-03-10,5,1,2,3
1555,2011-03-10,6,0,12,12
1556,2011-03-10,7,1,36,37
1557,2011-03-10,8,1,43,44
1558,2011-03-10,9,1,23,24
1559,2011-03-10,10,0,17,17
1560,2011-03-10,11,6,5,11
1561,2011-03-10,12,4,29,33
1562,2011-03-10,13,1,10,11
1563,2011-03-10,14,0,12,12
1564,2011-03-10,15,3,11,14
1565,2011-03-10,16,1,20,21
1566,2011-03-10,17,2,109,111
1567,2011-03-10,18,2,78,80
1568,2011-03-10,19,5,50,55
1569,2011-03-10,20,9,28,37
1570,2011-03-10,21,1,27,28
1571,2011-03-10,22,4,29,33
1572,2011-03-10,23,1,26,27
1573,2011-03-11,0,0,6,6
1574,2011-03-11,1,0,7,7
1575,2011-03-11,2,2,3,5
1576,2011-03-11,3,0,2,2
1577,2011-03-11,5,1,6,7
1578,2011-03-11,6,1,31,32
1579,2011-03-11,7,10,102,112
1580,2011-03-11,8,15,243,258
1581,2011-03-11,9,13,142,155
1582,2011-03-11,10,18,59,77
1583,2011-03-11,11,14,64,78
1584,2011-03-11,12,15,95,110
1585,2011-03-11,13,15,92,107
1586,2011-03-11,14,25,62,87
1587,2011-03-11,15,21,63,84
1588,2011-03-11,16,18,93,111
1589,2011-03-11,17,23,197,220
1590,2011-03-11,18,19,131,150
1591,2011-03-11,19,7,111,118
1592,2011-03-11,20,6,69,75
1593,2011-03-11,21,10,43,53
1594,2011-03-11,22,11,51,62
1595,2011-03-11,23,3,34,37
1596,2011-03-12,0,4,28,32
1597,2011-03-12,1,3,15,18
1598,2011-03-12,2,0,13,13
1599,2011-03-12,3,1,6,7
1600,2011-03-12,4,0,1,1
1601,2011-03-12,5,0,2,2
1602,2011-03-12,6,2,2,4
1603,2011-03-12,7,4,19,23
1604,2011-03-12,8,9,43,52
1605,2011-03-12,9,25,75,100
1606,2011-03-12,10,21,77,98
1607,2011-03-12,11,36,83,119
1608,2011-03-12,12,51,105,156
1609,2011-03-12,13,62,95,157
1610,2011-03-12,14,70,94,164
1611,2011-03-12,15,81,100,181
1612,2011-03-12,16,100,137,237
1613,2011-03-12,17,99,112,211
1614,2011-03-12,18,54,90,144
1615,2011-03-12,19,26,85,111
1616,2011-03-12,20,22,59,81
1617,2011-03-12,21,36,46,82
1618,2011-03-12,22,7,56,63
1619,2011-03-12,23,11,37,48
1620,2011-03-13,0,3,35,38
1621,2011-03-13,1,10,22,32
1622,2011-03-13,3,6,15,21
1623,2011-03-13,4,4,6,10
1624,2011-03-13,5,0,3,3
1625,2011-03-13,6,0,2,2
1626,2011-03-13,7,2,7,9
1627,2011-03-13,8,11,23,34
1628,2011-03-13,9,8,36,44
1629,2011-03-13,10,36,86,122
1630,2011-03-13,11,88,91,179
1631,2011-03-13,12,74,118,192
1632,2011-03-13,13,97,116,213
1633,2011-03-13,14,144,103,247
1634,2011-03-13,15,148,152,300
1635,2011-03-13,16,122,131,253
1636,2011-03-13,17,98,139,237
1637,2011-03-13,18,55,91,146
1638,2011-03-13,19,28,72,100
1639,2011-03-13,20,23,52,75
1640,2011-03-13,21,9,45,54
1641,2011-03-13,22,8,29,37
1642,2011-03-13,23,5,22,27
1643,2011-03-14,0,4,7,11
1644,2011-03-14,1,0,1,1
1645,2011-03-14,2,0,1,1
1646,2011-03-14,3,0,3,3
1647,2011-03-14,5,0,8,8
1648,2011-03-14,6,1,27,28
1649,2011-03-14,7,4,82,86
1650,2011-03-14,8,24,216,240
1651,2011-03-14,9,13,126,139
1652,2011-03-14,10,27,56,83
1653,2011-03-14,11,26,44,70
1654,2011-03-14,12,40,54,94
1655,2011-03-14,13,24,51,75
1656,2011-03-14,14,27,52,79
1657,2011-03-14,15,24,76,100
1658,2011-03-14,16,27,80,107
1659,2011-03-14,17,42,228,270
1660,2011-03-14,18,25,209,234
1661,2011-03-14,19,17,132,149
1662,2011-03-14,20,23,104,127
1663,2011-03-14,21,5,56,61
1664,2011-03-14,22,4,43,47
1665,2011-03-14,23,2,17,19
1666,2011-03-15,0,7,7,14
1667,2011-03-15,1,4,5,9
1668,2011-03-15,2,1,2,3
1669,2011-03-15,4,1,1,2
1670,2011-03-15,5,0,11,11
1671,2011-03-15,6,3,32,35
1672,2011-03-15,7,10,109,119
1673,2011-03-15,8,23,255,278
1674,2011-03-15,9,10,144,154
1675,2011-03-15,10,22,55,77
1676,2011-03-15,11,27,50,77
1677,2011-03-15,12,32,68,100
1678,2011-03-15,13,23,71,94
1679,2011-03-15,14,14,74,88
1680,2011-03-15,15,24,63,87
1681,2011-03-15,16,21,93,114
1682,2011-03-15,17,22,192,214
1683,2011-03-15,18,18,205,223
1684,2011-03-15,19,13,136,149
1685,2011-03-15,20,9,77,86
1686,2011-03-15,21,2,52,54
1687,2011-03-15,22,1,19,20
1688,2011-03-15,23,1,15,16
1689,2011-03-16,0,0,8,8
1690,2011-03-16,1,1,2,3
1691,2011-03-16,3,1,2,3
1692,2011-03-16,4,0,1,1
1693,2011-03-16,5,0,3,3
1694,2011-03-16,6,1,30,31
1695,2011-03-16,7,10,100,110
1696,2011-03-16,8,26,227,253
1697,2011-03-16,9,10,141,151
1698,2011-03-16,10,19,47,66
1699,2011-03-16,11,13,60,73
1700,2011-03-16,12,23,64,87
1701,2011-03-16,13,18,81,99
1702,2011-03-16,14,33,66,99
1703,2011-03-16,15,22,77,99
1704,2011-03-16,16,30,120,150
1705,2011-03-16,17,37,215,252
1706,2011-03-16,18,26,209,235
1707,2011-03-16,19,18,150,168
1708,2011-03-16,20,10,110,120
1709,2011-03-16,21,3,74,77
1710,2011-03-16,22,11,48,59
1711,2011-03-16,23,9,16,25
1712,2011-03-17,0,4,18,22
1713,2011-03-17,1,1,11,12
1714,2011-03-17,2,3,5,8
1715,2011-03-17,3,1,1,2
1716,2011-03-17,4,0,3,3
1717,2011-03-17,5,0,13,13
1718,2011-03-17,6,4,47,51
1719,2011-03-17,7,12,126,138
1720,2011-03-17,8,17,282,299
1721,2011-03-17,9,23,162,185
1722,2011-03-17,10,9,68,77
1723,2011-03-17,11,20,65,85
1724,2011-03-17,12,24,79,103
1725,2011-03-17,13,26,84,110
1726,2011-03-17,14,32,87,119
1727,2011-03-17,15,30,95,125
1728,2011-03-17,16,34,108,142
1729,2011-03-17,17,48,263,311
1730,2011-03-17,18,49,258,307
1731,2011-03-17,19,18,186,204
1732,2011-03-17,20,25,108,133
1733,2011-03-17,21,19,115,134
1734,2011-03-17,22,17,69,86
1735,2011-03-17,23,7,42,49
1736,2011-03-18,0,5,24,29
1737,2011-03-18,1,4,12,16
1738,2011-03-18,2,5,9,14
1739,2011-03-18,3,1,4,5
1740,2011-03-18,5,2,8,10
1741,2011-03-18,6,1,34,35
1742,2011-03-18,7,11,107,118
1743,2011-03-18,8,24,255,279
1744,2011-03-18,9,18,187,205
1745,2011-03-18,10,43,73,116
1746,2011-03-18,11,55,101,156
1747,2011-03-18,12,72,119,191
1748,2011-03-18,13,57,118,175
1749,2011-03-18,14,71,99,170
1750,2011-03-18,15,61,109,170
1751,2011-03-18,16,67,133,200
1752,2011-03-18,17,95,234,329
1753,2011-03-18,18,84,241,325
1754,2011-03-18,19,58,131,189
1755,2011-03-18,20,46,101,147
1756,2011-03-18,21,22,90,112
1757,2011-03-18,22,55,62,117
1758,2011-03-18,23,26,60,86
1759,2011-03-19,0,26,44,70
1760,2011-03-19,1,16,33,49
1761,2011-03-19,2,5,19,24
1762,2011-03-19,3,1,7,8
1763,2011-03-19,4,1,2,3
1764,2011-03-19,5,0,2,2
1765,2011-03-19,6,0,10,10
1766,2011-03-19,7,4,9,13
1767,2011-03-19,8,11,37,48
1768,2011-03-19,9,35,40,75
1769,2011-03-19,10,55,84,139
1770,2011-03-19,11,90,104,194
1771,2011-03-19,12,125,141,266
1772,2011-03-19,13,175,125,300
1773,2011-03-19,14,168,139,307
1774,2011-03-19,15,170,141,311
1775,2011-03-19,16,175,124,299
1776,2011-03-19,17,137,133,270
1777,2011-03-19,18,92,124,216
1778,2011-03-19,19,38,97,135
1779,2011-03-19,20,39,68,107
1780,2011-03-19,21,20,72,92
1781,2011-03-19,22,27,41,68
1782,2011-03-19,23,12,37,49
1783,2011-03-20,0,7,31,38
1784,2011-03-20,1,2,22,24
1785,2011-03-20,2,6,23,29
1786,2011-03-20,3,1,11,12
1787,2011-03-20,4,2,1,3
1788,2011-03-20,5,3,4,7
1789,2011-03-20,6,1,3,4
1790,2011-03-20,7,5,9,14
1791,2011-03-20,8,7,30,37
1792,2011-03-20,9,35,42,77
1793,2011-03-20,10,55,80,135
1794,2011-03-20,11,92,108,200
1795,2011-03-20,12,120,105,225
1796,2011-03-20,13,88,109,197
1797,2011-03-20,14,145,128,273
1798,2011-03-20,15,171,126,297
1799,2011-03-20,16,92,127,219
1800,2011-03-20,17,83,135,218
1801,2011-03-20,18,58,96,154
1802,2011-03-20,19,21,58,79
1803,2011-03-20,20,21,45,66
1804,2011-03-20,21,10,39,49
1805,2011-03-20,22,8,28,36
1806,2011-03-20,23,13,11,24
1807,2011-03-21,0,2,11,13
1808,2011-03-21,1,1,6,7
1809,2011-03-21,2,1,5,6
1810,2011-03-21,3,0,1,1
1811,2011-03-21,5,1,1,2
1812,2011-03-21,6,2,30,32
1813,2011-03-21,7,3,14,17
1814,2011-03-21,8,3,94,97
1815,2011-03-21,9,12,114,126
1816,2011-03-21,10,17,44,61
1817,2011-03-21,11,32,47,79
1818,2011-03-21,12,25,56,81
1819,2011-03-21,13,35,77,112
1820,2011-03-21,14,36,65,101
1821,2011-03-21,15,41,65,106
1822,2011-03-21,16,29,108,137
1823,2011-03-21,17,41,230,271
1824,2011-03-21,18,44,229,273
1825,2011-03-21,19,22,195,217
1826,2011-03-21,20,16,104,120
1827,2011-03-21,21,12,79,91
1828,2011-03-21,22,18,60,78
1829,2011-03-21,23,8,22,30
1830,2011-03-22,0,4,7,11
1831,2011-03-22,1,6,13,19
1832,2011-03-22,2,0,1,1
1833,2011-03-22,3,3,2,5
1834,2011-03-22,4,0,1,1
1835,2011-03-22,5,1,11,12
1836,2011-03-22,6,2,58,60
1837,2011-03-22,7,4,129,133
1838,2011-03-22,8,24,309,333
1839,2011-03-22,9,19,157,176
1840,2011-03-22,10,29,94,123
1841,2011-03-22,11,22,64,86
1842,2011-03-22,12,35,86,121
1843,2011-03-22,13,21,85,106
1844,2011-03-22,14,29,69,98
1845,2011-03-22,15,56,76,132
1846,2011-03-22,16,40,124,164
1847,2011-03-22,17,42,263,305
1848,2011-03-22,18,41,266,307
1849,2011-03-22,19,22,138,160
1850,2011-03-22,20,19,111,130
1851,2011-03-22,21,24,63,87
1852,2011-03-22,22,13,53,66
1853,2011-03-22,23,4,27,31
1854,2011-03-23,0,3,8,11
1855,2011-03-23,1,0,7,7
1856,2011-03-23,2,1,1,2
1857,2011-03-23,3,0,3,3
1858,2011-03-23,5,0,10,10
1859,2011-03-23,6,1,42,43
1860,2011-03-23,7,7,110,117
1861,2011-03-23,8,14,243,257
1862,2011-03-23,9,8,174,182
1863,2011-03-23,10,15,60,75
1864,2011-03-23,11,18,53,71
1865,2011-03-23,12,14,72,86
1866,2011-03-23,13,14,93,107
1867,2011-03-23,14,13,71,84
1868,2011-03-23,15,11,73,84
1869,2011-03-23,16,13,123,136
1870,2011-03-23,17,28,241,269
1871,2011-03-23,18,20,217,237
1872,2011-03-23,19,12,146,158
1873,2011-03-23,20,3,70,73
1874,2011-03-23,21,0,22,22
1875,2011-03-23,22,6,37,43
1876,2011-03-23,23,2,22,24
1877,2011-03-24,0,0,11,11
1878,2011-03-24,1,0,3,3
1879,2011-03-24,2,0,6,6
1880,2011-03-24,3,1,0,1
1881,2011-03-24,4,0,1,1
1882,2011-03-24,5,1,8,9
1883,2011-03-24,6,0,41,41
1884,2011-03-24,7,2,104,106
1885,2011-03-24,8,4,119,123
1886,2011-03-24,9,3,92,95
1887,2011-03-24,10,10,53,63
1888,2011-03-24,11,10,61,71
1889,2011-03-24,12,12,81,93
1890,2011-03-24,13,11,90,101
1891,2011-03-24,14,17,64,81
1892,2011-03-24,15,12,76,88
1893,2011-03-24,16,7,77,84
1894,2011-03-24,17,12,219,231
1895,2011-03-24,18,17,196,213
1896,2011-03-24,19,16,120,136
1897,2011-03-24,20,8,107,115
1898,2011-03-24,21,11,66,77
1899,2011-03-24,22,3,59,62
1900,2011-03-24,23,9,24,33
1901,2011-03-25,0,1,17,18
1902,2011-03-25,1,0,5,5
1903,2011-03-25,2,0,5,5
1904,2011-03-25,3,0,2,2
1905,2011-03-25,4,3,2,5
1906,2011-03-25,5,0,9,9
1907,2011-03-25,6,0,32,32
1908,2011-03-25,7,4,99,103
1909,2011-03-25,8,9,228,237
1910,2011-03-25,9,16,148,164
1911,2011-03-25,10,15,53,68
1912,2011-03-25,11,17,57,74
1913,2011-03-25,12,37,105,142
1914,2011-03-25,13,34,104,138
1915,2011-03-25,14,30,102,132
1916,2011-03-25,15,43,76,119
1917,2011-03-25,16,23,126,149
1918,2011-03-25,17,23,201,224
1919,2011-03-25,18,8,185,193
1920,2011-03-25,19,9,125,134
1921,2011-03-25,20,6,74,80
1922,2011-03-25,21,11,61,72
1923,2011-03-25,22,3,39,42
1924,2011-03-25,23,8,31,39
1925,2011-03-26,0,3,25,28
1926,2011-03-26,1,3,24,27
1927,2011-03-26,2,4,21,25
1928,2011-03-26,3,2,7,9
1929,2011-03-26,4,2,4,6
1930,2011-03-26,5,0,8,8
1931,2011-03-26,6,2,8,10
1932,2011-03-26,7,18,20,38
1933,2011-03-26,8,24,42,66
1934,2011-03-26,9,32,65,97
1935,2011-03-26,10,32,92,124
1936,2011-03-26,11,75,90,165
1937,2011-03-26,12,98,125,223
1938,2011-03-26,13,94,140,234
1939,2011-03-26,14,93,117,210
1940,2011-03-26,15,110,107,217
1941,2011-03-26,16,118,128,246
1942,2011-03-26,17,102,100,202
1943,2011-03-26,18,64,87,151
1944,2011-03-26,19,45,93,138
1945,2011-03-26,20,18,62,80
1946,2011-03-26,21,15,36,51
1947,2011-03-26,22,17,45,62
1948,2011-03-26,23,10,31,41
1949,2011-03-27,0,5,26,31
1950,2011-03-27,1,3,17,20
1951,2011-03-27,2,6,15,21
1952,2011-03-27,3,0,14,14
1953,2011-03-27,4,1,5,6
1954,2011-03-27,6,0,2,2
1955,2011-03-27,7,0,7,7
1956,2011-03-27,8,6,7,13
1957,2011-03-27,9,17,36,53
1958,2011-03-27,10,27,56,83
1959,2011-03-27,11,22,84,106
1960,2011-03-27,12,43,109,152
1961,2011-03-27,13,46,99,145
1962,2011-03-27,14,61,103,164
1963,2011-03-27,15,61,110,171
1964,2011-03-27,16,45,96,141
1965,2011-03-27,17,50,108,158
1966,2011-03-27,18,32,103,135
1967,2011-03-27,19,23,79,102
1968,2011-03-27,20,7,50,57
1969,2011-03-27,21,7,29,36
1970,2011-03-27,22,5,24,29
1971,2011-03-27,23,3,16,19
1972,2011-03-28,0,1,11,12
1973,2011-03-28,1,2,4,6
1974,2011-03-28,2,0,5,5
1975,2011-03-28,3,0,2,2
1976,2011-03-28,5,0,8,8
1977,2011-03-28,6,0,40,40
1978,2011-03-28,7,6,103,109
1979,2011-03-28,8,15,235,250
1980,2011-03-28,9,12,109,121
1981,2011-03-28,10,22,46,68
1982,2011-03-28,11,18,38,56
1983,2011-03-28,12,8,70,78
1984,2011-03-28,13,14,69,83
1985,2011-03-28,14,15,63,78
1986,2011-03-28,15,19,53,72
1987,2011-03-28,16,15,114,129
1988,2011-03-28,17,25,223,248
1989,2011-03-28,18,21,217,238
1990,2011-03-28,19,17,154,171
1991,2011-03-28,20,5,106,111
1992,2011-03-28,21,6,55,61
1993,2011-03-28,22,0,40,40
1994,2011-03-28,23,1,17,18
1995,2011-03-29,0,1,15,16
1996,2011-03-29,1,0,4,4
1997,2011-03-29,2,0,3,3
1998,2011-03-29,3,2,1,3
1999,2011-03-29,4,1,1,2
2000,2011-03-29,5,0,8,8
2001,2011-03-29,6,4,45,49
2002,2011-03-29,7,5,126,131
2003,2011-03-29,8,19,267,286
2004,2011-03-29,9,16,156,172
2005,2011-03-29,10,13,45,58
2006,2011-03-29,11,18,63,81
2007,2011-03-29,12,29,75,104
2008,2011-03-29,13,24,79,103
2009,2011-03-29,14,20,64,84
2010,2011-03-29,15,22,63,85
2011,2011-03-29,16,12,119,131
2012,2011-03-29,17,34,263,297
2013,2011-03-29,18,42,251,293
2014,2011-03-29,19,20,168,188
2015,2011-03-29,20,13,117,130
2016,2011-03-29,21,8,73,81
2017,2011-03-29,22,6,49,55
2018,2011-03-29,23,8,25,33
2019,2011-03-30,0,3,8,11
2020,2011-03-30,1,1,8,9
2021,2011-03-30,2,0,4,4
2022,2011-03-30,3,0,4,4
2023,2011-03-30,4,1,0,1
2024,2011-03-30,5,0,7,7
2025,2011-03-30,6,4,43,47
2026,2011-03-30,7,8,127,135
2027,2011-03-30,8,16,244,260
2028,2011-03-30,9,7,146,153
2029,2011-03-30,10,13,51,64
2030,2011-03-30,11,26,57,83
2031,2011-03-30,12,15,64,79
2032,2011-03-30,13,14,83,97
2033,2011-03-30,14,16,64,80
2034,2011-03-30,15,14,56,70
2035,2011-03-30,16,0,36,36
2036,2011-03-30,17,11,105,116
2037,2011-03-30,18,6,79,85
2038,2011-03-30,19,5,66,71
2039,2011-03-30,20,4,40,44
2040,2011-03-30,21,0,27,27
2041,2011-03-30,22,3,21,24
2042,2011-03-30,23,1,11,12
2043,2011-03-31,0,0,3,3
2044,2011-03-31,1,1,4,5
2045,2011-03-31,2,0,5,5
2046,2011-03-31,3,0,1,1
2047,2011-03-31,4,0,2,2
2048,2011-03-31,5,0,8,8
2049,2011-03-31,6,2,34,36
2050,2011-03-31,7,5,86,91
2051,2011-03-31,8,7,181,188
2052,2011-03-31,9,6,126,132
2053,2011-03-31,10,15,53,68
2054,2011-03-31,11,6,49,55
2055,2011-03-31,12,17,72,89
2056,2011-03-31,13,13,54,67
2057,2011-03-31,14,27,49,76
2058,2011-03-31,15,4,61,65
2059,2011-03-31,16,13,71,84
2060,2011-03-31,17,15,153,168
2061,2011-03-31,18,12,163,175
2062,2011-03-31,19,12,117,129
2063,2011-03-31,20,6,78,84
2064,2011-03-31,21,7,52,59
2065,2011-03-31,22,7,44,51
2066,2011-03-31,23,4,23,27
2067,2011-04-01,0,0,6,6
2068,2011-04-01,1,0,4,4
2069,2011-04-01,2,0,7,7
2070,2011-04-01,3,0,4,4
2071,2011-04-01,4,0,3,3
2072,2011-04-01,5,1,11,12
2073,2011-04-01,6,2,26,28
2074,2011-04-01,7,4,86,90
2075,2011-04-01,8,8,195,203
2076,2011-04-01,9,11,163,174
2077,2011-04-01,10,12,63,75
2078,2011-04-01,11,17,71,88
2079,2011-04-01,12,15,75,90
2080,2011-04-01,13,18,90,108
2081,2011-04-01,14,26,60,86
2082,2011-04-01,15,30,79,109
2083,2011-04-01,16,42,124,166
2084,2011-04-01,17,36,242,278
2085,2011-04-01,18,36,203,239
2086,2011-04-01,19,16,116,132
2087,2011-04-01,20,2,73,75
2088,2011-04-01,21,9,81,90
2089,2011-04-01,22,10,64,74
2090,2011-04-01,23,12,39,51
2091,2011-04-02,0,3,27,30
2092,2011-04-02,1,4,27,31
2093,2011-04-02,2,1,19,20
2094,2011-04-02,3,1,8,9
2095,2011-04-02,4,0,4,4
2096,2011-04-02,5,1,4,5
2097,2011-04-02,6,5,7,12
2098,2011-04-02,7,2,16,18
2099,2011-04-02,8,10,44,54
2100,2011-04-02,9,22,65,87
2101,2011-04-02,10,41,111,152
2102,2011-04-02,11,72,126,198
2103,2011-04-02,12,84,99,183
2104,2011-04-02,13,56,77,133
2105,2011-04-02,14,97,91,188
2106,2011-04-02,15,71,64,135
2107,2011-04-02,16,111,85,196
2108,2011-04-02,17,89,93,182
2109,2011-04-02,18,68,106,174
2110,2011-04-02,19,71,75,146
2111,2011-04-02,20,29,55,84
2112,2011-04-02,21,24,53,77
2113,2011-04-02,22,14,40,54
2114,2011-04-02,23,20,32,52
2115,2011-04-03,0,8,31,39
2116,2011-04-03,1,8,26,34
2117,2011-04-03,2,5,19,24
2118,2011-04-03,3,3,8,11
2119,2011-04-03,4,3,0,3
2120,2011-04-03,5,1,4,5
2121,2011-04-03,6,10,23,33
2122,2011-04-03,7,13,19,32
2123,2011-04-03,8,18,41,59
2124,2011-04-03,9,68,73,141
2125,2011-04-03,10,111,102,213
2126,2011-04-03,11,139,101,240
2127,2011-04-03,12,165,144,309
2128,2011-04-03,13,220,147,367
2129,2011-04-03,14,239,106,345
2130,2011-04-03,15,175,117,292
2131,2011-04-03,16,147,150,297
2132,2011-04-03,17,148,124,272
2133,2011-04-03,18,71,97,168
2134,2011-04-03,19,51,89,140
2135,2011-04-03,20,24,54,78
2136,2011-04-03,21,8,36,44
2137,2011-04-03,22,7,27,34
2138,2011-04-03,23,9,22,31
2139,2011-04-04,0,1,5,6
2140,2011-04-04,1,7,4,11
2141,2011-04-04,2,1,1,2
2142,2011-04-04,3,1,0,1
2143,2011-04-04,4,1,1,2
2144,2011-04-04,5,0,7,7
2145,2011-04-04,6,3,43,46
2146,2011-04-04,7,7,148,155
2147,2011-04-04,8,31,305,336
2148,2011-04-04,9,24,133,157
2149,2011-04-04,10,35,55,90
2150,2011-04-04,11,58,65,123
2151,2011-04-04,12,59,94,153
2152,2011-04-04,13,47,91,138
2153,2011-04-04,14,47,75,122
2154,2011-04-04,15,47,93,140
2155,2011-04-04,16,59,129,188
2156,2011-04-04,17,83,281,364
2157,2011-04-04,18,78,303,381
2158,2011-04-04,19,51,221,272
2159,2011-04-04,20,40,130,170
2160,2011-04-04,21,19,74,93
2161,2011-04-04,22,17,57,74
2162,2011-04-04,23,18,30,48
2163,2011-04-05,0,10,12,22
2164,2011-04-05,1,10,5,15
2165,2011-04-05,2,0,5,5
2166,2011-04-05,3,1,3,4
2167,2011-04-05,4,0,2,2
2168,2011-04-05,5,0,5,5
2169,2011-04-05,6,2,36,38
2170,2011-04-05,7,10,122,132
2171,2011-04-05,8,9,145,154
2172,2011-04-05,9,2,45,47
2173,2011-04-05,10,3,25,28
2174,2011-04-05,11,1,18,19
2175,2011-04-05,12,6,32,38
2176,2011-04-05,13,5,50,55
2177,2011-04-05,14,9,64,73
2178,2011-04-05,15,6,59,65
2179,2011-04-05,16,17,113,130
2180,2011-04-05,17,27,240,267
2181,2011-04-05,18,19,244,263
2182,2011-04-05,19,12,143,155
2183,2011-04-05,20,4,86,90
2184,2011-04-05,21,8,81,89
2185,2011-04-05,22,3,43,46
2186,2011-04-05,23,3,23,26
2187,2011-04-06,0,0,15,15
2188,2011-04-06,1,0,2,2
2189,2011-04-06,2,0,5,5
2190,2011-04-06,3,0,4,4
2191,2011-04-06,4,0,1,1
2192,2011-04-06,5,1,11,12
2193,2011-04-06,6,4,53,57
2194,2011-04-06,7,3,128,131
2195,2011-04-06,8,17,305,322
2196,2011-04-06,9,8,157,165
2197,2011-04-06,10,21,46,67
2198,2011-04-06,11,23,69,92
2199,2011-04-06,12,22,109,131
2200,2011-04-06,13,29,81,110
2201,2011-04-06,14,35,79,114
2202,2011-04-06,15,34,79,113
2203,2011-04-06,16,27,141,168
2204,2011-04-06,17,53,299,352
2205,2011-04-06,18,43,280,323
2206,2011-04-06,19,36,193,229
2207,2011-04-06,20,15,123,138
2208,2011-04-06,21,18,83,101
2209,2011-04-06,22,13,71,84
2210,2011-04-06,23,11,29,40
2211,2011-04-07,0,5,15,20
2212,2011-04-07,1,2,10,12
2213,2011-04-07,2,0,6,6
2214,2011-04-07,3,0,3,3
2215,2011-04-07,4,0,1,1
2216,2011-04-07,5,0,6,6
2217,2011-04-07,6,5,58,63
2218,2011-04-07,7,8,148,156
2219,2011-04-07,8,23,288,311
2220,2011-04-07,9,15,154,169
2221,2011-04-07,10,29,65,94
2222,2011-04-07,11,36,84,120
2223,2011-04-07,12,39,89,128
2224,2011-04-07,13,36,91,127
2225,2011-04-07,14,46,91,137
2226,2011-04-07,15,27,95,122
2227,2011-04-07,16,52,139,191
2228,2011-04-07,17,63,276,339
2229,2011-04-07,18,68,262,330
2230,2011-04-07,19,33,190,223
2231,2011-04-07,20,37,165,202
2232,2011-04-07,21,19,88,107
2233,2011-04-07,22,18,63,81
2234,2011-04-07,23,9,44,53
2235,2011-04-08,0,4,21,25
2236,2011-04-08,1,3,6,9
2237,2011-04-08,2,3,10,13
2238,2011-04-08,3,0,1,1
2239,2011-04-08,4,0,1,1
2240,2011-04-08,5,1,8,9
2241,2011-04-08,6,2,33,35
2242,2011-04-08,7,4,107,111
2243,2011-04-08,8,13,206,219
2244,2011-04-08,9,17,165,182
2245,2011-04-08,10,10,62,72
2246,2011-04-08,11,19,78,97
2247,2011-04-08,12,29,50,79
2248,2011-04-08,13,7,35,42
2249,2011-04-08,14,2,12,14
2250,2011-04-08,15,1,24,25
2251,2011-04-08,16,2,58,60
2252,2011-04-08,17,10,136,146
2253,2011-04-08,18,8,54,62
2254,2011-04-08,19,1,51,52
2255,2011-04-08,20,11,50,61
2256,2011-04-08,21,12,42,54
2257,2011-04-08,22,9,42,51
2258,2011-04-08,23,4,30,34
2259,2011-04-09,0,5,26,31
2260,2011-04-09,1,3,17,20
2261,2011-04-09,2,2,14,16
2262,2011-04-09,3,3,11,14
2263,2011-04-09,4,0,3,3
2264,2011-04-09,5,0,5,5
2265,2011-04-09,6,0,13,13
2266,2011-04-09,7,8,13,21
2267,2011-04-09,8,7,45,52
2268,2011-04-09,9,27,70,97
2269,2011-04-09,10,43,90,133
2270,2011-04-09,11,51,89,140
2271,2011-04-09,12,79,121,200
2272,2011-04-09,13,114,103,217
2273,2011-04-09,14,94,114,208
2274,2011-04-09,15,85,116,201
2275,2011-04-09,16,72,117,189
2276,2011-04-09,17,129,127,256
2277,2011-04-09,18,48,126,174
2278,2011-04-09,19,47,83,130
2279,2011-04-09,20,19,73,92
2280,2011-04-09,21,10,63,73
2281,2011-04-09,22,21,66,87
2282,2011-04-09,23,12,44,56
2283,2011-04-10,0,5,48,53
2284,2011-04-10,1,6,29,35
2285,2011-04-10,2,12,24,36
2286,2011-04-10,3,5,11,16
2287,2011-04-10,4,3,2,5
2288,2011-04-10,5,0,4,4
2289,2011-04-10,6,0,4,4
2290,2011-04-10,7,3,7,10
2291,2011-04-10,8,17,38,55
2292,2011-04-10,9,31,49,80
2293,2011-04-10,10,69,73,142
2294,2011-04-10,11,93,103,196
2295,2011-04-10,12,94,131,225
2296,2011-04-10,13,121,137,258
2297,2011-04-10,14,148,131,279
2298,2011-04-10,15,156,139,295
2299,2011-04-10,16,135,151,286
2300,2011-04-10,17,84,147,231
2301,2011-04-10,18,103,133,236
2302,2011-04-10,19,47,84,131
2303,2011-04-10,20,21,70,91
2304,2011-04-10,21,18,75,93
2305,2011-04-10,22,12,45,57
2306,2011-04-10,23,5,27,32
2307,2011-04-11,0,7,16,23
2308,2011-04-11,1,1,2,3
2309,2011-04-11,2,7,2,9
2310,2011-04-11,4,0,1,1
2311,2011-04-11,5,1,12,13
2312,2011-04-11,6,2,59,61
2313,2011-04-11,7,12,161,173
2314,2011-04-11,8,28,279,307
2315,2011-04-11,9,33,128,161
2316,2011-04-11,10,41,55,96
2317,2011-04-11,11,45,58,103
2318,2011-04-11,12,37,97,134
2319,2011-04-11,13,62,76,138
2320,2011-04-11,14,60,84,144
2321,2011-04-11,15,55,84,139
2322,2011-04-11,16,73,159,232
2323,2011-04-11,17,100,351,451
2324,2011-04-11,18,93,283,376
2325,2011-04-11,19,73,209,282
2326,2011-04-11,20,44,116,160
2327,2011-04-11,21,39,117,156
2328,2011-04-11,22,25,63,88
2329,2011-04-11,23,16,38,54
2330,2011-04-12,0,11,13,24
2331,2011-04-12,1,6,7,13
2332,2011-04-12,2,7,7,14
2333,2011-04-12,3,0,1,1
2334,2011-04-12,4,4,2,6
2335,2011-04-12,5,1,15,16
2336,2011-04-12,6,3,53,56
2337,2011-04-12,7,12,172,184
2338,2011-04-12,8,15,207,222
2339,2011-04-12,9,4,47,51
2340,2011-04-12,10,6,34,40
2341,2011-04-12,11,11,38,49
2342,2011-04-12,12,9,82,91
2343,2011-04-12,13,22,81,103
2344,2011-04-12,14,16,26,42
2345,2011-04-12,15,24,54,78
2346,2011-04-12,16,19,79,98
2347,2011-04-12,17,29,259,288
2348,2011-04-12,18,21,199,220
2349,2011-04-12,19,3,122,125
2350,2011-04-12,20,9,91,100
2351,2011-04-12,21,10,74,84
2352,2011-04-12,22,7,47,54
2353,2011-04-12,23,8,30,38
2354,2011-04-13,0,3,12,15
2355,2011-04-13,1,0,1,1
2356,2011-04-13,2,0,2,2
2357,2011-04-13,3,0,2,2
2358,2011-04-13,4,1,2,3
2359,2011-04-13,5,1,4,5
2360,2011-04-13,6,1,33,34
2361,2011-04-13,7,3,67,70
2362,2011-04-13,8,6,156,162
2363,2011-04-13,9,2,62,64
2364,2011-04-13,10,4,41,45
2365,2011-04-13,11,4,55,59
2366,2011-04-13,12,12,82,94
2367,2011-04-13,13,6,54,60
2368,2011-04-13,14,24,80,104
2369,2011-04-13,15,12,66,78
2370,2011-04-13,16,23,114,137
2371,2011-04-13,17,25,283,308
2372,2011-04-13,18,28,289,317
2373,2011-04-13,19,14,158,172
2374,2011-04-13,20,7,117,124
2375,2011-04-13,21,17,97,114
2376,2011-04-13,22,10,87,97
2377,2011-04-13,23,5,56,61
2378,2011-04-14,0,3,18,21
2379,2011-04-14,1,1,9,10
2380,2011-04-14,2,0,3,3
2381,2011-04-14,3,0,2,2
2382,2011-04-14,4,1,7,8
2383,2011-04-14,5,2,12,14
2384,2011-04-14,6,4,66,70
2385,2011-04-14,7,11,176,187
2386,2011-04-14,8,21,312,333
2387,2011-04-14,9,18,146,164
2388,2011-04-14,10,21,67,88
2389,2011-04-14,11,28,86,114
2390,2011-04-14,12,35,107,142
2391,2011-04-14,13,38,116,154
2392,2011-04-14,14,36,101,137
2393,2011-04-14,15,57,83,140
2394,2011-04-14,16,49,150,199
2395,2011-04-14,17,50,332,382
2396,2011-04-14,18,46,286,332
2397,2011-04-14,19,37,218,255
2398,2011-04-14,20,22,142,164
2399,2011-04-14,21,18,124,142
2400,2011-04-14,22,22,80,102
2401,2011-04-14,23,7,40,47
2402,2011-04-15,0,6,21,27
2403,2011-04-15,1,6,9,15
2404,2011-04-15,2,8,10,18
2405,2011-04-15,3,0,3,3
2406,2011-04-15,4,0,3,3
2407,2011-04-15,5,2,11,13
2408,2011-04-15,6,5,42,47
2409,2011-04-15,7,10,133,143
2410,2011-04-15,8,21,277,298
2411,2011-04-15,9,16,160,176
2412,2011-04-15,10,31,87,118
2413,2011-04-15,11,41,95,136
2414,2011-04-15,12,45,152,197
2415,2011-04-15,13,47,131,178
2416,2011-04-15,14,57,106,163
2417,2011-04-15,15,50,109,159
2418,2011-04-15,16,70,171,241
2419,2011-04-15,17,64,265,329
2420,2011-04-15,18,47,210,257
2421,2011-04-15,19,41,161,202
2422,2011-04-15,20,26,90,116
2423,2011-04-15,21,25,77,102
2424,2011-04-15,22,16,62,78
2425,2011-04-15,23,8,55,63
2426,2011-04-16,0,7,34,41
2427,2011-04-16,1,5,28,33
2428,2011-04-16,2,5,17,22
2429,2011-04-16,3,5,9,14
2430,2011-04-16,4,1,4,5
2431,2011-04-16,5,1,3,4
2432,2011-04-16,6,1,9,10
2433,2011-04-16,7,3,17,20
2434,2011-04-16,8,7,38,45
2435,2011-04-16,9,2,26,28
2436,2011-04-16,10,1,20,21
2437,2011-04-16,11,4,25,29
2438,2011-04-16,12,6,26,32
2439,2011-04-16,13,9,48,57
2440,2011-04-16,14,14,48,62
2441,2011-04-16,15,16,62,78
2442,2011-04-16,16,6,25,31
2443,2011-04-16,17,1,13,14
2444,2011-04-16,18,6,32,38
2445,2011-04-16,19,9,60,69
2446,2011-04-16,20,4,45,49
2447,2011-04-16,21,1,13,14
2448,2011-04-16,22,2,22,24
2449,2011-04-16,23,5,30,35
2450,2011-04-17,0,4,29,33
2451,2011-04-17,1,6,24,30
2452,2011-04-17,2,4,24,28
2453,2011-04-17,3,12,13,25
2454,2011-04-17,4,2,4,6
2455,2011-04-17,5,2,1,3
2456,2011-04-17,6,3,5,8
2457,2011-04-17,7,2,14,16
2458,2011-04-17,8,7,36,43
2459,2011-04-17,9,31,70,101
2460,2011-04-17,10,91,120,211
2461,2011-04-17,11,118,167,285
2462,2011-04-17,12,167,182,349
2463,2011-04-17,13,180,157,337
2464,2011-04-17,14,170,184,354
2465,2011-04-17,15,178,201,379
2466,2011-04-17,16,161,175,336
2467,2011-04-17,17,143,162,305
2468,2011-04-17,18,102,172,274
2469,2011-04-17,19,75,134,209
2470,2011-04-17,20,44,95,139
2471,2011-04-17,21,13,68,81
2472,2011-04-17,22,21,49,70
2473,2011-04-17,23,19,36,55
2474,2011-04-18,0,15,23,38
2475,2011-04-18,1,11,8,19
2476,2011-04-18,2,14,2,16
2477,2011-04-18,3,6,1,7
2478,2011-04-18,4,2,4,6
2479,2011-04-18,5,0,16,16
2480,2011-04-18,6,3,51,54
2481,2011-04-18,7,12,154,166
2482,2011-04-18,8,20,274,294
2483,2011-04-18,9,37,126,163
2484,2011-04-18,10,41,65,106
2485,2011-04-18,11,36,87,123
2486,2011-04-18,12,60,119,179
2487,2011-04-18,13,41,126,167
2488,2011-04-18,14,49,91,140
2489,2011-04-18,15,64,108,172
2490,2011-04-18,16,40,163,203
2491,2011-04-18,17,66,353,419
2492,2011-04-18,18,41,314,355
2493,2011-04-18,19,41,239,280
2494,2011-04-18,20,29,133,162
2495,2011-04-18,21,20,129,149
2496,2011-04-18,22,9,80,89
2497,2011-04-18,23,11,35,46
2498,2011-04-19,0,2,23,25
2499,2011-04-19,1,5,2,7
2500,2011-04-19,2,8,5,13
2501,2011-04-19,3,0,3,3
2502,2011-04-19,4,1,4,5
2503,2011-04-19,5,1,17,18
2504,2011-04-19,6,2,63,65
2505,2011-04-19,7,22,165,187
2506,2011-04-19,8,20,324,344
2507,2011-04-19,9,23,130,153
2508,2011-04-19,10,15,57,72
2509,2011-04-19,11,19,50,69
2510,2011-04-19,12,19,81,100
2511,2011-04-19,13,26,102,128
2512,2011-04-19,14,19,86,105
2513,2011-04-19,15,44,82,126
2514,2011-04-19,16,30,159,189
2515,2011-04-19,17,39,367,406
2516,2011-04-19,18,44,368,412
2517,2011-04-19,19,28,243,271
2518,2011-04-19,20,20,143,163
2519,2011-04-19,21,8,112,120
2520,2011-04-19,22,3,103,106
2521,2011-04-19,23,11,41,52
2522,2011-04-20,0,4,28,32
2523,2011-04-20,1,2,5,7
2524,2011-04-20,2,0,2,2
2525,2011-04-20,3,0,2,2
2526,2011-04-20,4,5,4,9
2527,2011-04-20,5,1,14,15
2528,2011-04-20,6,2,62,64
2529,2011-04-20,7,26,207,233
2530,2011-04-20,8,20,370,390
2531,2011-04-20,9,28,165,193
2532,2011-04-20,10,45,83,128
2533,2011-04-20,11,31,86,117
2534,2011-04-20,12,28,116,144
2535,2011-04-20,13,42,134,176
2536,2011-04-20,14,33,113,146
2537,2011-04-20,15,32,113,145
2538,2011-04-20,16,54,200,254
2539,2011-04-20,17,33,394,427
2540,2011-04-20,18,56,381,437
2541,2011-04-20,19,74,304,378
2542,2011-04-20,20,31,189,220
2543,2011-04-20,21,38,132,170
2544,2011-04-20,22,12,104,116
2545,2011-04-20,23,14,78,92
2546,2011-04-21,0,11,29,40
2547,2011-04-21,1,6,20,26
2548,2011-04-21,2,3,9,12
2549,2011-04-21,3,4,3,7
2550,2011-04-21,4,2,4,6
2551,2011-04-21,5,0,14,14
2552,2011-04-21,6,2,73,75
2553,2011-04-21,7,15,179,194
2554,2011-04-21,8,19,338,357
2555,2011-04-21,9,18,174,192
2556,2011-04-21,10,25,71,96
2557,2011-04-21,11,34,99,133
2558,2011-04-21,12,49,146,195
2559,2011-04-21,13,55,104,159
2560,2011-04-21,14,68,119,187
2561,2011-04-21,15,69,123,192
2562,2011-04-21,16,66,199,265
2563,2011-04-21,17,78,398,476
2564,2011-04-21,18,71,369,440
2565,2011-04-21,19,51,266,317
2566,2011-04-21,20,28,170,198
2567,2011-04-21,21,25,152,177
2568,2011-04-21,22,31,105,136
2569,2011-04-21,23,13,85,98
2570,2011-04-22,0,3,30,33
2571,2011-04-22,1,2,21,23
2572,2011-04-22,2,2,6,8
2573,2011-04-22,3,0,2,2
2574,2011-04-22,4,1,2,3
2575,2011-04-22,5,0,16,16
2576,2011-04-22,6,2,47,49
2577,2011-04-22,7,5,173,178
2578,2011-04-22,8,15,327,342
2579,2011-04-22,9,17,169,186
2580,2011-04-22,10,32,100,132
2581,2011-04-22,11,23,80,103
2582,2011-04-22,12,19,59,78
2583,2011-04-22,13,3,37,40
2584,2011-04-22,14,3,33,36
2585,2011-04-22,15,13,61,74
2586,2011-04-22,16,4,58,62
2587,2011-04-22,17,6,61,67
2588,2011-04-22,18,4,47,51
2589,2011-04-22,19,7,47,54
2590,2011-04-22,20,8,38,46
2591,2011-04-22,21,5,23,28
2592,2011-04-22,22,3,21,24
2593,2011-04-22,23,0,13,13
2594,2011-04-23,0,0,17,17
2595,2011-04-23,1,5,11,16
2596,2011-04-23,2,3,14,17
2597,2011-04-23,3,0,4,4
2598,2011-04-23,4,2,3,5
2599,2011-04-23,5,1,5,6
2600,2011-04-23,6,0,11,11
2601,2011-04-23,7,2,16,18
2602,2011-04-23,8,15,32,47
2603,2011-04-23,9,13,55,68
2604,2011-04-23,10,36,93,129
2605,2011-04-23,11,68,160,228
2606,2011-04-23,12,94,191,285
2607,2011-04-23,13,126,179,305
2608,2011-04-23,14,182,205,387
2609,2011-04-23,15,171,220,391
2610,2011-04-23,16,180,237,417
2611,2011-04-23,17,168,209,377
2612,2011-04-23,18,147,220,367
2613,2011-04-23,19,84,193,277
2614,2011-04-23,20,45,137,182
2615,2011-04-23,21,32,102,134
2616,2011-04-23,22,55,109,164
2617,2011-04-23,23,31,86,117
2618,2011-04-24,0,29,63,92
2619,2011-04-24,1,14,39,53
2620,2011-04-24,2,27,43,70
2621,2011-04-24,3,4,17,21
2622,2011-04-24,4,0,5,5
2623,2011-04-24,5,5,7,12
2624,2011-04-24,6,10,3,13
2625,2011-04-24,7,16,11,27
2626,2011-04-24,8,38,42,80
2627,2011-04-24,9,73,102,175
2628,2011-04-24,10,117,169,286
2629,2011-04-24,11,124,182,306
2630,2011-04-24,12,168,210,378
2631,2011-04-24,13,205,226,431
2632,2011-04-24,14,196,218,414
2633,2011-04-24,15,167,199,366
2634,2011-04-24,16,162,195,357
2635,2011-04-24,17,142,180,322
2636,2011-04-24,18,96,170,266
2637,2011-04-24,19,62,129,191
2638,2011-04-24,20,34,71,105
2639,2011-04-24,21,8,53,61
2640,2011-04-24,22,5,38,43
2641,2011-04-24,23,5,36,41
2642,2011-04-25,0,2,10,12
2643,2011-04-25,1,2,8,10
2644,2011-04-25,2,1,9,10
2645,2011-04-25,3,2,8,10
2646,2011-04-25,4,1,4,5
2647,2011-04-25,5,2,14,16
2648,2011-04-25,6,7,59,66
2649,2011-04-25,7,13,180,193
2650,2011-04-25,8,27,318,345
2651,2011-04-25,9,27,145,172
2652,2011-04-25,10,61,63,124
2653,2011-04-25,11,53,93,146
2654,2011-04-25,12,48,140,188
2655,2011-04-25,13,57,144,201
2656,2011-04-25,14,47,95,142
2657,2011-04-25,15,50,124,174
2658,2011-04-25,16,41,197,238
2659,2011-04-25,17,79,430,509
2660,2011-04-25,18,74,421,495
2661,2011-04-25,19,62,314,376
2662,2011-04-25,20,42,190,232
2663,2011-04-25,21,41,146,187
2664,2011-04-25,22,23,83,106
2665,2011-04-25,23,9,53,62
2666,2011-04-26,0,10,17,27
2667,2011-04-26,1,16,5,21
2668,2011-04-26,2,17,9,26
2669,2011-04-26,3,17,4,21
2670,2011-04-26,4,2,4,6
2671,2011-04-26,5,0,16,16
2672,2011-04-26,6,0,80,80
2673,2011-04-26,7,15,249,264
2674,2011-04-26,8,32,411,443
2675,2011-04-26,9,35,161,196
2676,2011-04-26,10,22,97,119
2677,2011-04-26,11,40,123,163
2678,2011-04-26,12,39,144,183
2679,2011-04-26,13,37,137,174
2680,2011-04-26,14,40,113,153
2681,2011-04-26,15,34,118,152
2682,2011-04-26,16,40,249,289
2683,2011-04-26,17,66,447,513
2684,2011-04-26,18,65,454,519
2685,2011-04-26,19,42,281,323
2686,2011-04-26,20,34,196,230
2687,2011-04-26,21,33,159,192
2688,2011-04-26,22,32,113,145
2689,2011-04-26,23,7,68,75
2690,2011-04-27,0,3,24,27
2691,2011-04-27,1,2,15,17
2692,2011-04-27,2,0,5,5
2693,2011-04-27,3,3,4,7
2694,2011-04-27,4,0,6,6
2695,2011-04-27,5,1,16,17
2696,2011-04-27,6,5,79,84
2697,2011-04-27,7,17,224,241
2698,2011-04-27,8,31,406,437
2699,2011-04-27,9,19,159,178
2700,2011-04-27,10,26,66,92
2701,2011-04-27,11,53,101,154
2702,2011-04-27,12,38,132,170
2703,2011-04-27,13,31,116,147
2704,2011-04-27,14,29,116,145
2705,2011-04-27,15,18,119,137
2706,2011-04-27,16,29,187,216
2707,2011-04-27,17,62,450,512
2708,2011-04-27,18,46,359,405
2709,2011-04-27,19,40,213,253
2710,2011-04-27,20,30,185,215
2711,2011-04-27,21,19,124,143
2712,2011-04-27,22,18,108,126
2713,2011-04-27,23,25,50,75
2714,2011-04-28,0,13,37,50
2715,2011-04-28,1,8,12,20
2716,2011-04-28,2,14,7,21
2717,2011-04-28,3,2,1,3
2718,2011-04-28,4,4,5,9
2719,2011-04-28,5,0,13,13
2720,2011-04-28,6,7,78,85
2721,2011-04-28,7,14,196,210
2722,2011-04-28,8,30,360,390
2723,2011-04-28,9,19,159,178
2724,2011-04-28,10,8,44,52
2725,2011-04-28,11,10,71,81
2726,2011-04-28,12,23,84,107
2727,2011-04-28,13,18,101,119
2728,2011-04-28,14,21,120,141
2729,2011-04-28,15,46,115,161
2730,2011-04-28,16,42,227,269
2731,2011-04-28,17,49,402,451
2732,2011-04-28,18,44,476,520
2733,2011-04-28,19,57,339,396
2734,2011-04-28,20,49,217,266
2735,2011-04-28,21,27,166,193
2736,2011-04-28,22,34,118,152
2737,2011-04-28,23,29,80,109
2738,2011-04-29,0,11,37,48
2739,2011-04-29,1,10,21,31
2740,2011-04-29,2,2,8,10
2741,2011-04-29,3,1,4,5
2742,2011-04-29,4,0,6,6
2743,2011-04-29,5,0,25,25
2744,2011-04-29,6,4,66,70
2745,2011-04-29,7,18,210,228
2746,2011-04-29,8,35,383,418
2747,2011-04-29,9,45,182,227
2748,2011-04-29,10,56,99,155
2749,2011-04-29,11,49,106,155
2750,2011-04-29,12,63,159,222
2751,2011-04-29,13,74,176,250
2752,2011-04-29,14,58,160,218
2753,2011-04-29,15,77,159,236
2754,2011-04-29,16,59,237,296
2755,2011-04-29,17,75,427,502
2756,2011-04-29,18,55,378,433
2757,2011-04-29,19,40,225,265
2758,2011-04-29,20,34,158,192
2759,2011-04-29,21,50,142,192
2760,2011-04-29,22,36,109,145
2761,2011-04-29,23,25,83,108
2762,2011-04-30,0,33,72,105
2763,2011-04-30,1,15,58,73
2764,2011-04-30,2,12,51,63
2765,2011-04-30,3,4,11,15
2766,2011-04-30,4,2,5,7
2767,2011-04-30,5,3,4,7
2768,2011-04-30,6,10,10,20
2769,2011-04-30,7,21,27,48
2770,2011-04-30,8,19,69,88
2771,2011-04-30,9,35,118,153
2772,2011-04-30,10,94,183,277
2773,2011-04-30,11,119,200,319
2774,2011-04-30,12,178,234,412
2775,2011-04-30,13,185,260,445
2776,2011-04-30,14,184,261,445
2777,2011-04-30,15,217,276,493
2778,2011-04-30,16,191,267,458
2779,2011-04-30,17,162,234,396
2780,2011-04-30,18,134,227,361
2781,2011-04-30,19,150,228,378
2782,2011-04-30,20,64,154,218
2783,2011-04-30,21,58,113,171
2784,2011-04-30,22,37,103,140
2785,2011-04-30,23,34,86,120
2786,2011-05-01,0,19,77,96
2787,2011-05-01,1,9,49,58
2788,2011-05-01,2,7,43,50
2789,2011-05-01,3,8,14,22
2790,2011-05-01,4,6,11,17
2791,2011-05-01,5,0,10,10
2792,2011-05-01,6,4,8,12
2793,2011-05-01,7,7,26,33
2794,2011-05-01,8,16,43,59
2795,2011-05-01,9,45,92,137
2796,2011-05-01,10,108,149,257
2797,2011-05-01,11,110,137,247
2798,2011-05-01,12,109,169,278
2799,2011-05-01,13,123,207,330
2800,2011-05-01,14,85,147,232
2801,2011-05-01,15,113,147,260
2802,2011-05-01,16,75,136,211
2803,2011-05-01,17,59,132,191
2804,2011-05-01,18,33,123,156
2805,2011-05-01,19,47,125,172
2806,2011-05-01,20,35,85,120
2807,2011-05-01,21,23,79,102
2808,2011-05-01,22,32,67,99
2809,2011-05-01,23,64,82,146
2810,2011-05-02,0,68,104,172
2811,2011-05-02,1,41,72,113
2812,2011-05-02,2,16,19,35
2813,2011-05-02,3,9,7,16
2814,2011-05-02,4,9,7,16
2815,2011-05-02,5,4,16,20
2816,2011-05-02,6,3,59,62
2817,2011-05-02,7,15,187,202
2818,2011-05-02,8,21,341,362
2819,2011-05-02,9,41,129,170
2820,2011-05-02,10,31,76,107
2821,2011-05-02,11,33,95,128
2822,2011-05-02,12,40,146,186
2823,2011-05-02,13,51,118,169
2824,2011-05-02,14,48,131,179
2825,2011-05-02,15,45,108,153
2826,2011-05-02,16,49,216,265
2827,2011-05-02,17,65,469,534
2828,2011-05-02,18,68,445,513
2829,2011-05-02,19,46,258,304
2830,2011-05-02,20,44,165,209
2831,2011-05-02,21,54,175,229
2832,2011-05-02,22,28,95,123
2833,2011-05-02,23,16,46,62
2834,2011-05-03,0,0,16,16
2835,2011-05-03,1,0,14,14
2836,2011-05-03,2,0,5,5
2837,2011-05-03,3,0,2,2
2838,2011-05-03,4,3,1,4
2839,2011-05-03,5,0,14,14
2840,2011-05-03,6,7,102,109
2841,2011-05-03,7,17,246,263
2842,2011-05-03,8,24,428,452
2843,2011-05-03,9,29,156,185
2844,2011-05-03,10,36,90,126
2845,2011-05-03,11,20,117,137
2846,2011-05-03,12,48,166,214
2847,2011-05-03,13,50,144,194
2848,2011-05-03,14,36,120,156
2849,2011-05-03,15,37,116,153
2850,2011-05-03,16,46,203,249
2851,2011-05-03,17,53,457,510
2852,2011-05-03,18,59,471,530
2853,2011-05-03,19,42,320,362
2854,2011-05-03,20,28,252,280
2855,2011-05-03,21,42,175,217
2856,2011-05-03,22,14,99,113
2857,2011-05-03,23,12,49,61
2858,2011-05-04,0,5,22,27
2859,2011-05-04,1,1,6,7
2860,2011-05-04,2,0,4,4
2861,2011-05-04,3,0,1,1
2862,2011-05-04,4,1,2,3
2863,2011-05-04,5,1,8,9
2864,2011-05-04,6,0,21,21
2865,2011-05-04,7,5,45,50
2866,2011-05-04,8,5,73,78
2867,2011-05-04,9,5,33,38
2868,2011-05-04,10,5,26,31
2869,2011-05-04,11,3,69,72
2870,2011-05-04,12,19,103,122
2871,2011-05-04,13,15,124,139
2872,2011-05-04,14,13,93,106
2873,2011-05-04,15,22,103,125
2874,2011-05-04,16,22,173,195
2875,2011-05-04,17,21,385,406
2876,2011-05-04,18,29,363,392
2877,2011-05-04,19,30,260,290
2878,2011-05-04,20,17,172,189
2879,2011-05-04,21,16,129,145
2880,2011-05-04,22,9,80,89
2881,2011-05-04,23,8,48,56
2882,2011-05-05,0,4,23,27
2883,2011-05-05,1,4,6,10
2884,2011-05-05,2,1,4,5
2885,2011-05-05,3,0,4,4
2886,2011-05-05,4,4,3,7
2887,2011-05-05,5,1,28,29
2888,2011-05-05,6,3,84,87
2889,2011-05-05,7,16,252,268
2890,2011-05-05,8,25,403,428
2891,2011-05-05,9,19,159,178
2892,2011-05-05,10,30,92,122
2893,2011-05-05,11,43,102,145
2894,2011-05-05,12,27,162,189
2895,2011-05-05,13,49,138,187
2896,2011-05-05,14,19,130,149
2897,2011-05-05,15,26,118,144
2898,2011-05-05,16,36,228,264
2899,2011-05-05,17,66,458,524
2900,2011-05-05,18,64,448,512
2901,2011-05-05,19,56,301,357
2902,2011-05-05,20,33,220,253
2903,2011-05-05,21,39,139,178
2904,2011-05-05,22,30,129,159
2905,2011-05-05,23,16,96,112
2906,2011-05-06,0,13,43,56
2907,2011-05-06,1,8,23,31
2908,2011-05-06,2,1,15,16
2909,2011-05-06,3,3,6,9
2910,2011-05-06,4,0,1,1
2911,2011-05-06,5,0,16,16
2912,2011-05-06,6,8,74,82
2913,2011-05-06,7,20,197,217
2914,2011-05-06,8,34,405,439
2915,2011-05-06,9,27,159,186
2916,2011-05-06,10,30,94,124
2917,2011-05-06,11,42,119,161
2918,2011-05-06,12,48,193,241
2919,2011-05-06,13,70,179,249
2920,2011-05-06,14,86,125,211
2921,2011-05-06,15,89,170,259
2922,2011-05-06,16,82,260,342
2923,2011-05-06,17,82,461,543
2924,2011-05-06,18,85,380,465
2925,2011-05-06,19,38,248,286
2926,2011-05-06,20,30,159,189
2927,2011-05-06,21,22,126,148
2928,2011-05-06,22,46,102,148
2929,2011-05-06,23,27,89,116
2930,2011-05-07,0,10,74,84
2931,2011-05-07,1,8,48,56
2932,2011-05-07,2,5,45,50
2933,2011-05-07,3,9,9,18
2934,2011-05-07,4,1,4,5
2935,2011-05-07,5,4,3,7
2936,2011-05-07,6,1,12,13
2937,2011-05-07,7,7,32,39
2938,2011-05-07,8,19,96,115
2939,2011-05-07,9,52,159,211
2940,2011-05-07,10,90,205,295
2941,2011-05-07,11,131,209,340
2942,2011-05-07,12,128,236,364
2943,2011-05-07,13,196,229,425
2944,2011-05-07,14,143,226,369
2945,2011-05-07,15,148,223,371
2946,2011-05-07,16,119,215,334
2947,2011-05-07,17,137,212,349
2948,2011-05-07,18,114,171,285
2949,2011-05-07,19,87,169,256
2950,2011-05-07,20,82,132,214
2951,2011-05-07,21,58,120,178
2952,2011-05-07,22,26,93,119
2953,2011-05-07,23,30,89,119
2954,2011-05-08,0,22,76,98
2955,2011-05-08,1,8,55,63
2956,2011-05-08,2,17,40,57
2957,2011-05-08,3,10,20,30
2958,2011-05-08,4,2,8,10
2959,2011-05-08,5,0,5,5
2960,2011-05-08,6,2,4,6
2961,2011-05-08,7,8,15,23
2962,2011-05-08,8,27,57,84
2963,2011-05-08,9,49,110,159
2964,2011-05-08,10,91,148,239
2965,2011-05-08,11,141,192,333
2966,2011-05-08,12,140,238,378
2967,2011-05-08,13,165,215,380
2968,2011-05-08,14,126,235,361
2969,2011-05-08,15,128,224,352
2970,2011-05-08,16,122,248,370
2971,2011-05-08,17,106,236,342
2972,2011-05-08,18,63,199,262
2973,2011-05-08,19,61,173,234
2974,2011-05-08,20,42,129,171
2975,2011-05-08,21,32,94,126
2976,2011-05-08,22,29,84,113
2977,2011-05-08,23,9,40,49
2978,2011-05-09,0,31,21,52
2979,2011-05-09,1,25,8,33
2980,2011-05-09,2,6,2,8
2981,2011-05-09,3,0,6,6
2982,2011-05-09,4,0,4,4
2983,2011-05-09,5,0,23,23
2984,2011-05-09,6,2,87,89
2985,2011-05-09,7,14,218,232
2986,2011-05-09,8,22,340,362
2987,2011-05-09,9,36,139,175
2988,2011-05-09,10,24,91,115
2989,2011-05-09,11,26,96,122
2990,2011-05-09,12,35,156,191
2991,2011-05-09,13,36,135,171
2992,2011-05-09,14,44,117,161
2993,2011-05-09,15,51,139,190
2994,2011-05-09,16,49,247,296
2995,2011-05-09,17,59,533,592
2996,2011-05-09,18,66,454,520
2997,2011-05-09,19,45,335,380
2998,2011-05-09,20,25,210,235
2999,2011-05-09,21,28,126,154
3000,2011-05-09,22,21,90,111
3001,2011-05-09,23,16,45,61
3002,2011-05-10,0,6,12,18
3003,2011-05-10,1,3,12,15
3004,2011-05-10,2,1,4,5
3005,2011-05-10,3,1,3,4
3006,2011-05-10,4,0,2,2
3007,2011-05-10,5,1,28,29
3008,2011-05-10,6,9,102,111
3009,2011-05-10,7,13,293,306
3010,2011-05-10,8,27,388,415
3011,2011-05-10,9,29,174,203
3012,2011-05-10,10,27,99,126
3013,2011-05-10,11,17,104,121
3014,2011-05-10,12,46,166,212
3015,2011-05-10,13,50,150,200
3016,2011-05-10,14,42,134,176
3017,2011-05-10,15,28,149,177
3018,2011-05-10,16,56,268,324
3019,2011-05-10,17,79,526,605
3020,2011-05-10,18,69,472,541
3021,2011-05-10,19,68,358,426
3022,2011-05-10,20,51,238,289
3023,2011-05-10,21,30,171,201
3024,2011-05-10,22,29,118,147
3025,2011-05-10,23,9,71,80
3026,2011-05-11,0,8,30,38
3027,2011-05-11,1,4,15,19
3028,2011-05-11,2,6,4,10
3029,2011-05-11,3,0,3,3
3030,2011-05-11,4,0,2,2
3031,2011-05-11,5,0,20,20
3032,2011-05-11,6,6,92,98
3033,2011-05-11,7,25,289,314
3034,2011-05-11,8,21,416,437
3035,2011-05-11,9,21,177,198
3036,2011-05-11,10,30,114,144
3037,2011-05-11,11,18,121,139
3038,2011-05-11,12,41,183,224
3039,2011-05-11,13,36,155,191
3040,2011-05-11,14,36,138,174
3041,2011-05-11,15,48,130,178
3042,2011-05-11,16,49,237,286
3043,2011-05-11,17,17,240,257
3044,2011-05-11,18,40,227,267
3045,2011-05-11,19,60,332,392
3046,2011-05-11,20,28,238,266
3047,2011-05-11,21,32,192,224
3048,2011-05-11,22,12,131,143
3049,2011-05-11,23,12,68,80
3050,2011-05-12,0,5,37,42
3051,2011-05-12,1,1,16,17
3052,2011-05-12,2,1,12,13
3053,2011-05-12,3,0,5,5
3054,2011-05-12,4,1,5,6
3055,2011-05-12,5,2,27,29
3056,2011-05-12,6,9,102,111
3057,2011-05-12,7,14,280,294
3058,2011-05-12,8,26,389,415
3059,2011-05-12,9,21,187,208
3060,2011-05-12,10,28,105,133
3061,2011-05-12,11,43,135,178
3062,2011-05-12,12,43,162,205
3063,2011-05-12,13,48,169,217
3064,2011-05-12,14,43,145,188
3065,2011-05-12,15,54,150,204
3066,2011-05-12,16,50,229,279
3067,2011-05-12,17,53,537,590
3068,2011-05-12,18,65,450,515
3069,2011-05-12,19,59,302,361
3070,2011-05-12,20,56,218,274
3071,2011-05-12,21,31,184,215
3072,2011-05-12,22,25,144,169
3073,2011-05-12,23,16,85,101
3074,2011-05-13,0,6,45,51
3075,2011-05-13,1,5,15,20
3076,2011-05-13,2,3,8,11
3077,2011-05-13,3,2,2,4
3078,2011-05-13,4,2,3,5
3079,2011-05-13,5,1,22,23
3080,2011-05-13,6,6,76,82
3081,2011-05-13,7,16,139,155
3082,2011-05-13,8,26,359,385
3083,2011-05-13,9,18,211,229
3084,2011-05-13,10,31,92,123
3085,2011-05-13,11,56,89,145
3086,2011-05-13,12,53,168,221
3087,2011-05-13,13,69,152,221
3088,2011-05-13,14,70,115,185
3089,2011-05-13,15,55,141,196
3090,2011-05-13,16,44,254,298
3091,2011-05-13,17,62,425,487
3092,2011-05-13,18,38,351,389
3093,2011-05-13,19,25,237,262
3094,2011-05-13,20,22,126,148
3095,2011-05-13,21,24,127,151
3096,2011-05-13,22,25,103,128
3097,2011-05-13,23,31,88,119
3098,2011-05-14,0,23,75,98
3099,2011-05-14,1,18,63,81
3100,2011-05-14,2,15,36,51
3101,2011-05-14,3,5,30,35
3102,2011-05-14,4,1,4,5
3103,2011-05-14,5,7,7,14
3104,2011-05-14,6,2,9,11
3105,2011-05-14,7,4,28,32
3106,2011-05-14,8,16,72,88
3107,2011-05-14,9,14,85,99
3108,2011-05-14,10,34,131,165
3109,2011-05-14,11,72,205,277
3110,2011-05-14,12,75,195,270
3111,2011-05-14,13,67,178,245
3112,2011-05-14,14,57,154,211
3113,2011-05-14,15,73,215,288
3114,2011-05-14,16,107,187,294
3115,2011-05-14,17,78,191,269
3116,2011-05-14,18,87,209,296
3117,2011-05-14,19,69,174,243
3118,2011-05-14,20,42,111,153
3119,2011-05-14,21,15,44,59
3120,2011-05-14,22,7,17,24
3121,2011-05-14,23,11,33,44
3122,2011-05-15,0,5,32,37
3123,2011-05-15,1,4,42,46
3124,2011-05-15,2,13,37,50
3125,2011-05-15,3,11,20,31
3126,2011-05-15,4,5,7,12
3127,2011-05-15,5,3,11,14
3128,2011-05-15,6,3,14,17
3129,2011-05-15,7,4,35,39
3130,2011-05-15,8,24,46,70
3131,2011-05-15,9,36,97,133
3132,2011-05-15,10,73,150,223
3133,2011-05-15,11,120,196,316
3134,2011-05-15,12,120,242,362
3135,2011-05-15,13,195,251,446
3136,2011-05-15,14,183,249,432
3137,2011-05-15,15,206,245,451
3138,2011-05-15,16,158,280,438
3139,2011-05-15,17,136,251,387
3140,2011-05-15,18,60,170,230
3141,2011-05-15,19,78,153,231
3142,2011-05-15,20,53,137,190
3143,2011-05-15,21,44,103,147
3144,2011-05-15,22,29,84,113
3145,2011-05-15,23,18,50,68
3146,2011-05-16,0,17,21,38
3147,2011-05-16,1,6,8,14
3148,2011-05-16,2,4,8,12
3149,2011-05-16,3,1,3,4
3150,2011-05-16,4,1,5,6
3151,2011-05-16,5,1,20,21
3152,2011-05-16,6,11,92,103
3153,2011-05-16,7,27,239,266
3154,2011-05-16,8,28,361,389
3155,2011-05-16,9,38,153,191
3156,2011-05-16,10,37,72,109
3157,2011-05-16,11,56,128,184
3158,2011-05-16,12,72,136,208
3159,2011-05-16,13,61,152,213
3160,2011-05-16,14,75,116,191
3161,2011-05-16,15,55,110,165
3162,2011-05-16,16,45,175,220
3163,2011-05-16,17,47,225,272
3164,2011-05-16,18,55,391,446
3165,2011-05-16,19,36,267,303
3166,2011-05-16,20,31,166,197
3167,2011-05-16,21,28,147,175
3168,2011-05-16,22,22,104,126
3169,2011-05-16,23,18,38,56
3170,2011-05-17,0,13,18,31
3171,2011-05-17,1,7,6,13
3172,2011-05-17,2,4,4,8
3173,2011-05-17,3,1,3,4
3174,2011-05-17,4,2,2,4
3175,2011-05-17,5,0,22,22
3176,2011-05-17,6,0,49,49
3177,2011-05-17,7,13,135,148
3178,2011-05-17,8,22,321,343
3179,2011-05-17,9,17,185,202
3180,2011-05-17,10,31,72,103
3181,2011-05-17,11,26,103,129
3182,2011-05-17,12,38,112,150
3183,2011-05-17,13,31,138,169
3184,2011-05-17,14,61,123,184
3185,2011-05-17,15,79,128,207
3186,2011-05-17,16,73,213,286
3187,2011-05-17,17,83,514,597
3188,2011-05-17,18,54,421,475
3189,2011-05-17,19,51,292,343
3190,2011-05-17,20,30,245,275
3191,2011-05-17,21,23,148,171
3192,2011-05-17,22,12,86,98
3193,2011-05-17,23,7,49,56
3194,2011-05-18,0,8,15,23
3195,2011-05-18,1,3,9,12
3196,2011-05-18,2,1,5,6
3197,2011-05-18,3,6,3,9
3198,2011-05-18,4,1,2,3
3199,2011-05-18,5,0,9,9
3200,2011-05-18,6,2,98,100
3201,2011-05-18,7,14,257,271
3202,2011-05-18,8,25,423,448
3203,2011-05-18,9,26,175,201
3204,2011-05-18,10,33,72,105
3205,2011-05-18,11,6,17,23
3206,2011-05-18,12,12,41,53
3207,2011-05-18,13,30,87,117
3208,2011-05-18,14,44,92,136
3209,2011-05-18,15,34,130,164
3210,2011-05-18,16,53,238,291
3211,2011-05-18,17,77,484,561
3212,2011-05-18,18,58,427,485
3213,2011-05-18,19,43,283,326
3214,2011-05-18,20,24,186,210
3215,2011-05-18,21,11,73,84
3216,2011-05-18,22,14,102,116
3217,2011-05-18,23,10,49,59
3218,2011-05-19,0,6,22,28
3219,2011-05-19,1,2,4,6
3220,2011-05-19,2,3,12,15
3221,2011-05-19,3,1,3,4
3222,2011-05-19,4,2,3,5
3223,2011-05-19,5,2,24,26
3224,2011-05-19,6,17,86,103
3225,2011-05-19,7,18,236,254
3226,2011-05-19,8,34,448,482
3227,2011-05-19,9,40,171,211
3228,2011-05-19,10,35,91,126
3229,2011-05-19,11,53,109,162
3230,2011-05-19,12,38,127,165
3231,2011-05-19,13,44,135,179
3232,2011-05-19,14,43,136,179
3233,2011-05-19,15,63,124,187
3234,2011-05-19,16,55,243,298
3235,2011-05-19,17,60,479,539
3236,2011-05-19,18,59,446,505
3237,2011-05-19,19,65,337,402
3238,2011-05-19,20,46,233,279
3239,2011-05-19,21,28,173,201
3240,2011-05-19,22,11,67,78
3241,2011-05-19,23,9,60,69
3242,2011-05-20,0,15,33,48
3243,2011-05-20,1,8,14,22
3244,2011-05-20,2,4,4,8
3245,2011-05-20,3,1,4,5
3246,2011-05-20,4,1,4,5
3247,2011-05-20,5,0,27,27
3248,2011-05-20,6,15,98,113
3249,2011-05-20,7,30,282,312
3250,2011-05-20,8,40,467,507
3251,2011-05-20,9,35,196,231
3252,2011-05-20,10,44,102,146
3253,2011-05-20,11,62,130,192
3254,2011-05-20,12,69,182,251
3255,2011-05-20,13,60,168,228
3256,2011-05-20,14,66,131,197
3257,2011-05-20,15,74,167,241
3258,2011-05-20,16,61,268,329
3259,2011-05-20,17,71,473,544
3260,2011-05-20,18,79,391,470
3261,2011-05-20,19,49,250,299
3262,2011-05-20,20,40,172,212
3263,2011-05-20,21,40,153,193
3264,2011-05-20,22,28,122,150
3265,2011-05-20,23,15,99,114
3266,2011-05-21,0,20,77,97
3267,2011-05-21,1,8,64,72
3268,2011-05-21,2,4,34,38
3269,2011-05-21,3,7,12,19
3270,2011-05-21,4,0,6,6
3271,2011-05-21,5,1,4,5
3272,2011-05-21,6,6,22,28
3273,2011-05-21,7,10,33,43
3274,2011-05-21,8,27,95,122
3275,2011-05-21,9,60,160,220
3276,2011-05-21,10,122,199,321
3277,2011-05-21,11,173,239,412
3278,2011-05-21,12,222,268,490
3279,2011-05-21,13,191,262,453
3280,2011-05-21,14,187,259,446
3281,2011-05-21,15,232,272,504
3282,2011-05-21,16,204,262,466
3283,2011-05-21,17,191,249,440
3284,2011-05-21,18,191,245,436
3285,2011-05-21,19,117,184,301
3286,2011-05-21,20,84,160,244
3287,2011-05-21,21,77,146,223
3288,2011-05-21,22,78,123,201
3289,2011-05-21,23,42,102,144
3290,2011-05-22,0,31,96,127
3291,2011-05-22,1,17,81,98
3292,2011-05-22,2,18,50,68
3293,2011-05-22,3,10,23,33
3294,2011-05-22,4,3,9,12
3295,2011-05-22,5,1,5,6
3296,2011-05-22,6,5,13,18
3297,2011-05-22,7,13,27,40
3298,2011-05-22,8,29,64,93
3299,2011-05-22,9,59,125,184
3300,2011-05-22,10,135,166,301
3301,2011-05-22,11,164,206,370
3302,2011-05-22,12,146,252,398
3303,2011-05-22,13,180,267,447
3304,2011-05-22,14,125,184,309
3305,2011-05-22,15,110,218,328
3306,2011-05-22,16,72,194,266
3307,2011-05-22,17,93,207,300
3308,2011-05-22,18,120,235,355
3309,2011-05-22,19,107,191,298
3310,2011-05-22,20,57,170,227
3311,2011-05-22,21,27,107,134
3312,2011-05-22,22,35,85,120
3313,2011-05-22,23,19,45,64
3314,2011-05-23,0,23,15,38
3315,2011-05-23,1,4,5,9
3316,2011-05-23,2,2,3,5
3317,2011-05-23,3,0,4,4
3318,2011-05-23,4,2,2,4
3319,2011-05-23,5,0,11,11
3320,2011-05-23,6,4,92,96
3321,2011-05-23,7,13,220,233
3322,2011-05-23,8,50,357,407
3323,2011-05-23,9,36,129,165
3324,2011-05-23,10,49,70,119
3325,2011-05-23,11,72,107,179
3326,2011-05-23,12,65,137,202
3327,2011-05-23,13,48,153,201
3328,2011-05-23,14,57,128,185
3329,2011-05-23,15,57,109,166
3330,2011-05-23,16,56,221,277
3331,2011-05-23,17,56,373,429
3332,2011-05-23,18,68,376,444
3333,2011-05-23,19,56,302,358
3334,2011-05-23,20,39,263,302
3335,2011-05-23,21,33,154,187
3336,2011-05-23,22,25,106,131
3337,2011-05-23,23,19,53,72
3338,2011-05-24,0,12,21,33
3339,2011-05-24,1,6,9,15
3340,2011-05-24,2,2,8,10
3341,2011-05-24,3,0,2,2
3342,2011-05-24,4,1,3,4
3343,2011-05-24,5,2,22,24
3344,2011-05-24,6,10,101,111
3345,2011-05-24,7,26,284,310
3346,2011-05-24,8,31,396,427
3347,2011-05-24,9,27,111,138
3348,2011-05-24,10,18,79,97
3349,2011-05-24,11,33,137,170
3350,2011-05-24,12,41,127,168
3351,2011-05-24,13,38,149,187
3352,2011-05-24,14,27,123,150
3353,2011-05-24,15,59,128,187
3354,2011-05-24,16,52,221,273
3355,2011-05-24,17,56,484,540
3356,2011-05-24,18,74,486,560
3357,2011-05-24,19,45,309,354
3358,2011-05-24,20,39,236,275
3359,2011-05-24,21,21,161,182
3360,2011-05-24,22,26,113,139
3361,2011-05-24,23,13,53,66
3362,2011-05-25,0,3,32,35
3363,2011-05-25,1,6,2,8
3364,2011-05-25,2,0,8,8
3365,2011-05-25,3,0,9,9
3366,2011-05-25,4,0,3,3
3367,2011-05-25,5,2,23,25
3368,2011-05-25,6,4,113,117
3369,2011-05-25,7,29,282,311
3370,2011-05-25,8,36,490,526
3371,2011-05-25,9,27,204,231
3372,2011-05-25,10,30,103,133
3373,2011-05-25,11,36,104,140
3374,2011-05-25,12,32,172,204
3375,2011-05-25,13,39,162,201
3376,2011-05-25,14,47,121,168
3377,2011-05-25,15,37,142,179
3378,2011-05-25,16,61,234,295
3379,2011-05-25,17,77,517,594
3380,2011-05-25,18,66,444,510
3381,2011-05-25,19,72,327,399
3382,2011-05-25,20,56,280,336
3383,2011-05-25,21,33,200,233
3384,2011-05-25,22,34,132,166
3385,2011-05-25,23,12,74,86
3386,2011-05-26,0,11,33,44
3387,2011-05-26,1,3,13,16
3388,2011-05-26,2,7,7,14
3389,2011-05-26,3,0,4,4
3390,2011-05-26,4,0,2,2
3391,2011-05-26,5,2,25,27
3392,2011-05-26,6,4,94,98
3393,2011-05-26,7,16,265,281
3394,2011-05-26,8,31,452,483
3395,2011-05-26,9,22,193,215
3396,2011-05-26,10,49,92,141
3397,2011-05-26,11,36,121,157
3398,2011-05-26,12,53,138,191
3399,2011-05-26,13,52,144,196
3400,2011-05-26,14,44,145,189
3401,2011-05-26,15,40,101,141
3402,2011-05-26,16,58,231,289
3403,2011-05-26,17,49,445,494
3404,2011-05-26,18,74,396,470
3405,2011-05-26,19,67,308,375
3406,2011-05-26,20,55,261,316
3407,2011-05-26,21,44,177,221
3408,2011-05-26,22,23,156,179
3409,2011-05-26,23,17,71,88
3410,2011-05-27,0,14,55,69
3411,2011-05-27,1,14,36,50
3412,2011-05-27,2,6,12,18
3413,2011-05-27,3,1,11,12
3414,2011-05-27,4,2,5,7
3415,2011-05-27,5,2,28,30
3416,2011-05-27,6,8,72,80
3417,2011-05-27,7,19,227,246
3418,2011-05-27,8,25,390,415
3419,2011-05-27,9,37,189,226
3420,2011-05-27,10,42,108,150
3421,2011-05-27,11,40,125,165
3422,2011-05-27,12,53,186,239
3423,2011-05-27,13,51,157,208
3424,2011-05-27,14,51,183,234
3425,2011-05-27,15,97,255,352
3426,2011-05-27,16,63,352,415
3427,2011-05-27,17,77,409,486
3428,2011-05-27,18,89,304,393
3429,2011-05-27,19,69,205,274
3430,2011-05-27,20,24,120,144
3431,2011-05-27,21,37,112,149
3432,2011-05-27,22,25,110,135
3433,2011-05-27,23,23,102,125
3434,2011-05-28,0,15,75,90
3435,2011-05-28,1,8,46,54
3436,2011-05-28,2,13,35,48
3437,2011-05-28,3,2,13,15
3438,2011-05-28,4,0,3,3
3439,2011-05-28,5,4,3,7
3440,2011-05-28,6,3,15,18
3441,2011-05-28,7,17,31,48
3442,2011-05-28,8,27,74,101
3443,2011-05-28,9,61,114,175
3444,2011-05-28,10,109,164,273
3445,2011-05-28,11,171,173,344
3446,2011-05-28,12,145,207,352
3447,2011-05-28,13,168,212,380
3448,2011-05-28,14,172,206,378
3449,2011-05-28,15,187,184,371
3450,2011-05-28,16,201,197,398
3451,2011-05-28,17,180,156,336
3452,2011-05-28,18,173,206,379
3453,2011-05-28,19,99,152,251
3454,2011-05-28,20,68,127,195
3455,2011-05-28,21,87,111,198
3456,2011-05-28,22,46,113,159
3457,2011-05-28,23,44,76,120
3458,2011-05-29,0,32,51,83
3459,2011-05-29,1,17,48,65
3460,2011-05-29,2,12,47,59
3461,2011-05-29,3,2,24,26
3462,2011-05-29,4,13,10,23
3463,2011-05-29,5,3,3,6
3464,2011-05-29,6,5,10,15
3465,2011-05-29,7,13,17,30
3466,2011-05-29,8,34,61,95
3467,2011-05-29,9,74,76,150
3468,2011-05-29,10,128,118,246
3469,2011-05-29,11,139,175,314
3470,2011-05-29,12,216,185,401
3471,2011-05-29,13,236,177,413
3472,2011-05-29,14,184,166,350
3473,2011-05-29,15,220,151,371
3474,2011-05-29,16,194,164,358
3475,2011-05-29,17,214,164,378
3476,2011-05-29,18,150,177,327
3477,2011-05-29,19,141,144,285
3478,2011-05-29,20,91,128,219
3479,2011-05-29,21,107,117,224
3480,2011-05-29,22,78,91,169
3481,2011-05-29,23,48,87,135
3482,2011-05-30,0,38,62,100
3483,2011-05-30,1,26,52,78
3484,2011-05-30,2,17,28,45
3485,2011-05-30,3,10,8,18
3486,2011-05-30,4,2,4,6
3487,2011-05-30,5,1,6,7
3488,2011-05-30,6,6,10,16
3489,2011-05-30,7,12,19,31
3490,2011-05-30,8,36,58,94
3491,2011-05-30,9,46,78,124
3492,2011-05-30,10,116,148,264
3493,2011-05-30,11,153,167,320
3494,2011-05-30,12,179,182,361
3495,2011-05-30,13,133,216,349
3496,2011-05-30,14,142,178,320
3497,2011-05-30,15,132,175,307
3498,2011-05-30,16,101,203,304
3499,2011-05-30,17,102,197,299
3500,2011-05-30,18,77,169,246
3501,2011-05-30,19,68,157,225
3502,2011-05-30,20,69,164,233
3503,2011-05-30,21,42,105,147
3504,2011-05-30,22,26,79,105
3505,2011-05-30,23,14,34,48
3506,2011-05-31,0,9,20,29
3507,2011-05-31,1,8,9,17
3508,2011-05-31,2,5,7,12
3509,2011-05-31,3,1,3,4
3510,2011-05-31,4,0,3,3
3511,2011-05-31,5,0,26,26
3512,2011-05-31,6,11,98,109
3513,2011-05-31,7,16,216,232
3514,2011-05-31,8,33,368,401
3515,2011-05-31,9,22,148,170
3516,2011-05-31,10,37,69,106
3517,2011-05-31,11,28,77,105
3518,2011-05-31,12,37,122,159
3519,2011-05-31,13,37,107,144
3520,2011-05-31,14,40,97,137
3521,2011-05-31,15,42,131,173
3522,2011-05-31,16,44,204,248
3523,2011-05-31,17,67,425,492
3524,2011-05-31,18,55,358,413
3525,2011-05-31,19,39,245,284
3526,2011-05-31,20,38,212,250
3527,2011-05-31,21,45,165,210
3528,2011-05-31,22,42,114,156
3529,2011-05-31,23,15,45,60
3530,2011-06-01,0,9,25,34
3531,2011-06-01,1,8,9,17
3532,2011-06-01,2,0,3,3
3533,2011-06-01,3,0,6,6
3534,2011-06-01,4,0,4,4
3535,2011-06-01,5,2,19,21
3536,2011-06-01,6,7,120,127
3537,2011-06-01,7,18,265,283
3538,2011-06-01,8,37,414,451
3539,2011-06-01,9,34,169,203
3540,2011-06-01,10,31,83,114
3541,2011-06-01,11,26,86,112
3542,2011-06-01,12,32,134,166
3543,2011-06-01,13,29,122,151
3544,2011-06-01,14,40,105,145
3545,2011-06-01,15,25,125,150
3546,2011-06-01,16,39,225,264
3547,2011-06-01,17,52,429,481
3548,2011-06-01,18,31,272,303
3549,2011-06-01,19,16,244,260
3550,2011-06-01,20,23,232,255
3551,2011-06-01,21,29,157,186
3552,2011-06-01,22,14,115,129
3553,2011-06-01,23,10,56,66
3554,2011-06-02,0,11,31,42
3555,2011-06-02,1,3,12,15
3556,2011-06-02,2,0,6,6
3557,2011-06-02,3,0,4,4
3558,2011-06-02,4,0,3,3
3559,2011-06-02,5,3,28,31
3560,2011-06-02,6,7,106,113
3561,2011-06-02,7,19,282,301
3562,2011-06-02,8,25,437,462
3563,2011-06-02,9,28,196,224
3564,2011-06-02,10,33,103,136
3565,2011-06-02,11,42,123,165
3566,2011-06-02,12,39,190,229
3567,2011-06-02,13,35,166,201
3568,2011-06-02,14,43,140,183
3569,2011-06-02,15,44,143,187
3570,2011-06-02,16,63,252,315
3571,2011-06-02,17,88,483,571
3572,2011-06-02,18,74,444,518
3573,2011-06-02,19,58,317,375
3574,2011-06-02,20,51,279,330
3575,2011-06-02,21,33,210,243
3576,2011-06-02,22,14,138,152
3577,2011-06-02,23,23,83,106
3578,2011-06-03,0,15,52,67
3579,2011-06-03,1,7,16,23
3580,2011-06-03,2,0,12,12
3581,2011-06-03,3,0,4,4
3582,2011-06-03,4,1,5,6
3583,2011-06-03,5,4,24,28
3584,2011-06-03,6,8,98,106
3585,2011-06-03,7,24,246,270
3586,2011-06-03,8,32,463,495
3587,2011-06-03,9,36,193,229
3588,2011-06-03,10,54,106,160
3589,2011-06-03,11,57,134,191
3590,2011-06-03,12,51,203,254
3591,2011-06-03,13,58,189,247
3592,2011-06-03,14,66,173,239
3593,2011-06-03,15,56,155,211
3594,2011-06-03,16,63,283,346
3595,2011-06-03,17,73,481,554
3596,2011-06-03,18,76,478,554
3597,2011-06-03,19,53,331,384
3598,2011-06-03,20,57,229,286
3599,2011-06-03,21,51,193,244
3600,2011-06-03,22,26,140,166
3601,2011-06-03,23,30,136,166
3602,2011-06-04,0,24,68,92
3603,2011-06-04,1,14,78,92
3604,2011-06-04,2,18,41,59
3605,2011-06-04,3,8,9,17
3606,2011-06-04,4,4,11,15
3607,2011-06-04,5,3,5,8
3608,2011-06-04,6,11,17,28
3609,2011-06-04,7,27,57,84
3610,2011-06-04,8,29,94,123
3611,2011-06-04,9,55,167,222
3612,2011-06-04,10,115,197,312
3613,2011-06-04,11,119,246,365
3614,2011-06-04,12,149,268,417
3615,2011-06-04,13,187,255,442
3616,2011-06-04,14,193,253,446
3617,2011-06-04,15,179,216,395
3618,2011-06-04,16,168,261,429
3619,2011-06-04,17,141,201,342
3620,2011-06-04,18,127,206,333
3621,2011-06-04,19,79,201,280
3622,2011-06-04,20,90,144,234
3623,2011-06-04,21,46,133,179
3624,2011-06-04,22,49,137,186
3625,2011-06-04,23,29,119,148
3626,2011-06-05,0,23,89,112
3627,2011-06-05,1,26,69,95
3628,2011-06-05,2,16,47,63
3629,2011-06-05,3,22,25,47
3630,2011-06-05,4,4,8,12
3631,2011-06-05,5,1,5,6
3632,2011-06-05,6,10,11,21
3633,2011-06-05,7,8,19,27
3634,2011-06-05,8,24,74,98
3635,2011-06-05,9,53,110,163
3636,2011-06-05,10,83,165,248
3637,2011-06-05,11,121,212,333
3638,2011-06-05,12,123,206,329
3639,2011-06-05,13,154,206,360
3640,2011-06-05,14,161,221,382
3641,2011-06-05,15,160,253,413
3642,2011-06-05,16,138,254,392
3643,2011-06-05,17,126,261,387
3644,2011-06-05,18,124,233,357
3645,2011-06-05,19,108,246,354
3646,2011-06-05,20,84,195,279
3647,2011-06-05,21,54,111,165
3648,2011-06-05,22,36,93,129
3649,2011-06-05,23,25,61,86
3650,2011-06-06,0,11,18,29
3651,2011-06-06,1,9,5,14
3652,2011-06-06,2,4,4,8
3653,2011-06-06,3,2,3,5
3654,2011-06-06,4,4,4,8
3655,2011-06-06,5,7,24,31
3656,2011-06-06,6,11,98,109
3657,2011-06-06,7,18,278,296
3658,2011-06-06,8,28,400,428
3659,2011-06-06,9,26,157,183
3660,2011-06-06,10,31,64,95
3661,2011-06-06,11,39,69,108
3662,2011-06-06,12,25,128,153
3663,2011-06-06,13,28,150,178
3664,2011-06-06,14,46,99,145
3665,2011-06-06,15,38,126,164
3666,2011-06-06,16,33,227,260
3667,2011-06-06,17,61,512,573
3668,2011-06-06,18,56,494,550
3669,2011-06-06,19,64,335,399
3670,2011-06-06,20,59,276,335
3671,2011-06-06,21,29,157,186
3672,2011-06-06,22,36,135,171
3673,2011-06-06,23,5,55,60
3674,2011-06-07,0,5,15,20
3675,2011-06-07,1,2,2,4
3676,2011-06-07,2,3,2,5
3677,2011-06-07,3,1,1,2
3678,2011-06-07,4,2,3,5
3679,2011-06-07,5,2,30,32
3680,2011-06-07,6,9,116,125
3681,2011-06-07,7,23,301,324
3682,2011-06-07,8,45,430,475
3683,2011-06-07,9,27,189,216
3684,2011-06-07,10,37,86,123
3685,2011-06-07,11,38,111,149
3686,2011-06-07,12,42,136,178
3687,2011-06-07,13,54,139,193
3688,2011-06-07,14,34,111,145
3689,2011-06-07,15,56,124,180
3690,2011-06-07,16,55,252,307
3691,2011-06-07,17,64,473,537
3692,2011-06-07,18,71,473,544
3693,2011-06-07,19,69,351,420
3694,2011-06-07,20,45,297,342
3695,2011-06-07,21,31,183,214
3696,2011-06-07,22,27,126,153
3697,2011-06-07,23,18,72,90
3698,2011-06-08,0,12,29,41
3699,2011-06-08,1,3,19,22
3700,2011-06-08,2,0,6,6
3701,2011-06-08,3,2,1,3
3702,2011-06-08,4,0,6,6
3703,2011-06-08,5,0,21,21
3704,2011-06-08,6,13,102,115
3705,2011-06-08,7,24,322,346
3706,2011-06-08,8,46,434,480
3707,2011-06-08,9,34,165,199
3708,2011-06-08,10,27,63,90
3709,2011-06-08,11,28,105,133
3710,2011-06-08,12,15,131,146
3711,2011-06-08,13,20,115,135
3712,2011-06-08,14,44,110,154
3713,2011-06-08,15,28,98,126
3714,2011-06-08,16,34,199,233
3715,2011-06-08,17,79,423,502
3716,2011-06-08,18,61,394,455
3717,2011-06-08,19,61,320,381
3718,2011-06-08,20,55,224,279
3719,2011-06-08,21,34,163,197
3720,2011-06-08,22,37,137,174
3721,2011-06-08,23,18,96,114
3722,2011-06-09,0,7,40,47
3723,2011-06-09,1,3,13,16
3724,2011-06-09,2,0,6,6
3725,2011-06-09,3,0,2,2
3726,2011-06-09,4,2,4,6
3727,2011-06-09,5,1,19,20
3728,2011-06-09,6,13,104,117
3729,2011-06-09,7,31,280,311
3730,2011-06-09,8,32,399,431
3731,2011-06-09,9,20,147,167
3732,2011-06-09,10,20,72,92
3733,2011-06-09,11,36,81,117
3734,2011-06-09,12,40,101,141
3735,2011-06-09,13,18,118,136
3736,2011-06-09,14,25,93,118
3737,2011-06-09,15,18,86,104
3738,2011-06-09,16,30,169,199
3739,2011-06-09,17,54,352,406
3740,2011-06-09,18,51,411,462
3741,2011-06-09,19,55,269,324
3742,2011-06-09,20,40,212,252
3743,2011-06-09,21,29,139,168
3744,2011-06-09,22,22,129,151
3745,2011-06-09,23,15,80,95
3746,2011-06-10,0,8,61,69
3747,2011-06-10,1,5,18,23
3748,2011-06-10,2,6,7,13
3749,2011-06-10,3,3,3,6
3750,2011-06-10,4,0,3,3
3751,2011-06-10,5,0,28,28
3752,2011-06-10,6,10,93,103
3753,2011-06-10,7,25,237,262
3754,2011-06-10,8,29,421,450
3755,2011-06-10,9,37,173,210
3756,2011-06-10,10,23,87,110
3757,2011-06-10,11,46,106,152
3758,2011-06-10,12,40,165,205
3759,2011-06-10,13,40,147,187
3760,2011-06-10,14,44,119,163
3761,2011-06-10,15,49,162,211
3762,2011-06-10,16,46,238,284
3763,2011-06-10,17,62,448,510
3764,2011-06-10,18,96,364,460
3765,2011-06-10,19,61,245,306
3766,2011-06-10,20,53,192,245
3767,2011-06-10,21,55,163,218
3768,2011-06-10,22,40,141,181
3769,2011-06-10,23,36,105,141
3770,2011-06-11,0,28,85,113
3771,2011-06-11,1,10,67,77
3772,2011-06-11,2,10,49,59
3773,2011-06-11,3,10,18,28
3774,2011-06-11,4,4,9,13
3775,2011-06-11,5,4,11,15
3776,2011-06-11,6,9,31,40
3777,2011-06-11,7,18,50,68
3778,2011-06-11,8,32,108,140
3779,2011-06-11,9,59,169,228
3780,2011-06-11,10,91,170,261
3781,2011-06-11,11,109,213,322
3782,2011-06-11,12,112,229,341
3783,2011-06-11,13,150,236,386
3784,2011-06-11,14,148,224,372
3785,2011-06-11,15,141,227,368
3786,2011-06-11,16,168,222,390
3787,2011-06-11,17,147,186,333
3788,2011-06-11,18,131,149,280
3789,2011-06-11,19,97,167,264
3790,2011-06-11,20,95,171,266
3791,2011-06-11,21,76,142,218
3792,2011-06-11,22,53,136,189
3793,2011-06-11,23,24,105,129
3794,2011-06-12,0,19,98,117
3795,2011-06-12,1,19,75,94
3796,2011-06-12,2,9,56,65
3797,2011-06-12,3,8,20,28
3798,2011-06-12,4,8,6,14
3799,2011-06-12,5,5,5,10
3800,2011-06-12,6,5,9,14
3801,2011-06-12,7,7,27,34
3802,2011-06-12,8,28,64,92
3803,2011-06-12,9,75,107,182
3804,2011-06-12,10,120,191,311
3805,2011-06-12,11,131,231,362
3806,2011-06-12,12,176,238,414
3807,2011-06-12,13,109,256,365
3808,2011-06-12,14,96,215,311
3809,2011-06-12,15,142,211,353
3810,2011-06-12,16,115,232,347
3811,2011-06-12,17,94,154,248
3812,2011-06-12,18,69,182,251
3813,2011-06-12,19,67,154,221
3814,2011-06-12,20,62,144,206
3815,2011-06-12,21,39,100,139
3816,2011-06-12,22,31,92,123
3817,2011-06-12,23,33,73,106
3818,2011-06-13,0,8,18,26
3819,2011-06-13,1,6,10,16
3820,2011-06-13,2,2,8,10
3821,2011-06-13,3,1,6,7
3822,2011-06-13,4,1,3,4
3823,2011-06-13,5,2,27,29
3824,2011-06-13,6,7,98,105
3825,2011-06-13,7,26,300,326
3826,2011-06-13,8,44,427,471
3827,2011-06-13,9,35,187,222
3828,2011-06-13,10,38,77,115
3829,2011-06-13,11,53,104,157
3830,2011-06-13,12,35,160,195
3831,2011-06-13,13,53,172,225
3832,2011-06-13,14,55,145,200
3833,2011-06-13,15,58,118,176
3834,2011-06-13,16,64,261,325
3835,2011-06-13,17,72,523,595
3836,2011-06-13,18,76,505,581
3837,2011-06-13,19,75,343,418
3838,2011-06-13,20,78,252,330
3839,2011-06-13,21,40,178,218
3840,2011-06-13,22,20,110,130
3841,2011-06-13,23,14,74,88
3842,2011-06-14,0,13,18,31
3843,2011-06-14,1,3,9,12
3844,2011-06-14,2,2,8,10
3845,2011-06-14,3,1,1,2
3846,2011-06-14,4,0,3,3
3847,2011-06-14,5,3,22,25
3848,2011-06-14,6,6,106,112
3849,2011-06-14,7,19,341,360
3850,2011-06-14,8,45,431,476
3851,2011-06-14,9,19,171,190
3852,2011-06-14,10,33,97,130
3853,2011-06-14,11,40,103,143
3854,2011-06-14,12,29,137,166
3855,2011-06-14,13,33,173,206
3856,2011-06-14,14,41,118,159
3857,2011-06-14,15,42,135,177
3858,2011-06-14,16,51,276,327
3859,2011-06-14,17,85,482,567
3860,2011-06-14,18,65,466,531
3861,2011-06-14,19,51,330,381
3862,2011-06-14,20,60,230,290
3863,2011-06-14,21,37,200,237
3864,2011-06-14,22,29,157,186
3865,2011-06-14,23,19,89,108
3866,2011-06-15,0,8,43,51
3867,2011-06-15,1,0,14,14
3868,2011-06-15,2,0,9,9
3869,2011-06-15,3,0,1,1
3870,2011-06-15,4,0,4,4
3871,2011-06-15,5,1,20,21
3872,2011-06-15,6,11,109,120
3873,2011-06-15,7,22,335,357
3874,2011-06-15,8,53,441,494
3875,2011-06-15,9,22,183,205
3876,2011-06-15,10,27,108,135
3877,2011-06-15,11,49,114,163
3878,2011-06-15,12,33,175,208
3879,2011-06-15,13,43,146,189
3880,2011-06-15,14,50,125,175
3881,2011-06-15,15,33,131,164
3882,2011-06-15,16,47,262,309
3883,2011-06-15,17,83,550,633
3884,2011-06-15,18,80,521,601
3885,2011-06-15,19,54,359,413
3886,2011-06-15,20,57,269,326
3887,2011-06-15,21,48,203,251
3888,2011-06-15,22,31,144,175
3889,2011-06-15,23,17,88,105
3890,2011-06-16,0,9,37,46
3891,2011-06-16,1,4,13,17
3892,2011-06-16,2,1,4,5
3893,2011-06-16,3,0,4,4
3894,2011-06-16,4,0,6,6
3895,2011-06-16,5,7,18,25
3896,2011-06-16,6,8,104,112
3897,2011-06-16,7,16,167,183
3898,2011-06-16,8,24,361,385
3899,2011-06-16,9,29,231,260
3900,2011-06-16,10,18,101,119
3901,2011-06-16,11,33,117,150
3902,2011-06-16,12,41,163,204
3903,2011-06-16,13,37,112,149
3904,2011-06-16,14,39,114,153
3905,2011-06-16,15,32,126,158
3906,2011-06-16,16,35,254,289
3907,2011-06-16,17,42,228,270
3908,2011-06-16,18,26,296,322
3909,2011-06-16,19,58,263,321
3910,2011-06-16,20,25,171,196
3911,2011-06-16,21,34,152,186
3912,2011-06-16,22,24,125,149
3913,2011-06-16,23,2,14,16
3914,2011-06-17,0,3,21,24
3915,2011-06-17,1,4,18,22
3916,2011-06-17,2,2,11,13
3917,2011-06-17,3,1,5,6
3918,2011-06-17,4,1,5,6
3919,2011-06-17,5,1,11,12
3920,2011-06-17,6,8,87,95
3921,2011-06-17,7,25,221,246
3922,2011-06-17,8,28,422,450
3923,2011-06-17,9,28,196,224
3924,2011-06-17,10,44,124,168
3925,2011-06-17,11,43,136,179
3926,2011-06-17,12,49,192,241
3927,2011-06-17,13,48,153,201
3928,2011-06-17,14,73,140,213
3929,2011-06-17,15,62,179,241
3930,2011-06-17,16,69,281,350
3931,2011-06-17,17,85,462,547
3932,2011-06-17,18,61,383,444
3933,2011-06-17,19,53,259,312
3934,2011-06-17,20,40,188,228
3935,2011-06-17,21,49,155,204
3936,2011-06-17,22,48,124,172
3937,2011-06-17,23,37,137,174
3938,2011-06-18,0,21,82,103
3939,2011-06-18,1,15,78,93
3940,2011-06-18,2,16,37,53
3941,2011-06-18,3,4,16,20
3942,2011-06-18,4,1,4,5
3943,2011-06-18,5,1,5,6
3944,2011-06-18,6,9,18,27
3945,2011-06-18,7,12,44,56
3946,2011-06-18,8,28,103,131
3947,2011-06-18,9,62,155,217
3948,2011-06-18,10,68,175,243
3949,2011-06-18,11,133,268,401
3950,2011-06-18,12,162,251,413
3951,2011-06-18,13,135,188,323
3952,2011-06-18,14,138,190,328
3953,2011-06-18,15,153,209,362
3954,2011-06-18,16,193,270,463
3955,2011-06-18,17,210,235,445
3956,2011-06-18,18,118,253,371
3957,2011-06-18,19,99,223,322
3958,2011-06-18,20,61,126,187
3959,2011-06-18,21,58,123,181
3960,2011-06-18,22,56,102,158
3961,2011-06-18,23,53,93,146
3962,2011-06-19,0,18,66,84
3963,2011-06-19,1,17,57,74
3964,2011-06-19,2,13,55,68
3965,2011-06-19,3,14,16,30
3966,2011-06-19,4,7,9,16
3967,2011-06-19,5,7,11,18
3968,2011-06-19,6,11,22,33
3969,2011-06-19,7,35,36,71
3970,2011-06-19,8,25,57,82
3971,2011-06-19,9,58,108,166
3972,2011-06-19,10,85,157,242
3973,2011-06-19,11,141,232,373
3974,2011-06-19,12,141,250,391
3975,2011-06-19,13,149,211,360
3976,2011-06-19,14,124,189,313
3977,2011-06-19,15,145,212,357
3978,2011-06-19,16,121,253,374
3979,2011-06-19,17,159,235,394
3980,2011-06-19,18,78,213,291
3981,2011-06-19,19,94,208,302
3982,2011-06-19,20,86,143,229
3983,2011-06-19,21,57,107,164
3984,2011-06-19,22,38,113,151
3985,2011-06-19,23,14,77,91
3986,2011-06-20,0,7,18,25
3987,2011-06-20,1,9,3,12
3988,2011-06-20,2,2,0,2
3989,2011-06-20,3,1,0,1
3990,2011-06-20,4,1,2,3
3991,2011-06-20,5,0,2,2
3992,2011-06-20,6,1,25,26
3993,2011-06-20,7,0,46,46
3994,2011-06-20,8,12,206,218
3995,2011-06-20,9,19,199,218
3996,2011-06-20,10,33,58,91
3997,2011-06-20,11,27,64,91
3998,2011-06-20,12,33,128,161
3999,2011-06-20,13,50,128,178
4000,2011-06-20,14,45,128,173
4001,2011-06-20,15,66,137,203
4002,2011-06-20,16,61,235,296
4003,2011-06-20,17,79,479,558
4004,2011-06-20,18,64,472,536
4005,2011-06-20,19,62,367,429
4006,2011-06-20,20,52,258,310
4007,2011-06-20,21,39,163,202
4008,2011-06-20,22,24,105,129
4009,2011-06-20,23,10,47,57
4010,2011-06-21,0,10,23,33
4011,2011-06-21,1,2,12,14
4012,2011-06-21,2,1,5,6
4013,2011-06-21,3,0,2,2
4014,2011-06-21,4,2,7,9
4015,2011-06-21,5,3,22,25
4016,2011-06-21,6,8,105,113
4017,2011-06-21,7,21,286,307
4018,2011-06-21,8,33,364,397
4019,2011-06-21,9,32,240,272
4020,2011-06-21,10,41,118,159
4021,2011-06-21,11,51,116,167
4022,2011-06-21,12,40,145,185
4023,2011-06-21,13,48,152,200
4024,2011-06-21,14,44,106,150
4025,2011-06-21,15,42,128,170
4026,2011-06-21,16,61,269,330
4027,2011-06-21,17,65,501,566
4028,2011-06-21,18,66,463,529
4029,2011-06-21,19,67,347,414
4030,2011-06-21,20,72,253,325
4031,2011-06-21,21,38,186,224
4032,2011-06-21,22,12,96,108
4033,2011-06-21,23,11,53,64
4034,2011-06-22,0,15,16,31
4035,2011-06-22,1,2,18,20
4036,2011-06-22,2,2,5,7
4037,2011-06-22,3,0,7,7
4038,2011-06-22,4,3,8,11
4039,2011-06-22,5,2,21,23
4040,2011-06-22,6,12,107,119
4041,2011-06-22,7,23,283,306
4042,2011-06-22,8,27,394,421
4043,2011-06-22,9,14,199,213
4044,2011-06-22,10,31,101,132
4045,2011-06-22,11,36,106,142
4046,2011-06-22,12,41,142,183
4047,2011-06-22,13,33,108,141
4048,2011-06-22,14,31,112,143
4049,2011-06-22,15,32,114,146
4050,2011-06-22,16,34,221,255
4051,2011-06-22,17,67,459,526
4052,2011-06-22,18,66,445,511
4053,2011-06-22,19,62,275,337
4054,2011-06-22,20,52,226,278
4055,2011-06-22,21,31,212,243
4056,2011-06-22,22,25,123,148
4057,2011-06-22,23,14,88,102
4058,2011-06-23,0,5,41,46
4059,2011-06-23,1,5,24,29
4060,2011-06-23,2,0,4,4
4061,2011-06-23,3,1,4,5
4062,2011-06-23,4,0,7,7
4063,2011-06-23,5,2,22,24
4064,2011-06-23,6,8,91,99
4065,2011-06-23,7,26,296,322
4066,2011-06-23,8,20,409,429
4067,2011-06-23,9,33,192,225
4068,2011-06-23,10,39,81,120
4069,2011-06-23,11,28,105,133
4070,2011-06-23,12,30,128,158
4071,2011-06-23,13,37,148,185
4072,2011-06-23,14,46,103,149
4073,2011-06-23,15,62,124,186
4074,2011-06-23,16,58,217,275
4075,2011-06-23,17,74,488,562
4076,2011-06-23,18,57,474,531
4077,2011-06-23,19,56,338,394
4078,2011-06-23,20,75,274,349
4079,2011-06-23,21,45,183,228
4080,2011-06-23,22,23,137,160
4081,2011-06-23,23,15,88,103
4082,2011-06-24,0,10,50,60
4083,2011-06-24,1,8,20,28
4084,2011-06-24,2,4,8,12
4085,2011-06-24,3,1,4,5
4086,2011-06-24,4,1,8,9
4087,2011-06-24,5,2,18,20
4088,2011-06-24,6,4,86,90
4089,2011-06-24,7,21,246,267
4090,2011-06-24,8,27,432,459
4091,2011-06-24,9,28,199,227
4092,2011-06-24,10,43,99,142
4093,2011-06-24,11,56,145,201
4094,2011-06-24,12,51,149,200
4095,2011-06-24,13,43,175,218
4096,2011-06-24,14,67,162,229
4097,2011-06-24,15,69,144,213
4098,2011-06-24,16,80,246,326
4099,2011-06-24,17,85,464,549
4100,2011-06-24,18,87,358,445
4101,2011-06-24,19,92,287,379
4102,2011-06-24,20,66,220,286
4103,2011-06-24,21,50,182,232
4104,2011-06-24,22,41,124,165
4105,2011-06-24,23,33,135,168
4106,2011-06-25,0,19,94,113
4107,2011-06-25,1,20,75,95
4108,2011-06-25,2,8,48,56
4109,2011-06-25,3,18,21,39
4110,2011-06-25,4,7,4,11
4111,2011-06-25,5,6,6,12
4112,2011-06-25,6,12,17,29
4113,2011-06-25,7,7,35,42
4114,2011-06-25,8,27,85,112
4115,2011-06-25,9,47,134,181
4116,2011-06-25,10,97,200,297
4117,2011-06-25,11,122,206,328
4118,2011-06-25,12,140,242,382
4119,2011-06-25,13,140,230,370
4120,2011-06-25,14,151,225,376
4121,2011-06-25,15,156,230,386
4122,2011-06-25,16,174,230,404
4123,2011-06-25,17,153,237,390
4124,2011-06-25,18,108,189,297
4125,2011-06-25,19,119,245,364
4126,2011-06-25,20,74,193,267
4127,2011-06-25,21,62,137,199
4128,2011-06-25,22,61,121,182
4129,2011-06-25,23,51,128,179
4130,2011-06-26,0,30,82,112
4131,2011-06-26,1,17,72,89
4132,2011-06-26,2,17,70,87
4133,2011-06-26,3,12,22,34
4134,2011-06-26,4,3,8,11
4135,2011-06-26,5,3,9,12
4136,2011-06-26,6,7,13,20
4137,2011-06-26,7,24,25,49
4138,2011-06-26,8,29,77,106
4139,2011-06-26,9,75,129,204
4140,2011-06-26,10,136,191,327
4141,2011-06-26,11,127,216,343
4142,2011-06-26,12,175,265,440
4143,2011-06-26,13,197,240,437
4144,2011-06-26,14,197,241,438
4145,2011-06-26,15,174,224,398
4146,2011-06-26,16,177,271,448
4147,2011-06-26,17,178,240,418
4148,2011-06-26,18,117,258,375
4149,2011-06-26,19,89,225,314
4150,2011-06-26,20,54,152,206
4151,2011-06-26,21,47,134,181
4152,2011-06-26,22,19,95,114
4153,2011-06-26,23,14,64,78
4154,2011-06-27,0,7,25,32
4155,2011-06-27,1,4,11,15
4156,2011-06-27,2,3,3,6
4157,2011-06-27,3,0,2,2
4158,2011-06-27,4,1,8,9
4159,2011-06-27,5,1,20,21
4160,2011-06-27,6,4,88,92
4161,2011-06-27,7,14,246,260
4162,2011-06-27,8,28,411,439
4163,2011-06-27,9,37,146,183
4164,2011-06-27,10,55,95,150
4165,2011-06-27,11,55,94,149
4166,2011-06-27,12,40,129,169
4167,2011-06-27,13,37,120,157
4168,2011-06-27,14,58,100,158
4169,2011-06-27,15,76,124,200
4170,2011-06-27,16,53,221,274
4171,2011-06-27,17,90,510,600
4172,2011-06-27,18,79,506,585
4173,2011-06-27,19,56,333,389
4174,2011-06-27,20,54,249,303
4175,2011-06-27,21,52,185,237
4176,2011-06-27,22,33,111,144
4177,2011-06-27,23,16,65,81
4178,2011-06-28,0,5,23,28
4179,2011-06-28,1,5,8,13
4180,2011-06-28,2,2,9,11
4181,2011-06-28,3,0,2,2
4182,2011-06-28,4,1,7,8
4183,2011-06-28,5,1,20,21
4184,2011-06-28,6,7,116,123
4185,2011-06-28,7,27,316,343
4186,2011-06-28,8,39,414,453
4187,2011-06-28,9,38,204,242
4188,2011-06-28,10,45,108,153
4189,2011-06-28,11,49,111,160
4190,2011-06-28,12,39,159,198
4191,2011-06-28,13,33,154,187
4192,2011-06-28,14,43,115,158
4193,2011-06-28,15,39,123,162
4194,2011-06-28,16,41,215,256
4195,2011-06-28,17,70,500,570
4196,2011-06-28,18,67,432,499
4197,2011-06-28,19,44,253,297
4198,2011-06-28,20,50,242,292
4199,2011-06-28,21,31,159,190
4200,2011-06-28,22,30,103,133
4201,2011-06-28,23,23,57,80
4202,2011-06-29,0,11,25,36
4203,2011-06-29,1,10,18,28
4204,2011-06-29,2,7,9,16
4205,2011-06-29,3,2,3,5
4206,2011-06-29,4,0,5,5
4207,2011-06-29,5,3,19,22
4208,2011-06-29,6,12,104,116
4209,2011-06-29,7,18,314,332
4210,2011-06-29,8,41,491,532
4211,2011-06-29,9,32,185,217
4212,2011-06-29,10,31,91,122
4213,2011-06-29,11,53,111,164
4214,2011-06-29,12,55,187,242
4215,2011-06-29,13,45,185,230
4216,2011-06-29,14,50,136,186
4217,2011-06-29,15,43,145,188
4218,2011-06-29,16,60,265,325
4219,2011-06-29,17,78,487,565
4220,2011-06-29,18,78,496,574
4221,2011-06-29,19,59,336,395
4222,2011-06-29,20,70,259,329
4223,2011-06-29,21,26,188,214
4224,2011-06-29,22,32,150,182
4225,2011-06-29,23,32,97,129
4226,2011-06-30,0,15,38,53
4227,2011-06-30,1,13,19,32
4228,2011-06-30,2,2,6,8
4229,2011-06-30,3,2,7,9
4230,2011-06-30,4,2,4,6
4231,2011-06-30,5,1,24,25
4232,2011-06-30,6,4,117,121
4233,2011-06-30,7,28,287,315
4234,2011-06-30,8,44,505,549
4235,2011-06-30,9,33,224,257
4236,2011-06-30,10,35,95,130
4237,2011-06-30,11,47,120,167
4238,2011-06-30,12,50,179,229
4239,2011-06-30,13,69,158,227
4240,2011-06-30,14,46,117,163
4241,2011-06-30,15,64,173,237
4242,2011-06-30,16,63,259,322
4243,2011-06-30,17,98,495,593
4244,2011-06-30,18,113,467,580
4245,2011-06-30,19,90,363,453
4246,2011-06-30,20,55,281,336
4247,2011-06-30,21,81,237,318
4248,2011-06-30,22,42,158,200
4249,2011-06-30,23,27,99,126
4250,2011-07-01,0,20,48,68
4251,2011-07-01,1,15,16,31
4252,2011-07-01,2,6,7,13
4253,2011-07-01,3,5,6,11
4254,2011-07-01,4,1,5,6
4255,2011-07-01,5,3,27,30
4256,2011-07-01,6,11,97,108
4257,2011-07-01,7,24,213,237
4258,2011-07-01,8,39,448,487
4259,2011-07-01,9,58,200,258
4260,2011-07-01,10,61,107,168
4261,2011-07-01,11,68,144,212
4262,2011-07-01,12,83,175,258
4263,2011-07-01,13,83,206,289
4264,2011-07-01,14,78,221,299
4265,2011-07-01,15,81,295,376
4266,2011-07-01,16,85,341,426
4267,2011-07-01,17,99,356,455
4268,2011-07-01,18,98,317,415
4269,2011-07-01,19,80,234,314
4270,2011-07-01,20,84,183,267
4271,2011-07-01,21,69,145,214
4272,2011-07-01,22,49,167,216
4273,2011-07-01,23,44,94,138
4274,2011-07-02,0,31,83,114
4275,2011-07-02,1,20,57,77
4276,2011-07-02,2,9,42,51
4277,2011-07-02,3,5,20,25
4278,2011-07-02,4,3,7,10
4279,2011-07-02,5,1,13,14
4280,2011-07-02,6,11,20,31
4281,2011-07-02,7,10,33,43
4282,2011-07-02,8,38,90,128
4283,2011-07-02,9,55,123,178
4284,2011-07-02,10,103,166,269
4285,2011-07-02,11,144,210,354
4286,2011-07-02,12,142,224,366
4287,2011-07-02,13,177,223,400
4288,2011-07-02,14,178,213,391
4289,2011-07-02,15,168,161,329
4290,2011-07-02,16,206,184,390
4291,2011-07-02,17,179,162,341
4292,2011-07-02,18,193,184,377
4293,2011-07-02,19,156,149,305
4294,2011-07-02,20,136,142,278
4295,2011-07-02,21,95,133,228
4296,2011-07-02,22,78,120,198
4297,2011-07-02,23,66,87,153
4298,2011-07-03,0,47,94,141
4299,2011-07-03,1,23,55,78
4300,2011-07-03,2,19,45,64
4301,2011-07-03,3,8,25,33
4302,2011-07-03,4,3,2,5
4303,2011-07-03,5,0,1,1
4304,2011-07-03,6,0,3,3
4305,2011-07-03,7,3,22,25
4306,2011-07-03,8,39,52,91
4307,2011-07-03,9,82,98,180
4308,2011-07-03,10,131,131,262
4309,2011-07-03,11,215,170,385
4310,2011-07-03,12,198,205,403
4311,2011-07-03,13,248,169,417
4312,2011-07-03,14,223,149,372
4313,2011-07-03,15,194,174,368
4314,2011-07-03,16,195,208,403
4315,2011-07-03,17,181,171,352
4316,2011-07-03,18,74,105,179
4317,2011-07-03,19,100,82,182
4318,2011-07-03,20,82,93,175
4319,2011-07-03,21,75,91,166
4320,2011-07-03,22,69,91,160
4321,2011-07-03,23,70,75,145
4322,2011-07-04,0,63,75,138
4323,2011-07-04,1,43,74,117
4324,2011-07-04,2,33,29,62
4325,2011-07-04,3,13,13,26
4326,2011-07-04,4,8,4,12
4327,2011-07-04,5,1,3,4
4328,2011-07-04,6,5,11,16
4329,2011-07-04,7,17,18,35
4330,2011-07-04,8,42,44,86
4331,2011-07-04,9,142,95,237
4332,2011-07-04,10,166,111,277
4333,2011-07-04,11,177,169,346
4334,2011-07-04,12,236,208,444
4335,2011-07-04,13,243,177,420
4336,2011-07-04,14,235,168,403
4337,2011-07-04,15,222,180,402
4338,2011-07-04,16,236,211,447
4339,2011-07-04,17,240,190,430
4340,2011-07-04,18,222,191,413
4341,2011-07-04,19,170,200,370
4342,2011-07-04,20,195,189,384
4343,2011-07-04,21,191,254,445
4344,2011-07-04,22,116,208,324
4345,2011-07-04,23,44,92,136
4346,2011-07-05,0,19,36,55
4347,2011-07-05,1,15,21,36
4348,2011-07-05,2,8,5,13
4349,2011-07-05,3,1,7,8
4350,2011-07-05,4,1,4,5
4351,2011-07-05,5,1,19,20
4352,2011-07-05,6,3,89,92
4353,2011-07-05,7,22,245,267
4354,2011-07-05,8,41,385,426
4355,2011-07-05,9,50,175,225
4356,2011-07-05,10,55,84,139
4357,2011-07-05,11,75,97,172
4358,2011-07-05,12,71,129,200
4359,2011-07-05,13,67,133,200
4360,2011-07-05,14,66,107,173
4361,2011-07-05,15,51,108,159
4362,2011-07-05,16,78,201,279
4363,2011-07-05,17,79,466,545
4364,2011-07-05,18,70,419,489
4365,2011-07-05,19,71,291,362
4366,2011-07-05,20,59,223,282
4367,2011-07-05,21,77,164,241
4368,2011-07-05,22,31,122,153
4369,2011-07-05,23,19,54,73
4370,2011-07-06,0,11,26,37
4371,2011-07-06,1,4,11,15
4372,2011-07-06,2,1,4,5
4373,2011-07-06,3,0,5,5
4374,2011-07-06,4,0,6,6
4375,2011-07-06,5,5,30,35
4376,2011-07-06,6,9,110,119
4377,2011-07-06,7,24,284,308
4378,2011-07-06,8,30,390,420
4379,2011-07-06,9,31,155,186
4380,2011-07-06,10,13,29,42
4381,2011-07-06,11,24,103,127
4382,2011-07-06,12,38,112,150
4383,2011-07-06,13,33,105,138
4384,2011-07-06,14,50,111,161
4385,2011-07-06,15,55,127,182
4386,2011-07-06,16,57,217,274
4387,2011-07-06,17,79,511,590
4388,2011-07-06,18,77,482,559
4389,2011-07-06,19,71,313,384
4390,2011-07-06,20,55,252,307
4391,2011-07-06,21,66,172,238
4392,2011-07-06,22,30,154,184
4393,2011-07-06,23,20,77,97
4394,2011-07-07,0,6,29,35
4395,2011-07-07,1,2,14,16
4396,2011-07-07,2,1,7,8
4397,2011-07-07,3,2,2,4
4398,2011-07-07,4,0,4,4
4399,2011-07-07,5,2,30,32
4400,2011-07-07,6,11,104,115
4401,2011-07-07,7,13,266,279
4402,2011-07-07,8,28,408,436
4403,2011-07-07,9,25,150,175
4404,2011-07-07,10,29,68,97
4405,2011-07-07,11,29,105,134
4406,2011-07-07,12,33,135,168
4407,2011-07-07,13,48,105,153
4408,2011-07-07,14,39,120,159
4409,2011-07-07,15,47,118,165
4410,2011-07-07,16,47,215,262
4411,2011-07-07,17,80,479,559
4412,2011-07-07,18,70,483,553
4413,2011-07-07,19,79,281,360
4414,2011-07-07,20,61,219,280
4415,2011-07-07,21,39,169,208
4416,2011-07-07,22,32,147,179
4417,2011-07-07,23,31,95,126
4418,2011-07-08,0,6,41,47
4419,2011-07-08,1,9,25,34
4420,2011-07-08,2,10,12,22
4421,2011-07-08,3,2,4,6
4422,2011-07-08,4,7,4,11
4423,2011-07-08,5,3,24,27
4424,2011-07-08,6,11,91,102
4425,2011-07-08,7,30,293,323
4426,2011-07-08,8,36,415,451
4427,2011-07-08,9,30,208,238
4428,2011-07-08,10,30,106,136
4429,2011-07-08,11,61,103,164
4430,2011-07-08,12,49,155,204
4431,2011-07-08,13,53,174,227
4432,2011-07-08,14,53,162,215
4433,2011-07-08,15,39,100,139
4434,2011-07-08,16,27,103,130
4435,2011-07-08,17,6,161,167
4436,2011-07-08,18,35,278,313
4437,2011-07-08,19,44,222,266
4438,2011-07-08,20,29,213,242
4439,2011-07-08,21,46,157,203
4440,2011-07-08,22,33,131,164
4441,2011-07-08,23,40,108,148
4442,2011-07-09,0,31,89,120
4443,2011-07-09,1,5,47,52
4444,2011-07-09,2,12,43,55
4445,2011-07-09,3,7,23,30
4446,2011-07-09,4,2,3,5
4447,2011-07-09,5,4,11,15
4448,2011-07-09,6,11,27,38
4449,2011-07-09,7,21,50,71
4450,2011-07-09,8,68,110,178
4451,2011-07-09,9,77,166,243
4452,2011-07-09,10,87,173,260
4453,2011-07-09,11,101,186,287
4454,2011-07-09,12,145,219,364
4455,2011-07-09,13,167,242,409
4456,2011-07-09,14,158,207,365
4457,2011-07-09,15,182,210,392
4458,2011-07-09,16,171,240,411
4459,2011-07-09,17,160,239,399
4460,2011-07-09,18,131,244,375
4461,2011-07-09,19,128,177,305
4462,2011-07-09,20,129,181,310
4463,2011-07-09,21,83,151,234
4464,2011-07-09,22,60,149,209
4465,2011-07-09,23,47,93,140
4466,2011-07-10,0,42,112,154
4467,2011-07-10,1,19,94,113
4468,2011-07-10,2,28,67,95
4469,2011-07-10,3,6,19,25
4470,2011-07-10,4,0,5,5
4471,2011-07-10,5,7,10,17
4472,2011-07-10,6,8,17,25
4473,2011-07-10,7,27,36,63
4474,2011-07-10,8,27,64,91
4475,2011-07-10,9,62,106,168
4476,2011-07-10,10,95,169,264
4477,2011-07-10,11,112,172,284
4478,2011-07-10,12,133,241,374
4479,2011-07-10,13,139,225,364
4480,2011-07-10,14,121,225,346
4481,2011-07-10,15,142,214,356
4482,2011-07-10,16,128,241,369
4483,2011-07-10,17,145,213,358
4484,2011-07-10,18,142,219,361
4485,2011-07-10,19,120,179,299
4486,2011-07-10,20,101,163,264
4487,2011-07-10,21,65,157,222
4488,2011-07-10,22,56,84,140
4489,2011-07-10,23,19,51,70
4490,2011-07-11,0,10,24,34
4491,2011-07-11,1,5,5,10
4492,2011-07-11,2,8,4,12
4493,2011-07-11,3,2,8,10
4494,2011-07-11,4,0,4,4
4495,2011-07-11,5,5,20,25
4496,2011-07-11,6,19,101,120
4497,2011-07-11,7,28,286,314
4498,2011-07-11,8,35,378,413
4499,2011-07-11,9,40,165,205
4500,2011-07-11,10,44,73,117
4501,2011-07-11,11,39,89,128
4502,2011-07-11,12,40,108,148
4503,2011-07-11,13,22,119,141
4504,2011-07-11,14,40,90,130
4505,2011-07-11,15,38,107,145
4506,2011-07-11,16,57,180,237
4507,2011-07-11,17,58,453,511
4508,2011-07-11,18,57,409,466
4509,2011-07-11,19,79,289,368
4510,2011-07-11,20,42,188,230
4511,2011-07-11,21,21,108,129
4512,2011-07-11,22,20,69,89
4513,2011-07-11,23,11,43,54
4514,2011-07-12,0,3,19,22
4515,2011-07-12,1,6,8,14
4516,2011-07-12,2,2,7,9
4517,2011-07-12,3,2,6,8
4518,2011-07-12,4,0,6,6
4519,2011-07-12,5,4,21,25
4520,2011-07-12,6,13,100,113
4521,2011-07-12,7,29,299,328
4522,2011-07-12,8,35,375,410
4523,2011-07-12,9,27,147,174
4524,2011-07-12,10,38,85,123
4525,2011-07-12,11,39,85,124
4526,2011-07-12,12,38,123,161
4527,2011-07-12,13,32,101,133
4528,2011-07-12,14,33,89,122
4529,2011-07-12,15,37,107,144
4530,2011-07-12,16,24,176,200
4531,2011-07-12,17,48,379,427
4532,2011-07-12,18,39,467,506
4533,2011-07-12,19,42,290,332
4534,2011-07-12,20,56,248,304
4535,2011-07-12,21,49,205,254
4536,2011-07-12,22,44,147,191
4537,2011-07-12,23,20,56,76
4538,2011-07-13,0,9,37,46
4539,2011-07-13,1,1,11,12
4540,2011-07-13,2,2,3,5
4541,2011-07-13,3,0,4,4
4542,2011-07-13,4,0,5,5
4543,2011-07-13,5,4,22,26
4544,2011-07-13,6,18,100,118
4545,2011-07-13,7,32,279,311
4546,2011-07-13,8,31,410,441
4547,2011-07-13,9,23,159,182
4548,2011-07-13,10,33,76,109
4549,2011-07-13,11,55,107,162
4550,2011-07-13,12,40,132,172
4551,2011-07-13,13,38,116,154
4552,2011-07-13,14,27,86,113
4553,2011-07-13,15,12,31,43
4554,2011-07-13,16,23,118,141
4555,2011-07-13,17,70,417,487
4556,2011-07-13,18,51,406,457
4557,2011-07-13,19,79,336,415
4558,2011-07-13,20,61,278,339
4559,2011-07-13,21,55,194,249
4560,2011-07-13,22,48,135,183
4561,2011-07-13,23,33,82,115
4562,2011-07-14,0,14,32,46
4563,2011-07-14,1,4,21,25
4564,2011-07-14,2,3,7,10
4565,2011-07-14,3,1,5,6
4566,2011-07-14,4,0,6,6
4567,2011-07-14,5,6,22,28
4568,2011-07-14,6,14,114,128
4569,2011-07-14,7,23,306,329
4570,2011-07-14,8,53,427,480
4571,2011-07-14,9,29,184,213
4572,2011-07-14,10,32,93,125
4573,2011-07-14,11,38,108,146
4574,2011-07-14,12,51,169,220
4575,2011-07-14,13,39,136,175
4576,2011-07-14,14,49,126,175
4577,2011-07-14,15,42,136,178
4578,2011-07-14,16,43,231,274
4579,2011-07-14,17,78,514,592
4580,2011-07-14,18,94,476,570
4581,2011-07-14,19,67,324,391
4582,2011-07-14,20,80,262,342
4583,2011-07-14,21,59,200,259
4584,2011-07-14,22,42,132,174
4585,2011-07-14,23,27,97,124
4586,2011-07-15,0,23,57,80
4587,2011-07-15,1,7,12,19
4588,2011-07-15,2,16,22,38
4589,2011-07-15,3,1,6,7
4590,2011-07-15,4,2,8,10
4591,2011-07-15,5,7,16,23
4592,2011-07-15,6,12,107,119
4593,2011-07-15,7,17,252,269
4594,2011-07-15,8,50,504,554
4595,2011-07-15,9,31,173,204
4596,2011-07-15,10,59,103,162
4597,2011-07-15,11,73,134,207
4598,2011-07-15,12,61,172,233
4599,2011-07-15,13,85,161,246
4600,2011-07-15,14,105,160,265
4601,2011-07-15,15,74,159,233
4602,2011-07-15,16,96,262,358
4603,2011-07-15,17,104,478,582
4604,2011-07-15,18,102,391,493
4605,2011-07-15,19,114,272,386
4606,2011-07-15,20,92,250,342
4607,2011-07-15,21,75,184,259
4608,2011-07-15,22,71,149,220
4609,2011-07-15,23,41,124,165
4610,2011-07-16,0,42,65,107
4611,2011-07-16,1,24,51,75
4612,2011-07-16,2,10,45,55
4613,2011-07-16,3,6,20,26
4614,2011-07-16,4,9,7,16
4615,2011-07-16,5,4,6,10
4616,2011-07-16,6,16,18,34
4617,2011-07-16,7,14,38,52
4618,2011-07-16,8,37,89,126
4619,2011-07-16,9,72,148,220
4620,2011-07-16,10,114,203,317
4621,2011-07-16,11,171,220,391
4622,2011-07-16,12,186,269,455
4623,2011-07-16,13,221,268,489
4624,2011-07-16,14,201,227,428
4625,2011-07-16,15,205,223,428
4626,2011-07-16,16,183,235,418
4627,2011-07-16,17,234,234,468
4628,2011-07-16,18,185,238,423
4629,2011-07-16,19,164,236,400
4630,2011-07-16,20,108,185,293
4631,2011-07-16,21,85,163,248
4632,2011-07-16,22,65,134,199
4633,2011-07-16,23,61,107,168
4634,2011-07-17,0,34,88,122
4635,2011-07-17,1,16,85,101
4636,2011-07-17,2,27,66,93
4637,2011-07-17,3,21,26,47
4638,2011-07-17,4,4,5,9
4639,2011-07-17,5,4,8,12
4640,2011-07-17,6,10,10,20
4641,2011-07-17,7,20,30,50
4642,2011-07-17,8,45,73,118
4643,2011-07-17,9,74,107,181
4644,2011-07-17,10,127,177,304
4645,2011-07-17,11,147,239,386
4646,2011-07-17,12,177,240,417
4647,2011-07-17,13,200,268,468
4648,2011-07-17,14,168,255,423
4649,2011-07-17,15,129,192,321
4650,2011-07-17,16,128,185,313
4651,2011-07-17,17,134,232,366
4652,2011-07-17,18,147,238,385
4653,2011-07-17,19,145,233,378
4654,2011-07-17,20,85,170,255
4655,2011-07-17,21,59,148,207
4656,2011-07-17,22,65,111,176
4657,2011-07-17,23,39,53,92
4658,2011-07-18,0,21,30,51
4659,2011-07-18,1,17,8,25
4660,2011-07-18,2,2,8,10
4661,2011-07-18,3,3,4,7
4662,2011-07-18,4,1,3,4
4663,2011-07-18,5,2,14,16
4664,2011-07-18,6,10,94,104
4665,2011-07-18,7,22,249,271
4666,2011-07-18,8,18,320,338
4667,2011-07-18,9,33,168,201
4668,2011-07-18,10,52,76,128
4669,2011-07-18,11,42,96,138
4670,2011-07-18,12,39,124,163
4671,2011-07-18,13,27,123,150
4672,2011-07-18,14,32,104,136
4673,2011-07-18,15,53,111,164
4674,2011-07-18,16,45,219,264
4675,2011-07-18,17,72,469,541
4676,2011-07-18,18,80,470,550
4677,2011-07-18,19,63,328,391
4678,2011-07-18,20,91,230,321
4679,2011-07-18,21,48,153,201
4680,2011-07-18,22,36,104,140
4681,2011-07-18,23,32,58,90
4682,2011-07-19,0,25,26,51
4683,2011-07-19,1,7,6,13
4684,2011-07-19,2,9,4,13
4685,2011-07-19,3,2,1,3
4686,2011-07-19,4,1,4,5
4687,2011-07-19,5,0,18,18
4688,2011-07-19,6,8,125,133
4689,2011-07-19,7,28,285,313
4690,2011-07-19,8,31,377,408
4691,2011-07-19,9,22,172,194
4692,2011-07-19,10,29,95,124
4693,2011-07-19,11,29,92,121
4694,2011-07-19,12,26,124,150
4695,2011-07-19,13,33,136,169
4696,2011-07-19,14,41,110,151
4697,2011-07-19,15,48,109,157
4698,2011-07-19,16,61,211,272
4699,2011-07-19,17,68,441,509
4700,2011-07-19,18,80,448,528
4701,2011-07-19,19,54,324,378
4702,2011-07-19,20,47,228,275
4703,2011-07-19,21,47,190,237
4704,2011-07-19,22,36,120,156
4705,2011-07-19,23,19,72,91
4706,2011-07-20,0,11,29,40
4707,2011-07-20,1,4,7,11
4708,2011-07-20,2,2,7,9
4709,2011-07-20,3,2,4,6
4710,2011-07-20,4,0,4,4
4711,2011-07-20,5,4,19,23
4712,2011-07-20,6,5,109,114
4713,2011-07-20,7,27,273,300
4714,2011-07-20,8,34,398,432
4715,2011-07-20,9,28,178,206
4716,2011-07-20,10,34,70,104
4717,2011-07-20,11,26,111,137
4718,2011-07-20,12,28,115,143
4719,2011-07-20,13,23,96,119
4720,2011-07-20,14,44,83,127
4721,2011-07-20,15,36,101,137
4722,2011-07-20,16,30,204,234
4723,2011-07-20,17,50,403,453
4724,2011-07-20,18,68,424,492
4725,2011-07-20,19,59,320,379
4726,2011-07-20,20,45,259,304
4727,2011-07-20,21,32,203,235
4728,2011-07-20,22,25,140,165
4729,2011-07-20,23,26,73,99
4730,2011-07-21,0,13,29,42
4731,2011-07-21,1,5,16,21
4732,2011-07-21,2,2,4,6
4733,2011-07-21,3,1,4,5
4734,2011-07-21,4,0,4,4
4735,2011-07-21,5,2,16,18
4736,2011-07-21,6,6,110,116
4737,2011-07-21,7,23,246,269
4738,2011-07-21,8,23,354,377
4739,2011-07-21,9,34,164,198
4740,2011-07-21,10,31,47,78
4741,2011-07-21,11,27,76,103
4742,2011-07-21,12,29,103,132
4743,2011-07-21,13,20,80,100
4744,2011-07-21,14,51,96,147
4745,2011-07-21,15,40,93,133
4746,2011-07-21,16,42,165,207
4747,2011-07-21,17,40,369,409
4748,2011-07-21,18,38,337,375
4749,2011-07-21,19,51,231,282
4750,2011-07-21,20,38,193,231
4751,2011-07-21,21,38,185,223
4752,2011-07-21,22,36,112,148
4753,2011-07-21,23,40,72,112
4754,2011-07-22,0,9,50,59
4755,2011-07-22,1,7,17,24
4756,2011-07-22,2,0,14,14
4757,2011-07-22,3,1,6,7
4758,2011-07-22,4,8,5,13
4759,2011-07-22,5,2,17,19
4760,2011-07-22,6,13,83,96
4761,2011-07-22,7,20,229,249
4762,2011-07-22,8,30,291,321
4763,2011-07-22,9,31,177,208
4764,2011-07-22,10,32,80,112
4765,2011-07-22,11,23,85,108
4766,2011-07-22,12,19,95,114
4767,2011-07-22,13,25,97,122
4768,2011-07-22,14,24,76,100
4769,2011-07-22,15,32,99,131
4770,2011-07-22,16,29,153,182
4771,2011-07-22,17,35,265,300
4772,2011-07-22,18,34,245,279
4773,2011-07-22,19,40,207,247
4774,2011-07-22,20,44,164,208
4775,2011-07-22,21,38,149,187
4776,2011-07-22,22,44,102,146
4777,2011-07-22,23,19,82,101
4778,2011-07-23,0,16,85,101
4779,2011-07-23,1,13,57,70
4780,2011-07-23,2,13,48,61
4781,2011-07-23,3,6,16,22
4782,2011-07-23,4,5,3,8
4783,2011-07-23,5,1,6,7
4784,2011-07-23,6,6,19,25
4785,2011-07-23,7,6,38,44
4786,2011-07-23,8,24,83,107
4787,2011-07-23,9,30,101,131
4788,2011-07-23,10,61,132,193
4789,2011-07-23,11,62,153,215
4790,2011-07-23,12,71,162,233
4791,2011-07-23,13,78,162,240
4792,2011-07-23,14,84,149,233
4793,2011-07-23,15,77,137,214
4794,2011-07-23,16,71,147,218
4795,2011-07-23,17,70,121,191
4796,2011-07-23,18,62,132,194
4797,2011-07-23,19,80,132,212
4798,2011-07-23,20,47,97,144
4799,2011-07-23,21,39,112,151
4800,2011-07-23,22,37,87,124
4801,2011-07-23,23,27,75,102
4802,2011-07-24,0,42,77,119
4803,2011-07-24,1,33,62,95
4804,2011-07-24,2,12,46,58
4805,2011-07-24,3,16,20,36
4806,2011-07-24,4,1,5,6
4807,2011-07-24,5,5,3,8
4808,2011-07-24,6,9,13,22
4809,2011-07-24,7,6,28,34
4810,2011-07-24,8,22,80,102
4811,2011-07-24,9,42,111,153
4812,2011-07-24,10,61,161,222
4813,2011-07-24,11,74,166,240
4814,2011-07-24,12,85,155,240
4815,2011-07-24,13,90,161,251
4816,2011-07-24,14,79,201,280
4817,2011-07-24,15,68,168,236
4818,2011-07-24,16,62,185,247
4819,2011-07-24,17,75,171,246
4820,2011-07-24,18,67,176,243
4821,2011-07-24,19,70,167,237
4822,2011-07-24,20,52,139,191
4823,2011-07-24,21,42,108,150
4824,2011-07-24,22,23,75,98
4825,2011-07-24,23,13,35,48
4826,2011-07-25,0,17,17,34
4827,2011-07-25,1,4,8,12
4828,2011-07-25,2,3,3,6
4829,2011-07-25,3,2,2,4
4830,2011-07-25,4,0,6,6
4831,2011-07-25,5,2,22,24
4832,2011-07-25,6,7,99,106
4833,2011-07-25,7,20,252,272
4834,2011-07-25,8,34,351,385
4835,2011-07-25,9,11,123,134
4836,2011-07-25,10,30,54,84
4837,2011-07-25,11,24,82,106
4838,2011-07-25,12,17,48,65
4839,2011-07-25,13,14,61,75
4840,2011-07-25,14,28,61,89
4841,2011-07-25,15,14,93,107
4842,2011-07-25,16,37,159,196
4843,2011-07-25,17,48,431,479
4844,2011-07-25,18,60,469,529
4845,2011-07-25,19,62,319,381
4846,2011-07-25,20,55,244,299
4847,2011-07-25,21,41,147,188
4848,2011-07-25,22,13,110,123
4849,2011-07-25,23,23,63,86
4850,2011-07-26,0,8,20,28
4851,2011-07-26,1,6,6,12
4852,2011-07-26,2,1,6,7
4853,2011-07-26,3,2,2,4
4854,2011-07-26,4,0,6,6
4855,2011-07-26,5,3,24,27
4856,2011-07-26,6,2,104,106
4857,2011-07-26,7,30,280,310
4858,2011-07-26,8,32,384,416
4859,2011-07-26,9,25,159,184
4860,2011-07-26,10,42,91,133
4861,2011-07-26,11,49,99,148
4862,2011-07-26,12,25,117,142
4863,2011-07-26,13,43,131,174
4864,2011-07-26,14,46,100,146
4865,2011-07-26,15,49,114,163
4866,2011-07-26,16,41,208,249
4867,2011-07-26,17,72,459,531
4868,2011-07-26,18,67,468,535
4869,2011-07-26,19,69,324,393
4870,2011-07-26,20,47,242,289
4871,2011-07-26,21,45,220,265
4872,2011-07-26,22,27,129,156
4873,2011-07-26,23,18,68,86
4874,2011-07-27,0,19,26,45
4875,2011-07-27,1,1,9,10
4876,2011-07-27,2,1,5,6
4877,2011-07-27,3,0,4,4
4878,2011-07-27,4,1,3,4
4879,2011-07-27,5,0,18,18
4880,2011-07-27,6,4,117,121
4881,2011-07-27,7,34,310,344
4882,2011-07-27,8,28,400,428
4883,2011-07-27,9,26,184,210
4884,2011-07-27,10,32,81,113
4885,2011-07-27,11,42,94,136
4886,2011-07-27,12,37,132,169
4887,2011-07-27,13,29,149,178
4888,2011-07-27,14,20,104,124
4889,2011-07-27,15,37,100,137
4890,2011-07-27,16,40,227,267
4891,2011-07-27,17,79,482,561
4892,2011-07-27,18,79,458,537
4893,2011-07-27,19,87,287,374
4894,2011-07-27,20,55,235,290
4895,2011-07-27,21,49,192,241
4896,2011-07-27,22,37,142,179
4897,2011-07-27,23,16,90,106
4898,2011-07-28,0,14,31,45
4899,2011-07-28,1,3,26,29
4900,2011-07-28,2,2,5,7
4901,2011-07-28,3,0,5,5
4902,2011-07-28,4,0,6,6
4903,2011-07-28,5,1,25,26
4904,2011-07-28,6,6,109,115
4905,2011-07-28,7,27,275,302
4906,2011-07-28,8,47,405,452
4907,2011-07-28,9,21,188,209
4908,2011-07-28,10,30,85,115
4909,2011-07-28,11,41,109,150
4910,2011-07-28,12,35,149,184
4911,2011-07-28,13,26,125,151
4912,2011-07-28,14,27,110,137
4913,2011-07-28,15,22,120,142
4914,2011-07-28,16,42,212,254
4915,2011-07-28,17,45,419,464
4916,2011-07-28,18,55,425,480
4917,2011-07-28,19,37,283,320
4918,2011-07-28,20,41,225,266
4919,2011-07-28,21,31,163,194
4920,2011-07-28,22,25,148,173
4921,2011-07-28,23,28,92,120
4922,2011-07-29,0,12,44,56
4923,2011-07-29,1,12,22,34
4924,2011-07-29,2,3,9,12
4925,2011-07-29,3,2,9,11
4926,2011-07-29,4,2,4,6
4927,2011-07-29,5,4,23,27
4928,2011-07-29,6,7,83,90
4929,2011-07-29,7,26,228,254
4930,2011-07-29,8,30,350,380
4931,2011-07-29,9,28,151,179
4932,2011-07-29,10,36,67,103
4933,2011-07-29,11,43,116,159
4934,2011-07-29,12,40,95,135
4935,2011-07-29,13,42,113,155
4936,2011-07-29,14,34,114,148
4937,2011-07-29,15,40,127,167
4938,2011-07-29,16,35,195,230
4939,2011-07-29,17,47,372,419
4940,2011-07-29,18,49,311,360
4941,2011-07-29,19,22,216,238
4942,2011-07-29,20,53,151,204
4943,2011-07-29,21,29,134,163
4944,2011-07-29,22,47,126,173
4945,2011-07-29,23,26,90,116
4946,2011-07-30,0,60,73,133
4947,2011-07-30,1,15,73,88
4948,2011-07-30,2,11,31,42
4949,2011-07-30,3,18,25,43
4950,2011-07-30,4,4,6,10
4951,2011-07-30,5,4,9,13
4952,2011-07-30,6,6,18,24
4953,2011-07-30,7,3,39,42
4954,2011-07-30,8,27,87,114
4955,2011-07-30,9,49,125,174
4956,2011-07-30,10,79,176,255
4957,2011-07-30,11,111,202,313
4958,2011-07-30,12,111,224,335
4959,2011-07-30,13,125,178,303
4960,2011-07-30,14,112,185,297
4961,2011-07-30,15,113,186,299
4962,2011-07-30,16,126,173,299
4963,2011-07-30,17,93,206,299
4964,2011-07-30,18,92,203,295
4965,2011-07-30,19,101,152,253
4966,2011-07-30,20,74,128,202
4967,2011-07-30,21,82,122,204
4968,2011-07-30,22,80,127,207
4969,2011-07-30,23,63,109,172
4970,2011-07-31,0,33,78,111
4971,2011-07-31,1,8,71,79
4972,2011-07-31,2,19,47,66
4973,2011-07-31,3,24,26,50
4974,2011-07-31,4,6,7,13
4975,2011-07-31,5,4,4,8
4976,2011-07-31,6,5,8,13
4977,2011-07-31,7,19,26,45
4978,2011-07-31,8,54,85,139
4979,2011-07-31,9,55,127,182
4980,2011-07-31,10,91,163,254
4981,2011-07-31,11,112,157,269
4982,2011-07-31,12,145,185,330
4983,2011-07-31,13,143,152,295
4984,2011-07-31,14,130,193,323
4985,2011-07-31,15,109,182,291
4986,2011-07-31,16,98,208,306
4987,2011-07-31,17,114,202,316
4988,2011-07-31,18,91,212,303
4989,2011-07-31,19,87,186,273
4990,2011-07-31,20,69,200,269
4991,2011-07-31,21,68,96,164
4992,2011-07-31,22,25,69,94
4993,2011-07-31,23,14,54,68
4994,2011-08-01,0,7,22,29
4995,2011-08-01,1,5,12,17
4996,2011-08-01,2,4,7,11
4997,2011-08-01,3,0,4,4
4998,2011-08-01,4,2,2,4
4999,2011-08-01,5,2,24,26
5000,2011-08-01,6,3,97,100
5001,2011-08-01,7,24,253,277
5002,2011-08-01,8,35,346,381
5003,2011-08-01,9,27,137,164
5004,2011-08-01,10,27,69,96
5005,2011-08-01,11,53,64,117
5006,2011-08-01,12,53,115,168
5007,2011-08-01,13,38,111,149
5008,2011-08-01,14,37,83,120
5009,2011-08-01,15,52,76,128
5010,2011-08-01,16,34,193,227
5011,2011-08-01,17,69,439,508
5012,2011-08-01,18,68,468,536
5013,2011-08-01,19,63,343,406
5014,2011-08-01,20,49,253,302
5015,2011-08-01,21,42,175,217
5016,2011-08-01,22,21,113,134
5017,2011-08-01,23,14,81,95
5018,2011-08-02,0,11,18,29
5019,2011-08-02,1,4,8,12
5020,2011-08-02,2,2,6,8
5021,2011-08-02,3,0,5,5
5022,2011-08-02,4,0,10,10
5023,2011-08-02,5,4,17,21
5024,2011-08-02,6,12,103,115
5025,2011-08-02,7,15,317,332
5026,2011-08-02,8,37,396,433
5027,2011-08-02,9,31,180,211
5028,2011-08-02,10,50,90,140
5029,2011-08-02,11,32,96,128
5030,2011-08-02,12,45,111,156
5031,2011-08-02,13,50,152,202
5032,2011-08-02,14,45,112,157
5033,2011-08-02,15,48,118,166
5034,2011-08-02,16,58,215,273
5035,2011-08-02,17,63,490,553
5036,2011-08-02,18,63,484,547
5037,2011-08-02,19,86,367,453
5038,2011-08-02,20,40,244,284
5039,2011-08-02,21,53,197,250
5040,2011-08-02,22,22,167,189
5041,2011-08-02,23,29,101,130
5042,2011-08-03,0,11,31,42
5043,2011-08-03,1,7,9,16
5044,2011-08-03,2,2,8,10
5045,2011-08-03,3,0,4,4
5046,2011-08-03,4,0,7,7
5047,2011-08-03,5,2,21,23
5048,2011-08-03,6,9,100,109
5049,2011-08-03,7,19,250,269
5050,2011-08-03,8,29,406,435
5051,2011-08-03,9,23,169,192
5052,2011-08-03,10,9,57,66
5053,2011-08-03,11,29,89,118
5054,2011-08-03,12,19,141,160
5055,2011-08-03,13,37,106,143
5056,2011-08-03,14,43,100,143
5057,2011-08-03,15,31,85,116
5058,2011-08-03,16,21,126,147
5059,2011-08-03,17,47,374,421
5060,2011-08-03,18,49,441,490
5061,2011-08-03,19,51,266,317
5062,2011-08-03,20,7,80,87
5063,2011-08-03,21,7,80,87
5064,2011-08-03,22,11,62,73
5065,2011-08-03,23,4,50,54
5066,2011-08-04,0,2,15,17
5067,2011-08-04,1,3,14,17
5068,2011-08-04,2,2,5,7
5069,2011-08-04,3,0,3,3
5070,2011-08-04,4,0,7,7
5071,2011-08-04,5,3,17,20
5072,2011-08-04,6,7,90,97
5073,2011-08-04,7,11,269,280
5074,2011-08-04,8,29,365,394
5075,2011-08-04,9,25,152,177
5076,2011-08-04,10,24,88,112
5077,2011-08-04,11,37,110,147
5078,2011-08-04,12,53,150,203
5079,2011-08-04,13,63,142,205
5080,2011-08-04,14,53,113,166
5081,2011-08-04,15,50,114,164
5082,2011-08-04,16,70,219,289
5083,2011-08-04,17,91,462,553
5084,2011-08-04,18,88,425,513
5085,2011-08-04,19,65,298,363
5086,2011-08-04,20,41,243,284
5087,2011-08-04,21,25,182,207
5088,2011-08-04,22,33,139,172
5089,2011-08-04,23,24,108,132
5090,2011-08-05,0,13,41,54
5091,2011-08-05,1,3,16,19
5092,2011-08-05,2,5,14,19
5093,2011-08-05,3,0,6,6
5094,2011-08-05,4,1,6,7
5095,2011-08-05,5,0,16,16
5096,2011-08-05,6,7,93,100
5097,2011-08-05,7,23,243,266
5098,2011-08-05,8,39,409,448
5099,2011-08-05,9,43,178,221
5100,2011-08-05,10,50,113,163
5101,2011-08-05,11,44,102,146
5102,2011-08-05,12,57,157,214
5103,2011-08-05,13,40,164,204
5104,2011-08-05,14,81,164,245
5105,2011-08-05,15,50,158,208
5106,2011-08-05,16,76,250,326
5107,2011-08-05,17,84,459,543
5108,2011-08-05,18,105,358,463
5109,2011-08-05,19,90,279,369
5110,2011-08-05,20,70,218,288
5111,2011-08-05,21,54,116,170
5112,2011-08-05,22,51,132,183
5113,2011-08-05,23,37,102,139
5114,2011-08-06,0,29,102,131
5115,2011-08-06,1,17,50,67
5116,2011-08-06,2,14,39,53
5117,2011-08-06,3,14,28,42
5118,2011-08-06,4,5,5,10
5119,2011-08-06,5,2,4,6
5120,2011-08-06,6,5,22,27
5121,2011-08-06,7,14,48,62
5122,2011-08-06,8,27,92,119
5123,2011-08-06,9,60,151,211
5124,2011-08-06,10,91,196,287
5125,2011-08-06,11,138,211,349
5126,2011-08-06,12,130,245,375
5127,2011-08-06,13,175,259,434
5128,2011-08-06,14,176,199,375
5129,2011-08-06,15,130,227,357
5130,2011-08-06,16,154,187,341
5131,2011-08-06,17,60,85,145
5132,2011-08-06,18,81,127,208
5133,2011-08-06,19,57,112,169
5134,2011-08-06,20,58,77,135
5135,2011-08-06,21,28,84,112
5136,2011-08-06,22,24,96,120
5137,2011-08-06,23,29,78,107
5138,2011-08-07,0,14,65,79
5139,2011-08-07,1,10,60,70
5140,2011-08-07,2,18,47,65
5141,2011-08-07,3,9,23,32
5142,2011-08-07,4,1,5,6
5143,2011-08-07,5,1,4,5
5144,2011-08-07,6,3,10,13
5145,2011-08-07,7,11,28,39
5146,2011-08-07,8,23,64,87
5147,2011-08-07,9,82,102,184
5148,2011-08-07,10,88,170,258
5149,2011-08-07,11,111,152,263
5150,2011-08-07,12,161,207,368
5151,2011-08-07,13,118,202,320
5152,2011-08-07,14,130,190,320
5153,2011-08-07,15,118,205,323
5154,2011-08-07,16,74,117,191
5155,2011-08-07,17,63,128,191
5156,2011-08-07,18,74,154,228
5157,2011-08-07,19,68,155,223
5158,2011-08-07,20,50,130,180
5159,2011-08-07,21,36,99,135
5160,2011-08-07,22,21,80,101
5161,2011-08-07,23,12,42,54
5162,2011-08-08,0,13,17,30
5163,2011-08-08,1,4,7,11
5164,2011-08-08,2,4,3,7
5165,2011-08-08,3,1,0,1
5166,2011-08-08,4,2,8,10
5167,2011-08-08,5,1,14,15
5168,2011-08-08,6,8,87,95
5169,2011-08-08,7,18,244,262
5170,2011-08-08,8,29,311,340
5171,2011-08-08,9,37,145,182
5172,2011-08-08,10,62,60,122
5173,2011-08-08,11,89,89,178
5174,2011-08-08,12,48,133,181
5175,2011-08-08,13,43,108,151
5176,2011-08-08,14,41,108,149
5177,2011-08-08,15,40,81,121
5178,2011-08-08,16,64,214,278
5179,2011-08-08,17,67,455,522
5180,2011-08-08,18,64,463,527
5181,2011-08-08,19,64,346,410
5182,2011-08-08,20,71,213,284
5183,2011-08-08,21,30,152,182
5184,2011-08-08,22,26,120,146
5185,2011-08-08,23,19,53,72
5186,2011-08-09,0,10,24,34
5187,2011-08-09,1,5,9,14
5188,2011-08-09,2,9,3,12
5189,2011-08-09,3,0,2,2
5190,2011-08-09,4,1,6,7
5191,2011-08-09,5,5,25,30
5192,2011-08-09,6,6,94,100
5193,2011-08-09,7,31,307,338
5194,2011-08-09,8,40,348,388
5195,2011-08-09,9,34,139,173
5196,2011-08-09,10,55,87,142
5197,2011-08-09,11,61,87,148
5198,2011-08-09,12,60,123,183
5199,2011-08-09,13,48,127,175
5200,2011-08-09,14,53,94,147
5201,2011-08-09,15,58,105,163
5202,2011-08-09,16,57,227,284
5203,2011-08-09,17,79,445,524
5204,2011-08-09,18,97,482,579
5205,2011-08-09,19,69,298,367
5206,2011-08-09,20,34,253,287
5207,2011-08-09,21,46,181,227
5208,2011-08-09,22,28,124,152
5209,2011-08-09,23,22,52,74
5210,2011-08-10,0,19,18,37
5211,2011-08-10,1,7,10,17
5212,2011-08-10,2,1,10,11
5213,2011-08-10,3,1,3,4
5214,2011-08-10,4,1,4,5
5215,2011-08-10,5,2,30,32
5216,2011-08-10,6,9,109,118
5217,2011-08-10,7,16,287,303
5218,2011-08-10,8,38,354,392
5219,2011-08-10,9,32,147,179
5220,2011-08-10,10,41,71,112
5221,2011-08-10,11,54,92,146
5222,2011-08-10,12,74,164,238
5223,2011-08-10,13,41,149,190
5224,2011-08-10,14,62,114,176
5225,2011-08-10,15,53,139,192
5226,2011-08-10,16,76,200,276
5227,2011-08-10,17,71,509,580
5228,2011-08-10,18,70,483,553
5229,2011-08-10,19,79,324,403
5230,2011-08-10,20,59,248,307
5231,2011-08-10,21,47,155,202
5232,2011-08-10,22,17,117,134
5233,2011-08-10,23,14,89,103
5234,2011-08-11,0,6,40,46
5235,2011-08-11,1,9,17,26
5236,2011-08-11,2,3,8,11
5237,2011-08-11,3,2,7,9
5238,2011-08-11,4,1,4,5
5239,2011-08-11,5,2,22,24
5240,2011-08-11,6,5,101,106
5241,2011-08-11,7,15,288,303
5242,2011-08-11,8,29,352,381
5243,2011-08-11,9,31,165,196
5244,2011-08-11,10,36,94,130
5245,2011-08-11,11,59,125,184
5246,2011-08-11,12,50,163,213
5247,2011-08-11,13,51,163,214
5248,2011-08-11,14,38,103,141
5249,2011-08-11,15,52,124,176
5250,2011-08-11,16,57,240,297
5251,2011-08-11,17,96,485,581
5252,2011-08-11,18,74,490,564
5253,2011-08-11,19,47,318,365
5254,2011-08-11,20,56,228,284
5255,2011-08-11,21,35,164,199
5256,2011-08-11,22,34,122,156
5257,2011-08-11,23,22,103,125
5258,2011-08-12,0,11,51,62
5259,2011-08-12,1,4,19,23
5260,2011-08-12,2,0,15,15
5261,2011-08-12,3,0,9,9
5262,2011-08-12,4,0,5,5
5263,2011-08-12,5,2,24,26
5264,2011-08-12,6,3,72,75
5265,2011-08-12,7,17,245,262
5266,2011-08-12,8,29,390,419
5267,2011-08-12,9,27,176,203
5268,2011-08-12,10,43,84,127
5269,2011-08-12,11,48,105,153
5270,2011-08-12,12,55,166,221
5271,2011-08-12,13,74,178,252
5272,2011-08-12,14,51,132,183
5273,2011-08-12,15,59,188,247
5274,2011-08-12,16,68,266,334
5275,2011-08-12,17,93,416,509
5276,2011-08-12,18,89,371,460
5277,2011-08-12,19,101,279,380
5278,2011-08-12,20,77,206,283
5279,2011-08-12,21,73,151,224
5280,2011-08-12,22,74,152,226
5281,2011-08-12,23,51,99,150
5282,2011-08-13,0,15,67,82
5283,2011-08-13,1,13,61,74
5284,2011-08-13,2,16,56,72
5285,2011-08-13,3,9,18,27
5286,2011-08-13,4,5,5,10
5287,2011-08-13,5,3,14,17
5288,2011-08-13,6,3,19,22
5289,2011-08-13,7,10,34,44
5290,2011-08-13,8,27,89,116
5291,2011-08-13,9,70,137,207
5292,2011-08-13,10,97,162,259
5293,2011-08-13,11,121,191,312
5294,2011-08-13,12,174,244,418
5295,2011-08-13,13,61,90,151
5296,2011-08-13,14,111,141,252
5297,2011-08-13,15,150,206,356
5298,2011-08-13,16,148,127,275
5299,2011-08-13,17,97,165,262
5300,2011-08-13,18,123,164,287
5301,2011-08-13,19,67,165,232
5302,2011-08-13,20,77,100,177
5303,2011-08-13,21,40,123,163
5304,2011-08-13,22,36,114,150
5305,2011-08-13,23,25,92,117
5306,2011-08-14,0,19,71,90
5307,2011-08-14,1,16,56,72
5308,2011-08-14,2,13,49,62
5309,2011-08-14,3,5,22,27
5310,2011-08-14,4,1,2,3
5311,2011-08-14,5,1,9,10
5312,2011-08-14,6,2,4,6
5313,2011-08-14,7,4,19,23
5314,2011-08-14,8,20,21,41
5315,2011-08-14,9,27,75,102
5316,2011-08-14,10,66,112,178
5317,2011-08-14,11,81,116,197
5318,2011-08-14,12,98,177,275
5319,2011-08-14,13,144,226,370
5320,2011-08-14,14,126,243,369
5321,2011-08-14,15,128,197,325
5322,2011-08-14,16,116,172,288
5323,2011-08-14,17,132,193,325
5324,2011-08-14,18,125,222,347
5325,2011-08-14,19,75,180,255
5326,2011-08-14,20,67,124,191
5327,2011-08-14,21,51,101,152
5328,2011-08-14,22,14,23,37
5329,2011-08-14,23,5,22,27
5330,2011-08-15,0,7,17,24
5331,2011-08-15,1,1,9,10
5332,2011-08-15,2,0,3,3
5333,2011-08-15,3,1,6,7
5334,2011-08-15,4,1,4,5
5335,2011-08-15,5,3,14,17
5336,2011-08-15,6,3,87,90
5337,2011-08-15,7,10,243,253
5338,2011-08-15,8,29,322,351
5339,2011-08-15,9,52,170,222
5340,2011-08-15,10,54,80,134
5341,2011-08-15,11,41,106,147
5342,2011-08-15,12,62,114,176
5343,2011-08-15,13,53,139,192
5344,2011-08-15,14,55,92,147
5345,2011-08-15,15,49,131,180
5346,2011-08-15,16,58,223,281
5347,2011-08-15,17,59,461,520
5348,2011-08-15,18,70,412,482
5349,2011-08-15,19,53,339,392
5350,2011-08-15,20,45,237,282
5351,2011-08-15,21,34,147,181
5352,2011-08-15,22,22,75,97
5353,2011-08-15,23,11,76,87
5354,2011-08-16,0,8,23,31
5355,2011-08-16,1,4,13,17
5356,2011-08-16,2,1,3,4
5357,2011-08-16,3,1,5,6
5358,2011-08-16,4,0,5,5
5359,2011-08-16,5,1,29,30
5360,2011-08-16,6,4,115,119
5361,2011-08-16,7,18,325,343
5362,2011-08-16,8,24,411,435
5363,2011-08-16,9,27,169,196
5364,2011-08-16,10,28,81,109
5365,2011-08-16,11,40,106,146
5366,2011-08-16,12,42,118,160
5367,2011-08-16,13,45,148,193
5368,2011-08-16,14,65,116,181
5369,2011-08-16,15,36,121,157
5370,2011-08-16,16,55,244,299
5371,2011-08-16,17,75,516,591
5372,2011-08-16,18,54,511,565
5373,2011-08-16,19,56,312,368
5374,2011-08-16,20,48,230,278
5375,2011-08-16,21,38,176,214
5376,2011-08-16,22,31,120,151
5377,2011-08-16,23,20,55,75
5378,2011-08-17,0,8,15,23
5379,2011-08-17,1,2,12,14
5380,2011-08-17,2,0,6,6
5381,2011-08-17,3,1,4,5
5382,2011-08-17,4,0,5,5
5383,2011-08-17,5,0,28,28
5384,2011-08-17,6,4,100,104
5385,2011-08-17,7,12,291,303
5386,2011-08-17,8,35,448,483
5387,2011-08-17,9,31,173,204
5388,2011-08-17,10,27,91,118
5389,2011-08-17,11,20,107,127
5390,2011-08-17,12,26,162,188
5391,2011-08-17,13,38,136,174
5392,2011-08-17,14,54,132,186
5393,2011-08-17,15,42,116,158
5394,2011-08-17,16,62,234,296
5395,2011-08-17,17,46,503,549
5396,2011-08-17,18,86,467,553
5397,2011-08-17,19,50,292,342
5398,2011-08-17,20,37,241,278
5399,2011-08-17,21,38,188,226
5400,2011-08-17,22,29,139,168
5401,2011-08-17,23,20,84,104
5402,2011-08-18,0,18,38,56
5403,2011-08-18,1,13,11,24
5404,2011-08-18,2,2,4,6
5405,2011-08-18,3,0,6,6
5406,2011-08-18,4,0,9,9
5407,2011-08-18,5,0,27,27
5408,2011-08-18,6,6,95,101
5409,2011-08-18,7,19,285,304
5410,2011-08-18,8,27,387,414
5411,2011-08-18,9,42,185,227
5412,2011-08-18,10,37,89,126
5413,2011-08-18,11,44,93,137
5414,2011-08-18,12,34,139,173
5415,2011-08-18,13,33,152,185
5416,2011-08-18,14,67,113,180
5417,2011-08-18,15,56,116,172
5418,2011-08-18,16,49,194,243
5419,2011-08-18,17,44,358,402
5420,2011-08-18,18,48,219,267
5421,2011-08-18,19,26,113,139
5422,2011-08-18,20,24,141,165
5423,2011-08-18,21,12,133,145
5424,2011-08-18,22,18,117,135
5425,2011-08-18,23,20,93,113
5426,2011-08-19,0,9,52,61
5427,2011-08-19,1,1,19,20
5428,2011-08-19,2,0,8,8
5429,2011-08-19,3,2,1,3
5430,2011-08-19,4,1,6,7
5431,2011-08-19,5,1,16,17
5432,2011-08-19,6,2,88,90
5433,2011-08-19,7,12,248,260
5434,2011-08-19,8,30,362,392
5435,2011-08-19,9,31,187,218
5436,2011-08-19,10,57,107,164
5437,2011-08-19,11,45,118,163
5438,2011-08-19,12,54,166,220
5439,2011-08-19,13,63,166,229
5440,2011-08-19,14,78,140,218
5441,2011-08-19,15,66,149,215
5442,2011-08-19,16,65,258,323
5443,2011-08-19,17,85,438,523
5444,2011-08-19,18,87,334,421
5445,2011-08-19,19,33,129,162
5446,2011-08-19,20,12,45,57
5447,2011-08-19,21,18,89,107
5448,2011-08-19,22,25,94,119
5449,2011-08-19,23,18,85,103
5450,2011-08-20,0,21,106,127
5451,2011-08-20,1,12,35,47
5452,2011-08-20,2,10,58,68
5453,2011-08-20,3,9,37,46
5454,2011-08-20,4,1,5,6
5455,2011-08-20,5,0,8,8
5456,2011-08-20,6,6,18,24
5457,2011-08-20,7,8,36,44
5458,2011-08-20,8,27,97,124
5459,2011-08-20,9,51,139,190
5460,2011-08-20,10,114,186,300
5461,2011-08-20,11,115,221,336
5462,2011-08-20,12,156,247,403
5463,2011-08-20,13,158,216,374
5464,2011-08-20,14,147,215,362
5465,2011-08-20,15,175,212,387
5466,2011-08-20,16,151,216,367
5467,2011-08-20,17,180,198,378
5468,2011-08-20,18,169,218,387
5469,2011-08-20,19,109,180,289
5470,2011-08-20,20,78,163,241
5471,2011-08-20,21,81,142,223
5472,2011-08-20,22,77,142,219
5473,2011-08-20,23,59,95,154
5474,2011-08-21,0,6,65,71
5475,2011-08-21,1,17,69,86
5476,2011-08-21,2,13,50,63
5477,2011-08-21,3,24,26,50
5478,2011-08-21,4,1,5,6
5479,2011-08-21,5,0,8,8
5480,2011-08-21,6,4,10,14
5481,2011-08-21,7,12,18,30
5482,2011-08-21,8,30,60,90
5483,2011-08-21,9,80,149,229
5484,2011-08-21,10,97,174,271
5485,2011-08-21,11,132,174,306
5486,2011-08-21,12,135,229,364
5487,2011-08-21,13,94,206,300
5488,2011-08-21,14,78,153,231
5489,2011-08-21,15,17,50,67
5490,2011-08-21,16,97,157,254
5491,2011-08-21,17,91,177,268
5492,2011-08-21,18,95,212,307
5493,2011-08-21,19,81,197,278
5494,2011-08-21,20,41,139,180
5495,2011-08-21,21,45,90,135
5496,2011-08-21,22,37,95,132
5497,2011-08-21,23,20,47,67
5498,2011-08-22,0,18,22,40
5499,2011-08-22,1,8,13,21
5500,2011-08-22,2,2,6,8
5501,2011-08-22,3,0,5,5
5502,2011-08-22,4,2,10,12
5503,2011-08-22,5,1,23,24
5504,2011-08-22,6,6,106,112
5505,2011-08-22,7,11,267,278
5506,2011-08-22,8,20,328,348
5507,2011-08-22,9,36,149,185
5508,2011-08-22,10,36,82,118
5509,2011-08-22,11,46,84,130
5510,2011-08-22,12,54,148,202
5511,2011-08-22,13,47,157,204
5512,2011-08-22,14,88,133,221
5513,2011-08-22,15,72,124,196
5514,2011-08-22,16,65,251,316
5515,2011-08-22,17,81,501,582
5516,2011-08-22,18,72,532,604
5517,2011-08-22,19,66,345,411
5518,2011-08-22,20,21,243,264
5519,2011-08-22,21,28,174,202
5520,2011-08-22,22,32,120,152
5521,2011-08-22,23,19,45,64
5522,2011-08-23,0,13,22,35
5523,2011-08-23,1,6,13,19
5524,2011-08-23,2,2,4,6
5525,2011-08-23,3,2,4,6
5526,2011-08-23,4,0,5,5
5527,2011-08-23,5,1,34,35
5528,2011-08-23,6,3,109,112
5529,2011-08-23,7,11,331,342
5530,2011-08-23,8,43,457,500
5531,2011-08-23,9,34,189,223
5532,2011-08-23,10,56,91,147
5533,2011-08-23,11,62,123,185
5534,2011-08-23,12,60,175,235
5535,2011-08-23,13,69,161,230
5536,2011-08-23,14,146,492,638
5537,2011-08-23,15,172,415,587
5538,2011-08-23,16,130,303,433
5539,2011-08-23,17,133,336,469
5540,2011-08-23,18,98,414,512
5541,2011-08-23,19,70,292,362
5542,2011-08-23,20,54,206,260
5543,2011-08-23,21,38,170,208
5544,2011-08-23,22,46,143,189
5545,2011-08-23,23,19,61,80
5546,2011-08-24,0,9,29,38
5547,2011-08-24,1,7,16,23
5548,2011-08-24,2,2,3,5
5549,2011-08-24,3,0,1,1
5550,2011-08-24,4,0,5,5
5551,2011-08-24,5,1,26,27
5552,2011-08-24,6,3,104,107
5553,2011-08-24,7,11,293,304
5554,2011-08-24,8,32,432,464
5555,2011-08-24,9,44,166,210
5556,2011-08-24,10,51,93,144
5557,2011-08-24,11,57,127,184
5558,2011-08-24,12,60,169,229
5559,2011-08-24,13,54,177,231
5560,2011-08-24,14,77,126,203
5561,2011-08-24,15,61,140,201
5562,2011-08-24,16,45,220,265
5563,2011-08-24,17,83,476,559
5564,2011-08-24,18,102,517,619
5565,2011-08-24,19,93,343,436
5566,2011-08-24,20,45,283,328
5567,2011-08-24,21,47,187,234
5568,2011-08-24,22,41,136,177
5569,2011-08-24,23,16,54,70
5570,2011-08-25,0,11,38,49
5571,2011-08-25,1,4,12,16
5572,2011-08-25,2,3,2,5
5573,2011-08-25,3,2,2,4
5574,2011-08-25,4,1,5,6
5575,2011-08-25,5,1,25,26
5576,2011-08-25,6,1,101,102
5577,2011-08-25,7,17,295,312
5578,2011-08-25,8,23,451,474
5579,2011-08-25,9,21,139,160
5580,2011-08-25,10,37,103,140
5581,2011-08-25,11,39,109,148
5582,2011-08-25,12,9,31,40
5583,2011-08-25,13,7,28,35
5584,2011-08-25,14,27,86,113
5585,2011-08-25,15,28,103,131
5586,2011-08-25,16,16,102,118
5587,2011-08-25,17,28,281,309
5588,2011-08-25,18,31,369,400
5589,2011-08-25,19,31,237,268
5590,2011-08-25,20,33,189,222
5591,2011-08-25,21,29,155,184
5592,2011-08-25,22,21,124,145
5593,2011-08-25,23,15,68,83
5594,2011-08-26,0,9,42,51
5595,2011-08-26,1,10,13,23
5596,2011-08-26,2,4,16,20
5597,2011-08-26,3,3,8,11
5598,2011-08-26,4,2,6,8
5599,2011-08-26,5,3,23,26
5600,2011-08-26,6,5,99,104
5601,2011-08-26,7,3,260,263
5602,2011-08-26,8,17,381,398
5603,2011-08-26,9,39,191,230
5604,2011-08-26,10,34,89,123
5605,2011-08-26,11,63,148,211
5606,2011-08-26,12,70,173,243
5607,2011-08-26,13,72,162,234
5608,2011-08-26,14,55,161,216
5609,2011-08-26,15,53,195,248
5610,2011-08-26,16,50,286,336
5611,2011-08-26,17,56,427,483
5612,2011-08-26,18,40,365,405
5613,2011-08-26,19,55,227,282
5614,2011-08-26,20,39,182,221
5615,2011-08-26,21,38,150,188
5616,2011-08-26,22,26,122,148
5617,2011-08-26,23,22,113,135
5618,2011-08-27,0,33,109,142
5619,2011-08-27,1,13,51,64
5620,2011-08-27,2,18,58,76
5621,2011-08-27,3,8,22,30
5622,2011-08-27,4,1,3,4
5623,2011-08-27,5,1,11,12
5624,2011-08-27,6,2,15,17
5625,2011-08-27,7,2,26,28
5626,2011-08-27,8,14,62,76
5627,2011-08-27,9,28,128,156
5628,2011-08-27,10,51,152,203
5629,2011-08-27,11,15,71,86
5630,2011-08-27,12,11,65,76
5631,2011-08-27,13,10,32,42
5632,2011-08-27,14,4,18,22
5633,2011-08-27,15,2,28,30
5634,2011-08-27,16,10,14,24
5635,2011-08-27,17,2,14,16
5636,2011-08-28,7,0,1,1
5637,2011-08-28,8,2,6,8
5638,2011-08-28,9,7,44,51
5639,2011-08-28,10,27,113,140
5640,2011-08-28,11,59,177,236
5641,2011-08-28,12,87,218,305
5642,2011-08-28,13,128,295,423
5643,2011-08-28,14,157,283,440
5644,2011-08-28,15,156,311,467
5645,2011-08-28,16,196,291,487
5646,2011-08-28,17,145,249,394
5647,2011-08-28,18,145,253,398
5648,2011-08-28,19,140,240,380
5649,2011-08-28,20,63,150,213
5650,2011-08-28,21,60,124,184
5651,2011-08-28,22,25,72,97
5652,2011-08-28,23,16,48,64
5653,2011-08-29,0,13,20,33
5654,2011-08-29,1,5,15,20
5655,2011-08-29,2,8,5,13
5656,2011-08-29,3,1,5,6
5657,2011-08-29,4,0,3,3
5658,2011-08-29,5,0,17,17
5659,2011-08-29,6,3,97,100
5660,2011-08-29,7,11,271,282
5661,2011-08-29,8,20,378,398
5662,2011-08-29,9,22,164,186
5663,2011-08-29,10,42,72,114
5664,2011-08-29,11,38,99,137
5665,2011-08-29,12,48,156,204
5666,2011-08-29,13,48,169,217
5667,2011-08-29,14,55,127,182
5668,2011-08-29,15,56,160,216
5669,2011-08-29,16,56,224,280
5670,2011-08-29,17,67,520,587
5671,2011-08-29,18,60,478,538
5672,2011-08-29,19,49,310,359
5673,2011-08-29,20,51,223,274
5674,2011-08-29,21,34,165,199
5675,2011-08-29,22,23,115,138
5676,2011-08-29,23,19,53,72
5677,2011-08-30,0,10,17,27
5678,2011-08-30,1,6,7,13
5679,2011-08-30,2,2,8,10
5680,2011-08-30,3,2,2,4
5681,2011-08-30,4,0,5,5
5682,2011-08-30,5,1,27,28
5683,2011-08-30,6,4,114,118
5684,2011-08-30,7,19,335,354
5685,2011-08-30,8,34,455,489
5686,2011-08-30,9,38,177,215
5687,2011-08-30,10,28,107,135
5688,2011-08-30,11,60,114,174
5689,2011-08-30,12,64,171,235
5690,2011-08-30,13,58,167,225
5691,2011-08-30,14,58,145,203
5692,2011-08-30,15,34,159,193
5693,2011-08-30,16,42,293,335
5694,2011-08-30,17,61,544,605
5695,2011-08-30,18,60,511,571
5696,2011-08-30,19,68,391,459
5697,2011-08-30,20,39,258,297
5698,2011-08-30,21,43,176,219
5699,2011-08-30,22,22,119,141
5700,2011-08-30,23,19,74,93
5701,2011-08-31,0,7,24,31
5702,2011-08-31,1,3,13,16
5703,2011-08-31,2,1,5,6
5704,2011-08-31,3,2,4,6
5705,2011-08-31,4,0,5,5
5706,2011-08-31,5,2,24,26
5707,2011-08-31,6,4,107,111
5708,2011-08-31,7,12,310,322
5709,2011-08-31,8,27,434,461
5710,2011-08-31,9,27,217,244
5711,2011-08-31,10,33,104,137
5712,2011-08-31,11,28,141,169
5713,2011-08-31,12,68,191,259
5714,2011-08-31,13,39,179,218
5715,2011-08-31,14,48,145,193
5716,2011-08-31,15,34,137,171
5717,2011-08-31,16,46,258,304
5718,2011-08-31,17,83,519,602
5719,2011-08-31,18,70,487,557
5720,2011-08-31,19,53,384,437
5721,2011-08-31,20,30,257,287
5722,2011-08-31,21,27,171,198
5723,2011-08-31,22,20,133,153
5724,2011-08-31,23,24,61,85
5725,2011-09-01,0,18,33,51
5726,2011-09-01,1,7,14,21
5727,2011-09-01,2,14,11,25
5728,2011-09-01,3,7,7,14
5729,2011-09-01,4,0,7,7
5730,2011-09-01,5,1,22,23
5731,2011-09-01,6,2,103,105
5732,2011-09-01,7,7,330,337
5733,2011-09-01,8,31,462,493
5734,2011-09-01,9,29,177,206
5735,2011-09-01,10,46,92,138
5736,2011-09-01,11,51,138,189
5737,2011-09-01,12,64,164,228
5738,2011-09-01,13,50,165,215
5739,2011-09-01,14,54,138,192
5740,2011-09-01,15,39,134,173
5741,2011-09-01,16,55,250,305
5742,2011-09-01,17,61,559,620
5743,2011-09-01,18,69,456,525
5744,2011-09-01,19,78,362,440
5745,2011-09-01,20,34,242,276
5746,2011-09-01,21,17,159,176
5747,2011-09-01,22,34,144,178
5748,2011-09-01,23,15,107,122
5749,2011-09-02,0,6,58,64
5750,2011-09-02,1,4,28,32
5751,2011-09-02,2,9,11,20
5752,2011-09-02,3,4,4,8
5753,2011-09-02,4,2,2,4
5754,2011-09-02,5,0,20,20
5755,2011-09-02,6,3,71,74
5756,2011-09-02,7,6,251,257
5757,2011-09-02,8,22,425,447
5758,2011-09-02,9,29,190,219
5759,2011-09-02,10,34,103,137
5760,2011-09-02,11,51,139,190
5761,2011-09-02,12,82,176,258
5762,2011-09-02,13,72,203,275
5763,2011-09-02,14,75,207,282
5764,2011-09-02,15,68,273,341
5765,2011-09-02,16,82,297,379
5766,2011-09-02,17,78,375,453
5767,2011-09-02,18,50,303,353
5768,2011-09-02,19,67,218,285
5769,2011-09-02,20,38,155,193
5770,2011-09-02,21,28,120,148
5771,2011-09-02,22,33,111,144
5772,2011-09-02,23,30,69,99
5773,2011-09-03,0,22,64,86
5774,2011-09-03,1,17,56,73
5775,2011-09-03,2,15,26,41
5776,2011-09-03,3,17,18,35
5777,2011-09-03,4,3,4,7
5778,2011-09-03,5,3,9,12
5779,2011-09-03,6,4,19,23
5780,2011-09-03,7,5,33,38
5781,2011-09-03,8,24,65,89
5782,2011-09-03,9,83,117,200
5783,2011-09-03,10,90,162,252
5784,2011-09-03,11,66,126,192
5785,2011-09-03,12,97,157,254
5786,2011-09-03,13,153,192,345
5787,2011-09-03,14,204,172,376
5788,2011-09-03,15,187,197,384
5789,2011-09-03,16,186,177,363
5790,2011-09-03,17,170,193,363
5791,2011-09-03,18,158,177,335
5792,2011-09-03,19,147,145,292
5793,2011-09-03,20,99,119,218
5794,2011-09-03,21,71,93,164
5795,2011-09-03,22,66,95,161
5796,2011-09-03,23,46,77,123
5797,2011-09-04,0,33,75,108
5798,2011-09-04,1,37,38,75
5799,2011-09-04,2,17,43,60
5800,2011-09-04,3,20,23,43
5801,2011-09-04,4,0,4,4
5802,2011-09-04,5,1,5,6
5803,2011-09-04,6,0,3,3
5804,2011-09-04,7,10,19,29
5805,2011-09-04,8,21,48,69
5806,2011-09-04,9,87,101,188
5807,2011-09-04,10,151,147,298
5808,2011-09-04,11,174,160,334
5809,2011-09-04,12,214,216,430
5810,2011-09-04,13,245,170,415
5811,2011-09-04,14,205,151,356
5812,2011-09-04,15,218,191,409
5813,2011-09-04,16,196,141,337
5814,2011-09-04,17,204,170,374
5815,2011-09-04,18,187,167,354
5816,2011-09-04,19,177,143,320
5817,2011-09-04,20,104,122,226
5818,2011-09-04,21,104,102,206
5819,2011-09-04,22,70,84,154
5820,2011-09-04,23,46,56,102
5821,2011-09-05,0,31,65,96
5822,2011-09-05,1,19,35,54
5823,2011-09-05,2,17,22,39
5824,2011-09-05,3,4,11,15
5825,2011-09-05,4,3,5,8
5826,2011-09-05,5,2,4,6
5827,2011-09-05,6,6,5,11
5828,2011-09-05,7,11,28,39
5829,2011-09-05,8,45,55,100
5830,2011-09-05,9,63,86,149
5831,2011-09-05,10,107,135,242
5832,2011-09-05,11,101,203,304
5833,2011-09-05,12,141,210,351
5834,2011-09-05,13,154,227,381
5835,2011-09-05,14,145,208,353
5836,2011-09-05,15,111,140,251
5837,2011-09-05,16,92,188,280
5838,2011-09-05,17,37,74,111
5839,2011-09-05,18,31,92,123
5840,2011-09-05,19,52,123,175
5841,2011-09-05,20,26,54,80
5842,2011-09-05,21,20,38,58
5843,2011-09-05,22,15,48,63
5844,2011-09-05,23,3,17,20
5845,2011-09-06,0,1,7,8
5846,2011-09-06,2,0,2,2
5847,2011-09-06,3,1,0,1
5848,2011-09-06,4,1,3,4
5849,2011-09-06,5,1,19,20
5850,2011-09-06,6,0,69,69
5851,2011-09-06,7,6,163,169
5852,2011-09-06,8,15,343,358
5853,2011-09-06,9,18,164,182
5854,2011-09-06,10,16,88,104
5855,2011-09-06,11,11,78,89
5856,2011-09-06,12,16,51,67
5857,2011-09-06,13,5,24,29
5858,2011-09-06,14,3,20,23
5859,2011-09-06,15,18,70,88
5860,2011-09-06,16,11,94,105
5861,2011-09-06,17,15,273,288
5862,2011-09-06,18,22,346,368
5863,2011-09-06,19,12,265,277
5864,2011-09-06,20,13,149,162
5865,2011-09-06,21,12,104,116
5866,2011-09-06,22,5,77,82
5867,2011-09-06,23,2,53,55
5868,2011-09-07,0,1,12,13
5869,2011-09-07,1,2,3,5
5870,2011-09-07,2,2,4,6
5871,2011-09-07,3,1,1,2
5872,2011-09-07,4,0,4,4
5873,2011-09-07,5,1,15,16
5874,2011-09-07,6,1,73,74
5875,2011-09-07,7,3,83,86
5876,2011-09-07,8,9,308,317
5877,2011-09-07,9,14,172,186
5878,2011-09-07,10,3,61,64
5879,2011-09-07,11,1,7,8
5880,2011-09-07,12,1,21,22
5881,2011-09-07,13,2,9,11
5882,2011-09-07,14,1,23,24
5883,2011-09-07,15,3,55,58
5884,2011-09-07,16,7,137,144
5885,2011-09-07,17,21,261,282
5886,2011-09-07,18,18,215,233
5887,2011-09-07,19,14,210,224
5888,2011-09-07,20,3,91,94
5889,2011-09-07,21,4,34,38
5890,2011-09-07,22,3,26,29
5891,2011-09-07,23,3,21,24
5892,2011-09-08,0,3,10,13
5893,2011-09-08,1,0,4,4
5894,2011-09-08,3,0,1,1
5895,2011-09-08,4,0,3,3
5896,2011-09-08,5,1,13,14
5897,2011-09-08,6,1,53,54
5898,2011-09-08,7,7,171,178
5899,2011-09-08,8,7,183,190
5900,2011-09-08,9,4,63,67
5901,2011-09-08,10,8,54,62
5902,2011-09-08,11,16,80,96
5903,2011-09-08,12,17,85,102
5904,2011-09-08,13,14,111,125
5905,2011-09-08,14,15,104,119
5906,2011-09-08,15,24,112,136
5907,2011-09-08,16,5,151,156
5908,2011-09-08,17,11,100,111
5909,2011-09-08,18,2,65,67
5910,2011-09-08,19,1,49,50
5911,2011-09-08,20,6,80,86
5912,2011-09-08,21,6,74,80
5913,2011-09-08,22,5,65,70
5914,2011-09-08,23,0,26,26
5915,2011-09-09,0,1,15,16
5916,2011-09-09,1,0,8,8
5917,2011-09-09,2,1,7,8
5918,2011-09-09,3,1,1,2
5919,2011-09-09,4,0,3,3
5920,2011-09-09,5,0,14,14
5921,2011-09-09,6,3,54,57
5922,2011-09-09,7,4,103,107
5923,2011-09-09,8,12,274,286
5924,2011-09-09,9,5,129,134
5925,2011-09-09,10,2,27,29
5926,2011-09-09,11,6,64,70
5927,2011-09-09,12,4,71,75
5928,2011-09-09,13,14,106,120
5929,2011-09-09,14,29,116,145
5930,2011-09-09,15,27,159,186
5931,2011-09-09,16,41,241,282
5932,2011-09-09,17,54,449,503
5933,2011-09-09,18,33,371,404
5934,2011-09-09,19,33,312,345
5935,2011-09-09,20,30,179,209
5936,2011-09-09,21,49,152,201
5937,2011-09-09,22,33,125,158
5938,2011-09-09,23,35,113,148
5939,2011-09-10,0,32,82,114
5940,2011-09-10,1,16,66,82
5941,2011-09-10,2,18,45,63
5942,2011-09-10,3,9,28,37
5943,2011-09-10,4,3,4,7
5944,2011-09-10,5,2,5,7
5945,2011-09-10,6,0,6,6
5946,2011-09-10,7,9,43,52
5947,2011-09-10,8,16,103,119
5948,2011-09-10,9,39,165,204
5949,2011-09-10,10,85,231,316
5950,2011-09-10,11,108,247,355
5951,2011-09-10,12,144,256,400
5952,2011-09-10,13,131,234,365
5953,2011-09-10,14,129,225,354
5954,2011-09-10,15,217,258,475
5955,2011-09-10,16,170,256,426
5956,2011-09-10,17,184,264,448
5957,2011-09-10,18,118,236,354
5958,2011-09-10,19,101,210,311
5959,2011-09-10,20,78,163,241
5960,2011-09-10,21,59,166,225
5961,2011-09-10,22,49,122,171
5962,2011-09-10,23,32,106,138
5963,2011-09-11,0,29,78,107
5964,2011-09-11,1,22,65,87
5965,2011-09-11,2,16,60,76
5966,2011-09-11,3,15,30,45
5967,2011-09-11,4,3,6,9
5968,2011-09-11,5,15,23,38
5969,2011-09-11,6,4,16,20
5970,2011-09-11,7,9,28,37
5971,2011-09-11,8,25,67,92
5972,2011-09-11,9,59,166,225
5973,2011-09-11,10,120,211,331
5974,2011-09-11,11,144,255,399
5975,2011-09-11,12,113,293,406
5976,2011-09-11,13,119,225,344
5977,2011-09-11,14,120,210,330
5978,2011-09-11,15,134,253,387
5979,2011-09-11,16,180,297,477
5980,2011-09-11,17,152,225,377
5981,2011-09-11,18,110,222,332
5982,2011-09-11,19,101,225,326
5983,2011-09-11,20,65,155,220
5984,2011-09-11,21,45,107,152
5985,2011-09-11,22,21,74,95
5986,2011-09-11,23,12,32,44
5987,2011-09-12,0,5,11,16
5988,2011-09-12,1,1,10,11
5989,2011-09-12,2,2,0,2
5990,2011-09-12,4,0,4,4
5991,2011-09-12,5,1,21,22
5992,2011-09-12,6,1,107,108
5993,2011-09-12,7,12,297,309
5994,2011-09-12,8,25,377,402
5995,2011-09-12,9,21,152,173
5996,2011-09-12,10,40,88,128
5997,2011-09-12,11,34,130,164
5998,2011-09-12,12,37,143,180
5999,2011-09-12,13,43,119,162
6000,2011-09-12,14,60,129,189
6001,2011-09-12,15,60,146,206
6002,2011-09-12,16,60,234,294
6003,2011-09-12,17,74,512,586
6004,2011-09-12,18,56,504,560
6005,2011-09-12,19,63,360,423
6006,2011-09-12,20,41,253,294
6007,2011-09-12,21,29,162,191
6008,2011-09-12,22,16,129,145
6009,2011-09-12,23,7,62,69
6010,2011-09-13,0,7,19,26
6011,2011-09-13,1,4,6,10
6012,2011-09-13,2,2,0,2
6013,2011-09-13,3,2,2,4
6014,2011-09-13,4,2,6,8
6015,2011-09-13,5,1,18,19
6016,2011-09-13,6,6,114,120
6017,2011-09-13,7,14,341,355
6018,2011-09-13,8,26,394,420
6019,2011-09-13,9,35,176,211
6020,2011-09-13,10,42,92,134
6021,2011-09-13,11,33,119,152
6022,2011-09-13,12,43,143,186
6023,2011-09-13,13,48,133,181
6024,2011-09-13,14,51,137,188
6025,2011-09-13,15,35,143,178
6026,2011-09-13,16,41,249,290
6027,2011-09-13,17,72,501,573
6028,2011-09-13,18,67,469,536
6029,2011-09-13,19,55,337,392
6030,2011-09-13,20,31,238,269
6031,2011-09-13,21,45,197,242
6032,2011-09-13,22,24,119,143
6033,2011-09-13,23,15,59,74
6034,2011-09-14,0,5,28,33
6035,2011-09-14,1,1,7,8
6036,2011-09-14,2,1,4,5
6037,2011-09-14,3,1,6,7
6038,2011-09-14,4,1,8,9
6039,2011-09-14,5,1,29,30
6040,2011-09-14,6,7,134,141
6041,2011-09-14,7,20,347,367
6042,2011-09-14,8,33,390,423
6043,2011-09-14,9,18,181,199
6044,2011-09-14,10,27,115,142
6045,2011-09-14,11,43,118,161
6046,2011-09-14,12,56,154,210
6047,2011-09-14,13,39,138,177
6048,2011-09-14,14,19,102,121
6049,2011-09-14,15,30,145,175
6050,2011-09-14,16,36,241,277
6051,2011-09-14,17,87,509,596
6052,2011-09-14,18,83,494,577
6053,2011-09-14,19,44,335,379
6054,2011-09-14,20,40,215,255
6055,2011-09-14,21,24,188,212
6056,2011-09-14,22,20,140,160
6057,2011-09-14,23,10,62,72
6058,2011-09-15,0,3,34,37
6059,2011-09-15,1,0,19,19
6060,2011-09-15,2,0,5,5
6061,2011-09-15,3,3,5,8
6062,2011-09-15,4,2,5,7
6063,2011-09-15,5,1,30,31
6064,2011-09-15,6,5,118,123
6065,2011-09-15,7,17,318,335
6066,2011-09-15,8,27,357,384
6067,2011-09-15,9,23,183,206
6068,2011-09-15,10,25,90,115
6069,2011-09-15,11,39,117,156
6070,2011-09-15,12,31,147,178
6071,2011-09-15,13,38,150,188
6072,2011-09-15,14,36,128,164
6073,2011-09-15,15,25,109,134
6074,2011-09-15,16,29,192,221
6075,2011-09-15,17,31,230,261
6076,2011-09-15,18,22,219,241
6077,2011-09-15,19,20,210,230
6078,2011-09-15,20,25,218,243
6079,2011-09-15,21,11,134,145
6080,2011-09-15,22,7,106,113
6081,2011-09-15,23,8,60,68
6082,2011-09-16,0,5,43,48
6083,2011-09-16,1,7,19,26
6084,2011-09-16,2,3,7,10
6085,2011-09-16,3,2,4,6
6086,2011-09-16,4,1,3,4
6087,2011-09-16,5,2,29,31
6088,2011-09-16,6,6,83,89
6089,2011-09-16,7,16,278,294
6090,2011-09-16,8,23,382,405
6091,2011-09-16,9,21,186,207
6092,2011-09-16,10,36,100,136
6093,2011-09-16,11,40,136,176
6094,2011-09-16,12,39,207,246
6095,2011-09-16,13,55,164,219
6096,2011-09-16,14,49,174,223
6097,2011-09-16,15,38,163,201
6098,2011-09-16,16,67,286,353
6099,2011-09-16,17,86,474,560
6100,2011-09-16,18,55,425,480
6101,2011-09-16,19,59,252,311
6102,2011-09-16,20,41,178,219
6103,2011-09-16,21,39,120,159
6104,2011-09-16,22,31,134,165
6105,2011-09-16,23,20,105,125
6106,2011-09-17,0,28,80,108
6107,2011-09-17,1,28,51,79
6108,2011-09-17,2,18,61,79
6109,2011-09-17,3,7,20,27
6110,2011-09-17,4,1,3,4
6111,2011-09-17,5,2,3,5
6112,2011-09-17,6,5,17,22
6113,2011-09-17,7,4,31,35
6114,2011-09-17,8,27,81,108
6115,2011-09-17,9,32,142,174
6116,2011-09-17,10,71,175,246
6117,2011-09-17,11,119,247,366
6118,2011-09-17,12,115,255,370
6119,2011-09-17,13,123,221,344
6120,2011-09-17,14,123,172,295
6121,2011-09-17,15,148,206,354
6122,2011-09-17,16,116,183,299
6123,2011-09-17,17,139,214,353
6124,2011-09-17,18,95,230,325
6125,2011-09-17,19,70,180,250
6126,2011-09-17,20,43,133,176
6127,2011-09-17,21,49,116,165
6128,2011-09-17,22,31,111,142
6129,2011-09-17,23,36,97,133
6130,2011-09-18,0,24,86,110
6131,2011-09-18,1,13,65,78
6132,2011-09-18,2,21,66,87
6133,2011-09-18,3,11,25,36
6134,2011-09-18,4,1,0,1
6135,2011-09-18,5,1,5,6
6136,2011-09-18,6,2,10,12
6137,2011-09-18,7,15,29,44
6138,2011-09-18,8,16,52,68
6139,2011-09-18,9,46,94,140
6140,2011-09-18,10,82,177,259
6141,2011-09-18,11,116,197,313
6142,2011-09-18,12,135,225,360
6143,2011-09-18,13,162,210,372
6144,2011-09-18,14,127,181,308
6145,2011-09-18,15,132,225,357
6146,2011-09-18,16,134,234,368
6147,2011-09-18,17,95,229,324
6148,2011-09-18,18,66,214,280
6149,2011-09-18,19,54,189,243
6150,2011-09-18,20,44,135,179
6151,2011-09-18,21,37,109,146
6152,2011-09-18,22,9,74,83
6153,2011-09-18,23,10,44,54
6154,2011-09-19,0,14,23,37
6155,2011-09-19,1,3,7,10
6156,2011-09-19,2,6,7,13
6157,2011-09-19,3,1,4,5
6158,2011-09-19,4,2,5,7
6159,2011-09-19,5,2,25,27
6160,2011-09-19,6,6,105,111
6161,2011-09-19,7,20,305,325
6162,2011-09-19,8,28,377,405
6163,2011-09-19,9,32,181,213
6164,2011-09-19,10,21,84,105
6165,2011-09-19,11,40,96,136
6166,2011-09-19,12,51,136,187
6167,2011-09-19,13,53,124,177
6168,2011-09-19,14,45,139,184
6169,2011-09-19,15,44,142,186
6170,2011-09-19,16,55,206,261
6171,2011-09-19,17,84,478,562
6172,2011-09-19,18,56,476,532
6173,2011-09-19,19,41,328,369
6174,2011-09-19,20,27,200,227
6175,2011-09-19,21,19,176,195
6176,2011-09-19,22,25,103,128
6177,2011-09-19,23,13,52,65
6178,2011-09-20,0,4,21,25
6179,2011-09-20,1,3,11,14
6180,2011-09-20,2,1,4,5
6181,2011-09-20,3,0,3,3
6182,2011-09-20,4,2,3,5
6183,2011-09-20,5,1,21,22
6184,2011-09-20,6,3,110,113
6185,2011-09-20,7,23,296,319
6186,2011-09-20,8,13,192,205
6187,2011-09-20,9,5,63,68
6188,2011-09-20,10,4,26,30
6189,2011-09-20,11,7,48,55
6190,2011-09-20,12,13,46,59
6191,2011-09-20,13,22,80,102
6192,2011-09-20,14,27,83,110
6193,2011-09-20,15,34,155,189
6194,2011-09-20,16,23,240,263
6195,2011-09-20,17,66,441,507
6196,2011-09-20,18,39,448,487
6197,2011-09-20,19,43,291,334
6198,2011-09-20,20,41,208,249
6199,2011-09-20,21,29,175,204
6200,2011-09-20,22,23,123,146
6201,2011-09-20,23,11,68,79
6202,2011-09-21,0,7,21,28
6203,2011-09-21,1,0,17,17
6204,2011-09-21,2,1,4,5
6205,2011-09-21,3,0,6,6
6206,2011-09-21,4,2,5,7
6207,2011-09-21,5,1,30,31
6208,2011-09-21,6,5,111,116
6209,2011-09-21,7,17,309,326
6210,2011-09-21,8,18,436,454
6211,2011-09-21,9,21,183,204
6212,2011-09-21,10,30,103,133
6213,2011-09-21,11,42,134,176
6214,2011-09-21,12,42,151,193
6215,2011-09-21,13,37,144,181
6216,2011-09-21,14,40,136,176
6217,2011-09-21,15,43,141,184
6218,2011-09-21,16,51,229,280
6219,2011-09-21,17,60,469,529
6220,2011-09-21,18,24,383,407
6221,2011-09-21,19,30,252,282
6222,2011-09-21,20,11,147,158
6223,2011-09-21,21,25,170,195
6224,2011-09-21,22,15,110,125
6225,2011-09-21,23,15,77,92
6226,2011-09-22,0,11,30,41
6227,2011-09-22,1,5,6,11
6228,2011-09-22,2,2,8,10
6229,2011-09-22,3,5,7,12
6230,2011-09-22,4,0,2,2
6231,2011-09-22,5,2,28,30
6232,2011-09-22,6,7,93,100
6233,2011-09-22,7,16,292,308
6234,2011-09-22,8,26,385,411
6235,2011-09-22,9,35,166,201
6236,2011-09-22,10,19,101,120
6237,2011-09-22,11,23,139,162
6238,2011-09-22,12,25,151,176
6239,2011-09-22,13,38,153,191
6240,2011-09-22,14,41,140,181
6241,2011-09-22,15,32,148,180
6242,2011-09-22,16,39,258,297
6243,2011-09-22,17,50,508,558
6244,2011-09-22,18,50,495,545
6245,2011-09-22,19,32,381,413
6246,2011-09-22,20,35,247,282
6247,2011-09-22,21,27,189,216
6248,2011-09-22,22,21,164,185
6249,2011-09-22,23,14,97,111
6250,2011-09-23,0,11,41,52
6251,2011-09-23,1,2,27,29
6252,2011-09-23,2,6,14,20
6253,2011-09-23,3,3,5,8
6254,2011-09-23,4,6,6,12
6255,2011-09-23,5,2,19,21
6256,2011-09-23,6,5,97,102
6257,2011-09-23,7,14,236,250
6258,2011-09-23,8,20,295,315
6259,2011-09-23,9,3,108,111
6260,2011-09-23,10,7,28,35
6261,2011-09-23,11,1,20,21
6262,2011-09-23,12,1,28,29
6263,2011-09-23,13,7,27,34
6264,2011-09-23,14,3,21,24
6265,2011-09-23,15,9,52,61
6266,2011-09-23,16,5,51,56
6267,2011-09-23,17,13,85,98
6268,2011-09-23,18,14,214,228
6269,2011-09-23,19,16,229,245
6270,2011-09-23,20,21,157,178
6271,2011-09-23,21,17,120,137
6272,2011-09-23,22,31,123,154
6273,2011-09-23,23,41,106,147
6274,2011-09-24,0,7,86,93
6275,2011-09-24,1,18,58,76
6276,2011-09-24,2,14,54,68
6277,2011-09-24,3,4,26,30
6278,2011-09-24,4,1,7,8
6279,2011-09-24,5,2,3,5
6280,2011-09-24,6,6,12,18
6281,2011-09-24,7,12,33,45
6282,2011-09-24,8,19,101,120
6283,2011-09-24,9,41,130,171
6284,2011-09-24,10,90,198,288
6285,2011-09-24,11,118,262,380
6286,2011-09-24,12,141,260,401
6287,2011-09-24,13,170,284,454
6288,2011-09-24,14,164,221,385
6289,2011-09-24,15,168,278,446
6290,2011-09-24,16,167,277,444
6291,2011-09-24,17,180,240,420
6292,2011-09-24,18,157,239,396
6293,2011-09-24,19,77,226,303
6294,2011-09-24,20,77,162,239
6295,2011-09-24,21,66,153,219
6296,2011-09-24,22,50,143,193
6297,2011-09-24,23,28,121,149
6298,2011-09-25,0,37,135,172
6299,2011-09-25,1,31,92,123
6300,2011-09-25,2,27,78,105
6301,2011-09-25,3,20,38,58
6302,2011-09-25,4,3,5,8
6303,2011-09-25,5,1,2,3
6304,2011-09-25,6,4,13,17
6305,2011-09-25,7,15,23,38
6306,2011-09-25,8,27,57,84
6307,2011-09-25,9,55,99,154
6308,2011-09-25,10,85,188,273
6309,2011-09-25,11,131,229,360
6310,2011-09-25,12,143,267,410
6311,2011-09-25,13,122,243,365
6312,2011-09-25,14,116,229,345
6313,2011-09-25,15,119,232,351
6314,2011-09-25,16,144,315,459
6315,2011-09-25,17,145,267,412
6316,2011-09-25,18,125,274,399
6317,2011-09-25,19,87,235,322
6318,2011-09-25,20,51,132,183
6319,2011-09-25,21,24,112,136
6320,2011-09-25,22,20,84,104
6321,2011-09-25,23,12,66,78
6322,2011-09-26,0,6,23,29
6323,2011-09-26,1,3,14,17
6324,2011-09-26,2,4,4,8
6325,2011-09-26,3,0,5,5
6326,2011-09-26,4,2,4,6
6327,2011-09-26,5,0,25,25
6328,2011-09-26,6,6,106,112
6329,2011-09-26,7,17,312,329
6330,2011-09-26,8,29,323,352
6331,2011-09-26,9,44,159,203
6332,2011-09-26,10,37,115,152
6333,2011-09-26,11,43,115,158
6334,2011-09-26,12,47,160,207
6335,2011-09-26,13,48,138,186
6336,2011-09-26,14,43,109,152
6337,2011-09-26,15,52,155,207
6338,2011-09-26,16,74,239,313
6339,2011-09-26,17,61,500,561
6340,2011-09-26,18,63,485,548
6341,2011-09-26,19,36,346,382
6342,2011-09-26,20,24,222,246
6343,2011-09-26,21,18,161,179
6344,2011-09-26,22,13,122,135
6345,2011-09-26,23,11,64,75
6346,2011-09-27,0,9,28,37
6347,2011-09-27,1,4,6,10
6348,2011-09-27,2,7,4,11
6349,2011-09-27,3,5,5,10
6350,2011-09-27,4,5,3,8
6351,2011-09-27,5,0,24,24
6352,2011-09-27,6,8,115,123
6353,2011-09-27,7,15,230,245
6354,2011-09-27,8,27,394,421
6355,2011-09-27,9,20,172,192
6356,2011-09-27,10,21,100,121
6357,2011-09-27,11,26,97,123
6358,2011-09-27,12,33,124,157
6359,2011-09-27,13,29,117,146
6360,2011-09-27,14,29,123,152
6361,2011-09-27,15,35,169,204
6362,2011-09-27,16,33,222,255
6363,2011-09-27,17,50,477,527
6364,2011-09-27,18,31,319,350
6365,2011-09-27,19,26,285,311
6366,2011-09-27,20,17,219,236
6367,2011-09-27,21,17,176,193
6368,2011-09-27,22,19,102,121
6369,2011-09-27,23,10,82,92
6370,2011-09-28,0,8,29,37
6371,2011-09-28,1,1,13,14
6372,2011-09-28,2,0,9,9
6373,2011-09-28,3,0,3,3
6374,2011-09-28,4,1,3,4
6375,2011-09-28,5,2,19,21
6376,2011-09-28,6,3,108,111
6377,2011-09-28,7,8,176,184
6378,2011-09-28,8,17,267,284
6379,2011-09-28,9,14,140,154
6380,2011-09-28,10,20,107,127
6381,2011-09-28,11,24,127,151
6382,2011-09-28,12,25,158,183
6383,2011-09-28,13,24,135,159
6384,2011-09-28,14,25,145,170
6385,2011-09-28,15,35,145,180
6386,2011-09-28,16,39,241,280
6387,2011-09-28,17,64,525,589
6388,2011-09-28,18,65,453,518
6389,2011-09-28,19,57,313,370
6390,2011-09-28,20,11,88,99
6391,2011-09-28,21,7,66,73
6392,2011-09-28,22,19,68,87
6393,2011-09-28,23,12,58,70
6394,2011-09-29,0,7,33,40
6395,2011-09-29,1,3,20,23
6396,2011-09-29,2,0,2,2
6397,2011-09-29,3,0,8,8
6398,2011-09-29,4,2,5,7
6399,2011-09-29,5,0,22,22
6400,2011-09-29,6,5,105,110
6401,2011-09-29,7,14,269,283
6402,2011-09-29,8,29,399,428
6403,2011-09-29,9,27,195,222
6404,2011-09-29,10,24,100,124
6405,2011-09-29,11,36,121,157
6406,2011-09-29,12,38,153,191
6407,2011-09-29,13,36,173,209
6408,2011-09-29,14,33,134,167
6409,2011-09-29,15,42,182,224
6410,2011-09-29,16,64,226,290
6411,2011-09-29,17,62,522,584
6412,2011-09-29,18,84,490,574
6413,2011-09-29,19,36,344,380
6414,2011-09-29,20,39,232,271
6415,2011-09-29,21,30,195,225
6416,2011-09-29,22,25,147,172
6417,2011-09-29,23,17,62,79
6418,2011-09-30,0,7,53,60
6419,2011-09-30,1,5,17,22
6420,2011-09-30,2,6,9,15
6421,2011-09-30,3,0,3,3
6422,2011-09-30,4,2,6,8
6423,2011-09-30,5,3,23,26
6424,2011-09-30,6,0,97,97
6425,2011-09-30,7,14,281,295
6426,2011-09-30,8,31,421,452
6427,2011-09-30,9,23,213,236
6428,2011-09-30,10,46,121,167
6429,2011-09-30,11,49,166,215
6430,2011-09-30,12,59,193,252
6431,2011-09-30,13,72,191,263
6432,2011-09-30,14,93,172,265
6433,2011-09-30,15,52,193,245
6434,2011-09-30,16,62,296,358
6435,2011-09-30,17,94,490,584
6436,2011-09-30,18,62,441,503
6437,2011-09-30,19,42,324,366
6438,2011-09-30,20,28,198,226
6439,2011-09-30,21,27,175,202
6440,2011-09-30,22,30,128,158
6441,2011-09-30,23,23,108,131
6442,2011-10-01,0,24,103,127
6443,2011-10-01,1,11,45,56
6444,2011-10-01,2,21,45,66
6445,2011-10-01,3,8,17,25
6446,2011-10-01,4,2,6,8
6447,2011-10-01,5,1,4,5
6448,2011-10-01,6,4,15,19
6449,2011-10-01,7,6,30,36
6450,2011-10-01,8,9,58,67
6451,2011-10-01,9,17,111,128
6452,2011-10-01,10,21,99,120
6453,2011-10-01,11,30,101,131
6454,2011-10-01,12,28,129,157
6455,2011-10-01,13,26,96,122
6456,2011-10-01,14,32,146,178
6457,2011-10-01,15,40,152,192
6458,2011-10-01,16,57,164,221
6459,2011-10-01,17,58,169,227
6460,2011-10-01,18,23,116,139
6461,2011-10-01,19,27,96,123
6462,2011-10-01,20,8,57,65
6463,2011-10-01,21,3,53,56
6464,2011-10-01,22,12,56,68
6465,2011-10-01,23,8,57,65
6466,2011-10-02,0,4,42,46
6467,2011-10-02,1,1,22,23
6468,2011-10-02,2,3,27,30
6469,2011-10-02,3,4,5,9
6470,2011-10-02,4,4,3,7
6471,2011-10-02,5,0,7,7
6472,2011-10-02,6,2,13,15
6473,2011-10-02,7,5,24,29
6474,2011-10-02,8,14,49,63
6475,2011-10-02,9,19,94,113
6476,2011-10-02,10,60,184,244
6477,2011-10-02,11,74,216,290
6478,2011-10-02,12,78,242,320
6479,2011-10-02,13,84,216,300
6480,2011-10-02,14,60,195,255
6481,2011-10-02,15,29,140,169
6482,2011-10-02,16,44,158,202
6483,2011-10-02,17,32,133,165
6484,2011-10-02,18,16,157,173
6485,2011-10-02,19,34,127,161
6486,2011-10-02,20,16,71,87
6487,2011-10-02,21,17,69,86
6488,2011-10-02,22,9,55,64
6489,2011-10-02,23,6,19,25
6490,2011-10-03,0,3,13,16
6491,2011-10-03,1,1,5,6
6492,2011-10-03,2,0,4,4
6493,2011-10-03,3,1,6,7
6494,2011-10-03,4,2,6,8
6495,2011-10-03,5,4,17,21
6496,2011-10-03,6,3,90,93
6497,2011-10-03,7,8,237,245
6498,2011-10-03,8,13,355,368
6499,2011-10-03,9,12,140,152
6500,2011-10-03,10,19,81,100
6501,2011-10-03,11,26,99,125
6502,2011-10-03,12,29,116,145
6503,2011-10-03,13,16,102,118
6504,2011-10-03,14,26,92,118
6505,2011-10-03,15,22,78,100
6506,2011-10-03,16,16,199,215
6507,2011-10-03,17,40,449,489
6508,2011-10-03,18,28,381,409
6509,2011-10-03,19,15,292,307
6510,2011-10-03,20,13,190,203
6511,2011-10-03,21,10,127,137
6512,2011-10-03,22,12,79,91
6513,2011-10-03,23,11,41,52
6514,2011-10-04,0,5,22,27
6515,2011-10-04,1,1,8,9
6516,2011-10-04,2,1,2,3
6517,2011-10-04,3,3,3,6
6518,2011-10-04,4,3,4,7
6519,2011-10-04,5,2,25,27
6520,2011-10-04,6,3,108,111
6521,2011-10-04,7,11,295,306
6522,2011-10-04,8,28,367,395
6523,2011-10-04,9,19,167,186
6524,2011-10-04,10,19,104,123
6525,2011-10-04,11,22,102,124
6526,2011-10-04,12,38,160,198
6527,2011-10-04,13,20,150,170
6528,2011-10-04,14,27,152,179
6529,2011-10-04,15,28,164,192
6530,2011-10-04,16,36,267,303
6531,2011-10-04,17,55,525,580
6532,2011-10-04,18,68,449,517
6533,2011-10-04,19,35,307,342
6534,2011-10-04,20,25,233,258
6535,2011-10-04,21,22,144,166
6536,2011-10-04,22,8,104,112
6537,2011-10-04,23,6,57,63
6538,2011-10-05,0,7,35,42
6539,2011-10-05,1,4,7,11
6540,2011-10-05,2,1,2,3
6541,2011-10-05,3,1,5,6
6542,2011-10-05,4,1,4,5
6543,2011-10-05,5,3,29,32
6544,2011-10-05,6,5,111,116
6545,2011-10-05,7,9,285,294
6546,2011-10-05,8,26,434,460
6547,2011-10-05,9,32,183,215
6548,2011-10-05,10,30,103,133
6549,2011-10-05,11,32,135,167
6550,2011-10-05,12,34,180,214
6551,2011-10-05,13,30,185,215
6552,2011-10-05,14,34,153,187
6553,2011-10-05,15,35,146,181
6554,2011-10-05,16,37,240,277
6555,2011-10-05,17,66,522,588
6556,2011-10-05,18,57,530,587
6557,2011-10-05,19,40,329,369
6558,2011-10-05,20,18,227,245
6559,2011-10-05,21,28,170,198
6560,2011-10-05,22,20,133,153
6561,2011-10-05,23,9,64,73
6562,2011-10-06,0,6,34,40
6563,2011-10-06,1,5,17,22
6564,2011-10-06,2,2,8,10
6565,2011-10-06,3,1,4,5
6566,2011-10-06,4,0,5,5
6567,2011-10-06,5,0,24,24
6568,2011-10-06,6,4,107,111
6569,2011-10-06,7,15,286,301
6570,2011-10-06,8,20,430,450
6571,2011-10-06,9,20,184,204
6572,2011-10-06,10,24,102,126
6573,2011-10-06,11,29,115,144
6574,2011-10-06,12,46,178,224
6575,2011-10-06,13,33,154,187
6576,2011-10-06,14,56,137,193
6577,2011-10-06,15,62,154,216
6578,2011-10-06,16,51,270,321
6579,2011-10-06,17,62,499,561
6580,2011-10-06,18,60,476,536
6581,2011-10-06,19,38,303,341
6582,2011-10-06,20,29,227,256
6583,2011-10-06,21,34,159,193
6584,2011-10-06,22,24,122,146
6585,2011-10-06,23,18,81,99
6586,2011-10-07,0,19,47,66
6587,2011-10-07,1,3,25,28
6588,2011-10-07,2,0,5,5
6589,2011-10-07,3,1,9,10
6590,2011-10-07,4,0,4,4
6591,2011-10-07,5,3,24,27
6592,2011-10-07,6,3,83,86
6593,2011-10-07,7,5,232,237
6594,2011-10-07,8,31,379,410
6595,2011-10-07,9,34,202,236
6596,2011-10-07,10,48,125,173
6597,2011-10-07,11,80,147,227
6598,2011-10-07,12,61,173,234
6599,2011-10-07,13,95,210,305
6600,2011-10-07,14,77,179,256
6601,2011-10-07,15,68,200,268
6602,2011-10-07,16,73,340,413
6603,2011-10-07,17,101,455,556
6604,2011-10-07,18,94,366,460
6605,2011-10-07,19,51,241,292
6606,2011-10-07,20,30,164,194
6607,2011-10-07,21,22,142,164
6608,2011-10-07,22,27,115,142
6609,2011-10-07,23,23,109,132
6610,2011-10-08,0,17,70,87
6611,2011-10-08,1,14,51,65
6612,2011-10-08,2,4,39,43
6613,2011-10-08,3,4,15,19
6614,2011-10-08,4,3,6,9
6615,2011-10-08,5,1,7,8
6616,2011-10-08,6,6,15,21
6617,2011-10-08,7,27,45,72
6618,2011-10-08,8,14,89,103
6619,2011-10-08,9,54,159,213
6620,2011-10-08,10,120,213,333
6621,2011-10-08,11,175,218,393
6622,2011-10-08,12,190,252,442
6623,2011-10-08,13,257,223,480
6624,2011-10-08,14,251,207,458
6625,2011-10-08,15,262,225,487
6626,2011-10-08,16,221,223,444
6627,2011-10-08,17,174,213,387
6628,2011-10-08,18,135,221,356
6629,2011-10-08,19,75,170,245
6630,2011-10-08,20,78,122,200
6631,2011-10-08,21,54,131,185
6632,2011-10-08,22,45,100,145
6633,2011-10-08,23,52,89,141
6634,2011-10-09,0,46,82,128
6635,2011-10-09,1,15,60,75
6636,2011-10-09,2,20,33,53
6637,2011-10-09,3,10,20,30
6638,2011-10-09,4,7,7,14
6639,2011-10-09,5,1,13,14
6640,2011-10-09,6,7,14,21
6641,2011-10-09,7,18,25,43
6642,2011-10-09,8,25,82,107
6643,2011-10-09,9,66,117,183
6644,2011-10-09,10,155,206,361
6645,2011-10-09,11,189,229,418
6646,2011-10-09,12,212,235,447
6647,2011-10-09,13,225,192,417
6648,2011-10-09,14,272,226,498
6649,2011-10-09,15,198,199,397
6650,2011-10-09,16,223,240,463
6651,2011-10-09,17,208,226,434
6652,2011-10-09,18,186,224,410
6653,2011-10-09,19,116,184,300
6654,2011-10-09,20,59,134,193
6655,2011-10-09,21,53,118,171
6656,2011-10-09,22,48,100,148
6657,2011-10-09,23,38,82,120
6658,2011-10-10,0,11,42,53
6659,2011-10-10,1,4,30,34
6660,2011-10-10,2,4,14,18
6661,2011-10-10,3,2,9,11
6662,2011-10-10,4,2,4,6
6663,2011-10-10,5,2,19,21
6664,2011-10-10,6,5,37,42
6665,2011-10-10,7,12,100,112
6666,2011-10-10,8,27,219,246
6667,2011-10-10,9,58,157,215
6668,2011-10-10,10,107,152,259
6669,2011-10-10,11,139,179,318
6670,2011-10-10,12,164,199,363
6671,2011-10-10,13,145,216,361
6672,2011-10-10,14,146,223,369
6673,2011-10-10,15,130,252,382
6674,2011-10-10,16,154,239,393
6675,2011-10-10,17,125,328,453
6676,2011-10-10,18,108,360,468
6677,2011-10-10,19,67,263,330
6678,2011-10-10,20,37,184,221
6679,2011-10-10,21,27,148,175
6680,2011-10-10,22,22,102,124
6681,2011-10-10,23,12,63,75
6682,2011-10-11,0,14,16,30
6683,2011-10-11,1,2,9,11
6684,2011-10-11,2,1,3,4
6685,2011-10-11,3,2,1,3
6686,2011-10-11,4,0,5,5
6687,2011-10-11,5,0,20,20
6688,2011-10-11,6,9,112,121
6689,2011-10-11,7,19,326,345
6690,2011-10-11,8,31,369,400
6691,2011-10-11,9,40,193,233
6692,2011-10-11,10,38,109,147
6693,2011-10-11,11,31,89,120
6694,2011-10-11,12,51,130,181
6695,2011-10-11,13,42,138,180
6696,2011-10-11,14,54,117,171
6697,2011-10-11,15,36,138,174
6698,2011-10-11,16,63,256,319
6699,2011-10-11,17,70,529,599
6700,2011-10-11,18,45,484,529
6701,2011-10-11,19,33,279,312
6702,2011-10-11,20,31,202,233
6703,2011-10-11,21,17,152,169
6704,2011-10-11,22,27,115,142
6705,2011-10-11,23,10,45,55
6706,2011-10-12,0,2,23,25
6707,2011-10-12,1,2,8,10
6708,2011-10-12,2,0,2,2
6709,2011-10-12,3,0,2,2
6710,2011-10-12,4,1,6,7
6711,2011-10-12,5,0,22,22
6712,2011-10-12,6,5,106,111
6713,2011-10-12,7,15,240,255
6714,2011-10-12,8,27,373,400
6715,2011-10-12,9,14,179,193
6716,2011-10-12,10,15,96,111
6717,2011-10-12,11,18,100,118
6718,2011-10-12,12,9,53,62
6719,2011-10-12,13,25,76,101
6720,2011-10-12,14,8,70,78
6721,2011-10-12,15,3,42,45
6722,2011-10-12,16,5,50,55
6723,2011-10-12,17,16,235,251
6724,2011-10-12,18,11,160,171
6725,2011-10-12,19,7,101,108
6726,2011-10-12,20,9,79,88
6727,2011-10-12,21,9,71,80
6728,2011-10-12,22,3,40,43
6729,2011-10-12,23,13,41,54
6730,2011-10-13,0,1,14,15
6731,2011-10-13,1,3,9,12
6732,2011-10-13,2,0,4,4
6733,2011-10-13,3,2,4,6
6734,2011-10-13,4,2,5,7
6735,2011-10-13,5,1,16,17
6736,2011-10-13,6,1,51,52
6737,2011-10-13,7,5,75,80
6738,2011-10-13,8,10,199,209
6739,2011-10-13,9,3,106,109
6740,2011-10-13,10,16,51,67
6741,2011-10-13,11,8,72,80
6742,2011-10-13,12,10,94,104
6743,2011-10-13,13,20,136,156
6744,2011-10-13,14,22,111,133
6745,2011-10-13,15,27,126,153
6746,2011-10-13,16,36,239,275
6747,2011-10-13,17,47,427,474
6748,2011-10-13,18,20,242,262
6749,2011-10-13,19,18,187,205
6750,2011-10-13,20,15,164,179
6751,2011-10-13,21,8,115,123
6752,2011-10-13,22,13,100,113
6753,2011-10-13,23,2,45,47
6754,2011-10-14,0,10,28,38
6755,2011-10-14,1,8,16,24
6756,2011-10-14,2,0,6,6
6757,2011-10-14,3,1,6,7
6758,2011-10-14,4,0,8,8
6759,2011-10-14,5,0,17,17
6760,2011-10-14,6,4,90,94
6761,2011-10-14,7,9,136,145
6762,2011-10-14,8,23,184,207
6763,2011-10-14,9,16,162,178
6764,2011-10-14,10,17,103,120
6765,2011-10-14,11,11,73,84
6766,2011-10-14,12,13,62,75
6767,2011-10-14,13,18,108,126
6768,2011-10-14,14,37,116,153
6769,2011-10-14,15,61,166,227
6770,2011-10-14,16,80,261,341
6771,2011-10-14,17,55,421,476
6772,2011-10-14,18,62,361,423
6773,2011-10-14,19,27,212,239
6774,2011-10-14,20,19,173,192
6775,2011-10-14,21,22,155,177
6776,2011-10-14,22,20,120,140
6777,2011-10-14,23,15,80,95
6778,2011-10-15,0,18,87,105
6779,2011-10-15,1,9,63,72
6780,2011-10-15,2,16,39,55
6781,2011-10-15,3,5,17,22
6782,2011-10-15,4,0,7,7
6783,2011-10-15,5,1,6,7
6784,2011-10-15,6,5,15,20
6785,2011-10-15,7,17,40,57
6786,2011-10-15,8,24,101,125
6787,2011-10-15,9,50,156,206
6788,2011-10-15,10,113,206,319
6789,2011-10-15,11,153,215,368
6790,2011-10-15,12,195,258,453
6791,2011-10-15,13,171,217,388
6792,2011-10-15,14,242,223,465
6793,2011-10-15,15,165,200,365
6794,2011-10-15,16,179,256,435
6795,2011-10-15,17,177,255,432
6796,2011-10-15,18,121,239,360
6797,2011-10-15,19,61,172,233
6798,2011-10-15,20,42,134,176
6799,2011-10-15,21,53,115,168
6800,2011-10-15,22,45,120,165
6801,2011-10-15,23,33,99,132
6802,2011-10-16,0,22,84,106
6803,2011-10-16,1,13,63,76
6804,2011-10-16,2,13,51,64
6805,2011-10-16,3,11,30,41
6806,2011-10-16,4,5,7,12
6807,2011-10-16,5,1,5,6
6808,2011-10-16,6,3,7,10
6809,2011-10-16,7,9,39,48
6810,2011-10-16,8,28,67,95
6811,2011-10-16,9,39,147,186
6812,2011-10-16,10,121,223,344
6813,2011-10-16,11,159,211,370
6814,2011-10-16,12,167,270,437
6815,2011-10-16,13,169,267,436
6816,2011-10-16,14,204,250,454
6817,2011-10-16,15,182,230,412
6818,2011-10-16,16,177,280,457
6819,2011-10-16,17,152,247,399
6820,2011-10-16,18,102,222,324
6821,2011-10-16,19,52,179,231
6822,2011-10-16,20,49,126,175
6823,2011-10-16,21,14,85,99
6824,2011-10-16,22,42,86,128
6825,2011-10-16,23,14,46,60
6826,2011-10-17,0,12,25,37
6827,2011-10-17,1,2,15,17
6828,2011-10-17,2,4,3,7
6829,2011-10-17,3,0,2,2
6830,2011-10-17,4,2,3,5
6831,2011-10-17,5,1,28,29
6832,2011-10-17,6,7,107,114
6833,2011-10-17,7,10,299,309
6834,2011-10-17,8,33,379,412
6835,2011-10-17,9,26,180,206
6836,2011-10-17,10,43,90,133
6837,2011-10-17,11,35,129,164
6838,2011-10-17,12,39,165,204
6839,2011-10-17,13,49,149,198
6840,2011-10-17,14,44,118,162
6841,2011-10-17,15,66,141,207
6842,2011-10-17,16,64,234,298
6843,2011-10-17,17,80,536,616
6844,2011-10-17,18,49,461,510
6845,2011-10-17,19,45,285,330
6846,2011-10-17,20,40,184,224
6847,2011-10-17,21,36,138,174
6848,2011-10-17,22,16,87,103
6849,2011-10-17,23,10,48,58
6850,2011-10-18,0,8,21,29
6851,2011-10-18,1,4,7,11
6852,2011-10-18,2,1,4,5
6853,2011-10-18,3,0,1,1
6854,2011-10-18,4,0,4,4
6855,2011-10-18,5,2,18,20
6856,2011-10-18,6,4,102,106
6857,2011-10-18,7,15,321,336
6858,2011-10-18,8,25,467,492
6859,2011-10-18,9,29,197,226
6860,2011-10-18,10,27,74,101
6861,2011-10-18,11,35,110,145
6862,2011-10-18,12,42,158,200
6863,2011-10-18,13,48,171,219
6864,2011-10-18,14,32,133,165
6865,2011-10-18,15,66,139,205
6866,2011-10-18,16,58,243,301
6867,2011-10-18,17,72,551,623
6868,2011-10-18,18,57,507,564
6869,2011-10-18,19,30,284,314
6870,2011-10-18,20,23,199,222
6871,2011-10-18,21,28,175,203
6872,2011-10-18,22,22,115,137
6873,2011-10-18,23,7,63,70
6874,2011-10-19,0,11,23,34
6875,2011-10-19,1,7,9,16
6876,2011-10-19,2,1,4,5
6877,2011-10-19,4,0,3,3
6878,2011-10-19,5,0,3,3
6879,2011-10-19,6,3,27,30
6880,2011-10-19,7,1,66,67
6881,2011-10-19,8,10,198,208
6882,2011-10-19,9,17,184,201
6883,2011-10-19,10,14,106,120
6884,2011-10-19,11,33,115,148
6885,2011-10-19,12,13,116,129
6886,2011-10-19,13,20,86,106
6887,2011-10-19,14,17,78,95
6888,2011-10-19,15,21,98,119
6889,2011-10-19,16,21,179,200
6890,2011-10-19,17,11,166,177
6891,2011-10-19,18,8,129,137
6892,2011-10-19,19,8,188,196
6893,2011-10-19,20,5,140,145
6894,2011-10-19,21,6,77,83
6895,2011-10-19,22,13,94,107
6896,2011-10-19,23,14,55,69
6897,2011-10-20,0,4,22,26
6898,2011-10-20,1,4,10,14
6899,2011-10-20,2,0,4,4
6900,2011-10-20,3,0,1,1
6901,2011-10-20,4,2,6,8
6902,2011-10-20,5,2,24,26
6903,2011-10-20,6,5,87,92
6904,2011-10-20,7,15,299,314
6905,2011-10-20,8,17,404,421
6906,2011-10-20,9,26,194,220
6907,2011-10-20,10,25,102,127
6908,2011-10-20,11,30,97,127
6909,2011-10-20,12,28,170,198
6910,2011-10-20,13,28,133,161
6911,2011-10-20,14,38,114,152
6912,2011-10-20,15,22,137,159
6913,2011-10-20,16,31,202,233
6914,2011-10-20,17,56,433,489
6915,2011-10-20,18,39,429,468
6916,2011-10-20,19,20,277,297
6917,2011-10-20,20,34,203,237
6918,2011-10-20,21,16,146,162
6919,2011-10-20,22,22,105,127
6920,2011-10-20,23,7,82,89
6921,2011-10-21,0,8,41,49
6922,2011-10-21,1,7,19,26
6923,2011-10-21,2,6,11,17
6924,2011-10-21,3,0,7,7
6925,2011-10-21,4,0,6,6
6926,2011-10-21,5,0,30,30
6927,2011-10-21,6,7,78,85
6928,2011-10-21,7,5,224,229
6929,2011-10-21,8,16,383,399
6930,2011-10-21,9,33,189,222
6931,2011-10-21,10,32,105,137
6932,2011-10-21,11,39,134,173
6933,2011-10-21,12,47,191,238
6934,2011-10-21,13,43,162,205
6935,2011-10-21,14,67,128,195
6936,2011-10-21,15,57,177,234
6937,2011-10-21,16,60,238,298
6938,2011-10-21,17,79,442,521
6939,2011-10-21,18,43,350,393
6940,2011-10-21,19,25,225,250
6941,2011-10-21,20,29,151,180
6942,2011-10-21,21,31,109,140
6943,2011-10-21,22,24,85,109
6944,2011-10-21,23,18,97,115
6945,2011-10-22,0,16,80,96
6946,2011-10-22,1,20,47,67
6947,2011-10-22,2,6,24,30
6948,2011-10-22,3,1,19,20
6949,2011-10-22,4,4,4,8
6950,2011-10-22,5,1,7,8
6951,2011-10-22,6,1,16,17
6952,2011-10-22,7,8,48,56
6953,2011-10-22,8,26,86,112
6954,2011-10-22,9,46,120,166
6955,2011-10-22,10,87,143,230
6956,2011-10-22,11,110,168,278
6957,2011-10-22,12,132,209,341
6958,2011-10-22,13,136,182,318
6959,2011-10-22,14,133,176,309
6960,2011-10-22,15,159,216,375
6961,2011-10-22,16,169,188,357
6962,2011-10-22,17,143,214,357
6963,2011-10-22,18,111,214,325
6964,2011-10-22,19,47,170,217
6965,2011-10-22,20,48,109,157
6966,2011-10-22,21,37,118,155
6967,2011-10-22,22,30,110,140
6968,2011-10-22,23,27,80,107
6969,2011-10-23,0,24,62,86
6970,2011-10-23,1,11,59,70
6971,2011-10-23,2,10,40,50
6972,2011-10-23,3,15,31,46
6973,2011-10-23,4,5,1,6
6974,2011-10-23,5,1,2,3
6975,2011-10-23,6,0,11,11
6976,2011-10-23,7,3,17,20
6977,2011-10-23,8,32,56,88
6978,2011-10-23,9,48,94,142
6979,2011-10-23,10,104,181,285
6980,2011-10-23,11,131,201,332
6981,2011-10-23,12,164,243,407
6982,2011-10-23,13,160,248,408
6983,2011-10-23,14,192,210,402
6984,2011-10-23,15,171,209,380
6985,2011-10-23,16,188,212,400
6986,2011-10-23,17,120,216,336
6987,2011-10-23,18,88,194,282
6988,2011-10-23,19,53,138,191
6989,2011-10-23,20,32,110,142
6990,2011-10-23,21,24,75,99
6991,2011-10-23,22,25,68,93
6992,2011-10-23,23,18,29,47
6993,2011-10-24,0,6,25,31
6994,2011-10-24,1,7,8,15
6995,2011-10-24,2,1,5,6
6996,2011-10-24,3,1,3,4
6997,2011-10-24,4,1,5,6
6998,2011-10-24,5,2,19,21
6999,2011-10-24,6,3,82,85
7000,2011-10-24,7,11,272,283
7001,2011-10-24,8,20,374,394
7002,2011-10-24,9,29,163,192
7003,2011-10-24,10,47,81,128
7004,2011-10-24,11,58,109,167
7005,2011-10-24,12,64,152,216
7006,2011-10-24,13,60,136,196
7007,2011-10-24,14,63,142,205
7008,2011-10-24,15,52,120,172
7009,2011-10-24,16,68,241,309
7010,2011-10-24,17,87,519,606
7011,2011-10-24,18,58,426,484
7012,2011-10-24,19,25,211,236
7013,2011-10-24,20,11,115,126
7014,2011-10-24,21,12,110,122
7015,2011-10-24,22,3,76,79
7016,2011-10-24,23,9,50,59
7017,2011-10-25,0,4,26,30
7018,2011-10-25,1,5,6,11
7019,2011-10-25,2,2,3,5
7020,2011-10-25,3,1,3,4
7021,2011-10-25,4,0,4,4
7022,2011-10-25,5,0,24,24
7023,2011-10-25,6,3,94,97
7024,2011-10-25,7,15,296,311
7025,2011-10-25,8,25,380,405
7026,2011-10-25,9,29,191,220
7027,2011-10-25,10,26,100,126
7028,2011-10-25,11,46,119,165
7029,2011-10-25,12,35,162,197
7030,2011-10-25,13,37,159,196
7031,2011-10-25,14,65,132,197
7032,2011-10-25,15,63,167,230
7033,2011-10-25,16,52,231,283
7034,2011-10-25,17,68,513,581
7035,2011-10-25,18,65,442,507
7036,2011-10-25,19,44,288,332
7037,2011-10-25,20,40,206,246
7038,2011-10-25,21,32,166,198
7039,2011-10-25,22,22,147,169
7040,2011-10-25,23,15,77,92
7041,2011-10-26,0,4,28,32
7042,2011-10-26,1,3,9,12
7043,2011-10-26,2,2,1,3
7044,2011-10-26,3,0,3,3
7045,2011-10-26,4,0,5,5
7046,2011-10-26,5,0,20,20
7047,2011-10-26,6,0,91,91
7048,2011-10-26,7,15,282,297
7049,2011-10-26,8,26,436,462
7050,2011-10-26,9,14,222,236
7051,2011-10-26,10,26,105,131
7052,2011-10-26,11,23,131,154
7053,2011-10-26,12,39,154,193
7054,2011-10-26,13,20,62,82
7055,2011-10-26,14,14,52,66
7056,2011-10-26,15,11,58,69
7057,2011-10-26,16,17,196,213
7058,2011-10-26,17,40,407,447
7059,2011-10-26,18,55,396,451
7060,2011-10-26,19,25,299,324
7061,2011-10-26,20,27,178,205
7062,2011-10-26,21,17,135,152
7063,2011-10-26,22,23,111,134
7064,2011-10-26,23,3,71,74
7065,2011-10-27,0,3,23,26
7066,2011-10-27,1,2,9,11
7067,2011-10-27,2,3,5,8
7068,2011-10-27,3,1,3,4
7069,2011-10-27,4,1,3,4
7070,2011-10-27,5,1,14,15
7071,2011-10-27,6,4,41,45
7072,2011-10-27,7,9,127,136
7073,2011-10-27,8,12,299,311
7074,2011-10-27,9,16,154,170
7075,2011-10-27,10,10,49,59
7076,2011-10-27,11,8,43,51
7077,2011-10-27,12,8,45,53
7078,2011-10-27,13,10,62,72
7079,2011-10-27,14,16,75,91
7080,2011-10-27,15,12,92,104
7081,2011-10-27,16,14,193,207
7082,2011-10-27,17,31,290,321
7083,2011-10-27,18,14,222,236
7084,2011-10-27,19,19,200,219
7085,2011-10-27,20,11,170,181
7086,2011-10-27,21,13,116,129
7087,2011-10-27,22,14,97,111
7088,2011-10-27,23,8,57,65
7089,2011-10-28,0,4,39,43
7090,2011-10-28,1,7,9,16
7091,2011-10-28,2,1,3,4
7092,2011-10-28,3,4,4,8
7093,2011-10-28,4,5,5,10
7094,2011-10-28,5,0,25,25
7095,2011-10-28,6,1,74,75
7096,2011-10-28,7,6,197,203
7097,2011-10-28,8,13,361,374
7098,2011-10-28,9,19,209,228
7099,2011-10-28,10,28,101,129
7100,2011-10-28,11,40,126,166
7101,2011-10-28,12,46,164,210
7102,2011-10-28,13,43,184,227
7103,2011-10-28,14,33,149,182
7104,2011-10-28,15,44,170,214
7105,2011-10-28,16,45,261,306
7106,2011-10-28,17,35,402,437
7107,2011-10-28,18,36,329,365
7108,2011-10-28,19,16,183,199
7109,2011-10-28,20,12,127,139
7110,2011-10-28,21,5,69,74
7111,2011-10-28,22,4,30,34
7112,2011-10-28,23,8,31,39
7113,2011-10-29,0,0,17,17
7114,2011-10-29,1,0,18,18
7115,2011-10-29,2,1,16,17
7116,2011-10-29,3,0,8,8
7117,2011-10-29,4,0,1,1
7118,2011-10-29,5,0,1,1
7119,2011-10-29,6,4,1,5
7120,2011-10-29,7,1,6,7
7121,2011-10-29,8,4,16,20
7122,2011-10-29,9,1,19,20
7123,2011-10-29,10,0,12,12
7124,2011-10-29,11,1,26,27
7125,2011-10-29,12,6,43,49
7126,2011-10-29,13,0,30,30
7127,2011-10-29,14,0,28,28
7128,2011-10-29,15,3,37,40
7129,2011-10-29,16,3,19,22
7130,2011-10-29,17,3,28,31
7131,2011-10-29,18,6,36,42
7132,2011-10-29,19,3,36,39
7133,2011-10-29,20,7,40,47
7134,2011-10-29,21,1,48,49
7135,2011-10-29,22,10,43,53
7136,2011-10-29,23,3,33,36
7137,2011-10-30,0,7,46,53
7138,2011-10-30,1,9,34,43
7139,2011-10-30,2,7,43,50
7140,2011-10-30,3,7,24,31
7141,2011-10-30,4,1,9,10
7142,2011-10-30,5,0,4,4
7143,2011-10-30,6,2,8,10
7144,2011-10-30,7,7,15,22
7145,2011-10-30,8,20,57,77
7146,2011-10-30,9,55,90,145
7147,2011-10-30,10,53,124,177
7148,2011-10-30,11,58,177,235
7149,2011-10-30,12,85,228,313
7150,2011-10-30,13,113,230,343
7151,2011-10-30,14,91,207,298
7152,2011-10-30,15,88,199,287
7153,2011-10-30,16,107,210,317
7154,2011-10-30,17,54,187,241
7155,2011-10-30,18,51,159,210
7156,2011-10-30,19,28,121,149
7157,2011-10-30,20,18,72,90
7158,2011-10-30,21,4,71,75
7159,2011-10-30,22,13,58,71
7160,2011-10-30,23,7,30,37
7161,2011-10-31,0,3,20,23
7162,2011-10-31,1,5,8,13
7163,2011-10-31,2,0,3,3
7164,2011-10-31,3,0,3,3
7165,2011-10-31,4,1,5,6
7166,2011-10-31,5,0,18,18
7167,2011-10-31,6,4,80,84
7168,2011-10-31,7,11,215,226
7169,2011-10-31,8,17,350,367
7170,2011-10-31,9,14,193,207
7171,2011-10-31,10,18,87,105
7172,2011-10-31,11,31,96,127
7173,2011-10-31,12,30,140,170
7174,2011-10-31,13,24,125,149
7175,2011-10-31,14,22,119,141
7176,2011-10-31,15,27,141,168
7177,2011-10-31,16,30,240,270
7178,2011-10-31,17,44,440,484
7179,2011-10-31,18,30,385,415
7180,2011-10-31,19,12,224,236
7181,2011-10-31,20,18,151,169
7182,2011-10-31,21,7,108,115
7183,2011-10-31,22,8,75,83
7184,2011-10-31,23,6,45,51
7185,2011-11-01,0,3,17,20
7186,2011-11-01,1,3,8,11
7187,2011-11-01,2,1,3,4
7188,2011-11-01,3,1,5,6
7189,2011-11-01,4,1,7,8
7190,2011-11-01,5,0,18,18
7191,2011-11-01,6,3,88,91
7192,2011-11-01,7,8,243,251
7193,2011-11-01,8,17,400,417
7194,2011-11-01,9,16,205,221
7195,2011-11-01,10,21,113,134
7196,2011-11-01,11,16,100,116
7197,2011-11-01,12,23,151,174
7198,2011-11-01,13,20,147,167
7199,2011-11-01,14,32,117,149
7200,2011-11-01,15,38,144,182
7201,2011-11-01,16,46,249,295
7202,2011-11-01,17,36,470,506
7203,2011-11-01,18,39,416,455
7204,2011-11-01,19,39,271,310
7205,2011-11-01,20,18,191,209
7206,2011-11-01,21,13,114,127
7207,2011-11-01,22,5,91,96
7208,2011-11-01,23,11,60,71
7209,2011-11-02,0,0,18,18
7210,2011-11-02,1,2,8,10
7211,2011-11-02,2,0,2,2
7212,2011-11-02,3,0,2,2
7213,2011-11-02,4,0,3,3
7214,2011-11-02,5,0,26,26
7215,2011-11-02,6,1,90,91
7216,2011-11-02,7,11,234,245
7217,2011-11-02,8,20,447,467
7218,2011-11-02,9,14,211,225
7219,2011-11-02,10,25,106,131
7220,2011-11-02,11,27,116,143
7221,2011-11-02,12,32,156,188
7222,2011-11-02,13,22,139,161
7223,2011-11-02,14,40,131,171
7224,2011-11-02,15,26,155,181
7225,2011-11-02,16,34,230,264
7226,2011-11-02,17,29,518,547
7227,2011-11-02,18,31,442,473
7228,2011-11-02,19,25,254,279
7229,2011-11-02,20,5,176,181
7230,2011-11-02,21,13,154,167
7231,2011-11-02,22,7,97,104
7232,2011-11-02,23,3,53,56
7233,2011-11-03,0,3,28,31
7234,2011-11-03,1,3,12,15
7235,2011-11-03,2,2,5,7
7236,2011-11-03,3,1,4,5
7237,2011-11-03,4,1,2,3
7238,2011-11-03,5,1,27,28
7239,2011-11-03,6,3,95,98
7240,2011-11-03,7,12,275,287
7241,2011-11-03,8,8,386,394
7242,2011-11-03,9,9,154,163
7243,2011-11-03,10,12,96,108
7244,2011-11-03,11,12,108,120
7245,2011-11-03,12,17,159,176
7246,2011-11-03,13,18,145,163
7247,2011-11-03,14,32,119,151
7248,2011-11-03,15,24,136,160
7249,2011-11-03,16,33,232,265
7250,2011-11-03,17,33,455,488
7251,2011-11-03,18,24,402,426
7252,2011-11-03,19,18,233,251
7253,2011-11-03,20,11,191,202
7254,2011-11-03,21,4,139,143
7255,2011-11-03,22,21,114,135
7256,2011-11-03,23,15,80,95
7257,2011-11-04,0,11,31,42
7258,2011-11-04,1,1,16,17
7259,2011-11-04,2,2,8,10
7260,2011-11-04,3,1,7,8
7261,2011-11-04,4,1,6,7
7262,2011-11-04,5,0,23,23
7263,2011-11-04,6,2,63,65
7264,2011-11-04,7,10,234,244
7265,2011-11-04,8,8,384,392
7266,2011-11-04,9,15,235,250
7267,2011-11-04,10,19,113,132
7268,2011-11-04,11,34,127,161
7269,2011-11-04,12,44,150,194
7270,2011-11-04,13,33,159,192
7271,2011-11-04,14,54,145,199
7272,2011-11-04,15,45,191,236
7273,2011-11-04,16,53,235,288
7274,2011-11-04,17,42,436,478
7275,2011-11-04,18,35,332,367
7276,2011-11-04,19,14,178,192
7277,2011-11-04,20,15,167,182
7278,2011-11-04,21,8,114,122
7279,2011-11-04,22,6,108,114
7280,2011-11-04,23,17,71,88
7281,2011-11-05,0,4,48,52
7282,2011-11-05,1,5,57,62
7283,2011-11-05,2,7,24,31
7284,2011-11-05,3,0,8,8
7285,2011-11-05,4,3,4,7
7286,2011-11-05,5,0,2,2
7287,2011-11-05,6,3,20,23
7288,2011-11-05,7,3,31,34
7289,2011-11-05,8,4,79,83
7290,2011-11-05,9,30,111,141
7291,2011-11-05,10,56,170,226
7292,2011-11-05,11,69,169,238
7293,2011-11-05,12,136,229,365
7294,2011-11-05,13,148,203,351
7295,2011-11-05,14,158,224,382
7296,2011-11-05,15,141,197,338
7297,2011-11-05,16,128,204,332
7298,2011-11-05,17,100,231,331
7299,2011-11-05,18,52,183,235
7300,2011-11-05,19,45,154,199
7301,2011-11-05,20,29,134,163
7302,2011-11-05,21,19,97,116
7303,2011-11-05,22,10,72,82
7304,2011-11-05,23,4,80,84
7305,2011-11-06,0,10,65,75
7306,2011-11-06,1,11,102,113
7307,2011-11-06,2,6,23,29
7308,2011-11-06,3,5,4,9
7309,2011-11-06,4,0,6,6
7310,2011-11-06,5,0,5,5
7311,2011-11-06,6,5,11,16
7312,2011-11-06,7,4,24,28
7313,2011-11-06,8,19,70,89
7314,2011-11-06,9,36,134,170
7315,2011-11-06,10,76,184,260
7316,2011-11-06,11,104,214,318
7317,2011-11-06,12,120,224,344
7318,2011-11-06,13,105,206,311
7319,2011-11-06,14,101,216,317
7320,2011-11-06,15,96,205,301
7321,2011-11-06,16,84,257,341
7322,2011-11-06,17,71,181,252
7323,2011-11-06,18,39,143,182
7324,2011-11-06,19,21,127,148
7325,2011-11-06,20,16,99,115
7326,2011-11-06,21,11,76,87
7327,2011-11-06,22,5,40,45
7328,2011-11-06,23,7,43,50
7329,2011-11-07,0,1,14,15
7330,2011-11-07,1,2,6,8
7331,2011-11-07,2,0,2,2
7332,2011-11-07,3,0,3,3
7333,2011-11-07,4,2,4,6
7334,2011-11-07,5,1,25,26
7335,2011-11-07,6,2,96,98
7336,2011-11-07,7,6,302,308
7337,2011-11-07,8,13,392,405
7338,2011-11-07,9,18,150,168
7339,2011-11-07,10,28,92,120
7340,2011-11-07,11,28,98,126
7341,2011-11-07,12,21,157,178
7342,2011-11-07,13,32,156,188
7343,2011-11-07,14,30,115,145
7344,2011-11-07,15,38,131,169
7345,2011-11-07,16,40,253,293
7346,2011-11-07,17,39,477,516
7347,2011-11-07,18,18,397,415
7348,2011-11-07,19,20,273,293
7349,2011-11-07,20,17,185,202
7350,2011-11-07,21,10,129,139
7351,2011-11-07,22,6,98,104
7352,2011-11-07,23,1,47,48
7353,2011-11-08,0,0,17,17
7354,2011-11-08,1,3,8,11
7355,2011-11-08,2,0,1,1
7356,2011-11-08,3,0,3,3
7357,2011-11-08,4,0,4,4
7358,2011-11-08,5,1,17,18
7359,2011-11-08,6,3,95,98
7360,2011-11-08,7,7,314,321
7361,2011-11-08,8,11,444,455
7362,2011-11-08,9,14,172,186
7363,2011-11-08,10,25,103,128
7364,2011-11-08,11,21,122,143
7365,2011-11-08,12,28,173,201
7366,2011-11-08,13,31,163,194
7367,2011-11-08,14,32,126,158
7368,2011-11-08,15,33,154,187
7369,2011-11-08,16,39,248,287
7370,2011-11-08,17,40,457,497
7371,2011-11-08,18,30,427,457
7372,2011-11-08,19,14,260,274
7373,2011-11-08,20,12,166,178
7374,2011-11-08,21,16,164,180
7375,2011-11-08,22,13,92,105
7376,2011-11-08,23,3,43,46
7377,2011-11-09,0,0,13,13
7378,2011-11-09,1,0,10,10
7379,2011-11-09,2,0,5,5
7380,2011-11-09,3,0,4,4
7381,2011-11-09,4,0,4,4
7382,2011-11-09,5,0,28,28
7383,2011-11-09,6,0,96,96
7384,2011-11-09,7,0,297,297
7385,2011-11-09,8,19,428,447
7386,2011-11-09,9,22,195,217
7387,2011-11-09,10,16,88,104
7388,2011-11-09,11,21,131,152
7389,2011-11-09,12,24,156,180
7390,2011-11-09,13,31,134,165
7391,2011-11-09,14,26,152,178
7392,2011-11-09,15,21,128,149
7393,2011-11-09,16,24,252,276
7394,2011-11-09,17,27,449,476
7395,2011-11-09,18,21,383,404
7396,2011-11-09,19,12,287,299
7397,2011-11-09,20,18,198,216
7398,2011-11-09,21,9,150,159
7399,2011-11-09,22,9,103,112
7400,2011-11-09,23,5,61,66
7401,2011-11-10,0,0,24,24
7402,2011-11-10,1,1,10,11
7403,2011-11-10,2,0,5,5
7404,2011-11-10,3,0,5,5
7405,2011-11-10,4,1,2,3
7406,2011-11-10,5,1,22,23
7407,2011-11-10,6,4,109,113
7408,2011-11-10,7,6,264,270
7409,2011-11-10,8,18,410,428
7410,2011-11-10,9,23,188,211
7411,2011-11-10,10,17,99,116
7412,2011-11-10,11,9,97,106
7413,2011-11-10,12,18,149,167
7414,2011-11-10,13,9,86,95
7415,2011-11-10,14,6,58,64
7416,2011-11-10,15,5,57,62
7417,2011-11-10,16,6,66,72
7418,2011-11-10,17,9,166,175
7419,2011-11-10,18,10,260,270
7420,2011-11-10,19,19,191,210
7421,2011-11-10,20,8,160,168
7422,2011-11-10,21,6,130,136
7423,2011-11-10,22,5,82,87
7424,2011-11-10,23,9,72,81
7425,2011-11-11,0,10,55,65
7426,2011-11-11,1,3,16,19
7427,2011-11-11,2,1,10,11
7428,2011-11-11,3,0,6,6
7429,2011-11-11,4,0,8,8
7430,2011-11-11,5,0,13,13
7431,2011-11-11,6,0,46,46
7432,2011-11-11,7,5,116,121
7433,2011-11-11,8,9,248,257
7434,2011-11-11,9,15,186,201
7435,2011-11-11,10,38,156,194
7436,2011-11-11,11,20,147,167
7437,2011-11-11,12,41,194,235
7438,2011-11-11,13,57,178,235
7439,2011-11-11,14,64,181,245
7440,2011-11-11,15,29,185,214
7441,2011-11-11,16,49,188,237
7442,2011-11-11,17,24,280,304
7443,2011-11-11,18,23,184,207
7444,2011-11-11,19,17,179,196
7445,2011-11-11,20,12,97,109
7446,2011-11-11,21,4,79,83
7447,2011-11-11,22,13,78,91
7448,2011-11-11,23,6,67,73
7449,2011-11-12,0,12,52,64
7450,2011-11-12,1,9,45,54
7451,2011-11-12,2,7,38,45
7452,2011-11-12,3,4,13,17
7453,2011-11-12,4,0,7,7
7454,2011-11-12,5,1,3,4
7455,2011-11-12,6,0,7,7
7456,2011-11-12,7,3,24,27
7457,2011-11-12,8,14,87,101
7458,2011-11-12,9,18,139,157
7459,2011-11-12,10,62,168,230
7460,2011-11-12,11,102,213,315
7461,2011-11-12,12,142,222,364
7462,2011-11-12,13,128,223,351
7463,2011-11-12,14,191,242,433
7464,2011-11-12,15,165,216,381
7465,2011-11-12,16,137,222,359
7466,2011-11-12,17,92,191,283
7467,2011-11-12,18,53,148,201
7468,2011-11-12,19,32,138,170
7469,2011-11-12,20,31,97,128
7470,2011-11-12,21,19,98,117
7471,2011-11-12,22,30,87,117
7472,2011-11-12,23,23,78,101
7473,2011-11-13,0,12,60,72
7474,2011-11-13,1,13,57,70
7475,2011-11-13,2,9,48,57
7476,2011-11-13,3,8,20,28
7477,2011-11-13,4,1,5,6
7478,2011-11-13,5,2,3,5
7479,2011-11-13,6,5,18,23
7480,2011-11-13,7,13,30,43
7481,2011-11-13,8,24,55,79
7482,2011-11-13,9,38,96,134
7483,2011-11-13,10,63,176,239
7484,2011-11-13,11,108,185,293
7485,2011-11-13,12,112,239,351
7486,2011-11-13,13,105,226,331
7487,2011-11-13,14,108,262,370
7488,2011-11-13,15,89,216,305
7489,2011-11-13,16,93,225,318
7490,2011-11-13,17,44,184,228
7491,2011-11-13,18,35,154,189
7492,2011-11-13,19,36,121,157
7493,2011-11-13,20,24,114,138
7494,2011-11-13,21,19,75,94
7495,2011-11-13,22,25,62,87
7496,2011-11-13,23,18,49,67
7497,2011-11-14,0,8,22,30
7498,2011-11-14,1,5,6,11
7499,2011-11-14,2,7,10,17
7500,2011-11-14,3,4,3,7
7501,2011-11-14,4,0,3,3
7502,2011-11-14,5,0,19,19
7503,2011-11-14,6,10,102,112
7504,2011-11-14,7,11,304,315
7505,2011-11-14,8,27,420,447
7506,2011-11-14,9,29,203,232
7507,2011-11-14,10,26,81,107
7508,2011-11-14,11,22,105,127
7509,2011-11-14,12,36,164,200
7510,2011-11-14,13,50,151,201
7511,2011-11-14,14,46,137,183
7512,2011-11-14,15,53,141,194
7513,2011-11-14,16,50,261,311
7514,2011-11-14,17,54,453,507
7515,2011-11-14,18,29,457,486
7516,2011-11-14,19,28,268,296
7517,2011-11-14,20,30,207,237
7518,2011-11-14,21,37,174,211
7519,2011-11-14,22,17,95,112
7520,2011-11-14,23,13,47,60
7521,2011-11-15,0,7,15,22
7522,2011-11-15,1,5,4,9
7523,2011-11-15,2,7,8,15
7524,2011-11-15,3,0,4,4
7525,2011-11-15,4,1,6,7
7526,2011-11-15,5,2,25,27
7527,2011-11-15,6,4,102,106
7528,2011-11-15,7,21,295,316
7529,2011-11-15,8,27,452,479
7530,2011-11-15,9,26,172,198
7531,2011-11-15,10,23,114,137
7532,2011-11-15,11,18,115,133
7533,2011-11-15,12,28,148,176
7534,2011-11-15,13,21,132,153
7535,2011-11-15,14,27,118,145
7536,2011-11-15,15,36,155,191
7537,2011-11-15,16,31,237,268
7538,2011-11-15,17,29,419,448
7539,2011-11-15,18,27,410,437
7540,2011-11-15,19,27,257,284
7541,2011-11-15,20,26,208,234
7542,2011-11-15,21,23,144,167
7543,2011-11-15,22,19,106,125
7544,2011-11-15,23,14,66,80
7545,2011-11-16,0,5,26,31
7546,2011-11-16,1,0,5,5
7547,2011-11-16,2,4,6,10
7548,2011-11-16,3,2,3,5
7549,2011-11-16,4,1,3,4
7550,2011-11-16,5,0,13,13
7551,2011-11-16,6,4,51,55
7552,2011-11-16,7,7,130,137
7553,2011-11-16,8,9,222,231
7554,2011-11-16,9,5,77,82
7555,2011-11-16,10,4,32,36
7556,2011-11-16,11,7,53,60
7557,2011-11-16,12,5,48,53
7558,2011-11-16,13,6,51,57
7559,2011-11-16,14,12,49,61
7560,2011-11-16,15,16,50,66
7561,2011-11-16,16,13,110,123
7562,2011-11-16,17,17,214,231
7563,2011-11-16,18,13,175,188
7564,2011-11-16,19,3,106,109
7565,2011-11-16,20,5,91,96
7566,2011-11-16,21,3,72,75
7567,2011-11-16,22,1,45,46
7568,2011-11-16,23,3,28,31
7569,2011-11-17,0,2,21,23
7570,2011-11-17,1,0,5,5
7571,2011-11-17,2,0,5,5
7572,2011-11-17,3,0,3,3
7573,2011-11-17,4,1,3,4
7574,2011-11-17,5,1,21,22
7575,2011-11-17,6,3,71,74
7576,2011-11-17,7,4,163,167
7577,2011-11-17,8,12,341,353
7578,2011-11-17,9,14,184,198
7579,2011-11-17,10,7,73,80
7580,2011-11-17,11,4,92,96
7581,2011-11-17,12,6,114,120
7582,2011-11-17,13,15,109,124
7583,2011-11-17,14,5,105,110
7584,2011-11-17,15,10,106,116
7585,2011-11-17,16,8,186,194
7586,2011-11-17,17,20,375,395
7587,2011-11-17,18,9,297,306
7588,2011-11-17,19,7,207,214
7589,2011-11-17,20,7,156,163
7590,2011-11-17,21,3,111,114
7591,2011-11-17,22,1,81,82
7592,2011-11-17,23,0,57,57
7593,2011-11-18,0,2,27,29
7594,2011-11-18,1,0,10,10
7595,2011-11-18,2,2,8,10
7596,2011-11-18,3,0,2,2
7597,2011-11-18,4,0,5,5
7598,2011-11-18,5,0,22,22
7599,2011-11-18,6,1,69,70
7600,2011-11-18,7,5,210,215
7601,2011-11-18,8,6,368,374
7602,2011-11-18,9,6,204,210
7603,2011-11-18,10,10,105,115
7604,2011-11-18,11,18,122,140
7605,2011-11-18,12,21,139,160
7606,2011-11-18,13,31,145,176
7607,2011-11-18,14,30,122,152
7608,2011-11-18,15,27,149,176
7609,2011-11-18,16,19,188,207
7610,2011-11-18,17,17,360,377
7611,2011-11-18,18,16,308,324
7612,2011-11-18,19,7,177,184
7613,2011-11-18,20,8,125,133
7614,2011-11-18,21,3,107,110
7615,2011-11-18,22,9,88,97
7616,2011-11-18,23,5,53,58
7617,2011-11-19,0,4,48,52
7618,2011-11-19,1,1,34,35
7619,2011-11-19,2,12,34,46
7620,2011-11-19,3,4,11,15
7621,2011-11-19,4,4,4,8
7622,2011-11-19,5,0,2,2
7623,2011-11-19,6,2,10,12
7624,2011-11-19,7,3,37,40
7625,2011-11-19,8,12,80,92
7626,2011-11-19,9,12,127,139
7627,2011-11-19,10,35,158,193
7628,2011-11-19,11,50,181,231
7629,2011-11-19,12,93,214,307
7630,2011-11-19,13,118,242,360
7631,2011-11-19,14,121,223,344
7632,2011-11-19,15,118,257,375
7633,2011-11-19,16,99,186,285
7634,2011-11-19,17,61,169,230
7635,2011-11-19,18,36,171,207
7636,2011-11-19,19,33,147,180
7637,2011-11-19,20,48,114,162
7638,2011-11-19,21,29,79,108
7639,2011-11-19,22,26,80,106
7640,2011-11-19,23,20,71,91
7641,2011-11-20,0,14,77,91
7642,2011-11-20,1,11,72,83
7643,2011-11-20,2,12,43,55
7644,2011-11-20,3,6,30,36
7645,2011-11-20,4,2,10,12
7646,2011-11-20,5,0,3,3
7647,2011-11-20,6,3,6,9
7648,2011-11-20,7,4,18,22
7649,2011-11-20,8,13,51,64
7650,2011-11-20,9,29,107,136
7651,2011-11-20,10,46,182,228
7652,2011-11-20,11,74,210,284
7653,2011-11-20,12,70,230,300
7654,2011-11-20,13,84,280,364
7655,2011-11-20,14,112,246,358
7656,2011-11-20,15,110,240,350
7657,2011-11-20,16,81,218,299
7658,2011-11-20,17,35,165,200
7659,2011-11-20,18,22,123,145
7660,2011-11-20,19,17,137,154
7661,2011-11-20,20,23,86,109
7662,2011-11-20,21,11,91,102
7663,2011-11-20,22,5,35,40
7664,2011-11-20,23,3,25,28
7665,2011-11-21,0,4,13,17
7666,2011-11-21,1,4,8,12
7667,2011-11-21,2,1,2,3
7668,2011-11-21,3,0,4,4
7669,2011-11-21,4,0,5,5
7670,2011-11-21,5,0,20,20
7671,2011-11-21,6,0,75,75
7672,2011-11-21,7,17,227,244
7673,2011-11-21,8,13,368,381
7674,2011-11-21,9,15,218,233
7675,2011-11-21,10,25,109,134
7676,2011-11-21,11,16,110,126
7677,2011-11-21,12,24,135,159
7678,2011-11-21,13,13,120,133
7679,2011-11-21,14,14,118,132
7680,2011-11-21,15,15,93,108
7681,2011-11-21,16,13,95,108
7682,2011-11-21,17,10,198,208
7683,2011-11-21,18,8,183,191
7684,2011-11-21,19,2,134,136
7685,2011-11-21,20,5,74,79
7686,2011-11-21,21,11,102,113
7687,2011-11-21,22,6,70,76
7688,2011-11-21,23,4,29,33
7689,2011-11-22,0,0,14,14
7690,2011-11-22,1,1,5,6
7691,2011-11-22,2,2,4,6
7692,2011-11-22,3,1,2,3
7693,2011-11-22,4,0,7,7
7694,2011-11-22,5,1,17,18
7695,2011-11-22,6,1,62,63
7696,2011-11-22,7,2,119,121
7697,2011-11-22,8,5,182,187
7698,2011-11-22,9,2,145,147
7699,2011-11-22,10,6,45,51
7700,2011-11-22,11,4,28,32
7701,2011-11-22,12,3,17,20
7702,2011-11-22,13,4,22,26
7703,2011-11-22,14,4,31,35
7704,2011-11-22,15,2,32,34
7705,2011-11-22,16,3,59,62
7706,2011-11-22,17,4,160,164
7707,2011-11-22,18,0,144,144
7708,2011-11-22,19,5,105,110
7709,2011-11-22,20,6,120,126
7710,2011-11-22,21,4,84,88
7711,2011-11-22,22,6,79,85
7712,2011-11-22,23,3,35,38
7713,2011-11-23,0,2,14,16
7714,2011-11-23,1,0,8,8
7715,2011-11-23,2,1,5,6
7716,2011-11-23,3,1,2,3
7717,2011-11-23,4,0,5,5
7718,2011-11-23,5,1,16,17
7719,2011-11-23,6,1,67,68
7720,2011-11-23,7,2,152,154
7721,2011-11-23,8,7,304,311
7722,2011-11-23,9,3,163,166
7723,2011-11-23,10,6,69,75
7724,2011-11-23,11,9,105,114
7725,2011-11-23,12,9,148,157
7726,2011-11-23,13,12,162,174
7727,2011-11-23,14,13,198,211
7728,2011-11-23,15,13,194,207
7729,2011-11-23,16,4,167,171
7730,2011-11-23,17,7,156,163
7731,2011-11-23,18,7,136,143
7732,2011-11-23,19,6,115,121
7733,2011-11-23,20,1,66,67
7734,2011-11-23,21,0,66,66
7735,2011-11-23,22,3,59,62
7736,2011-11-23,23,4,46,50
7737,2011-11-24,0,1,22,23
7738,2011-11-24,1,1,23,24
7739,2011-11-24,2,3,18,21
7740,2011-11-24,3,1,4,5
7741,2011-11-24,4,1,1,2
7742,2011-11-24,5,1,9,10
7743,2011-11-24,6,1,5,6
7744,2011-11-24,7,9,29,38
7745,2011-11-24,8,4,42,46
7746,2011-11-24,9,13,66,79
7747,2011-11-24,10,34,64,98
7748,2011-11-24,11,51,90,141
7749,2011-11-24,12,62,86,148
7750,2011-11-24,13,84,88,172
7751,2011-11-24,14,74,92,166
7752,2011-11-24,15,78,71,149
7753,2011-11-24,16,48,64,112
7754,2011-11-24,17,34,40,74
7755,2011-11-24,18,13,23,36
7756,2011-11-24,19,15,13,28
7757,2011-11-24,20,14,17,31
7758,2011-11-24,21,7,18,25
7759,2011-11-24,22,8,14,22
7760,2011-11-24,23,2,19,21
7761,2011-11-25,0,7,22,29
7762,2011-11-25,1,2,12,14
7763,2011-11-25,2,4,6,10
7764,2011-11-25,3,0,2,2
7765,2011-11-25,4,4,3,7
7766,2011-11-25,5,2,3,5
7767,2011-11-25,6,4,9,13
7768,2011-11-25,7,4,31,35
7769,2011-11-25,8,6,68,74
7770,2011-11-25,9,25,68,93
7771,2011-11-25,10,60,80,140
7772,2011-11-25,11,99,126,225
7773,2011-11-25,12,126,144,270
7774,2011-11-25,13,142,140,282
7775,2011-11-25,14,123,149,272
7776,2011-11-25,15,165,143,308
7777,2011-11-25,16,122,138,260
7778,2011-11-25,17,57,127,184
7779,2011-11-25,18,45,105,150
7780,2011-11-25,19,37,95,132
7781,2011-11-25,20,20,75,95
7782,2011-11-25,21,24,59,83
7783,2011-11-25,22,12,45,57
7784,2011-11-25,23,5,27,32
7785,2011-11-26,0,9,37,46
7786,2011-11-26,1,6,24,30
7787,2011-11-26,2,3,19,22
7788,2011-11-26,3,8,9,17
7789,2011-11-26,4,0,4,4
7790,2011-11-26,5,0,3,3
7791,2011-11-26,6,2,8,10
7792,2011-11-26,7,4,13,17
7793,2011-11-26,8,10,46,56
7794,2011-11-26,9,16,62,78
7795,2011-11-26,10,57,81,138
7796,2011-11-26,11,107,122,229
7797,2011-11-26,12,136,165,301
7798,2011-11-26,13,178,144,322
7799,2011-11-26,14,141,157,298
7800,2011-11-26,15,154,155,309
7801,2011-11-26,16,136,135,271
7802,2011-11-26,17,62,121,183
7803,2011-11-26,18,67,118,185
7804,2011-11-26,19,46,99,145
7805,2011-11-26,20,55,86,141
7806,2011-11-26,21,20,69,89
7807,2011-11-26,22,14,50,64
7808,2011-11-26,23,18,49,67
7809,2011-11-27,0,7,39,46
7810,2011-11-27,1,9,34,43
7811,2011-11-27,2,9,21,30
7812,2011-11-27,3,9,8,17
7813,2011-11-27,4,0,4,4
7814,2011-11-27,5,0,5,5
7815,2011-11-27,6,0,9,9
7816,2011-11-27,7,12,11,23
7817,2011-11-27,8,6,36,42
7818,2011-11-27,9,21,89,110
7819,2011-11-27,10,58,131,189
7820,2011-11-27,11,83,153,236
7821,2011-11-27,12,63,192,255
7822,2011-11-27,13,97,213,310
7823,2011-11-27,14,113,193,306
7824,2011-11-27,15,96,218,314
7825,2011-11-27,16,94,220,314
7826,2011-11-27,17,37,162,199
7827,2011-11-27,18,25,130,155
7828,2011-11-27,19,28,107,135
7829,2011-11-27,20,10,91,101
7830,2011-11-27,21,13,75,88
7831,2011-11-27,22,13,53,66
7832,2011-11-27,23,5,26,31
7833,2011-11-28,0,6,10,16
7834,2011-11-28,1,1,12,13
7835,2011-11-28,3,1,4,5
7836,2011-11-28,4,0,3,3
7837,2011-11-28,5,0,34,34
7838,2011-11-28,6,6,93,99
7839,2011-11-28,7,7,268,275
7840,2011-11-28,8,13,391,404
7841,2011-11-28,9,17,189,206
7842,2011-11-28,10,21,85,106
7843,2011-11-28,11,11,106,117
7844,2011-11-28,12,13,159,172
7845,2011-11-28,13,25,134,159
7846,2011-11-28,14,14,128,142
7847,2011-11-28,15,18,130,148
7848,2011-11-28,16,24,235,259
7849,2011-11-28,17,24,439,463
7850,2011-11-28,18,20,388,408
7851,2011-11-28,19,4,257,261
7852,2011-11-28,20,12,205,217
7853,2011-11-28,21,4,151,155
7854,2011-11-28,22,7,99,106
7855,2011-11-28,23,5,39,44
7856,2011-11-29,0,4,18,22
7857,2011-11-29,1,1,16,17
7858,2011-11-29,2,0,5,5
7859,2011-11-29,3,0,2,2
7860,2011-11-29,4,1,4,5
7861,2011-11-29,5,1,21,22
7862,2011-11-29,6,1,87,88
7863,2011-11-29,7,12,326,338
7864,2011-11-29,8,9,438,447
7865,2011-11-29,9,5,196,201
7866,2011-11-29,10,2,34,36
7867,2011-11-29,11,1,10,11
7868,2011-11-29,12,1,17,18
7869,2011-11-29,13,0,22,22
7870,2011-11-29,14,1,34,35
7871,2011-11-29,15,5,60,65
7872,2011-11-29,16,5,144,149
7873,2011-11-29,17,8,344,352
7874,2011-11-29,18,11,343,354
7875,2011-11-29,19,6,240,246
7876,2011-11-29,20,8,173,181
7877,2011-11-29,21,9,115,124
7878,2011-11-29,22,5,90,95
7879,2011-11-29,23,0,52,52
7880,2011-11-30,0,1,23,24
7881,2011-11-30,1,0,7,7
7882,2011-11-30,2,0,5,5
7883,2011-11-30,3,0,1,1
7884,2011-11-30,4,0,5,5
7885,2011-11-30,5,1,21,22
7886,2011-11-30,6,3,98,101
7887,2011-11-30,7,9,275,284
7888,2011-11-30,8,13,461,474
7889,2011-11-30,9,7,184,191
7890,2011-11-30,10,15,93,108
7891,2011-11-30,11,10,112,122
7892,2011-11-30,12,12,146,158
7893,2011-11-30,13,16,130,146
7894,2011-11-30,14,13,98,111
7895,2011-11-30,15,10,104,114
7896,2011-11-30,16,26,194,220
7897,2011-11-30,17,15,360,375
7898,2011-11-30,18,7,367,374
7899,2011-11-30,19,6,271,277
7900,2011-11-30,20,6,180,186
7901,2011-11-30,21,7,127,134
7902,2011-11-30,22,5,82,87
7903,2011-11-30,23,4,45,49
7904,2011-12-01,0,1,19,20
7905,2011-12-01,1,1,8,9
7906,2011-12-01,2,1,7,8
7907,2011-12-01,3,1,6,7
7908,2011-12-01,4,0,1,1
7909,2011-12-01,5,1,22,23
7910,2011-12-01,6,5,91,96
7911,2011-12-01,7,11,264,275
7912,2011-12-01,8,15,457,472
7913,2011-12-01,9,9,212,221
7914,2011-12-01,10,7,85,92
7915,2011-12-01,11,7,93,100
7916,2011-12-01,12,9,137,146
7917,2011-12-01,13,17,137,154
7918,2011-12-01,14,20,121,141
7919,2011-12-01,15,10,142,152
7920,2011-12-01,16,9,189,198
7921,2011-12-01,17,9,405,414
7922,2011-12-01,18,12,390,402
7923,2011-12-01,19,9,218,227
7924,2011-12-01,20,12,175,187
7925,2011-12-01,21,8,153,161
7926,2011-12-01,22,5,99,104
7927,2011-12-01,23,3,69,72
7928,2011-12-02,0,6,31,37
7929,2011-12-02,1,1,13,14
7930,2011-12-02,2,0,10,10
7931,2011-12-02,3,0,1,1
7932,2011-12-02,4,0,2,2
7933,2011-12-02,5,0,22,22
7934,2011-12-02,6,3,82,85
7935,2011-12-02,7,6,198,204
7936,2011-12-02,8,13,426,439
7937,2011-12-02,9,12,232,244
7938,2011-12-02,10,16,89,105
7939,2011-12-02,11,18,140,158
7940,2011-12-02,12,18,182,200
7941,2011-12-02,13,19,187,206
7942,2011-12-02,14,25,145,170
7943,2011-12-02,15,24,175,199
7944,2011-12-02,16,22,252,274
7945,2011-12-02,17,20,389,409
7946,2011-12-02,18,10,359,369
7947,2011-12-02,19,13,245,258
7948,2011-12-02,20,12,176,188
7949,2011-12-02,21,9,101,110
7950,2011-12-02,22,7,95,102
7951,2011-12-02,23,14,81,95
7952,2011-12-03,0,10,64,74
7953,2011-12-03,1,9,60,69
7954,2011-12-03,2,9,41,50
7955,2011-12-03,3,4,5,9
7956,2011-12-03,4,1,6,7
7957,2011-12-03,5,0,6,6
7958,2011-12-03,6,1,10,11
7959,2011-12-03,7,2,23,25
7960,2011-12-03,8,1,62,63
7961,2011-12-03,9,23,97,120
7962,2011-12-03,10,23,171,194
7963,2011-12-03,11,48,226,274
7964,2011-12-03,12,78,279,357
7965,2011-12-03,13,70,216,286
7966,2011-12-03,14,92,249,341
7967,2011-12-03,15,100,232,332
7968,2011-12-03,16,75,222,297
7969,2011-12-03,17,46,183,229
7970,2011-12-03,18,31,189,220
7971,2011-12-03,19,31,143,174
7972,2011-12-03,20,17,105,122
7973,2011-12-03,21,5,101,106
7974,2011-12-03,22,17,94,111
7975,2011-12-03,23,12,71,83
7976,2011-12-04,0,18,63,81
7977,2011-12-04,1,20,54,74
7978,2011-12-04,2,11,51,62
7979,2011-12-04,3,7,33,40
7980,2011-12-04,4,2,9,11
7981,2011-12-04,5,2,2,4
7982,2011-12-04,6,1,3,4
7983,2011-12-04,7,3,22,25
7984,2011-12-04,8,7,48,55
7985,2011-12-04,9,12,113,125
7986,2011-12-04,10,36,177,213
7987,2011-12-04,11,48,201,249
7988,2011-12-04,12,81,241,322
7989,2011-12-04,13,89,266,355
7990,2011-12-04,14,77,241,318
7991,2011-12-04,15,69,220,289
7992,2011-12-04,16,64,263,327
7993,2011-12-04,17,38,206,244
7994,2011-12-04,18,10,159,169
7995,2011-12-04,19,15,156,171
7996,2011-12-04,20,8,113,121
7997,2011-12-04,21,7,65,72
7998,2011-12-04,22,5,59,64
7999,2011-12-04,23,3,42,45
8000,2011-12-05,0,3,21,24
8001,2011-12-05,1,2,10,12
8002,2011-12-05,2,0,8,8
8003,2011-12-05,3,0,2,2
8004,2011-12-05,4,0,7,7
8005,2011-12-05,5,1,24,25
8006,2011-12-05,6,1,87,88
8007,2011-12-05,7,9,271,280
8008,2011-12-05,8,12,385,397
8009,2011-12-05,9,12,178,190
8010,2011-12-05,10,9,76,85
8011,2011-12-05,11,17,103,120
8012,2011-12-05,12,29,124,153
8013,2011-12-05,13,18,145,163
8014,2011-12-05,14,7,125,132
8015,2011-12-05,15,16,130,146
8016,2011-12-05,16,10,233,243
8017,2011-12-05,17,16,424,440
8018,2011-12-05,18,13,379,392
8019,2011-12-05,19,13,288,301
8020,2011-12-05,20,15,186,201
8021,2011-12-05,21,10,160,170
8022,2011-12-05,22,12,93,105
8023,2011-12-05,23,8,52,60
8024,2011-12-06,0,3,25,28
8025,2011-12-06,1,2,14,16
8026,2011-12-06,2,0,3,3
8027,2011-12-06,3,0,3,3
8028,2011-12-06,4,0,7,7
8029,2011-12-06,5,0,20,20
8030,2011-12-06,6,5,80,85
8031,2011-12-06,7,7,224,231
8032,2011-12-06,8,13,396,409
8033,2011-12-06,9,4,198,202
8034,2011-12-06,10,6,44,50
8035,2011-12-06,11,4,27,31
8036,2011-12-06,12,5,51,56
8037,2011-12-06,13,6,63,69
8038,2011-12-06,14,6,67,73
8039,2011-12-06,15,2,43,45
8040,2011-12-06,16,4,83,87
8041,2011-12-06,17,13,247,260
8042,2011-12-06,18,17,283,300
8043,2011-12-06,19,10,220,230
8044,2011-12-06,20,3,104,107
8045,2011-12-06,21,6,107,113
8046,2011-12-06,22,5,81,86
8047,2011-12-06,23,5,47,52
8048,2011-12-07,0,3,30,33
8049,2011-12-07,1,4,9,13
8050,2011-12-07,2,2,4,6
8051,2011-12-07,3,0,3,3
8052,2011-12-07,4,0,1,1
8053,2011-12-07,5,0,3,3
8054,2011-12-07,6,0,18,18
8055,2011-12-07,7,3,42,45
8056,2011-12-07,8,6,79,85
8057,2011-12-07,9,0,62,62
8058,2011-12-07,10,1,32,33
8059,2011-12-07,11,3,47,50
8060,2011-12-07,12,4,29,33
8061,2011-12-07,13,5,28,33
8062,2011-12-07,14,1,23,24
8063,2011-12-07,15,5,24,29
8064,2011-12-07,16,3,28,31
8065,2011-12-07,17,4,48,52
8066,2011-12-07,18,3,48,51
8067,2011-12-07,19,2,31,33
8068,2011-12-07,20,1,24,25
8069,2011-12-07,21,0,6,6
8070,2011-12-07,22,0,13,13
8071,2011-12-07,23,0,16,16
8072,2011-12-08,0,0,21,21
8073,2011-12-08,1,1,6,7
8074,2011-12-08,2,0,4,4
8075,2011-12-08,3,0,1,1
8076,2011-12-08,4,0,1,1
8077,2011-12-08,5,0,12,12
8078,2011-12-08,6,0,71,71
8079,2011-12-08,7,11,233,244
8080,2011-12-08,8,11,416,427
8081,2011-12-08,9,7,212,219
8082,2011-12-08,10,1,108,109
8083,2011-12-08,11,6,99,105
8084,2011-12-08,12,8,148,156
8085,2011-12-08,13,9,112,121
8086,2011-12-08,14,16,121,137
8087,2011-12-08,15,19,98,117
8088,2011-12-08,16,7,198,205
8089,2011-12-08,17,10,320,330
8090,2011-12-08,18,12,305,317
8091,2011-12-08,19,12,219,231
8092,2011-12-08,20,5,169,174
8093,2011-12-08,21,4,132,136
8094,2011-12-08,22,8,82,90
8095,2011-12-08,23,3,57,60
8096,2011-12-09,0,8,26,34
8097,2011-12-09,1,2,12,14
8098,2011-12-09,2,1,10,11
8099,2011-12-09,3,1,5,6
8100,2011-12-09,4,1,1,2
8101,2011-12-09,5,0,20,20
8102,2011-12-09,6,1,62,63
8103,2011-12-09,7,4,192,196
8104,2011-12-09,8,7,374,381
8105,2011-12-09,9,8,252,260
8106,2011-12-09,10,11,112,123
8107,2011-12-09,11,15,119,134
8108,2011-12-09,12,27,146,173
8109,2011-12-09,13,27,140,167
8110,2011-12-09,14,24,162,186
8111,2011-12-09,15,29,160,189
8112,2011-12-09,16,23,222,245
8113,2011-12-09,17,10,350,360
8114,2011-12-09,18,10,306,316
8115,2011-12-09,19,10,188,198
8116,2011-12-09,20,10,137,147
8117,2011-12-09,21,9,129,138
8118,2011-12-09,22,15,112,127
8119,2011-12-09,23,6,87,93
8120,2011-12-10,0,11,66,77
8121,2011-12-10,1,11,54,65
8122,2011-12-10,2,12,48,60
8123,2011-12-10,3,5,20,25
8124,2011-12-10,4,0,3,3
8125,2011-12-10,5,0,6,6
8126,2011-12-10,6,1,10,11
8127,2011-12-10,7,0,11,11
8128,2011-12-10,8,5,67,72
8129,2011-12-10,9,15,132,147
8130,2011-12-10,10,31,159,190
8131,2011-12-10,11,44,190,234
8132,2011-12-10,12,48,232,280
8133,2011-12-10,13,47,238,285
8134,2011-12-10,14,51,240,291
8135,2011-12-10,15,59,236,295
8136,2011-12-10,16,59,178,237
8137,2011-12-10,17,34,148,182
8138,2011-12-10,18,28,143,171
8139,2011-12-10,19,15,138,153
8140,2011-12-10,20,10,112,122
8141,2011-12-10,21,4,78,82
8142,2011-12-10,22,7,86,93
8143,2011-12-10,23,5,61,66
8144,2011-12-11,0,5,68,73
8145,2011-12-11,1,8,54,62
8146,2011-12-11,2,5,47,52
8147,2011-12-11,3,2,17,19
8148,2011-12-11,4,0,5,5
8149,2011-12-11,5,0,6,6
8150,2011-12-11,6,0,10,10
8151,2011-12-11,7,1,29,30
8152,2011-12-11,8,4,66,70
8153,2011-12-11,9,19,88,107
8154,2011-12-11,10,30,164,194
8155,2011-12-11,11,31,164,195
8156,2011-12-11,12,42,240,282
8157,2011-12-11,13,44,218,262
8158,2011-12-11,14,44,197,241
8159,2011-12-11,15,47,218,265
8160,2011-12-11,16,31,173,204
8161,2011-12-11,17,13,148,161
8162,2011-12-11,18,12,149,161
8163,2011-12-11,19,7,97,104
8164,2011-12-11,20,10,60,70
8165,2011-12-11,21,10,53,63
8166,2011-12-11,22,7,36,43
8167,2011-12-11,23,4,29,33
8168,2011-12-12,0,4,16,20
8169,2011-12-12,1,0,9,9
8170,2011-12-12,2,0,4,4
8171,2011-12-12,3,0,2,2
8172,2011-12-12,4,0,3,3
8173,2011-12-12,5,0,21,21
8174,2011-12-12,6,1,62,63
8175,2011-12-12,7,4,227,231
8176,2011-12-12,8,7,374,381
8177,2011-12-12,9,12,207,219
8178,2011-12-12,10,14,89,103
8179,2011-12-12,11,15,97,112
8180,2011-12-12,12,7,125,132
8181,2011-12-12,13,13,153,166
8182,2011-12-12,14,16,94,110
8183,2011-12-12,15,8,123,131
8184,2011-12-12,16,5,208,213
8185,2011-12-12,17,7,345,352
8186,2011-12-12,18,8,345,353
8187,2011-12-12,19,9,229,238
8188,2011-12-12,20,8,157,165
8189,2011-12-12,21,2,118,120
8190,2011-12-12,22,0,71,71
8191,2011-12-12,23,3,42,45
8192,2011-12-13,0,1,16,17
8193,2011-12-13,1,0,4,4
8194,2011-12-13,2,1,1,2
8195,2011-12-13,3,0,3,3
8196,2011-12-13,4,0,4,4
8197,2011-12-13,5,0,19,19
8198,2011-12-13,6,0,91,91
8199,2011-12-13,7,2,218,220
8200,2011-12-13,8,9,386,395
8201,2011-12-13,9,10,220,230
8202,2011-12-13,10,3,98,101
8203,2011-12-13,11,9,113,122
8204,2011-12-13,12,20,143,163
8205,2011-12-13,13,7,120,127
8206,2011-12-13,14,18,115,133
8207,2011-12-13,15,7,143,150
8208,2011-12-13,16,12,193,205
8209,2011-12-13,17,17,375,392
8210,2011-12-13,18,12,364,376
8211,2011-12-13,19,5,259,264
8212,2011-12-13,20,7,153,160
8213,2011-12-13,21,5,133,138
8214,2011-12-13,22,5,102,107
8215,2011-12-13,23,4,54,58
8216,2011-12-14,0,0,21,21
8217,2011-12-14,1,0,8,8
8218,2011-12-14,2,0,2,2
8219,2011-12-14,3,0,3,3
8220,2011-12-14,4,0,4,4
8221,2011-12-14,5,0,26,26
8222,2011-12-14,6,0,86,86
8223,2011-12-14,7,4,242,246
8224,2011-12-14,8,9,453,462
8225,2011-12-14,9,9,228,237
8226,2011-12-14,10,9,132,141
8227,2011-12-14,11,12,101,113
8228,2011-12-14,12,6,138,144
8229,2011-12-14,13,14,116,130
8230,2011-12-14,14,17,132,149
8231,2011-12-14,15,24,141,165
8232,2011-12-14,16,12,231,243
8233,2011-12-14,17,19,370,389
8234,2011-12-14,18,11,374,385
8235,2011-12-14,19,9,254,263
8236,2011-12-14,20,6,167,173
8237,2011-12-14,21,9,141,150
8238,2011-12-14,22,5,97,102
8239,2011-12-14,23,3,48,51
8240,2011-12-15,0,5,44,49
8241,2011-12-15,1,5,15,20
8242,2011-12-15,2,1,5,6
8243,2011-12-15,3,1,2,3
8244,2011-12-15,4,0,6,6
8245,2011-12-15,5,0,24,24
8246,2011-12-15,6,2,89,91
8247,2011-12-15,7,6,250,256
8248,2011-12-15,8,8,447,455
8249,2011-12-15,9,6,273,279
8250,2011-12-15,10,4,103,107
8251,2011-12-15,11,9,125,134
8252,2011-12-15,12,17,138,155
8253,2011-12-15,13,14,148,162
8254,2011-12-15,14,8,122,130
8255,2011-12-15,15,6,76,82
8256,2011-12-15,16,7,124,131
8257,2011-12-15,17,14,306,320
8258,2011-12-15,18,14,359,373
8259,2011-12-15,19,13,270,283
8260,2011-12-15,20,12,205,217
8261,2011-12-15,21,10,142,152
8262,2011-12-15,22,8,114,122
8263,2011-12-15,23,10,103,113
8264,2011-12-16,0,12,60,72
8265,2011-12-16,1,3,28,31
8266,2011-12-16,2,0,23,23
8267,2011-12-16,3,2,3,5
8268,2011-12-16,4,1,4,5
8269,2011-12-16,5,0,25,25
8270,2011-12-16,6,2,79,81
8271,2011-12-16,7,5,225,230
8272,2011-12-16,8,10,440,450
8273,2011-12-16,9,8,231,239
8274,2011-12-16,10,10,119,129
8275,2011-12-16,11,9,134,143
8276,2011-12-16,12,10,160,170
8277,2011-12-16,13,12,124,136
8278,2011-12-16,14,13,114,127
8279,2011-12-16,15,12,138,150
8280,2011-12-16,16,12,208,220
8281,2011-12-16,17,13,351,364
8282,2011-12-16,18,10,282,292
8283,2011-12-16,19,11,200,211
8284,2011-12-16,20,6,145,151
8285,2011-12-16,21,7,95,102
8286,2011-12-16,22,6,100,106
8287,2011-12-16,23,4,71,75
8288,2011-12-17,0,3,57,60
8289,2011-12-17,1,4,37,41
8290,2011-12-17,2,11,47,58
8291,2011-12-17,3,4,22,26
8292,2011-12-17,4,0,9,9
8293,2011-12-17,5,2,7,9
8294,2011-12-17,6,0,15,15
8295,2011-12-17,7,0,21,21
8296,2011-12-17,8,4,54,58
8297,2011-12-17,9,5,93,98
8298,2011-12-17,10,10,170,180
8299,2011-12-17,11,21,186,207
8300,2011-12-17,12,28,215,243
8301,2011-12-17,13,32,202,234
8302,2011-12-17,14,30,205,235
8303,2011-12-17,15,33,192,225
8304,2011-12-17,16,30,190,220
8305,2011-12-17,17,12,153,165
8306,2011-12-17,18,7,149,156
8307,2011-12-17,19,11,92,103
8308,2011-12-17,20,7,97,104
8309,2011-12-17,21,8,87,95
8310,2011-12-17,22,7,73,80
8311,2011-12-17,23,6,62,68
8312,2011-12-18,0,7,62,69
8313,2011-12-18,1,3,42,45
8314,2011-12-18,2,2,39,41
8315,2011-12-18,3,2,16,18
8316,2011-12-18,4,0,1,1
8317,2011-12-18,5,1,4,5
8318,2011-12-18,6,0,3,3
8319,2011-12-18,7,1,11,12
8320,2011-12-18,8,1,31,32
8321,2011-12-18,9,6,73,79
8322,2011-12-18,10,7,118,125
8323,2011-12-18,11,20,165,185
8324,2011-12-18,12,26,201,227
8325,2011-12-18,13,18,208,226
8326,2011-12-18,14,19,198,217
8327,2011-12-18,15,23,182,205
8328,2011-12-18,16,27,201,228
8329,2011-12-18,17,10,124,134
8330,2011-12-18,18,15,123,138
8331,2011-12-18,19,5,128,133
8332,2011-12-18,20,10,93,103
8333,2011-12-18,21,9,78,87
8334,2011-12-18,22,2,47,49
8335,2011-12-18,23,6,31,37
8336,2011-12-19,0,3,14,17
8337,2011-12-19,1,3,8,11
8338,2011-12-19,2,0,3,3
8339,2011-12-19,3,0,3,3
8340,2011-12-19,4,0,4,4
8341,2011-12-19,5,0,21,21
8342,2011-12-19,6,0,66,66
8343,2011-12-19,7,4,185,189
8344,2011-12-19,8,8,386,394
8345,2011-12-19,9,17,165,182
8346,2011-12-19,10,12,95,107
8347,2011-12-19,11,22,103,125
8348,2011-12-19,12,13,128,141
8349,2011-12-19,13,15,122,137
8350,2011-12-19,14,30,105,135
8351,2011-12-19,15,24,127,151
8352,2011-12-19,16,19,189,208
8353,2011-12-19,17,15,359,374
8354,2011-12-19,18,10,343,353
8355,2011-12-19,19,18,233,251
8356,2011-12-19,20,9,194,203
8357,2011-12-19,21,15,109,124
8358,2011-12-19,22,12,95,107
8359,2011-12-19,23,10,50,60
8360,2011-12-20,0,0,21,21
8361,2011-12-20,1,0,6,6
8362,2011-12-20,2,1,9,10
8363,2011-12-20,3,1,1,2
8364,2011-12-20,4,0,4,4
8365,2011-12-20,5,0,15,15
8366,2011-12-20,6,1,70,71
8367,2011-12-20,7,7,259,266
8368,2011-12-20,8,10,413,423
8369,2011-12-20,9,14,244,258
8370,2011-12-20,10,20,109,129
8371,2011-12-20,11,13,115,128
8372,2011-12-20,12,16,157,173
8373,2011-12-20,13,18,163,181
8374,2011-12-20,14,11,125,136
8375,2011-12-20,15,15,139,154
8376,2011-12-20,16,20,216,236
8377,2011-12-20,17,14,413,427
8378,2011-12-20,18,26,382,408
8379,2011-12-20,19,6,215,221
8380,2011-12-20,20,3,143,146
8381,2011-12-20,21,4,138,142
8382,2011-12-20,22,3,103,106
8383,2011-12-20,23,13,37,50
8384,2011-12-21,0,7,18,25
8385,2011-12-21,1,1,10,11
8386,2011-12-21,2,0,4,4
8387,2011-12-21,3,0,2,2
8388,2011-12-21,4,0,2,2
8389,2011-12-21,5,0,28,28
8390,2011-12-21,6,1,73,74
8391,2011-12-21,7,5,224,229
8392,2011-12-21,8,12,387,399
8393,2011-12-21,9,14,219,233
8394,2011-12-21,10,6,83,89
8395,2011-12-21,11,3,52,55
8396,2011-12-21,12,3,56,59
8397,2011-12-21,13,3,54,57
8398,2011-12-21,14,11,40,51
8399,2011-12-21,15,4,57,61
8400,2011-12-21,16,6,94,100
8401,2011-12-21,17,3,224,227
8402,2011-12-21,18,2,277,279
8403,2011-12-21,19,9,201,210
8404,2011-12-21,20,5,157,162
8405,2011-12-21,21,9,115,124
8406,2011-12-21,22,3,102,105
8407,2011-12-21,23,0,54,54
8408,2011-12-22,0,3,24,27
8409,2011-12-22,1,0,15,15
8410,2011-12-22,2,1,10,11
8411,2011-12-22,3,0,6,6
8412,2011-12-22,4,0,3,3
8413,2011-12-22,5,1,15,16
8414,2011-12-22,6,1,61,62
8415,2011-12-22,7,4,182,186
8416,2011-12-22,8,10,329,339
8417,2011-12-22,9,10,212,222
8418,2011-12-22,10,13,122,135
8419,2011-12-22,11,10,133,143
8420,2011-12-22,12,22,176,198
8421,2011-12-22,13,21,165,186
8422,2011-12-22,14,23,133,156
8423,2011-12-22,15,28,185,213
8424,2011-12-22,16,30,224,254
8425,2011-12-22,17,24,330,354
8426,2011-12-22,18,11,274,285
8427,2011-12-22,19,12,127,139
8428,2011-12-22,20,0,33,33
8429,2011-12-22,21,2,15,17
8430,2011-12-22,22,0,17,17
8431,2011-12-22,23,1,10,11
8432,2011-12-23,0,2,6,8
8433,2011-12-23,1,1,11,12
8434,2011-12-23,2,1,12,13
8435,2011-12-23,3,0,4,4
8436,2011-12-23,4,0,2,2
8437,2011-12-23,5,0,7,7
8438,2011-12-23,6,0,40,40
8439,2011-12-23,7,4,87,91
8440,2011-12-23,8,9,172,181
8441,2011-12-23,9,4,151,155
8442,2011-12-23,10,8,93,101
8443,2011-12-23,11,26,146,172
8444,2011-12-23,12,14,154,168
8445,2011-12-23,13,17,176,193
8446,2011-12-23,14,23,174,197
8447,2011-12-23,15,12,184,196
8448,2011-12-23,16,15,164,179
8449,2011-12-23,17,11,129,140
8450,2011-12-23,18,4,91,95
8451,2011-12-23,19,1,74,75
8452,2011-12-23,20,3,47,50
8453,2011-12-23,21,0,32,32
8454,2011-12-23,22,4,42,46
8455,2011-12-23,23,4,21,25
8456,2011-12-24,0,3,20,23
8457,2011-12-24,1,1,15,16
8458,2011-12-24,2,4,20,24
8459,2011-12-24,3,0,5,5
8460,2011-12-24,4,0,3,3
8461,2011-12-24,5,1,3,4
8462,2011-12-24,6,0,10,10
8463,2011-12-24,7,0,10,10
8464,2011-12-24,8,0,25,25
8465,2011-12-24,9,3,51,54
8466,2011-12-24,10,4,50,54
8467,2011-12-24,11,9,60,69
8468,2011-12-24,12,14,80,94
8469,2011-12-24,13,24,97,121
8470,2011-12-24,14,15,69,84
8471,2011-12-24,15,15,82,97
8472,2011-12-24,16,25,72,97
8473,2011-12-24,17,15,50,65
8474,2011-12-24,18,2,33,35
8475,2011-12-24,19,1,23,24
8476,2011-12-24,20,5,19,24
8477,2011-12-24,21,4,15,19
8478,2011-12-24,22,8,12,20
8479,2011-12-24,23,1,16,17
8480,2011-12-25,0,2,4,6
8481,2011-12-25,1,2,2,4
8482,2011-12-25,2,0,2,2
8483,2011-12-25,3,1,3,4
8484,2011-12-25,5,0,1,1
8485,2011-12-25,6,0,1,1
8486,2011-12-25,7,0,4,4
8487,2011-12-25,8,1,4,5
8488,2011-12-25,9,3,20,23
8489,2011-12-25,10,31,12,43
8490,2011-12-25,11,43,42,85
8491,2011-12-25,12,25,38,63
8492,2011-12-25,13,40,38,78
8493,2011-12-25,14,41,43,84
8494,2011-12-25,15,42,48,90
8495,2011-12-25,16,36,48,84
8496,2011-12-25,17,11,33,44
8497,2011-12-25,18,7,23,30
8498,2011-12-25,19,2,13,15
8499,2011-12-25,20,8,17,25
8500,2011-12-25,21,4,14,18
8501,2011-12-25,22,2,15,17
8502,2011-12-25,23,2,14,16
8503,2011-12-26,0,5,6,11
8504,2011-12-26,1,3,7,10
8505,2011-12-26,2,2,5,7
8506,2011-12-26,4,0,2,2
8507,2011-12-26,5,0,2,2
8508,2011-12-26,6,0,4,4
8509,2011-12-26,7,2,17,19
8510,2011-12-26,8,5,13,18
8511,2011-12-26,9,24,37,61
8512,2011-12-26,10,31,38,69
8513,2011-12-26,11,40,50,90
8514,2011-12-26,12,34,65,99
8515,2011-12-26,13,57,80,137
8516,2011-12-26,14,73,75,148
8517,2011-12-26,15,26,99,125
8518,2011-12-26,16,27,69,96
8519,2011-12-26,17,30,67,97
8520,2011-12-26,18,21,54,75
8521,2011-12-26,19,16,49,65
8522,2011-12-26,20,14,41,55
8523,2011-12-26,21,10,38,48
8524,2011-12-26,22,5,21,26
8525,2011-12-26,23,4,25,29
8526,2011-12-27,0,3,9,12
8527,2011-12-27,1,0,6,6
8528,2011-12-27,2,2,2,4
8529,2011-12-27,3,0,2,2
8530,2011-12-27,4,0,3,3
8531,2011-12-27,5,0,8,8
8532,2011-12-27,6,0,35,35
8533,2011-12-27,7,1,79,80
8534,2011-12-27,8,9,155,164
8535,2011-12-27,9,19,84,103
8536,2011-12-27,10,13,47,60
8537,2011-12-27,11,6,24,30
8538,2011-12-27,12,8,16,24
8539,2011-12-27,13,1,16,17
8540,2011-12-27,14,0,14,14
8541,2011-12-27,15,2,17,19
8542,2011-12-27,16,2,44,46
8543,2011-12-27,17,6,107,113
8544,2011-12-27,18,9,126,135
8545,2011-12-27,19,3,86,89
8546,2011-12-27,20,3,66,69
8547,2011-12-27,21,11,51,62
8548,2011-12-27,22,3,28,31
8549,2011-12-27,23,2,24,26
8550,2011-12-28,0,0,10,10
8551,2011-12-28,1,0,11,11
8552,2011-12-28,2,0,7,7
8553,2011-12-28,3,0,4,4
8554,2011-12-28,5,0,9,9
8555,2011-12-28,6,1,41,42
8556,2011-12-28,7,4,105,109
8557,2011-12-28,8,11,206,217
8558,2011-12-28,9,18,167,185
8559,2011-12-28,10,12,83,95
8560,2011-12-28,11,18,93,111
8561,2011-12-28,12,32,108,140
8562,2011-12-28,13,24,132,156
8563,2011-12-28,14,24,95,119
8564,2011-12-28,15,16,100,116
8565,2011-12-28,16,23,143,166
8566,2011-12-28,17,25,223,248
8567,2011-12-28,18,10,156,166
8568,2011-12-28,19,16,132,148
8569,2011-12-28,20,9,68,77
8570,2011-12-28,21,7,62,69
8571,2011-12-28,22,2,31,33
8572,2011-12-28,23,3,34,37
8573,2011-12-29,0,4,23,27
8574,2011-12-29,1,0,14,14
8575,2011-12-29,2,0,3,3
8576,2011-12-29,3,0,2,2
8577,2011-12-29,4,1,2,3
8578,2011-12-29,5,0,9,9
8579,2011-12-29,6,2,39,41
8580,2011-12-29,7,2,104,106
8581,2011-12-29,8,3,206,209
8582,2011-12-29,9,15,152,167
8583,2011-12-29,10,13,97,110
8584,2011-12-29,11,23,96,119
8585,2011-12-29,12,12,117,129
8586,2011-12-29,13,36,93,129
8587,2011-12-29,14,30,112,142
8588,2011-12-29,15,27,150,177
8589,2011-12-29,16,22,155,177
8590,2011-12-29,17,14,222,236
8591,2011-12-29,18,15,191,206
8592,2011-12-29,19,11,122,133
8593,2011-12-29,20,8,88,96
8594,2011-12-29,21,8,60,68
8595,2011-12-29,22,6,48,54
8596,2011-12-29,23,2,44,46
8597,2011-12-30,0,4,25,29
8598,2011-12-30,1,9,11,20
8599,2011-12-30,2,2,10,12
8600,2011-12-30,3,0,6,6
8601,2011-12-30,4,0,2,2
8602,2011-12-30,5,0,9,9
8603,2011-12-30,6,1,31,32
8604,2011-12-30,7,3,90,93
8605,2011-12-30,8,12,191,203
8606,2011-12-30,9,19,174,193
8607,2011-12-30,10,10,108,118
8608,2011-12-30,11,45,126,171
8609,2011-12-30,12,38,158,196
8610,2011-12-30,13,53,152,205
8611,2011-12-30,14,67,174,241
8612,2011-12-30,15,56,234,290
8613,2011-12-30,16,36,240,276
8614,2011-12-30,17,54,187,241
8615,2011-12-30,18,19,159,178
8616,2011-12-30,19,16,93,109
8617,2011-12-30,20,16,75,91
8618,2011-12-30,21,11,84,95
8619,2011-12-30,22,7,77,84
8620,2011-12-30,23,13,60,73
8621,2011-12-31,0,7,37,44
8622,2011-12-31,1,4,30,34
8623,2011-12-31,2,1,27,28
8624,2011-12-31,3,1,17,18
8625,2011-12-31,4,1,9,10
8626,2011-12-31,5,1,0,1
8627,2011-12-31,6,1,5,6
8628,2011-12-31,7,6,13,19
8629,2011-12-31,8,7,42,49
8630,2011-12-31,9,18,71,89
8631,2011-12-31,10,20,108,128
8632,2011-12-31,11,65,152,217
8633,2011-12-31,12,93,178,271
8634,2011-12-31,13,108,200,308
8635,2011-12-31,14,115,181,296
8636,2011-12-31,15,89,161,250
8637,2011-12-31,16,52,139,191
8638,2011-12-31,17,28,99,127
8639,2011-12-31,18,13,80,93
8640,2011-12-31,19,19,70,89
8641,2011-12-31,20,8,63,71
8642,2011-12-31,21,2,49,51
8643,2011-12-31,22,2,33,35
8644,2011-12-31,23,4,26,30
8645,2012-01-01,0,5,43,48
8646,2012-01-01,1,15,77,92
8647,2012-01-01,2,16,57,73
8648,2012-01-01,3,11,39,50
8649,2012-01-01,4,0,8,8
8650,2012-01-01,5,0,5,5
8651,2012-01-01,6,1,1,2
8652,2012-01-01,7,1,6,7
8653,2012-01-01,8,4,10,14
8654,2012-01-01,9,13,27,40
8655,2012-01-01,10,18,52,70
8656,2012-01-01,11,40,97,137
8657,2012-01-01,12,58,141,199
8658,2012-01-01,13,82,133,215
8659,2012-01-01,14,121,142,263
8660,2012-01-01,15,102,163,265
8661,2012-01-01,16,68,141,209
8662,2012-01-01,17,36,74,110
8663,2012-01-01,18,25,79,104
8664,2012-01-01,19,20,83,103
8665,2012-01-01,20,25,58,83
8666,2012-01-01,21,10,58,68
8667,2012-01-01,22,13,52,65
8668,2012-01-01,23,4,25,29
8669,2012-01-02,0,8,30,38
8670,2012-01-02,1,1,11,12
8671,2012-01-02,2,1,6,7
8672,2012-01-02,4,0,2,2
8673,2012-01-02,5,1,3,4
8674,2012-01-02,6,0,14,14
8675,2012-01-02,7,0,16,16
8676,2012-01-02,8,2,51,53
8677,2012-01-02,9,15,54,69
8678,2012-01-02,10,20,88,108
8679,2012-01-02,11,33,139,172
8680,2012-01-02,12,41,161,202
8681,2012-01-02,13,26,148,174
8682,2012-01-02,14,10,141,151
8683,2012-01-02,15,29,140,169
8684,2012-01-02,16,10,142,152
8685,2012-01-02,17,17,136,153
8686,2012-01-02,18,13,112,125
8687,2012-01-02,19,4,87,91
8688,2012-01-02,20,5,82,87
8689,2012-01-02,21,3,62,65
8690,2012-01-02,22,3,36,39
8691,2012-01-02,23,2,32,34
8692,2012-01-03,0,0,13,13
8693,2012-01-03,1,1,5,6
8694,2012-01-03,2,0,3,3
8695,2012-01-03,3,0,2,2
8696,2012-01-03,4,0,4,4
8697,2012-01-03,5,0,12,12
8698,2012-01-03,6,4,79,83
8699,2012-01-03,7,2,166,168
8700,2012-01-03,8,5,348,353
8701,2012-01-03,9,8,145,153
8702,2012-01-03,10,5,55,60
8703,2012-01-03,11,12,62,74
8704,2012-01-03,12,4,70,74
8705,2012-01-03,13,5,68,73
8706,2012-01-03,14,7,69,76
8707,2012-01-03,15,9,68,77
8708,2012-01-03,16,7,128,135
8709,2012-01-03,17,4,240,244
8710,2012-01-03,18,10,213,223
8711,2012-01-03,19,4,151,155
8712,2012-01-03,20,0,113,113
8713,2012-01-03,21,2,65,67
8714,2012-01-03,22,0,33,33
8715,2012-01-03,23,0,18,18
8716,2012-01-04,0,0,8,8
8717,2012-01-04,1,0,3,3
8718,2012-01-04,2,0,1,1
8719,2012-01-04,3,0,1,1
8720,2012-01-04,4,0,2,2
8721,2012-01-04,5,0,14,14
8722,2012-01-04,6,0,58,58
8723,2012-01-04,7,1,150,151
8724,2012-01-04,8,5,310,315
8725,2012-01-04,9,7,172,179
8726,2012-01-04,10,7,58,65
8727,2012-01-04,11,6,40,46
8728,2012-01-04,12,9,75,84
8729,2012-01-04,13,9,82,91
8730,2012-01-04,14,6,69,75
8731,2012-01-04,15,9,81,90
8732,2012-01-04,16,8,123,131
8733,2012-01-04,17,9,270,279
8734,2012-01-04,18,9,276,285
8735,2012-01-04,19,2,182,184
8736,2012-01-04,20,2,121,123
8737,2012-01-04,21,2,87,89
8738,2012-01-04,22,4,47,51
8739,2012-01-04,23,0,32,32
8740,2012-01-05,0,1,12,13
8741,2012-01-05,1,0,5,5
8742,2012-01-05,2,0,4,4
8743,2012-01-05,3,0,4,4
8744,2012-01-05,4,0,5,5
8745,2012-01-05,5,0,26,26
8746,2012-01-05,6,0,77,77
8747,2012-01-05,7,3,211,214
8748,2012-01-05,8,11,381,392
8749,2012-01-05,9,7,217,224
8750,2012-01-05,10,5,80,85
8751,2012-01-05,11,6,77,83
8752,2012-01-05,12,6,113,119
8753,2012-01-05,13,6,113,119
8754,2012-01-05,14,13,105,118
8755,2012-01-05,15,6,112,118
8756,2012-01-05,16,19,177,196
8757,2012-01-05,17,19,394,413
8758,2012-01-05,18,9,366,375
8759,2012-01-05,19,10,252,262
8760,2012-01-05,20,5,167,172
8761,2012-01-05,21,9,88,97
8762,2012-01-05,22,1,69,70
8763,2012-01-05,23,4,56,60
8764,2012-01-06,0,1,24,25
8765,2012-01-06,1,2,6,8
8766,2012-01-06,2,2,3,5
8767,2012-01-06,3,1,3,4
8768,2012-01-06,4,0,3,3
8769,2012-01-06,5,0,13,13
8770,2012-01-06,6,1,67,68
8771,2012-01-06,7,4,202,206
8772,2012-01-06,8,11,434,445
8773,2012-01-06,9,4,238,242
8774,2012-01-06,10,14,102,116
8775,2012-01-06,11,8,129,137
8776,2012-01-06,12,23,166,189
8777,2012-01-06,13,16,186,202
8778,2012-01-06,14,23,150,173
8779,2012-01-06,15,43,173,216
8780,2012-01-06,16,35,254,289
8781,2012-01-06,17,20,450,470
8782,2012-01-06,18,28,386,414
8783,2012-01-06,19,11,258,269
8784,2012-01-06,20,14,160,174
8785,2012-01-06,21,18,137,155
8786,2012-01-06,22,12,119,131
8787,2012-01-06,23,13,87,100
8788,2012-01-07,0,2,77,79
8789,2012-01-07,1,6,56,62
8790,2012-01-07,2,2,36,38
8791,2012-01-07,3,1,18,19
8792,2012-01-07,4,1,9,10
8793,2012-01-07,5,2,7,9
8794,2012-01-07,6,0,7,7
8795,2012-01-07,7,0,20,20
8796,2012-01-07,8,0,64,64
8797,2012-01-07,9,14,115,129
8798,2012-01-07,10,43,157,200
8799,2012-01-07,11,74,247,321
8800,2012-01-07,12,101,271,372
8801,2012-01-07,13,150,294,444
8802,2012-01-07,14,157,354,511
8803,2012-01-07,15,133,311,444
8804,2012-01-07,16,134,266,400
8805,2012-01-07,17,86,231,317
8806,2012-01-07,18,49,238,287
8807,2012-01-07,19,44,169,213
8808,2012-01-07,20,21,147,168
8809,2012-01-07,21,22,117,139
8810,2012-01-07,22,16,89,105
8811,2012-01-07,23,16,104,120
8812,2012-01-08,0,14,77,91
8813,2012-01-08,1,10,61,71
8814,2012-01-08,2,10,56,66
8815,2012-01-08,3,6,26,32
8816,2012-01-08,4,2,4,6
8817,2012-01-08,5,0,2,2
8818,2012-01-08,6,0,2,2
8819,2012-01-08,7,1,23,24
8820,2012-01-08,8,4,52,56
8821,2012-01-08,9,23,102,125
8822,2012-01-08,10,27,178,205
8823,2012-01-08,11,55,201,256
8824,2012-01-08,12,80,271,351
8825,2012-01-08,13,77,263,340
8826,2012-01-08,14,75,250,325
8827,2012-01-08,15,89,236,325
8828,2012-01-08,16,58,257,315
8829,2012-01-08,17,22,197,219
8830,2012-01-08,18,19,161,180
8831,2012-01-08,19,8,105,113
8832,2012-01-08,20,7,120,127
8833,2012-01-08,21,10,80,90
8834,2012-01-08,22,4,53,57
8835,2012-01-08,23,0,30,30
8836,2012-01-09,0,3,12,15
8837,2012-01-09,1,1,4,5
8838,2012-01-09,2,2,3,5
8839,2012-01-09,3,0,3,3
8840,2012-01-09,4,0,4,4
8841,2012-01-09,5,0,20,20
8842,2012-01-09,6,3,84,87
8843,2012-01-09,7,1,236,237
8844,2012-01-09,8,13,404,417
8845,2012-01-09,9,9,181,190
8846,2012-01-09,10,13,79,92
8847,2012-01-09,11,6,82,88
8848,2012-01-09,12,10,92,102
8849,2012-01-09,13,3,69,72
8850,2012-01-09,14,5,47,52
8851,2012-01-09,15,5,62,67
8852,2012-01-09,16,3,46,49
8853,2012-01-09,17,5,148,153
8854,2012-01-09,18,6,156,162
8855,2012-01-09,19,3,185,188
8856,2012-01-09,20,5,123,128
8857,2012-01-09,21,1,76,77
8858,2012-01-09,22,8,54,62
8859,2012-01-09,23,1,49,50
8860,2012-01-10,0,0,14,14
8861,2012-01-10,1,2,3,5
8862,2012-01-10,2,2,2,4
8863,2012-01-10,3,0,1,1
8864,2012-01-10,4,0,4,4
8865,2012-01-10,5,0,23,23
8866,2012-01-10,6,0,79,79
8867,2012-01-10,7,3,221,224
8868,2012-01-10,8,6,461,467
8869,2012-01-10,9,11,184,195
8870,2012-01-10,10,3,79,82
8871,2012-01-10,11,8,92,100
8872,2012-01-10,12,13,126,139
8873,2012-01-10,13,15,162,177
8874,2012-01-10,14,10,95,105
8875,2012-01-10,15,17,119,136
8876,2012-01-10,16,15,222,237
8877,2012-01-10,17,14,443,457
8878,2012-01-10,18,13,368,381
8879,2012-01-10,19,11,264,275
8880,2012-01-10,20,10,189,199
8881,2012-01-10,21,7,109,116
8882,2012-01-10,22,10,104,114
8883,2012-01-10,23,3,36,39
8884,2012-01-11,0,2,26,28
8885,2012-01-11,1,1,6,7
8886,2012-01-11,2,0,5,5
8887,2012-01-11,3,0,4,4
8888,2012-01-11,4,0,1,1
8889,2012-01-11,5,0,22,22
8890,2012-01-11,6,2,71,73
8891,2012-01-11,7,9,246,255
8892,2012-01-11,8,11,486,497
8893,2012-01-11,9,7,220,227
8894,2012-01-11,10,13,82,95
8895,2012-01-11,11,9,90,99
8896,2012-01-11,12,4,51,55
8897,2012-01-11,13,8,57,65
8898,2012-01-11,14,3,69,72
8899,2012-01-11,15,6,72,78
8900,2012-01-11,16,6,112,118
8901,2012-01-11,17,6,127,133
8902,2012-01-11,18,2,95,97
8903,2012-01-11,19,1,93,94
8904,2012-01-11,20,2,53,55
8905,2012-01-11,21,0,28,28
8906,2012-01-11,22,0,49,49
8907,2012-01-11,23,0,9,9
8908,2012-01-12,0,0,3,3
8909,2012-01-12,1,0,3,3
8910,2012-01-12,2,1,1,2
8911,2012-01-12,3,0,3,3
8912,2012-01-12,4,0,1,1
8913,2012-01-12,5,0,16,16
8914,2012-01-12,6,1,86,87
8915,2012-01-12,7,2,220,222
8916,2012-01-12,8,11,493,504
8917,2012-01-12,9,10,219,229
8918,2012-01-12,10,6,84,90
8919,2012-01-12,11,18,101,119
8920,2012-01-12,12,14,128,142
8921,2012-01-12,13,13,167,180
8922,2012-01-12,14,24,128,152
8923,2012-01-12,15,32,156,188
8924,2012-01-12,16,33,246,279
8925,2012-01-12,17,24,468,492
8926,2012-01-12,18,22,394,416
8927,2012-01-12,19,17,306,323
8928,2012-01-12,20,11,229,240
8929,2012-01-12,21,12,160,172
8930,2012-01-12,22,12,121,133
8931,2012-01-12,23,7,60,67
8932,2012-01-13,0,4,38,42
8933,2012-01-13,1,0,12,12
8934,2012-01-13,2,1,13,14
8935,2012-01-13,3,3,4,7
8936,2012-01-13,4,1,2,3
8937,2012-01-13,5,0,21,21
8938,2012-01-13,6,2,70,72
8939,2012-01-13,7,3,174,177
8940,2012-01-13,8,11,404,415
8941,2012-01-13,9,10,203,213
8942,2012-01-13,10,2,99,101
8943,2012-01-13,11,11,100,111
8944,2012-01-13,12,14,140,154
8945,2012-01-13,13,14,140,154
8946,2012-01-13,14,10,118,128
8947,2012-01-13,15,15,123,138
8948,2012-01-13,16,18,214,232
8949,2012-01-13,17,15,315,330
8950,2012-01-13,18,6,293,299
8951,2012-01-13,19,7,198,205
8952,2012-01-13,20,6,126,132
8953,2012-01-13,21,7,94,101
8954,2012-01-13,22,7,57,64
8955,2012-01-13,23,5,59,64
8956,2012-01-14,0,2,40,42
8957,2012-01-14,1,6,43,49
8958,2012-01-14,2,6,32,38
8959,2012-01-14,3,6,13,19
8960,2012-01-14,4,0,3,3
8961,2012-01-14,5,0,4,4
8962,2012-01-14,6,0,5,5
8963,2012-01-14,7,0,24,24
8964,2012-01-14,8,3,89,92
8965,2012-01-14,9,3,80,83
8966,2012-01-14,10,14,134,148
8967,2012-01-14,11,28,147,175
8968,2012-01-14,12,30,186,216
8969,2012-01-14,13,38,179,217
8970,2012-01-14,14,52,179,231
8971,2012-01-14,15,49,172,221
8972,2012-01-14,16,28,177,205
8973,2012-01-14,17,15,126,141
8974,2012-01-14,18,21,122,143
8975,2012-01-14,19,12,90,102
8976,2012-01-14,20,8,94,102
8977,2012-01-14,21,3,66,69
8978,2012-01-14,22,4,61,65
8979,2012-01-14,23,5,71,76
8980,2012-01-15,0,9,49,58
8981,2012-01-15,1,2,41,43
8982,2012-01-15,2,5,38,43
8983,2012-01-15,3,1,23,24
8984,2012-01-15,4,1,5,6
8985,2012-01-15,5,0,5,5
8986,2012-01-15,6,1,7,8
8987,2012-01-15,7,3,13,16
8988,2012-01-15,8,2,34,36
8989,2012-01-15,9,10,80,90
8990,2012-01-15,10,11,110,121
8991,2012-01-15,11,21,142,163
8992,2012-01-15,12,41,188,229
8993,2012-01-15,13,40,183,223
8994,2012-01-15,14,25,163,188
8995,2012-01-15,15,33,173,206
8996,2012-01-15,16,31,174,205
8997,2012-01-15,17,15,131,146
8998,2012-01-15,18,7,112,119
8999,2012-01-15,19,9,101,110
9000,2012-01-15,20,9,83,92
9001,2012-01-15,21,1,71,72
9002,2012-01-15,22,2,58,60
9003,2012-01-15,23,3,25,28
9004,2012-01-16,0,2,23,25
9005,2012-01-16,1,2,18,20
9006,2012-01-16,2,3,15,18
9007,2012-01-16,3,0,3,3
9008,2012-01-16,4,2,6,8
9009,2012-01-16,5,1,5,6
9010,2012-01-16,6,0,13,13
9011,2012-01-16,7,5,28,33
9012,2012-01-16,8,3,78,81
9013,2012-01-16,9,7,88,95
9014,2012-01-16,10,19,105,124
9015,2012-01-16,11,21,159,180
9016,2012-01-16,12,20,163,183
9017,2012-01-16,13,26,196,222
9018,2012-01-16,14,23,156,179
9019,2012-01-16,15,17,172,189
9020,2012-01-16,16,22,155,177
9021,2012-01-16,17,19,173,192
9022,2012-01-16,18,6,172,178
9023,2012-01-16,19,10,132,142
9024,2012-01-16,20,2,87,89
9025,2012-01-16,21,3,46,49
9026,2012-01-16,22,4,39,43
9027,2012-01-16,23,0,28,28
9028,2012-01-17,0,0,12,12
9029,2012-01-17,1,0,2,2
9030,2012-01-17,2,0,12,12
9031,2012-01-17,4,0,2,2
9032,2012-01-17,5,0,13,13
9033,2012-01-17,6,0,60,60
9034,2012-01-17,7,5,120,125
9035,2012-01-17,8,2,90,92
9036,2012-01-17,9,6,61,67
9037,2012-01-17,10,1,62,63
9038,2012-01-17,11,2,72,74
9039,2012-01-17,12,3,83,86
9040,2012-01-17,13,8,95,103
9041,2012-01-17,14,12,118,130
9042,2012-01-17,15,6,122,128
9043,2012-01-17,16,14,205,219
9044,2012-01-17,17,20,435,455
9045,2012-01-17,18,12,446,458
9046,2012-01-17,19,11,292,303
9047,2012-01-17,20,11,167,178
9048,2012-01-17,21,6,175,181
9049,2012-01-17,22,5,85,90
9050,2012-01-17,23,1,59,60
9051,2012-01-18,0,3,14,17
9052,2012-01-18,1,0,10,10
9053,2012-01-18,2,1,1,2
9054,2012-01-18,3,1,3,4
9055,2012-01-18,4,0,1,1
9056,2012-01-18,5,0,29,29
9057,2012-01-18,6,0,88,88
9058,2012-01-18,7,1,261,262
9059,2012-01-18,8,15,475,490
9060,2012-01-18,9,6,194,200
9061,2012-01-18,10,5,88,93
9062,2012-01-18,11,4,110,114
9063,2012-01-18,12,6,153,159
9064,2012-01-18,13,6,122,128
9065,2012-01-18,14,7,97,104
9066,2012-01-18,15,8,122,130
9067,2012-01-18,16,13,163,176
9068,2012-01-18,17,8,336,344
9069,2012-01-18,18,8,338,346
9070,2012-01-18,19,5,250,255
9071,2012-01-18,20,1,162,163
9072,2012-01-18,21,5,118,123
9073,2012-01-18,22,4,74,78
9074,2012-01-18,23,2,35,37
9075,2012-01-19,0,0,15,15
9076,2012-01-19,1,0,5,5
9077,2012-01-19,2,0,3,3
9078,2012-01-19,3,0,4,4
9079,2012-01-19,4,0,1,1
9080,2012-01-19,5,0,19,19
9081,2012-01-19,6,0,84,84
9082,2012-01-19,7,2,202,204
9083,2012-01-19,8,9,413,422
9084,2012-01-19,9,7,201,208
9085,2012-01-19,10,10,98,108
9086,2012-01-19,11,6,93,99
9087,2012-01-19,12,5,106,111
9088,2012-01-19,13,6,117,123
9089,2012-01-19,14,15,104,119
9090,2012-01-19,15,9,118,127
9091,2012-01-19,16,8,184,192
9092,2012-01-19,17,21,363,384
9093,2012-01-19,18,16,344,360
9094,2012-01-19,19,5,229,234
9095,2012-01-19,20,7,184,191
9096,2012-01-19,21,4,115,119
9097,2012-01-19,22,0,90,90
9098,2012-01-19,23,1,55,56
9099,2012-01-20,0,3,24,27
9100,2012-01-20,1,0,15,15
9101,2012-01-20,2,0,10,10
9102,2012-01-20,3,0,4,4
9103,2012-01-20,4,0,3,3
9104,2012-01-20,5,0,19,19
9105,2012-01-20,6,0,68,68
9106,2012-01-20,7,2,182,184
9107,2012-01-20,8,4,421,425
9108,2012-01-20,9,20,240,260
9109,2012-01-20,10,1,94,95
9110,2012-01-20,11,6,113,119
9111,2012-01-20,12,5,119,124
9112,2012-01-20,13,12,143,155
9113,2012-01-20,14,8,106,114
9114,2012-01-20,15,12,143,155
9115,2012-01-20,16,11,161,172
9116,2012-01-20,17,9,334,343
9117,2012-01-20,18,5,292,297
9118,2012-01-20,19,6,182,188
9119,2012-01-20,20,1,138,139
9120,2012-01-20,21,5,98,103
9121,2012-01-20,22,1,69,70
9122,2012-01-20,23,3,34,37
9123,2012-01-21,0,0,23,23
9124,2012-01-21,1,1,22,23
9125,2012-01-21,2,1,23,24
9126,2012-01-21,3,0,13,13
9127,2012-01-21,4,0,1,1
9128,2012-01-21,5,0,2,2
9129,2012-01-21,6,0,1,1
9130,2012-01-21,7,3,10,13
9131,2012-01-21,8,3,21,24
9132,2012-01-21,9,2,39,41
9133,2012-01-21,10,0,45,45
9134,2012-01-21,11,1,62,63
9135,2012-01-21,12,5,61,66
9136,2012-01-21,13,9,66,75
9137,2012-01-21,14,6,87,93
9138,2012-01-21,15,6,110,116
9139,2012-01-21,16,5,113,118
9140,2012-01-21,17,7,98,105
9141,2012-01-21,18,3,105,108
9142,2012-01-21,19,0,85,85
9143,2012-01-21,20,5,61,66
9144,2012-01-21,21,5,64,69
9145,2012-01-21,22,3,55,58
9146,2012-01-21,23,1,50,51
9147,2012-01-22,0,1,50,51
9148,2012-01-22,1,1,48,49
9149,2012-01-22,2,1,45,46
9150,2012-01-22,3,1,18,19
9151,2012-01-22,4,1,1,2
9152,2012-01-22,5,1,2,3
9153,2012-01-22,6,0,4,4
9154,2012-01-22,7,2,11,13
9155,2012-01-22,8,3,29,32
9156,2012-01-22,9,9,53,62
9157,2012-01-22,10,9,119,128
9158,2012-01-22,11,18,110,128
9159,2012-01-22,12,24,160,184
9160,2012-01-22,13,24,174,198
9161,2012-01-22,14,19,159,178
9162,2012-01-22,15,27,148,175
9163,2012-01-22,16,12,143,155
9164,2012-01-22,17,8,100,108
9165,2012-01-22,18,11,110,121
9166,2012-01-22,19,9,79,88
9167,2012-01-22,20,5,67,72
9168,2012-01-22,21,8,36,44
9169,2012-01-22,22,0,57,57
9170,2012-01-22,23,2,35,37
9171,2012-01-23,0,2,17,19
9172,2012-01-23,1,0,4,4
9173,2012-01-23,2,0,2,2
9174,2012-01-23,3,0,1,1
9175,2012-01-23,4,0,1,1
9176,2012-01-23,5,0,18,18
9177,2012-01-23,6,6,36,42
9178,2012-01-23,7,8,113,121
9179,2012-01-23,8,5,266,271
9180,2012-01-23,9,13,196,209
9181,2012-01-23,10,10,139,149
9182,2012-01-23,11,5,57,62
9183,2012-01-23,12,10,50,60
9184,2012-01-23,13,5,32,37
9185,2012-01-23,14,13,47,60
9186,2012-01-23,15,10,64,74
9187,2012-01-23,16,14,106,120
9188,2012-01-23,17,6,265,271
9189,2012-01-23,18,7,273,280
9190,2012-01-23,19,9,211,220
9191,2012-01-23,20,8,158,166
9192,2012-01-23,21,8,111,119
9193,2012-01-23,22,4,64,68
9194,2012-01-23,23,2,34,36
9195,2012-01-24,0,6,18,24
9196,2012-01-24,1,2,7,9
9197,2012-01-24,2,2,6,8
9198,2012-01-24,3,0,3,3
9199,2012-01-24,4,0,2,2
9200,2012-01-24,5,0,25,25
9201,2012-01-24,6,1,86,87
9202,2012-01-24,7,11,219,230
9203,2012-01-24,8,11,473,484
9204,2012-01-24,9,11,242,253
9205,2012-01-24,10,23,93,116
9206,2012-01-24,11,30,121,151
9207,2012-01-24,12,25,150,175
9208,2012-01-24,13,33,166,199
9209,2012-01-24,14,35,136,171
9210,2012-01-24,15,52,155,207
9211,2012-01-24,16,35,243,278
9212,2012-01-24,17,41,469,510
9213,2012-01-24,18,32,386,418
9214,2012-01-24,19,20,307,327
9215,2012-01-24,20,18,208,226
9216,2012-01-24,21,18,153,171
9217,2012-01-24,22,14,108,122
9218,2012-01-24,23,19,80,99
9219,2012-01-25,0,6,26,32
9220,2012-01-25,1,4,7,11
9221,2012-01-25,2,3,3,6
9222,2012-01-25,3,0,1,1
9223,2012-01-25,4,0,4,4
9224,2012-01-25,5,0,31,31
9225,2012-01-25,6,1,87,88
9226,2012-01-25,7,14,241,255
9227,2012-01-25,8,18,493,511
9228,2012-01-25,9,18,217,235
9229,2012-01-25,10,30,110,140
9230,2012-01-25,11,52,104,156
9231,2012-01-25,12,46,145,191
9232,2012-01-25,13,63,142,205
9233,2012-01-25,14,53,105,158
9234,2012-01-25,15,30,123,153
9235,2012-01-25,16,29,217,246
9236,2012-01-25,17,27,439,466
9237,2012-01-25,18,24,414,438
9238,2012-01-25,19,5,307,312
9239,2012-01-25,20,10,224,234
9240,2012-01-25,21,19,163,182
9241,2012-01-25,22,12,101,113
9242,2012-01-25,23,3,63,66
9243,2012-01-26,0,3,21,24
9244,2012-01-26,1,5,16,21
9245,2012-01-26,2,1,6,7
9246,2012-01-26,3,1,5,6
9247,2012-01-26,4,0,3,3
9248,2012-01-26,5,0,28,28
9249,2012-01-26,6,0,87,87
9250,2012-01-26,7,11,225,236
9251,2012-01-26,8,16,510,526
9252,2012-01-26,9,18,255,273
9253,2012-01-26,10,16,92,108
9254,2012-01-26,11,11,98,109
9255,2012-01-26,12,29,135,164
9256,2012-01-26,13,17,155,172
9257,2012-01-26,14,16,107,123
9258,2012-01-26,15,22,140,162
9259,2012-01-26,16,15,206,221
9260,2012-01-26,17,15,389,404
9261,2012-01-26,18,12,392,404
9262,2012-01-26,19,11,296,307
9263,2012-01-26,20,8,215,223
9264,2012-01-26,21,8,179,187
9265,2012-01-26,22,3,138,141
9266,2012-01-26,23,5,85,90
9267,2012-01-27,0,6,33,39
9268,2012-01-27,1,6,23,29
9269,2012-01-27,2,2,11,13
9270,2012-01-27,3,3,5,8
9271,2012-01-27,4,1,3,4
9272,2012-01-27,5,0,24,24
9273,2012-01-27,6,0,71,71
9274,2012-01-27,7,6,130,136
9275,2012-01-27,8,14,205,219
9276,2012-01-27,9,6,100,106
9277,2012-01-27,10,9,116,125
9278,2012-01-27,11,10,94,104
9279,2012-01-27,12,25,153,178
9280,2012-01-27,13,26,174,200
9281,2012-01-27,14,23,150,173
9282,2012-01-27,15,27,166,193
9283,2012-01-27,16,26,239,265
9284,2012-01-27,17,16,399,415
9285,2012-01-27,18,20,357,377
9286,2012-01-27,19,10,237,247
9287,2012-01-27,20,6,151,157
9288,2012-01-27,21,8,126,134
9289,2012-01-27,22,11,106,117
9290,2012-01-27,23,8,76,84
9291,2012-01-28,0,1,67,68
9292,2012-01-28,1,1,56,57
9293,2012-01-28,2,3,38,41
9294,2012-01-28,3,1,16,17
9295,2012-01-28,4,0,8,8
9296,2012-01-28,5,0,9,9
9297,2012-01-28,6,3,12,15
9298,2012-01-28,7,3,28,31
9299,2012-01-28,8,9,81,90
9300,2012-01-28,9,13,144,157
9301,2012-01-28,10,27,162,189
9302,2012-01-28,11,55,233,288
9303,2012-01-28,12,70,241,311
9304,2012-01-28,13,81,291,372
9305,2012-01-28,14,123,237,360
9306,2012-01-28,15,90,320,410
9307,2012-01-28,16,131,273,404
9308,2012-01-28,17,57,230,287
9309,2012-01-28,18,40,202,242
9310,2012-01-28,19,33,169,202
9311,2012-01-28,20,5,113,118
9312,2012-01-28,21,18,110,128
9313,2012-01-28,22,6,95,101
9314,2012-01-28,23,6,78,84
9315,2012-01-29,0,15,81,96
9316,2012-01-29,1,5,65,70
9317,2012-01-29,2,3,48,51
9318,2012-01-29,3,4,17,21
9319,2012-01-29,4,0,5,5
9320,2012-01-29,5,1,6,7
9321,2012-01-29,6,1,4,5
9322,2012-01-29,7,0,12,12
9323,2012-01-29,8,9,59,68
9324,2012-01-29,9,13,96,109
9325,2012-01-29,10,38,149,187
9326,2012-01-29,11,56,196,252
9327,2012-01-29,12,74,208,282
9328,2012-01-29,13,78,237,315
9329,2012-01-29,14,49,226,275
9330,2012-01-29,15,68,238,306
9331,2012-01-29,16,54,266,320
9332,2012-01-29,17,33,199,232
9333,2012-01-29,18,17,151,168
9334,2012-01-29,19,14,144,158
9335,2012-01-29,20,13,96,109
9336,2012-01-29,21,0,69,69
9337,2012-01-29,22,7,55,62
9338,2012-01-29,23,4,21,25
9339,2012-01-30,0,0,10,10
9340,2012-01-30,1,0,9,9
9341,2012-01-30,2,1,6,7
9342,2012-01-30,3,0,4,4
9343,2012-01-30,4,0,5,5
9344,2012-01-30,5,0,25,25
9345,2012-01-30,6,0,80,80
9346,2012-01-30,7,4,219,223
9347,2012-01-30,8,12,475,487
9348,2012-01-30,9,5,190,195
9349,2012-01-30,10,3,81,84
9350,2012-01-30,11,6,92,98
9351,2012-01-30,12,5,129,134
9352,2012-01-30,13,15,117,132
9353,2012-01-30,14,15,98,113
9354,2012-01-30,15,7,130,137
9355,2012-01-30,16,11,207,218
9356,2012-01-30,17,16,423,439
9357,2012-01-30,18,11,397,408
9358,2012-01-30,19,8,291,299
9359,2012-01-30,20,2,177,179
9360,2012-01-30,21,3,155,158
9361,2012-01-30,22,2,88,90
9362,2012-01-30,23,0,51,51
9363,2012-01-31,0,0,15,15
9364,2012-01-31,1,1,7,8
9365,2012-01-31,2,0,2,2
9366,2012-01-31,3,0,2,2
9367,2012-01-31,4,0,1,1
9368,2012-01-31,5,0,22,22
9369,2012-01-31,6,0,102,102
9370,2012-01-31,7,6,269,275
9371,2012-01-31,8,14,494,508
9372,2012-01-31,9,30,231,261
9373,2012-01-31,10,34,110,144
9374,2012-01-31,11,14,125,139
9375,2012-01-31,12,13,179,192
9376,2012-01-31,13,27,172,199
9377,2012-01-31,14,18,141,159
9378,2012-01-31,15,27,148,175
9379,2012-01-31,16,30,272,302
9380,2012-01-31,17,41,514,555
9381,2012-01-31,18,16,483,499
9382,2012-01-31,19,22,301,323
9383,2012-01-31,20,15,223,238
9384,2012-01-31,21,3,161,164
9385,2012-01-31,22,11,117,128
9386,2012-01-31,23,2,61,63
9387,2012-02-01,0,0,30,30
9388,2012-02-01,1,0,4,4
9389,2012-02-01,2,1,6,7
9390,2012-02-01,3,0,3,3
9391,2012-02-01,4,0,1,1
9392,2012-02-01,5,0,18,18
9393,2012-02-01,6,0,67,67
9394,2012-02-01,7,7,200,207
9395,2012-02-01,8,15,501,516
9396,2012-02-01,9,9,266,275
9397,2012-02-01,10,9,121,130
9398,2012-02-01,11,27,116,143
9399,2012-02-01,12,26,153,179
9400,2012-02-01,13,12,170,182
9401,2012-02-01,14,33,157,190
9402,2012-02-01,15,25,166,191
9403,2012-02-01,16,22,258,280
9404,2012-02-01,17,31,508,539
9405,2012-02-01,18,12,506,518
9406,2012-02-01,19,20,312,332
9407,2012-02-01,20,10,252,262
9408,2012-02-01,21,16,218,234
9409,2012-02-01,22,7,133,140
9410,2012-02-01,23,22,75,97
9411,2012-02-02,0,7,24,31
9412,2012-02-02,1,3,14,17
9413,2012-02-02,2,2,7,9
9414,2012-02-02,3,0,2,2
9415,2012-02-02,4,0,1,1
9416,2012-02-02,5,0,19,19
9417,2012-02-02,6,1,72,73
9418,2012-02-02,7,4,200,204
9419,2012-02-02,8,9,434,443
9420,2012-02-02,9,15,213,228
9421,2012-02-02,10,6,71,77
9422,2012-02-02,11,6,99,105
9423,2012-02-02,12,8,139,147
9424,2012-02-02,13,13,122,135
9425,2012-02-02,14,12,129,141
9426,2012-02-02,15,24,149,173
9427,2012-02-02,16,18,211,229
9428,2012-02-02,17,13,435,448
9429,2012-02-02,18,17,392,409
9430,2012-02-02,19,16,308,324
9431,2012-02-02,20,9,201,210
9432,2012-02-02,21,4,139,143
9433,2012-02-02,22,3,105,108
9434,2012-02-02,23,0,61,61
9435,2012-02-03,0,1,36,37
9436,2012-02-03,1,3,19,22
9437,2012-02-03,2,0,6,6
9438,2012-02-03,3,0,4,4
9439,2012-02-03,4,0,2,2
9440,2012-02-03,5,0,17,17
9441,2012-02-03,6,0,88,88
9442,2012-02-03,7,10,217,227
9443,2012-02-03,8,12,428,440
9444,2012-02-03,9,18,252,270
9445,2012-02-03,10,15,111,126
9446,2012-02-03,11,15,147,162
9447,2012-02-03,12,25,192,217
9448,2012-02-03,13,25,170,195
9449,2012-02-03,14,22,148,170
9450,2012-02-03,15,48,165,213
9451,2012-02-03,16,36,272,308
9452,2012-02-03,17,30,454,484
9453,2012-02-03,18,17,366,383
9454,2012-02-03,19,11,252,263
9455,2012-02-03,20,8,152,160
9456,2012-02-03,21,8,123,131
9457,2012-02-03,22,3,115,118
9458,2012-02-03,23,3,72,75
9459,2012-02-04,0,10,75,85
9460,2012-02-04,1,0,42,42
9461,2012-02-04,2,5,38,43
9462,2012-02-04,3,1,17,18
9463,2012-02-04,4,1,5,6
9464,2012-02-04,5,1,3,4
9465,2012-02-04,6,1,4,5
9466,2012-02-04,7,1,27,28
9467,2012-02-04,8,4,85,89
9468,2012-02-04,9,16,139,155
9469,2012-02-04,10,31,191,222
9470,2012-02-04,11,46,218,264
9471,2012-02-04,12,40,258,298
9472,2012-02-04,13,58,241,299
9473,2012-02-04,14,47,227,274
9474,2012-02-04,15,61,237,298
9475,2012-02-04,16,20,121,141
9476,2012-02-04,17,13,54,67
9477,2012-02-04,18,6,58,64
9478,2012-02-04,19,5,75,80
9479,2012-02-04,20,4,73,77
9480,2012-02-04,21,4,71,75
9481,2012-02-04,22,4,89,93
9482,2012-02-04,23,4,66,70
9483,2012-02-05,0,3,58,61
9484,2012-02-05,1,5,46,51
9485,2012-02-05,2,4,57,61
9486,2012-02-05,3,4,13,17
9487,2012-02-05,4,0,9,9
9488,2012-02-05,5,0,4,4
9489,2012-02-05,6,0,4,4
9490,2012-02-05,7,0,16,16
9491,2012-02-05,8,4,58,62
9492,2012-02-05,9,9,83,92
9493,2012-02-05,10,10,137,147
9494,2012-02-05,11,22,157,179
9495,2012-02-05,12,25,217,242
9496,2012-02-05,13,32,240,272
9497,2012-02-05,14,40,201,241
9498,2012-02-05,15,55,214,269
9499,2012-02-05,16,35,256,291
9500,2012-02-05,17,31,274,305
9501,2012-02-05,18,10,168,178
9502,2012-02-05,19,6,61,67
9503,2012-02-05,20,3,47,50
9504,2012-02-05,21,6,59,65
9505,2012-02-05,22,9,180,189
9506,2012-02-05,23,4,37,41
9507,2012-02-06,0,7,14,21
9508,2012-02-06,1,0,6,6
9509,2012-02-06,2,0,3,3
9510,2012-02-06,4,0,2,2
9511,2012-02-06,5,0,17,17
9512,2012-02-06,6,0,72,72
9513,2012-02-06,7,5,227,232
9514,2012-02-06,8,10,429,439
9515,2012-02-06,9,8,265,273
9516,2012-02-06,10,20,93,113
9517,2012-02-06,11,12,103,115
9518,2012-02-06,12,19,131,150
9519,2012-02-06,13,17,124,141
9520,2012-02-06,14,14,125,139
9521,2012-02-06,15,25,146,171
9522,2012-02-06,16,13,214,227
9523,2012-02-06,17,13,415,428
9524,2012-02-06,18,11,424,435
9525,2012-02-06,19,7,283,290
9526,2012-02-06,20,7,190,197
9527,2012-02-06,21,11,142,153
9528,2012-02-06,22,4,84,88
9529,2012-02-06,23,3,41,44
9530,2012-02-07,0,1,21,22
9531,2012-02-07,1,8,6,14
9532,2012-02-07,2,0,4,4
9533,2012-02-07,3,1,1,2
9534,2012-02-07,4,0,2,2
9535,2012-02-07,5,0,15,15
9536,2012-02-07,6,2,98,100
9537,2012-02-07,7,6,292,298
9538,2012-02-07,8,7,521,528
9539,2012-02-07,9,11,275,286
9540,2012-02-07,10,12,103,115
9541,2012-02-07,11,9,121,130
9542,2012-02-07,12,10,160,170
9543,2012-02-07,13,15,169,184
9544,2012-02-07,14,11,128,139
9545,2012-02-07,15,13,134,147
9546,2012-02-07,16,19,256,275
9547,2012-02-07,17,15,493,508
9548,2012-02-07,18,10,502,512
9549,2012-02-07,19,11,325,336
9550,2012-02-07,20,6,203,209
9551,2012-02-07,21,20,168,188
9552,2012-02-07,22,11,106,117
9553,2012-02-07,23,2,48,50
9554,2012-02-08,0,2,21,23
9555,2012-02-08,1,1,9,10
9556,2012-02-08,2,0,1,1
9557,2012-02-08,3,0,1,1
9558,2012-02-08,4,0,1,1
9559,2012-02-08,5,0,20,20
9560,2012-02-08,6,3,93,96
9561,2012-02-08,7,5,276,281
9562,2012-02-08,8,12,494,506
9563,2012-02-08,9,8,245,253
9564,2012-02-08,10,1,107,108
9565,2012-02-08,11,5,95,100
9566,2012-02-08,12,14,124,138
9567,2012-02-08,13,15,110,125
9568,2012-02-08,14,8,99,107
9569,2012-02-08,15,5,48,53
9570,2012-02-08,16,2,71,73
9571,2012-02-08,17,8,147,155
9572,2012-02-08,18,4,163,167
9573,2012-02-08,19,3,156,159
9574,2012-02-08,20,2,122,124
9575,2012-02-08,21,3,122,125
9576,2012-02-08,22,3,94,97
9577,2012-02-08,23,3,57,60
9578,2012-02-09,0,3,22,25
9579,2012-02-09,1,2,10,12
9580,2012-02-09,2,0,2,2
9581,2012-02-09,3,0,4,4
9582,2012-02-09,4,0,1,1
9583,2012-02-09,5,0,18,18
9584,2012-02-09,6,1,73,74
9585,2012-02-09,7,3,258,261
9586,2012-02-09,8,11,475,486
9587,2012-02-09,9,9,228,237
9588,2012-02-09,10,7,90,97
9589,2012-02-09,11,4,95,99
9590,2012-02-09,12,10,146,156
9591,2012-02-09,13,10,142,152
9592,2012-02-09,14,18,124,142
9593,2012-02-09,15,14,120,134
9594,2012-02-09,16,15,217,232
9595,2012-02-09,17,12,384,396
9596,2012-02-09,18,13,399,412
9597,2012-02-09,19,8,285,293
9598,2012-02-09,20,2,193,195
9599,2012-02-09,21,8,167,175
9600,2012-02-09,22,2,104,106
9601,2012-02-09,23,9,74,83
9602,2012-02-10,0,4,39,43
9603,2012-02-10,1,2,11,13
9604,2012-02-10,2,7,9,16
9605,2012-02-10,3,0,5,5
9606,2012-02-10,4,0,2,2
9607,2012-02-10,5,0,17,17
9608,2012-02-10,6,3,61,64
9609,2012-02-10,7,5,225,230
9610,2012-02-10,8,1,448,449
9611,2012-02-10,9,9,261,270
9612,2012-02-10,10,5,120,125
9613,2012-02-10,11,19,130,149
9614,2012-02-10,12,8,166,174
9615,2012-02-10,13,22,165,187
9616,2012-02-10,14,8,136,144
9617,2012-02-10,15,27,162,189
9618,2012-02-10,16,27,235,262
9619,2012-02-10,17,15,378,393
9620,2012-02-10,18,14,343,357
9621,2012-02-10,19,16,244,260
9622,2012-02-10,20,7,141,148
9623,2012-02-10,21,14,108,122
9624,2012-02-10,22,11,102,113
9625,2012-02-10,23,1,64,65
9626,2012-02-11,0,3,49,52
9627,2012-02-11,1,2,42,44
9628,2012-02-11,2,2,24,26
9629,2012-02-11,3,0,9,9
9630,2012-02-11,4,0,4,4
9631,2012-02-11,5,0,2,2
9632,2012-02-11,6,1,8,9
9633,2012-02-11,7,0,19,19
9634,2012-02-11,8,1,76,77
9635,2012-02-11,9,5,85,90
9636,2012-02-11,10,23,143,166
9637,2012-02-11,11,26,157,183
9638,2012-02-11,12,25,193,218
9639,2012-02-11,13,18,215,233
9640,2012-02-11,14,38,202,240
9641,2012-02-11,15,12,111,123
9642,2012-02-11,16,12,132,144
9643,2012-02-11,17,13,131,144
9644,2012-02-11,18,3,105,108
9645,2012-02-11,19,2,85,87
9646,2012-02-11,20,1,60,61
9647,2012-02-11,21,5,43,48
9648,2012-02-11,22,0,45,45
9649,2012-02-11,23,0,20,20
9650,2012-02-12,0,0,21,21
9651,2012-02-12,1,0,24,24
9652,2012-02-12,2,1,25,26
9653,2012-02-12,3,0,14,14
9654,2012-02-12,4,0,1,1
9655,2012-02-12,5,0,3,3
9656,2012-02-12,6,0,2,2
9657,2012-02-12,7,0,18,18
9658,2012-02-12,8,0,26,26
9659,2012-02-12,9,3,59,62
9660,2012-02-12,10,8,83,91
9661,2012-02-12,11,3,119,122
9662,2012-02-12,12,7,132,139
9663,2012-02-12,13,10,127,137
9664,2012-02-12,14,9,100,109
9665,2012-02-12,15,5,150,155
9666,2012-02-12,16,16,146,162
9667,2012-02-12,17,4,82,86
9668,2012-02-12,18,4,92,96
9669,2012-02-12,19,2,78,80
9670,2012-02-12,20,1,55,56
9671,2012-02-12,21,0,35,35
9672,2012-02-12,22,0,28,28
9673,2012-02-12,23,0,20,20
9674,2012-02-13,0,0,9,9
9675,2012-02-13,1,0,6,6
9676,2012-02-13,2,0,4,4
9677,2012-02-13,3,0,1,1
9678,2012-02-13,4,0,2,2
9679,2012-02-13,5,0,17,17
9680,2012-02-13,6,1,71,72
9681,2012-02-13,7,1,194,195
9682,2012-02-13,8,4,412,416
9683,2012-02-13,9,7,197,204
9684,2012-02-13,10,1,70,71
9685,2012-02-13,11,5,85,90
9686,2012-02-13,12,7,111,118
9687,2012-02-13,13,11,127,138
9688,2012-02-13,14,10,124,134
9689,2012-02-13,15,10,144,154
9690,2012-02-13,16,5,205,210
9691,2012-02-13,17,8,398,406
9692,2012-02-13,18,6,394,400
9693,2012-02-13,19,7,253,260
9694,2012-02-13,20,4,206,210
9695,2012-02-13,21,2,142,144
9696,2012-02-13,22,3,98,101
9697,2012-02-13,23,2,33,35
9698,2012-02-14,0,0,13,13
9699,2012-02-14,1,0,6,6
9700,2012-02-14,2,0,3,3
9701,2012-02-14,3,0,3,3
9702,2012-02-14,4,0,2,2
9703,2012-02-14,5,2,19,21
9704,2012-02-14,6,1,88,89
9705,2012-02-14,7,4,273,277
9706,2012-02-14,8,3,507,510
9707,2012-02-14,9,6,253,259
9708,2012-02-14,10,8,89,97
9709,2012-02-14,11,3,106,109
9710,2012-02-14,12,10,160,170
9711,2012-02-14,13,6,166,172
9712,2012-02-14,14,11,109,120
9713,2012-02-14,15,7,138,145
9714,2012-02-14,16,15,249,264
9715,2012-02-14,17,19,502,521
9716,2012-02-14,18,8,393,401
9717,2012-02-14,19,11,267,278
9718,2012-02-14,20,6,177,183
9719,2012-02-14,21,4,104,108
9720,2012-02-14,22,5,72,77
9721,2012-02-14,23,2,55,57
9722,2012-02-15,0,0,20,20
9723,2012-02-15,1,0,5,5
9724,2012-02-15,2,0,4,4
9725,2012-02-15,3,0,3,3
9726,2012-02-15,4,0,1,1
9727,2012-02-15,5,0,25,25
9728,2012-02-15,6,3,91,94
9729,2012-02-15,7,3,316,319
9730,2012-02-15,8,7,502,509
9731,2012-02-15,9,5,226,231
9732,2012-02-15,10,12,108,120
9733,2012-02-15,11,13,125,138
9734,2012-02-15,12,11,148,159
9735,2012-02-15,13,11,156,167
9736,2012-02-15,14,6,128,134
9737,2012-02-15,15,7,161,168
9738,2012-02-15,16,9,221,230
9739,2012-02-15,17,17,463,480
9740,2012-02-15,18,9,456,465
9741,2012-02-15,19,9,300,309
9742,2012-02-15,20,4,207,211
9743,2012-02-15,21,8,168,176
9744,2012-02-15,22,3,102,105
9745,2012-02-15,23,4,53,57
9746,2012-02-16,0,1,22,23
9747,2012-02-16,1,0,5,5
9748,2012-02-16,2,1,4,5
9749,2012-02-16,3,0,1,1
9750,2012-02-16,4,0,2,2
9751,2012-02-16,5,0,20,20
9752,2012-02-16,6,4,81,85
9753,2012-02-16,7,3,282,285
9754,2012-02-16,8,9,485,494
9755,2012-02-16,9,3,198,201
9756,2012-02-16,10,2,43,45
9757,2012-02-16,11,2,69,71
9758,2012-02-16,12,1,42,43
9759,2012-02-16,13,2,62,64
9760,2012-02-16,14,1,30,31
9761,2012-02-16,15,3,50,53
9762,2012-02-16,16,8,109,117
9763,2012-02-16,17,8,279,287
9764,2012-02-16,18,8,343,351
9765,2012-02-16,19,4,254,258
9766,2012-02-16,20,5,209,214
9767,2012-02-16,21,3,141,144
9768,2012-02-16,22,3,108,111
9769,2012-02-16,23,3,69,72
9770,2012-02-17,0,2,32,34
9771,2012-02-17,1,2,16,18
9772,2012-02-17,2,1,11,12
9773,2012-02-17,3,0,1,1
9774,2012-02-17,4,0,1,1
9775,2012-02-17,5,0,16,16
9776,2012-02-17,6,1,69,70
9777,2012-02-17,7,4,220,224
9778,2012-02-17,8,4,512,516
9779,2012-02-17,9,8,271,279
9780,2012-02-17,10,13,101,114
9781,2012-02-17,11,9,131,140
9782,2012-02-17,12,21,176,197
9783,2012-02-17,13,34,170,204
9784,2012-02-17,14,33,134,167
9785,2012-02-17,15,41,180,221
9786,2012-02-17,16,56,251,307
9787,2012-02-17,17,36,425,461
9788,2012-02-17,18,15,359,374
9789,2012-02-17,19,16,259,275
9790,2012-02-17,20,13,156,169
9791,2012-02-17,21,15,110,125
9792,2012-02-17,22,15,91,106
9793,2012-02-17,23,10,71,81
9794,2012-02-18,0,5,80,85
9795,2012-02-18,1,7,38,45
9796,2012-02-18,2,6,39,45
9797,2012-02-18,3,3,15,18
9798,2012-02-18,4,3,4,7
9799,2012-02-18,5,0,1,1
9800,2012-02-18,6,1,8,9
9801,2012-02-18,7,7,33,40
9802,2012-02-18,8,10,91,101
9803,2012-02-18,9,22,115,137
9804,2012-02-18,10,48,156,204
9805,2012-02-18,11,102,182,284
9806,2012-02-18,12,127,238,365
9807,2012-02-18,13,165,213,378
9808,2012-02-18,14,183,238,421
9809,2012-02-18,15,229,266,495
9810,2012-02-18,16,186,215,401
9811,2012-02-18,17,142,215,357
9812,2012-02-18,18,70,173,243
9813,2012-02-18,19,38,148,186
9814,2012-02-18,20,25,122,147
9815,2012-02-18,21,25,88,113
9816,2012-02-18,22,17,97,114
9817,2012-02-18,23,12,61,73
9818,2012-02-19,0,9,64,73
9819,2012-02-19,1,10,62,72
9820,2012-02-19,2,3,44,47
9821,2012-02-19,3,3,12,15
9822,2012-02-19,4,0,3,3
9823,2012-02-19,5,1,1,2
9824,2012-02-19,6,0,5,5
9825,2012-02-19,7,2,12,14
9826,2012-02-19,8,8,46,54
9827,2012-02-19,9,20,72,92
9828,2012-02-19,10,49,142,191
9829,2012-02-19,11,82,142,224
9830,2012-02-19,12,71,183,254
9831,2012-02-19,13,64,197,261
9832,2012-02-19,14,48,188,236
9833,2012-02-19,15,85,165,250
9834,2012-02-19,16,62,149,211
9835,2012-02-19,17,22,131,153
9836,2012-02-19,18,23,143,166
9837,2012-02-19,19,18,100,118
9838,2012-02-19,20,22,81,103
9839,2012-02-19,21,3,33,36
9840,2012-02-19,22,8,45,53
9841,2012-02-19,23,5,30,35
9842,2012-02-20,0,5,35,40
9843,2012-02-20,1,3,11,14
9844,2012-02-20,2,1,19,20
9845,2012-02-20,3,0,8,8
9846,2012-02-20,5,0,6,6
9847,2012-02-20,6,1,9,10
9848,2012-02-20,7,2,41,43
9849,2012-02-20,8,9,112,121
9850,2012-02-20,9,12,98,110
9851,2012-02-20,10,30,111,141
9852,2012-02-20,11,45,162,207
9853,2012-02-20,12,65,216,281
9854,2012-02-20,13,66,241,307
9855,2012-02-20,14,57,199,256
9856,2012-02-20,15,54,228,282
9857,2012-02-20,16,64,214,278
9858,2012-02-20,17,27,223,250
9859,2012-02-20,18,27,213,240
9860,2012-02-20,19,8,163,171
9861,2012-02-20,20,9,117,126
9862,2012-02-20,21,8,88,96
9863,2012-02-20,22,9,49,58
9864,2012-02-20,23,0,26,26
9865,2012-02-21,0,1,11,12
9866,2012-02-21,1,0,7,7
9867,2012-02-21,2,0,3,3
9868,2012-02-21,4,0,2,2
9869,2012-02-21,5,0,14,14
9870,2012-02-21,6,3,83,86
9871,2012-02-21,7,6,270,276
9872,2012-02-21,8,5,454,459
9873,2012-02-21,9,6,211,217
9874,2012-02-21,10,8,75,83
9875,2012-02-21,11,5,82,87
9876,2012-02-21,12,16,147,163
9877,2012-02-21,13,8,122,130
9878,2012-02-21,14,16,107,123
9879,2012-02-21,15,23,137,160
9880,2012-02-21,16,14,236,250
9881,2012-02-21,17,21,411,432
9882,2012-02-21,18,11,412,423
9883,2012-02-21,19,5,296,301
9884,2012-02-21,20,4,218,222
9885,2012-02-21,21,7,146,153
9886,2012-02-21,22,3,97,100
9887,2012-02-21,23,1,45,46
9888,2012-02-22,0,5,18,23
9889,2012-02-22,1,3,4,7
9890,2012-02-22,2,1,5,6
9891,2012-02-22,3,1,3,4
9892,2012-02-22,4,0,2,2
9893,2012-02-22,5,1,29,30
9894,2012-02-22,6,5,84,89
9895,2012-02-22,7,10,290,300
9896,2012-02-22,8,9,557,566
9897,2012-02-22,9,11,242,253
9898,2012-02-22,10,17,122,139
9899,2012-02-22,11,22,147,169
9900,2012-02-22,12,21,184,205
9901,2012-02-22,13,15,173,188
9902,2012-02-22,14,35,142,177
9903,2012-02-22,15,33,161,194
9904,2012-02-22,16,30,267,297
9905,2012-02-22,17,43,483,526
9906,2012-02-22,18,42,482,524
9907,2012-02-22,19,22,302,324
9908,2012-02-22,20,25,245,270
9909,2012-02-22,21,19,218,237
9910,2012-02-22,22,18,126,144
9911,2012-02-22,23,5,56,61
9912,2012-02-23,0,12,29,41
9913,2012-02-23,1,3,12,15
9914,2012-02-23,2,5,4,9
9915,2012-02-23,3,2,4,6
9916,2012-02-23,4,0,1,1
9917,2012-02-23,5,2,30,32
9918,2012-02-23,6,3,86,89
9919,2012-02-23,7,9,312,321
9920,2012-02-23,8,11,543,554
9921,2012-02-23,9,14,225,239
9922,2012-02-23,10,41,106,147
9923,2012-02-23,11,54,128,182
9924,2012-02-23,12,25,198,223
9925,2012-02-23,13,29,186,215
9926,2012-02-23,14,37,155,192
9927,2012-02-23,15,46,169,215
9928,2012-02-23,16,46,295,341
9929,2012-02-23,17,49,555,604
9930,2012-02-23,18,36,485,521
9931,2012-02-23,19,20,345,365
9932,2012-02-23,20,22,242,264
9933,2012-02-23,21,17,202,219
9934,2012-02-23,22,19,116,135
9935,2012-02-23,23,14,71,85
9936,2012-02-24,0,12,34,46
9937,2012-02-24,1,3,15,18
9938,2012-02-24,2,1,4,5
9939,2012-02-24,3,0,5,5
9940,2012-02-24,4,0,2,2
9941,2012-02-24,5,1,25,26
9942,2012-02-24,6,2,78,80
9943,2012-02-24,7,7,263,270
9944,2012-02-24,8,17,447,464
9945,2012-02-24,9,15,228,243
9946,2012-02-24,10,22,120,142
9947,2012-02-24,11,27,135,162
9948,2012-02-24,12,27,197,224
9949,2012-02-24,13,30,151,181
9950,2012-02-24,14,5,26,31
9951,2012-02-24,15,11,82,93
9952,2012-02-24,16,12,165,177
9953,2012-02-24,17,14,240,254
9954,2012-02-24,18,11,288,299
9955,2012-02-24,19,6,227,233
9956,2012-02-24,20,8,156,164
9957,2012-02-24,21,1,149,150
9958,2012-02-24,22,4,101,105
9959,2012-02-24,23,10,75,85
9960,2012-02-25,0,5,56,61
9961,2012-02-25,1,4,40,44
9962,2012-02-25,2,1,35,36
9963,2012-02-25,3,0,7,7
9964,2012-02-25,4,0,2,2
9965,2012-02-25,5,0,3,3
9966,2012-02-25,6,1,12,13
9967,2012-02-25,7,3,20,23
9968,2012-02-25,8,3,89,92
9969,2012-02-25,9,15,106,121
9970,2012-02-25,10,24,155,179
9971,2012-02-25,11,23,183,206
9972,2012-02-25,12,41,212,253
9973,2012-02-25,13,48,177,225
9974,2012-02-25,14,35,176,211
9975,2012-02-25,15,21,208,229
9976,2012-02-25,16,32,162,194
9977,2012-02-25,17,16,140,156
9978,2012-02-25,18,7,121,128
9979,2012-02-25,19,12,134,146
9980,2012-02-25,20,10,94,104
9981,2012-02-25,21,5,79,84
9982,2012-02-25,22,4,78,82
9983,2012-02-25,23,7,83,90
9984,2012-02-26,0,7,63,70
9985,2012-02-26,1,5,49,54
9986,2012-02-26,2,5,35,40
9987,2012-02-26,3,0,20,20
9988,2012-02-26,4,1,5,6
9989,2012-02-26,5,0,5,5
9990,2012-02-26,6,0,2,2
9991,2012-02-26,7,2,19,21
9992,2012-02-26,8,2,57,59
9993,2012-02-26,9,10,75,85
9994,2012-02-26,10,28,160,188
9995,2012-02-26,11,43,180,223
9996,2012-02-26,12,49,254,303
9997,2012-02-26,13,58,261,319
9998,2012-02-26,14,68,262,330
9999,2012-02-26,15,72,280,352
10000,2012-02-26,16,64,275,339
10001,2012-02-26,17,46,240,286
10002,2012-02-26,18,17,197,214
10003,2012-02-26,19,13,127,140
10004,2012-02-26,20,9,76,85
10005,2012-02-26,21,8,75,83
10006,2012-02-26,22,3,67,70
10007,2012-02-26,23,5,59,64
10008,2012-02-27,0,2,27,29
10009,2012-02-27,1,0,6,6
10010,2012-02-27,2,0,4,4
10011,2012-02-27,3,0,2,2
10012,2012-02-27,4,0,1,1
10013,2012-02-27,5,0,16,16
10014,2012-02-27,6,1,88,89
10015,2012-02-27,7,2,274,276
10016,2012-02-27,8,14,512,526
10017,2012-02-27,9,11,214,225
10018,2012-02-27,10,16,88,104
10019,2012-02-27,11,11,91,102
10020,2012-02-27,12,13,162,175
10021,2012-02-27,13,23,159,182
10022,2012-02-27,14,24,129,153
10023,2012-02-27,15,24,149,173
10024,2012-02-27,16,20,263,283
10025,2012-02-27,17,26,499,525
10026,2012-02-27,18,10,515,525
10027,2012-02-27,19,16,317,333
10028,2012-02-27,20,11,207,218
10029,2012-02-27,21,14,179,193
10030,2012-02-27,22,9,81,90
10031,2012-02-27,23,6,50,56
10032,2012-02-28,0,0,10,10
10033,2012-02-28,1,0,6,6
10034,2012-02-28,2,1,2,3
10035,2012-02-28,3,0,6,6
10036,2012-02-28,4,0,2,2
10037,2012-02-28,5,1,19,20
10038,2012-02-28,6,1,99,100
10039,2012-02-28,7,12,309,321
10040,2012-02-28,8,16,541,557
10041,2012-02-28,9,7,227,234
10042,2012-02-28,10,14,118,132
10043,2012-02-28,11,8,154,162
10044,2012-02-28,12,19,163,182
10045,2012-02-28,13,16,171,187
10046,2012-02-28,14,13,120,133
10047,2012-02-28,15,17,148,165
10048,2012-02-28,16,17,269,286
10049,2012-02-28,17,33,496,529
10050,2012-02-28,18,17,428,445
10051,2012-02-28,19,15,287,302
10052,2012-02-28,20,2,200,202
10053,2012-02-28,21,10,176,186
10054,2012-02-28,22,6,93,99
10055,2012-02-28,23,4,60,64
10056,2012-02-29,0,2,30,32
10057,2012-02-29,1,0,6,6
10058,2012-02-29,2,0,4,4
10059,2012-02-29,3,0,2,2
10060,2012-02-29,5,0,27,27
10061,2012-02-29,6,4,99,103
10062,2012-02-29,7,11,237,248
10063,2012-02-29,8,2,115,117
10064,2012-02-29,9,5,34,39
10065,2012-02-29,10,0,10,10
10066,2012-02-29,11,1,9,10
10067,2012-02-29,12,1,68,69
10068,2012-02-29,13,4,72,76
10069,2012-02-29,14,2,54,56
10070,2012-02-29,15,3,85,88
10071,2012-02-29,16,5,159,164
10072,2012-02-29,17,7,246,253
10073,2012-02-29,18,11,176,187
10074,2012-02-29,19,0,101,101
10075,2012-02-29,20,2,94,96
10076,2012-02-29,21,0,39,39
10077,2012-02-29,22,2,53,55
10078,2012-02-29,23,3,30,33
10079,2012-03-01,0,1,10,11
10080,2012-03-01,1,0,12,12
10081,2012-03-01,2,0,6,6
10082,2012-03-01,3,0,3,3
10083,2012-03-01,4,0,5,5
10084,2012-03-01,5,0,18,18
10085,2012-03-01,6,2,106,108
10086,2012-03-01,7,8,296,304
10087,2012-03-01,8,15,573,588
10088,2012-03-01,9,5,273,278
10089,2012-03-01,10,11,123,134
10090,2012-03-01,11,19,148,167
10091,2012-03-01,12,16,202,218
10092,2012-03-01,13,23,183,206
10093,2012-03-01,14,37,172,209
10094,2012-03-01,15,31,186,217
10095,2012-03-01,16,38,319,357
10096,2012-03-01,17,49,547,596
10097,2012-03-01,18,27,496,523
10098,2012-03-01,19,11,316,327
10099,2012-03-01,20,12,235,247
10100,2012-03-01,21,7,186,193
10101,2012-03-01,22,3,120,123
10102,2012-03-01,23,9,76,85
10103,2012-03-02,0,1,43,44
10104,2012-03-02,1,2,18,20
10105,2012-03-02,2,2,4,6
10106,2012-03-02,3,0,3,3
10107,2012-03-02,4,0,2,2
10108,2012-03-02,5,0,24,24
10109,2012-03-02,6,4,87,91
10110,2012-03-02,7,4,257,261
10111,2012-03-02,8,16,527,543
10112,2012-03-02,9,15,292,307
10113,2012-03-02,10,13,116,129
10114,2012-03-02,11,40,151,191
10115,2012-03-02,12,40,193,233
10116,2012-03-02,13,31,188,219
10117,2012-03-02,14,29,174,203
10118,2012-03-02,15,5,71,76
10119,2012-03-02,16,1,48,49
10120,2012-03-02,17,5,122,127
10121,2012-03-02,18,6,152,158
10122,2012-03-02,19,12,159,171
10123,2012-03-02,20,7,92,99
10124,2012-03-02,21,2,97,99
10125,2012-03-02,22,6,69,75
10126,2012-03-02,23,4,19,23
10127,2012-03-03,0,1,21,22
10128,2012-03-03,1,0,44,44
10129,2012-03-03,2,4,34,38
10130,2012-03-03,3,1,19,20
10131,2012-03-03,4,0,2,2
10132,2012-03-03,5,1,0,1
10133,2012-03-03,6,1,6,7
10134,2012-03-03,7,2,14,16
10135,2012-03-03,8,2,46,48
10136,2012-03-03,9,7,86,93
10137,2012-03-03,10,31,132,163
10138,2012-03-03,11,33,176,209
10139,2012-03-03,12,47,249,296
10140,2012-03-03,13,87,251,338
10141,2012-03-03,14,151,277,428
10142,2012-03-03,15,145,246,391
10143,2012-03-03,16,166,297,463
10144,2012-03-03,17,106,274,380
10145,2012-03-03,18,53,248,301
10146,2012-03-03,19,34,188,222
10147,2012-03-03,20,28,117,145
10148,2012-03-03,21,24,128,152
10149,2012-03-03,22,19,115,134
10150,2012-03-03,23,12,94,106
10151,2012-03-04,0,5,66,71
10152,2012-03-04,1,16,59,75
10153,2012-03-04,2,14,66,80
10154,2012-03-04,3,5,21,26
10155,2012-03-04,4,3,11,14
10156,2012-03-04,5,0,5,5
10157,2012-03-04,6,0,5,5
10158,2012-03-04,7,2,21,23
10159,2012-03-04,8,12,53,65
10160,2012-03-04,9,14,101,115
10161,2012-03-04,10,31,157,188
10162,2012-03-04,11,64,189,253
10163,2012-03-04,12,71,254,325
10164,2012-03-04,13,108,249,357
10165,2012-03-04,14,106,224,330
10166,2012-03-04,15,82,247,329
10167,2012-03-04,16,68,226,294
10168,2012-03-04,17,49,209,258
10169,2012-03-04,18,20,164,184
10170,2012-03-04,19,12,117,129
10171,2012-03-04,20,8,79,87
10172,2012-03-04,21,9,68,77
10173,2012-03-04,22,9,53,62
10174,2012-03-04,23,2,24,26
10175,2012-03-05,0,2,15,17
10176,2012-03-05,1,3,3,6
10177,2012-03-05,2,1,3,4
10178,2012-03-05,3,0,1,1
10179,2012-03-05,4,0,1,1
10180,2012-03-05,5,1,17,18
10181,2012-03-05,6,2,89,91
10182,2012-03-05,7,7,249,256
10183,2012-03-05,8,13,414,427
10184,2012-03-05,9,11,182,193
10185,2012-03-05,10,12,74,86
10186,2012-03-05,11,17,86,103
10187,2012-03-05,12,15,121,136
10188,2012-03-05,13,11,108,119
10189,2012-03-05,14,13,113,126
10190,2012-03-05,15,20,110,130
10191,2012-03-05,16,30,180,210
10192,2012-03-05,17,11,373,384
10193,2012-03-05,18,12,360,372
10194,2012-03-05,19,6,221,227
10195,2012-03-05,20,8,168,176
10196,2012-03-05,21,4,112,116
10197,2012-03-05,22,2,76,78
10198,2012-03-05,23,2,29,31
10199,2012-03-06,0,0,6,6
10200,2012-03-06,1,0,6,6
10201,2012-03-06,2,0,4,4
10202,2012-03-06,3,0,1,1
10203,2012-03-06,4,0,3,3
10204,2012-03-06,5,0,25,25
10205,2012-03-06,6,3,99,102
10206,2012-03-06,7,5,268,273
10207,2012-03-06,8,14,482,496
10208,2012-03-06,9,11,221,232
10209,2012-03-06,10,16,113,129
10210,2012-03-06,11,20,110,130
10211,2012-03-06,12,9,129,138
10212,2012-03-06,13,16,148,164
10213,2012-03-06,14,20,115,135
10214,2012-03-06,15,24,141,165
10215,2012-03-06,16,22,224,246
10216,2012-03-06,17,21,421,442
10217,2012-03-06,18,14,437,451
10218,2012-03-06,19,9,277,286
10219,2012-03-06,20,3,183,186
10220,2012-03-06,21,5,141,146
10221,2012-03-06,22,5,100,105
10222,2012-03-06,23,3,51,54
10223,2012-03-07,0,3,12,15
10224,2012-03-07,1,1,4,5
10225,2012-03-07,2,0,4,4
10226,2012-03-07,3,1,2,3
10227,2012-03-07,4,0,3,3
10228,2012-03-07,5,0,18,18
10229,2012-03-07,6,4,103,107
10230,2012-03-07,7,12,331,343
10231,2012-03-07,8,12,551,563
10232,2012-03-07,9,12,249,261
10233,2012-03-07,10,20,125,145
10234,2012-03-07,11,33,124,157
10235,2012-03-07,12,40,175,215
10236,2012-03-07,13,26,174,200
10237,2012-03-07,14,38,135,173
10238,2012-03-07,15,44,164,208
10239,2012-03-07,16,34,254,288
10240,2012-03-07,17,58,552,610
10241,2012-03-07,18,35,504,539
10242,2012-03-07,19,16,342,358
10243,2012-03-07,20,18,237,255
10244,2012-03-07,21,11,174,185
10245,2012-03-07,22,10,147,157
10246,2012-03-07,23,4,58,62
10247,2012-03-08,0,11,35,46
10248,2012-03-08,1,4,17,21
10249,2012-03-08,2,6,5,11
10250,2012-03-08,3,0,3,3
10251,2012-03-08,4,0,2,2
10252,2012-03-08,5,1,26,27
10253,2012-03-08,6,4,102,106
10254,2012-03-08,7,8,322,330
10255,2012-03-08,8,12,567,579
10256,2012-03-08,9,19,278,297
10257,2012-03-08,10,19,119,138
10258,2012-03-08,11,48,156,204
10259,2012-03-08,12,27,223,250
10260,2012-03-08,13,35,196,231
10261,2012-03-08,14,48,155,203
10262,2012-03-08,15,24,160,184
10263,2012-03-08,16,37,304,341
10264,2012-03-08,17,51,537,588
10265,2012-03-08,18,45,541,586
10266,2012-03-08,19,21,387,408
10267,2012-03-08,20,20,274,294
10268,2012-03-08,21,27,206,233
10269,2012-03-08,22,12,138,150
10270,2012-03-08,23,6,86,92
10271,2012-03-09,0,3,51,54
10272,2012-03-09,1,4,22,26
10273,2012-03-09,2,2,9,11
10274,2012-03-09,3,0,6,6
10275,2012-03-09,4,0,1,1
10276,2012-03-09,5,2,26,28
10277,2012-03-09,6,2,83,85
10278,2012-03-09,7,6,259,265
10279,2012-03-09,8,17,482,499
10280,2012-03-09,9,17,266,283
10281,2012-03-09,10,14,145,159
10282,2012-03-09,11,17,169,186
10283,2012-03-09,12,27,173,200
10284,2012-03-09,13,49,174,223
10285,2012-03-09,14,49,129,178
10286,2012-03-09,15,50,186,236
10287,2012-03-09,16,51,287,338
10288,2012-03-09,17,68,493,561
10289,2012-03-09,18,30,435,465
10290,2012-03-09,19,12,226,238
10291,2012-03-09,20,3,152,155
10292,2012-03-09,21,8,131,139
10293,2012-03-09,22,7,96,103
10294,2012-03-09,23,9,76,85
10295,2012-03-10,0,9,66,75
10296,2012-03-10,1,1,50,51
10297,2012-03-10,2,12,30,42
10298,2012-03-10,3,0,16,16
10299,2012-03-10,4,1,3,4
10300,2012-03-10,5,3,7,10
10301,2012-03-10,6,1,11,12
10302,2012-03-10,7,4,36,40
10303,2012-03-10,8,15,95,110
10304,2012-03-10,9,21,126,147
10305,2012-03-10,10,47,174,221
10306,2012-03-10,11,56,218,274
10307,2012-03-10,12,88,237,325
10308,2012-03-10,13,89,263,352
10309,2012-03-10,14,117,258,375
10310,2012-03-10,15,132,272,404
10311,2012-03-10,16,115,270,385
10312,2012-03-10,17,104,244,348
10313,2012-03-10,18,67,227,294
10314,2012-03-10,19,25,154,179
10315,2012-03-10,20,20,99,119
10316,2012-03-10,21,16,93,109
10317,2012-03-10,22,19,80,99
10318,2012-03-10,23,6,75,81
10319,2012-03-11,0,7,62,69
10320,2012-03-11,1,4,56,60
10321,2012-03-11,3,15,51,66
10322,2012-03-11,4,7,15,22
10323,2012-03-11,5,2,4,6
10324,2012-03-11,6,2,8,10
10325,2012-03-11,7,2,15,17
10326,2012-03-11,8,4,66,70
10327,2012-03-11,9,20,70,90
10328,2012-03-11,10,71,147,218
10329,2012-03-11,11,90,209,299
10330,2012-03-11,12,146,257,403
10331,2012-03-11,13,176,285,461
10332,2012-03-11,14,212,287,499
10333,2012-03-11,15,201,280,481
10334,2012-03-11,16,208,297,505
10335,2012-03-11,17,199,292,491
10336,2012-03-11,18,133,253,386
10337,2012-03-11,19,55,198,253
10338,2012-03-11,20,42,126,168
10339,2012-03-11,21,37,109,146
10340,2012-03-11,22,13,80,93
10341,2012-03-11,23,12,39,51
10342,2012-03-12,0,4,18,22
10343,2012-03-12,1,1,9,10
10344,2012-03-12,2,4,5,9
10345,2012-03-12,3,0,2,2
10346,2012-03-12,4,0,2,2
10347,2012-03-12,5,1,15,16
10348,2012-03-12,6,2,84,86
10349,2012-03-12,7,9,255,264
10350,2012-03-12,8,17,543,560
10351,2012-03-12,9,21,256,277
10352,2012-03-12,10,39,96,135
10353,2012-03-12,11,39,111,150
10354,2012-03-12,12,59,157,216
10355,2012-03-12,13,74,175,249
10356,2012-03-12,14,76,145,221
10357,2012-03-12,15,74,158,232
10358,2012-03-12,16,77,253,330
10359,2012-03-12,17,87,551,638
10360,2012-03-12,18,89,617,706
10361,2012-03-12,19,67,376,443
10362,2012-03-12,20,49,236,285
10363,2012-03-12,21,22,180,202
10364,2012-03-12,22,17,115,132
10365,2012-03-12,23,10,53,63
10366,2012-03-13,0,5,21,26
10367,2012-03-13,1,2,12,14
10368,2012-03-13,2,0,1,1
10369,2012-03-13,3,0,2,2
10370,2012-03-13,5,0,24,24
10371,2012-03-13,6,5,103,108
10372,2012-03-13,7,16,288,304
10373,2012-03-13,8,22,565,587
10374,2012-03-13,9,18,322,340
10375,2012-03-13,10,28,113,141
10376,2012-03-13,11,64,154,218
10377,2012-03-13,12,47,194,241
10378,2012-03-13,13,53,179,232
10379,2012-03-13,14,52,158,210
10380,2012-03-13,15,68,196,264
10381,2012-03-13,16,53,309,362
10382,2012-03-13,17,62,607,669
10383,2012-03-13,18,95,635,730
10384,2012-03-13,19,51,420,471
10385,2012-03-13,20,45,304,349
10386,2012-03-13,21,44,199,243
10387,2012-03-13,22,24,143,167
10388,2012-03-13,23,8,77,85
10389,2012-03-14,0,5,33,38
10390,2012-03-14,1,2,23,25
10391,2012-03-14,2,0,2,2
10392,2012-03-14,3,1,3,4
10393,2012-03-14,4,1,4,5
10394,2012-03-14,5,2,25,27
10395,2012-03-14,6,1,119,120
10396,2012-03-14,7,20,346,366
10397,2012-03-14,8,34,622,656
10398,2012-03-14,9,26,324,350
10399,2012-03-14,10,38,146,184
10400,2012-03-14,11,65,149,214
10401,2012-03-14,12,55,211,266
10402,2012-03-14,13,57,196,253
10403,2012-03-14,14,61,158,219
10404,2012-03-14,15,86,192,278
10405,2012-03-14,16,78,277,355
10406,2012-03-14,17,141,639,780
10407,2012-03-14,18,102,639,741
10408,2012-03-14,19,70,400,470
10409,2012-03-14,20,43,278,321
10410,2012-03-14,21,48,240,288
10411,2012-03-14,22,43,155,198
10412,2012-03-14,23,19,71,90
10413,2012-03-15,0,14,46,60
10414,2012-03-15,1,15,8,23
10415,2012-03-15,2,14,5,19
10416,2012-03-15,3,0,7,7
10417,2012-03-15,4,11,3,14
10418,2012-03-15,5,2,23,25
10419,2012-03-15,6,4,112,116
10420,2012-03-15,7,14,362,376
10421,2012-03-15,8,21,600,621
10422,2012-03-15,9,30,280,310
10423,2012-03-15,10,34,130,164
10424,2012-03-15,11,60,150,210
10425,2012-03-15,12,59,203,262
10426,2012-03-15,13,62,209,271
10427,2012-03-15,14,81,175,256
10428,2012-03-15,15,100,184,284
10429,2012-03-15,16,94,328,422
10430,2012-03-15,17,80,625,705
10431,2012-03-15,18,98,637,735
10432,2012-03-15,19,72,350,422
10433,2012-03-15,20,60,266,326
10434,2012-03-15,21,36,202,238
10435,2012-03-15,22,32,136,168
10436,2012-03-15,23,12,83,95
10437,2012-03-16,0,8,49,57
10438,2012-03-16,1,4,22,26
10439,2012-03-16,2,0,4,4
10440,2012-03-16,3,0,3,3
10441,2012-03-16,4,0,2,2
10442,2012-03-16,5,2,30,32
10443,2012-03-16,6,3,96,99
10444,2012-03-16,7,13,262,275
10445,2012-03-16,8,28,527,555
10446,2012-03-16,9,35,273,308
10447,2012-03-16,10,44,130,174
10448,2012-03-16,11,40,166,206
10449,2012-03-16,12,72,221,293
10450,2012-03-16,13,52,206,258
10451,2012-03-16,14,56,143,199
10452,2012-03-16,15,19,87,106
10453,2012-03-16,16,18,110,128
10454,2012-03-16,17,23,229,252
10455,2012-03-16,18,31,375,406
10456,2012-03-16,19,23,271,294
10457,2012-03-16,20,31,202,233
10458,2012-03-16,21,8,142,150
10459,2012-03-16,22,16,129,145
10460,2012-03-16,23,22,102,124
10461,2012-03-17,0,13,86,99
10462,2012-03-17,1,12,56,68
10463,2012-03-17,2,10,32,42
10464,2012-03-17,3,2,23,25
10465,2012-03-17,4,0,1,1
10466,2012-03-17,5,5,3,8
10467,2012-03-17,6,1,28,29
10468,2012-03-17,7,29,57,86
10469,2012-03-17,8,63,153,216
10470,2012-03-17,9,104,214,318
10471,2012-03-17,10,140,298,438
10472,2012-03-17,11,226,354,580
10473,2012-03-17,12,286,362,648
10474,2012-03-17,13,286,394,680
10475,2012-03-17,14,351,328,679
10476,2012-03-17,15,357,318,675
10477,2012-03-17,16,367,313,680
10478,2012-03-17,17,291,351,642
10479,2012-03-17,18,221,334,555
10480,2012-03-17,19,155,253,408
10481,2012-03-17,20,89,178,267
10482,2012-03-17,21,54,166,220
10483,2012-03-17,22,58,150,208
10484,2012-03-17,23,34,148,182
10485,2012-03-18,0,27,76,103
10486,2012-03-18,1,25,83,108
10487,2012-03-18,2,15,40,55
10488,2012-03-18,3,3,15,18
10489,2012-03-18,4,6,8,14
10490,2012-03-18,5,0,4,4
10491,2012-03-18,6,2,8,10
10492,2012-03-18,7,17,25,42
10493,2012-03-18,8,25,70,95
10494,2012-03-18,9,64,111,175
10495,2012-03-18,10,140,210,350
10496,2012-03-18,11,129,237,366
10497,2012-03-18,12,222,277,499
10498,2012-03-18,13,198,341,539
10499,2012-03-18,14,218,299,517
10500,2012-03-18,15,239,311,550
10501,2012-03-18,16,229,307,536
10502,2012-03-18,17,231,306,537
10503,2012-03-18,18,165,289,454
10504,2012-03-18,19,118,228,346
10505,2012-03-18,20,59,139,198
10506,2012-03-18,21,44,127,171
10507,2012-03-18,22,21,78,99
10508,2012-03-18,23,7,37,44
10509,2012-03-19,0,4,18,22
10510,2012-03-19,1,0,14,14
10511,2012-03-19,2,1,7,8
10512,2012-03-19,3,0,2,2
10513,2012-03-19,4,0,3,3
10514,2012-03-19,5,0,30,30
10515,2012-03-19,6,2,117,119
10516,2012-03-19,7,25,326,351
10517,2012-03-19,8,16,556,572
10518,2012-03-19,9,55,274,329
10519,2012-03-19,10,56,126,182
10520,2012-03-19,11,55,142,197
10521,2012-03-19,12,72,209,281
10522,2012-03-19,13,69,193,262
10523,2012-03-19,14,60,197,257
10524,2012-03-19,15,97,188,285
10525,2012-03-19,16,65,318,383
10526,2012-03-19,17,106,610,716
10527,2012-03-19,18,120,677,797
10528,2012-03-19,19,86,457,543
10529,2012-03-19,20,34,294,328
10530,2012-03-19,21,33,187,220
10531,2012-03-19,22,17,128,145
10532,2012-03-19,23,9,45,54
10533,2012-03-20,0,5,24,29
10534,2012-03-20,1,6,9,15
10535,2012-03-20,2,2,8,10
10536,2012-03-20,3,0,3,3
10537,2012-03-20,4,0,6,6
10538,2012-03-20,5,0,20,20
10539,2012-03-20,6,6,94,100
10540,2012-03-20,7,3,166,169
10541,2012-03-20,8,28,484,512
10542,2012-03-20,9,41,280,321
10543,2012-03-20,10,44,120,164
10544,2012-03-20,11,74,155,229
10545,2012-03-20,12,56,204,260
10546,2012-03-20,13,77,205,282
10547,2012-03-20,14,66,181,247
10548,2012-03-20,15,67,176,243
10549,2012-03-20,16,99,330,429
10550,2012-03-20,17,108,636,744
10551,2012-03-20,18,136,656,792
10552,2012-03-20,19,75,470,545
10553,2012-03-20,20,78,296,374
10554,2012-03-20,21,38,233,271
10555,2012-03-20,22,32,154,186
10556,2012-03-20,23,10,79,89
10557,2012-03-21,0,4,28,32
10558,2012-03-21,1,4,22,26
10559,2012-03-21,2,2,8,10
10560,2012-03-21,3,1,7,8
10561,2012-03-21,4,0,3,3
10562,2012-03-21,5,4,35,39
10563,2012-03-21,6,10,139,149
10564,2012-03-21,7,34,335,369
10565,2012-03-21,8,33,501,534
10566,2012-03-21,9,38,251,289
10567,2012-03-21,10,30,124,154
10568,2012-03-21,11,38,150,188
10569,2012-03-21,12,58,170,228
10570,2012-03-21,13,81,220,301
10571,2012-03-21,14,74,149,223
10572,2012-03-21,15,67,175,242
10573,2012-03-21,16,91,285,376
10574,2012-03-21,17,113,606,719
10575,2012-03-21,18,152,618,770
10576,2012-03-21,19,85,488,573
10577,2012-03-21,20,76,292,368
10578,2012-03-21,21,47,202,249
10579,2012-03-21,22,41,154,195
10580,2012-03-21,23,37,87,124
10581,2012-03-22,0,9,31,40
10582,2012-03-22,1,14,15,29
10583,2012-03-22,2,1,5,6
10584,2012-03-22,3,0,7,7
10585,2012-03-22,4,0,5,5
10586,2012-03-22,5,2,32,34
10587,2012-03-22,6,10,125,135
10588,2012-03-22,7,29,329,358
10589,2012-03-22,8,51,590,641
10590,2012-03-22,9,41,271,312
10591,2012-03-22,10,32,109,141
10592,2012-03-22,11,53,164,217
10593,2012-03-22,12,48,223,271
10594,2012-03-22,13,83,212,295
10595,2012-03-22,14,95,160,255
10596,2012-03-22,15,103,201,304
10597,2012-03-22,16,125,299,424
10598,2012-03-22,17,154,650,804
10599,2012-03-22,18,147,646,793
10600,2012-03-22,19,117,466,583
10601,2012-03-22,20,64,355,419
10602,2012-03-22,21,66,305,371
10603,2012-03-22,22,56,162,218
10604,2012-03-22,23,34,115,149
10605,2012-03-23,0,29,65,94
10606,2012-03-23,1,19,32,51
10607,2012-03-23,2,12,20,32
10608,2012-03-23,3,4,6,10
10609,2012-03-23,4,0,3,3
10610,2012-03-23,5,5,29,34
10611,2012-03-23,6,6,110,116
10612,2012-03-23,7,27,316,343
10613,2012-03-23,8,47,602,649
10614,2012-03-23,9,75,297,372
10615,2012-03-23,10,125,149,274
10616,2012-03-23,11,131,181,312
10617,2012-03-23,12,200,272,472
10618,2012-03-23,13,172,254,426
10619,2012-03-23,14,208,219,427
10620,2012-03-23,15,191,280,471
10621,2012-03-23,16,219,364,583
10622,2012-03-23,17,263,683,946
10623,2012-03-23,18,237,576,813
10624,2012-03-23,19,213,466,679
10625,2012-03-23,20,117,321,438
10626,2012-03-23,21,64,214,278
10627,2012-03-23,22,53,215,268
10628,2012-03-23,23,51,122,173
10629,2012-03-24,0,45,108,153
10630,2012-03-24,1,20,107,127
10631,2012-03-24,2,14,53,67
10632,2012-03-24,3,10,22,32
10633,2012-03-24,4,1,6,7
10634,2012-03-24,5,0,4,4
10635,2012-03-24,6,4,23,27
10636,2012-03-24,7,25,45,70
10637,2012-03-24,8,41,112,153
10638,2012-03-24,9,96,151,247
10639,2012-03-24,10,148,194,342
10640,2012-03-24,11,98,175,273
10641,2012-03-24,12,61,118,179
10642,2012-03-24,13,62,134,196
10643,2012-03-24,14,63,159,222
10644,2012-03-24,15,118,171,289
10645,2012-03-24,16,49,125,174
10646,2012-03-24,17,47,67,114
10647,2012-03-24,18,27,106,133
10648,2012-03-24,19,28,105,133
10649,2012-03-24,20,31,77,108
10650,2012-03-24,21,16,86,102
10651,2012-03-24,22,12,69,81
10652,2012-03-24,23,17,87,104
10653,2012-03-25,0,18,62,80
10654,2012-03-25,1,24,65,89
10655,2012-03-25,2,6,29,35
10656,2012-03-25,3,8,10,18
10657,2012-03-25,4,1,7,8
10658,2012-03-25,5,0,6,6
10659,2012-03-25,6,5,13,18
10660,2012-03-25,7,14,25,39
10661,2012-03-25,8,21,66,87
10662,2012-03-25,9,26,90,116
10663,2012-03-25,10,78,170,248
10664,2012-03-25,11,106,212,318
10665,2012-03-25,12,122,234,356
10666,2012-03-25,13,110,254,364
10667,2012-03-25,14,123,283,406
10668,2012-03-25,15,139,278,417
10669,2012-03-25,16,153,336,489
10670,2012-03-25,17,146,267,413
10671,2012-03-25,18,202,284,486
10672,2012-03-25,19,114,252,366
10673,2012-03-25,20,63,195,258
10674,2012-03-25,21,25,121,146
10675,2012-03-25,22,19,90,109
10676,2012-03-25,23,9,56,65
10677,2012-03-26,0,10,23,33
10678,2012-03-26,1,18,10,28
10679,2012-03-26,2,14,6,20
10680,2012-03-26,3,0,1,1
10681,2012-03-26,4,0,4,4
10682,2012-03-26,5,0,36,36
10683,2012-03-26,6,7,109,116
10684,2012-03-26,7,15,351,366
10685,2012-03-26,8,32,614,646
10686,2012-03-26,9,37,240,277
10687,2012-03-26,10,55,95,150
10688,2012-03-26,11,47,129,176
10689,2012-03-26,12,63,215,278
10690,2012-03-26,13,82,221,303
10691,2012-03-26,14,58,158,216
10692,2012-03-26,15,66,156,222
10693,2012-03-26,16,60,239,299
10694,2012-03-26,17,65,597,662
10695,2012-03-26,18,90,589,679
10696,2012-03-26,19,41,412,453
10697,2012-03-26,20,12,208,220
10698,2012-03-26,21,11,175,186
10699,2012-03-26,22,13,80,93
10700,2012-03-26,23,2,45,47
10701,2012-03-27,0,1,7,8
10702,2012-03-27,1,1,4,5
10703,2012-03-27,2,1,6,7
10704,2012-03-27,3,0,3,3
10705,2012-03-27,4,0,3,3
10706,2012-03-27,5,1,16,17
10707,2012-03-27,6,5,96,101
10708,2012-03-27,7,9,276,285
10709,2012-03-27,8,14,564,578
10710,2012-03-27,9,8,256,264
10711,2012-03-27,10,20,118,138
10712,2012-03-27,11,34,137,171
10713,2012-03-27,12,34,186,220
10714,2012-03-27,13,46,162,208
10715,2012-03-27,14,37,143,180
10716,2012-03-27,15,42,154,196
10717,2012-03-27,16,38,263,301
10718,2012-03-27,17,72,535,607
10719,2012-03-27,18,67,574,641
10720,2012-03-27,19,40,373,413
10721,2012-03-27,20,28,262,290
10722,2012-03-27,21,21,196,217
10723,2012-03-27,22,7,124,131
10724,2012-03-27,23,5,58,63
10725,2012-03-28,0,1,28,29
10726,2012-03-28,1,0,8,8
10727,2012-03-28,2,0,3,3
10728,2012-03-28,3,1,4,5
10729,2012-03-28,4,1,0,1
10730,2012-03-28,5,2,38,40
10731,2012-03-28,6,4,110,114
10732,2012-03-28,7,10,347,357
10733,2012-03-28,8,19,630,649
10734,2012-03-28,9,16,293,309
10735,2012-03-28,10,33,137,170
10736,2012-03-28,11,54,166,220
10737,2012-03-28,12,50,214,264
10738,2012-03-28,13,60,211,271
10739,2012-03-28,14,52,168,220
10740,2012-03-28,15,47,149,196
10741,2012-03-28,16,51,169,220
10742,2012-03-28,17,72,530,602
10743,2012-03-28,18,61,578,639
10744,2012-03-28,19,40,404,444
10745,2012-03-28,20,39,318,357
10746,2012-03-28,21,28,231,259
10747,2012-03-28,22,21,148,169
10748,2012-03-28,23,12,81,93
10749,2012-03-29,0,10,36,46
10750,2012-03-29,1,15,18,33
10751,2012-03-29,2,0,6,6
10752,2012-03-29,3,1,4,5
10753,2012-03-29,4,1,8,9
10754,2012-03-29,5,2,29,31
10755,2012-03-29,6,3,113,116
10756,2012-03-29,7,14,349,363
10757,2012-03-29,8,26,618,644
10758,2012-03-29,9,22,291,313
10759,2012-03-29,10,42,124,166
10760,2012-03-29,11,54,164,218
10761,2012-03-29,12,63,225,288
10762,2012-03-29,13,51,219,270
10763,2012-03-29,14,63,172,235
10764,2012-03-29,15,109,193,302
10765,2012-03-29,16,67,317,384
10766,2012-03-29,17,83,614,697
10767,2012-03-29,18,83,593,676
10768,2012-03-29,19,47,415,462
10769,2012-03-29,20,34,293,327
10770,2012-03-29,21,10,212,222
10771,2012-03-29,22,17,132,149
10772,2012-03-29,23,17,75,92
10773,2012-03-30,0,10,48,58
10774,2012-03-30,1,6,20,26
10775,2012-03-30,2,1,6,7
10776,2012-03-30,3,0,7,7
10777,2012-03-30,4,1,1,2
10778,2012-03-30,5,0,26,26
10779,2012-03-30,6,5,80,85
10780,2012-03-30,7,9,279,288
10781,2012-03-30,8,38,548,586
10782,2012-03-30,9,29,292,321
10783,2012-03-30,10,50,137,187
10784,2012-03-30,11,48,152,200
10785,2012-03-30,12,59,205,264
10786,2012-03-30,13,42,198,240
10787,2012-03-30,14,56,169,225
10788,2012-03-30,15,73,207,280
10789,2012-03-30,16,75,291,366
10790,2012-03-30,17,93,509,602
10791,2012-03-30,18,68,489,557
10792,2012-03-30,19,42,348,390
10793,2012-03-30,20,17,188,205
10794,2012-03-30,21,29,189,218
10795,2012-03-30,22,23,127,150
10796,2012-03-30,23,16,104,120
10797,2012-03-31,0,12,79,91
10798,2012-03-31,1,17,64,81
10799,2012-03-31,2,14,54,68
10800,2012-03-31,3,10,21,31
10801,2012-03-31,4,4,4,8
10802,2012-03-31,5,0,5,5
10803,2012-03-31,6,7,16,23
10804,2012-03-31,7,5,37,42
10805,2012-03-31,8,19,126,145
10806,2012-03-31,9,62,159,221
10807,2012-03-31,10,108,202,310
10808,2012-03-31,11,184,278,462
10809,2012-03-31,12,263,349,612
10810,2012-03-31,13,264,367,631
10811,2012-03-31,14,241,304,545
10812,2012-03-31,15,274,325,599
10813,2012-03-31,16,243,285,528
10814,2012-03-31,17,238,300,538
10815,2012-03-31,18,101,237,338
10816,2012-03-31,19,93,190,283
10817,2012-03-31,20,52,152,204
10818,2012-03-31,21,36,106,142
10819,2012-03-31,22,40,113,153
10820,2012-03-31,23,12,100,112
10821,2012-04-01,0,8,59,67
10822,2012-04-01,1,13,49,62
10823,2012-04-01,2,20,60,80
10824,2012-04-01,3,4,21,25
10825,2012-04-01,4,3,9,12
10826,2012-04-01,5,8,10,18
10827,2012-04-01,6,9,87,96
10828,2012-04-01,7,29,54,83
10829,2012-04-01,8,37,86,123
10830,2012-04-01,9,102,170,272
10831,2012-04-01,10,132,223,355
10832,2012-04-01,11,180,267,447
10833,2012-04-01,12,187,254,441
10834,2012-04-01,13,190,272,462
10835,2012-04-01,14,282,273,555
10836,2012-04-01,15,295,274,569
10837,2012-04-01,16,236,271,507
10838,2012-04-01,17,232,318,550
10839,2012-04-01,18,153,274,427
10840,2012-04-01,19,110,227,337
10841,2012-04-01,20,65,162,227
10842,2012-04-01,21,34,98,132
10843,2012-04-01,22,7,60,67
10844,2012-04-01,23,10,53,63
10845,2012-04-02,0,6,11,17
10846,2012-04-02,1,0,5,5
10847,2012-04-02,2,2,3,5
10848,2012-04-02,4,2,2,4
10849,2012-04-02,5,2,22,24
10850,2012-04-02,6,6,103,109
10851,2012-04-02,7,11,290,301
10852,2012-04-02,8,37,541,578
10853,2012-04-02,9,52,262,314
10854,2012-04-02,10,85,117,202
10855,2012-04-02,11,81,127,208
10856,2012-04-02,12,100,179,279
10857,2012-04-02,13,97,182,279
10858,2012-04-02,14,127,140,267
10859,2012-04-02,15,132,189,321
10860,2012-04-02,16,104,291,395
10861,2012-04-02,17,128,595,723
10862,2012-04-02,18,75,539,614
10863,2012-04-02,19,66,427,493
10864,2012-04-02,20,48,273,321
10865,2012-04-02,21,24,210,234
10866,2012-04-02,22,18,105,123
10867,2012-04-02,23,6,59,65
10868,2012-04-03,0,1,32,33
10869,2012-04-03,1,0,12,12
10870,2012-04-03,2,0,5,5
10871,2012-04-03,3,0,3,3
10872,2012-04-03,4,0,1,1
10873,2012-04-03,5,2,25,27
10874,2012-04-03,6,2,98,100
10875,2012-04-03,7,14,318,332
10876,2012-04-03,8,27,570,597
10877,2012-04-03,9,54,351,405
10878,2012-04-03,10,77,140,217
10879,2012-04-03,11,90,164,254
10880,2012-04-03,12,100,227,327
10881,2012-04-03,13,121,223,344
10882,2012-04-03,14,120,188,308
10883,2012-04-03,15,109,204,313
10884,2012-04-03,16,145,337,482
10885,2012-04-03,17,123,627,750
10886,2012-04-03,18,139,657,796
10887,2012-04-03,19,98,457,555
10888,2012-04-03,20,55,319,374
10889,2012-04-03,21,33,206,239
10890,2012-04-03,22,25,129,154
10891,2012-04-03,23,13,64,77
10892,2012-04-04,0,18,23,41
10893,2012-04-04,1,0,11,11
10894,2012-04-04,2,0,5,5
10895,2012-04-04,3,0,3,3
10896,2012-04-04,4,0,1,1
10897,2012-04-04,5,0,27,27
10898,2012-04-04,6,6,120,126
10899,2012-04-04,7,12,348,360
10900,2012-04-04,8,32,647,679
10901,2012-04-04,9,47,315,362
10902,2012-04-04,10,68,99,167
10903,2012-04-04,11,61,149,210
10904,2012-04-04,12,73,210,283
10905,2012-04-04,13,70,179,249
10906,2012-04-04,14,82,171,253
10907,2012-04-04,15,86,180,266
10908,2012-04-04,16,86,302,388
10909,2012-04-04,17,99,642,741
10910,2012-04-04,18,113,640,753
10911,2012-04-04,19,75,416,491
10912,2012-04-04,20,39,330,369
10913,2012-04-04,21,43,250,293
10914,2012-04-04,22,30,147,177
10915,2012-04-04,23,19,109,128
10916,2012-04-05,0,12,33,45
10917,2012-04-05,1,4,9,13
10918,2012-04-05,2,7,11,18
10919,2012-04-05,3,0,5,5
10920,2012-04-05,4,0,1,1
10921,2012-04-05,5,1,27,28
10922,2012-04-05,6,8,117,125
10923,2012-04-05,7,15,338,353
10924,2012-04-05,8,28,603,631
10925,2012-04-05,9,61,284,345
10926,2012-04-05,10,88,156,244
10927,2012-04-05,11,109,158,267
10928,2012-04-05,12,66,204,270
10929,2012-04-05,13,89,200,289
10930,2012-04-05,14,142,140,282
10931,2012-04-05,15,99,172,271
10932,2012-04-05,16,84,315,399
10933,2012-04-05,17,145,669,814
10934,2012-04-05,18,80,613,693
10935,2012-04-05,19,64,418,482
10936,2012-04-05,20,33,271,304
10937,2012-04-05,21,25,201,226
10938,2012-04-05,22,20,129,149
10939,2012-04-05,23,12,122,134
10940,2012-04-06,0,12,49,61
10941,2012-04-06,1,10,28,38
10942,2012-04-06,2,6,5,11
10943,2012-04-06,3,3,5,8
10944,2012-04-06,4,2,3,5
10945,2012-04-06,5,0,23,23
10946,2012-04-06,6,0,79,79
10947,2012-04-06,7,15,228,243
10948,2012-04-06,8,19,487,506
10949,2012-04-06,9,58,316,374
10950,2012-04-06,10,81,157,238
10951,2012-04-06,11,112,173,285
10952,2012-04-06,12,113,219,332
10953,2012-04-06,13,173,235,408
10954,2012-04-06,14,240,248,488
10955,2012-04-06,15,217,315,532
10956,2012-04-06,16,184,349,533
10957,2012-04-06,17,172,479,651
10958,2012-04-06,18,105,376,481
10959,2012-04-06,19,115,293,408
10960,2012-04-06,20,61,187,248
10961,2012-04-06,21,54,136,190
10962,2012-04-06,22,34,123,157
10963,2012-04-06,23,21,90,111
10964,2012-04-07,0,9,84,93
10965,2012-04-07,1,9,59,68
10966,2012-04-07,2,11,25,36
10967,2012-04-07,3,7,19,26
10968,2012-04-07,4,3,4,7
10969,2012-04-07,5,0,2,2
10970,2012-04-07,6,1,18,19
10971,2012-04-07,7,14,39,53
10972,2012-04-07,8,29,93,122
10973,2012-04-07,9,103,173,276
10974,2012-04-07,10,187,174,361
10975,2012-04-07,11,249,241,490
10976,2012-04-07,12,321,267,588
10977,2012-04-07,13,355,280,635
10978,2012-04-07,14,326,250,576
10979,2012-04-07,15,321,302,623
10980,2012-04-07,16,353,253,606
10981,2012-04-07,17,300,264,564
10982,2012-04-07,18,227,282,509
10983,2012-04-07,19,171,239,410
10984,2012-04-07,20,73,134,207
10985,2012-04-07,21,75,158,233
10986,2012-04-07,22,76,106,182
10987,2012-04-07,23,33,84,117
10988,2012-04-08,0,21,63,84
10989,2012-04-08,1,14,50,64
10990,2012-04-08,2,7,24,31
10991,2012-04-08,3,8,18,26
10992,2012-04-08,4,0,7,7
10993,2012-04-08,5,4,8,12
10994,2012-04-08,6,7,21,28
10995,2012-04-08,7,12,25,37
10996,2012-04-08,8,19,64,83
10997,2012-04-08,9,70,108,178
10998,2012-04-08,10,114,179,293
10999,2012-04-08,11,195,203,398
11000,2012-04-08,12,198,256,454
11001,2012-04-08,13,230,248,478
11002,2012-04-08,14,254,246,500
11003,2012-04-08,15,260,222,482
11004,2012-04-08,16,232,242,474
11005,2012-04-08,17,185,222,407
11006,2012-04-08,18,151,157,308
11007,2012-04-08,19,90,186,276
11008,2012-04-08,20,65,145,210
11009,2012-04-08,21,53,77,130
11010,2012-04-08,22,33,83,116
11011,2012-04-08,23,10,41,51
11012,2012-04-09,0,8,27,35
11013,2012-04-09,1,4,12,16
11014,2012-04-09,2,2,4,6
11015,2012-04-09,3,0,3,3
11016,2012-04-09,4,2,3,5
11017,2012-04-09,5,2,30,32
11018,2012-04-09,6,3,108,111
11019,2012-04-09,7,11,318,329
11020,2012-04-09,8,22,589,611
11021,2012-04-09,9,50,233,283
11022,2012-04-09,10,65,113,178
11023,2012-04-09,11,96,127,223
11024,2012-04-09,12,94,184,278
11025,2012-04-09,13,108,171,279
11026,2012-04-09,14,66,152,218
11027,2012-04-09,15,82,171,253
11028,2012-04-09,16,81,307,388
11029,2012-04-09,17,67,560,627
11030,2012-04-09,18,60,579,639
11031,2012-04-09,19,35,384,419
11032,2012-04-09,20,21,253,274
11033,2012-04-09,21,14,149,163
11034,2012-04-09,22,6,102,108
11035,2012-04-09,23,6,60,66
11036,2012-04-10,0,3,23,26
11037,2012-04-10,1,0,9,9
11038,2012-04-10,2,0,2,2
11039,2012-04-10,3,0,2,2
11040,2012-04-10,4,0,2,2
11041,2012-04-10,5,0,24,24
11042,2012-04-10,6,3,99,102
11043,2012-04-10,7,16,366,382
11044,2012-04-10,8,22,663,685
11045,2012-04-10,9,16,302,318
11046,2012-04-10,10,49,130,179
11047,2012-04-10,11,78,159,237
11048,2012-04-10,12,74,182,256
11049,2012-04-10,13,82,199,281
11050,2012-04-10,14,75,149,224
11051,2012-04-10,15,46,152,198
11052,2012-04-10,16,66,291,357
11053,2012-04-10,17,88,650,738
11054,2012-04-10,18,78,624,702
11055,2012-04-10,19,51,425,476
11056,2012-04-10,20,34,243,277
11057,2012-04-10,21,15,190,205
11058,2012-04-10,22,9,116,125
11059,2012-04-10,23,14,46,60
11060,2012-04-11,0,8,22,30
11061,2012-04-11,1,3,9,12
11062,2012-04-11,2,0,2,2
11063,2012-04-11,3,0,2,2
11064,2012-04-11,5,1,26,27
11065,2012-04-11,6,3,102,105
11066,2012-04-11,7,18,303,321
11067,2012-04-11,8,14,571,585
11068,2012-04-11,9,20,280,300
11069,2012-04-11,10,26,127,153
11070,2012-04-11,11,38,140,178
11071,2012-04-11,12,35,145,180
11072,2012-04-11,13,16,143,159
11073,2012-04-11,14,34,100,134
11074,2012-04-11,15,50,149,199
11075,2012-04-11,16,51,253,304
11076,2012-04-11,17,52,521,573
11077,2012-04-11,18,39,542,581
11078,2012-04-11,19,28,353,381
11079,2012-04-11,20,22,213,235
11080,2012-04-11,21,11,152,163
11081,2012-04-11,22,4,129,133
11082,2012-04-11,23,9,52,61
11083,2012-04-12,0,1,22,23
11084,2012-04-12,1,2,6,8
11085,2012-04-12,2,0,4,4
11086,2012-04-12,3,2,3,5
11087,2012-04-12,4,0,1,1
11088,2012-04-12,5,0,21,21
11089,2012-04-12,6,2,94,96
11090,2012-04-12,7,12,292,304
11091,2012-04-12,8,20,597,617
11092,2012-04-12,9,16,270,286
11093,2012-04-12,10,38,102,140
11094,2012-04-12,11,50,172,222
11095,2012-04-12,12,60,197,257
11096,2012-04-12,13,55,146,201
11097,2012-04-12,14,74,148,222
11098,2012-04-12,15,42,168,210
11099,2012-04-12,16,54,295,349
11100,2012-04-12,17,60,583,643
11101,2012-04-12,18,63,544,607
11102,2012-04-12,19,50,383,433
11103,2012-04-12,20,26,251,277
11104,2012-04-12,21,13,170,183
11105,2012-04-12,22,15,137,152
11106,2012-04-12,23,8,83,91
11107,2012-04-13,0,14,41,55
11108,2012-04-13,1,2,27,29
11109,2012-04-13,2,6,5,11
11110,2012-04-13,3,3,7,10
11111,2012-04-13,4,1,4,5
11112,2012-04-13,5,2,18,20
11113,2012-04-13,6,0,84,84
11114,2012-04-13,7,13,282,295
11115,2012-04-13,8,24,533,557
11116,2012-04-13,9,36,286,322
11117,2012-04-13,10,59,133,192
11118,2012-04-13,11,75,157,232
11119,2012-04-13,12,104,213,317
11120,2012-04-13,13,112,240,352
11121,2012-04-13,14,125,218,343
11122,2012-04-13,15,115,232,347
11123,2012-04-13,16,113,348,461
11124,2012-04-13,17,117,616,733
11125,2012-04-13,18,107,561,668
11126,2012-04-13,19,75,348,423
11127,2012-04-13,20,44,238,282
11128,2012-04-13,21,36,149,185
11129,2012-04-13,22,34,177,211
11130,2012-04-13,23,35,162,197
11131,2012-04-14,0,11,82,93
11132,2012-04-14,1,10,60,70
11133,2012-04-14,2,3,53,56
11134,2012-04-14,3,6,26,32
11135,2012-04-14,4,5,9,14
11136,2012-04-14,5,2,5,7
11137,2012-04-14,6,2,19,21
11138,2012-04-14,7,8,56,64
11139,2012-04-14,8,24,135,159
11140,2012-04-14,9,59,203,262
11141,2012-04-14,10,139,264,403
11142,2012-04-14,11,205,346,551
11143,2012-04-14,12,274,399,673
11144,2012-04-14,13,308,363,671
11145,2012-04-14,14,288,361,649
11146,2012-04-14,15,311,343,654
11147,2012-04-14,16,253,319,572
11148,2012-04-14,17,251,304,555
11149,2012-04-14,18,197,276,473
11150,2012-04-14,19,163,292,455
11151,2012-04-14,20,111,206,317
11152,2012-04-14,21,53,159,212
11153,2012-04-14,22,64,146,210
11154,2012-04-14,23,44,149,193
11155,2012-04-15,0,30,94,124
11156,2012-04-15,1,17,88,105
11157,2012-04-15,2,20,54,74
11158,2012-04-15,3,18,27,45
11159,2012-04-15,4,2,10,12
11160,2012-04-15,5,4,6,10
11161,2012-04-15,6,5,11,16
11162,2012-04-15,7,16,30,46
11163,2012-04-15,8,33,62,95
11164,2012-04-15,9,97,153,250
11165,2012-04-15,10,186,232,418
11166,2012-04-15,11,227,297,524
11167,2012-04-15,12,275,349,624
11168,2012-04-15,13,298,373,671
11169,2012-04-15,14,282,339,621
11170,2012-04-15,15,266,345,611
11171,2012-04-15,16,286,322,608
11172,2012-04-15,17,262,353,615
11173,2012-04-15,18,182,291,473
11174,2012-04-15,19,114,259,373
11175,2012-04-15,20,86,203,289
11176,2012-04-15,21,76,151,227
11177,2012-04-15,22,37,97,134
11178,2012-04-15,23,25,65,90
11179,2012-04-16,0,15,26,41
11180,2012-04-16,1,7,21,28
11181,2012-04-16,2,5,9,14
11182,2012-04-16,3,3,4,7
11183,2012-04-16,4,0,5,5
11184,2012-04-16,5,4,34,38
11185,2012-04-16,6,9,123,132
11186,2012-04-16,7,20,361,381
11187,2012-04-16,8,48,543,591
11188,2012-04-16,9,59,235,294
11189,2012-04-16,10,75,145,220
11190,2012-04-16,11,115,135,250
11191,2012-04-16,12,75,192,267
11192,2012-04-16,13,79,184,263
11193,2012-04-16,14,105,179,284
11194,2012-04-16,15,81,193,274
11195,2012-04-16,16,92,263,355
11196,2012-04-16,17,111,597,708
11197,2012-04-16,18,87,579,666
11198,2012-04-16,19,61,454,515
11199,2012-04-16,20,48,323,371
11200,2012-04-16,21,39,228,267
11201,2012-04-16,22,35,176,211
11202,2012-04-16,23,24,97,121
11203,2012-04-17,0,10,33,43
11204,2012-04-17,1,6,5,11
11205,2012-04-17,2,1,3,4
11206,2012-04-17,3,0,6,6
11207,2012-04-17,4,3,5,8
11208,2012-04-17,5,1,28,29
11209,2012-04-17,6,8,136,144
11210,2012-04-17,7,18,441,459
11211,2012-04-17,8,42,623,665
11212,2012-04-17,9,71,324,395
11213,2012-04-17,10,52,163,215
11214,2012-04-17,11,65,171,236
11215,2012-04-17,12,65,177,242
11216,2012-04-17,13,52,187,239
11217,2012-04-17,14,59,196,255
11218,2012-04-17,15,92,216,308
11219,2012-04-17,16,50,315,365
11220,2012-04-17,17,108,668,776
11221,2012-04-17,18,104,659,763
11222,2012-04-17,19,73,459,532
11223,2012-04-17,20,44,355,399
11224,2012-04-17,21,36,253,289
11225,2012-04-17,22,18,138,156
11226,2012-04-17,23,10,70,80
11227,2012-04-18,0,3,35,38
11228,2012-04-18,1,1,13,14
11229,2012-04-18,2,1,8,9
11230,2012-04-18,3,0,6,6
11231,2012-04-18,4,0,7,7
11232,2012-04-18,5,0,34,34
11233,2012-04-18,6,5,126,131
11234,2012-04-18,7,11,405,416
11235,2012-04-18,8,25,546,571
11236,2012-04-18,9,20,242,262
11237,2012-04-18,10,31,117,148
11238,2012-04-18,11,14,103,117
11239,2012-04-18,12,15,93,108
11240,2012-04-18,13,13,50,63
11241,2012-04-18,14,8,43,51
11242,2012-04-18,15,10,87,97
11243,2012-04-18,16,36,199,235
11244,2012-04-18,17,46,440,486
11245,2012-04-18,18,27,477,504
11246,2012-04-18,19,26,339,365
11247,2012-04-18,20,8,247,255
11248,2012-04-18,21,24,163,187
11249,2012-04-18,22,9,151,160
11250,2012-04-18,23,14,56,70
11251,2012-04-19,0,5,20,25
11252,2012-04-19,1,2,11,13
11253,2012-04-19,2,2,4,6
11254,2012-04-19,3,1,3,4
11255,2012-04-19,4,0,4,4
11256,2012-04-19,5,0,30,30
11257,2012-04-19,6,4,115,119
11258,2012-04-19,7,15,386,401
11259,2012-04-19,8,26,646,672
11260,2012-04-19,9,31,267,298
11261,2012-04-19,10,46,142,188
11262,2012-04-19,11,46,176,222
11263,2012-04-19,12,50,210,260
11264,2012-04-19,13,52,182,234
11265,2012-04-19,14,54,180,234
11266,2012-04-19,15,66,192,258
11267,2012-04-19,16,63,324,387
11268,2012-04-19,17,85,656,741
11269,2012-04-19,18,99,672,771
11270,2012-04-19,19,70,504,574
11271,2012-04-19,20,52,347,399
11272,2012-04-19,21,27,232,259
11273,2012-04-19,22,29,215,244
11274,2012-04-19,23,20,123,143
11275,2012-04-20,0,5,57,62
11276,2012-04-20,1,3,22,25
11277,2012-04-20,2,3,14,17
11278,2012-04-20,3,1,6,7
11279,2012-04-20,4,0,2,2
11280,2012-04-20,5,1,24,25
11281,2012-04-20,6,8,104,112
11282,2012-04-20,7,9,343,352
11283,2012-04-20,8,33,660,693
11284,2012-04-20,9,30,322,352
11285,2012-04-20,10,67,168,235
11286,2012-04-20,11,64,187,251
11287,2012-04-20,12,102,256,358
11288,2012-04-20,13,104,273,377
11289,2012-04-20,14,156,233,389
11290,2012-04-20,15,145,258,403
11291,2012-04-20,16,151,427,578
11292,2012-04-20,17,122,692,814
11293,2012-04-20,18,110,550,660
11294,2012-04-20,19,82,405,487
11295,2012-04-20,20,52,281,333
11296,2012-04-20,21,35,251,286
11297,2012-04-20,22,26,172,198
11298,2012-04-20,23,31,153,184
11299,2012-04-21,0,30,111,141
11300,2012-04-21,1,24,62,86
11301,2012-04-21,2,12,66,78
11302,2012-04-21,3,4,24,28
11303,2012-04-21,4,0,8,8
11304,2012-04-21,5,0,1,1
11305,2012-04-21,6,10,21,31
11306,2012-04-21,7,21,54,75
11307,2012-04-21,8,52,147,199
11308,2012-04-21,9,115,212,327
11309,2012-04-21,10,183,293,476
11310,2012-04-21,11,260,344,604
11311,2012-04-21,12,261,370,631
11312,2012-04-21,13,291,352,643
11313,2012-04-21,14,278,324,602
11314,2012-04-21,15,267,355,622
11315,2012-04-21,16,266,362,628
11316,2012-04-21,17,259,298,557
11317,2012-04-21,18,133,282,415
11318,2012-04-21,19,9,42,51
11319,2012-04-21,20,5,34,39
11320,2012-04-21,21,20,79,99
11321,2012-04-21,22,20,86,106
11322,2012-04-21,23,18,73,91
11323,2012-04-22,0,32,82,114
11324,2012-04-22,1,10,63,73
11325,2012-04-22,2,7,45,52
11326,2012-04-22,3,7,32,39
11327,2012-04-22,4,0,7,7
11328,2012-04-22,5,0,5,5
11329,2012-04-22,6,6,5,11
11330,2012-04-22,7,2,19,21
11331,2012-04-22,8,8,43,51
11332,2012-04-22,9,8,68,76
11333,2012-04-22,10,11,56,67
11334,2012-04-22,11,7,68,75
11335,2012-04-22,12,5,55,60
11336,2012-04-22,13,5,46,51
11337,2012-04-22,14,3,50,53
11338,2012-04-22,15,0,38,38
11339,2012-04-22,16,4,31,35
11340,2012-04-22,17,2,25,27
11341,2012-04-22,18,1,37,38
11342,2012-04-22,19,1,34,35
11343,2012-04-22,20,1,33,34
11344,2012-04-22,21,0,11,11
11345,2012-04-22,22,0,12,12
11346,2012-04-22,23,0,15,15
11347,2012-04-23,0,0,6,6
11348,2012-04-23,1,1,1,2
11349,2012-04-23,2,1,3,4
11350,2012-04-23,3,0,1,1
11351,2012-04-23,4,0,3,3
11352,2012-04-23,5,0,14,14
11353,2012-04-23,6,1,42,43
11354,2012-04-23,7,1,202,203
11355,2012-04-23,8,11,461,472
11356,2012-04-23,9,17,246,263
11357,2012-04-23,10,12,88,100
11358,2012-04-23,11,10,88,98
11359,2012-04-23,12,12,115,127
11360,2012-04-23,13,9,98,107
11361,2012-04-23,14,12,99,111
11362,2012-04-23,15,11,100,111
11363,2012-04-23,16,10,93,103
11364,2012-04-23,17,13,217,230
11365,2012-04-23,18,10,365,375
11366,2012-04-23,19,11,282,293
11367,2012-04-23,20,17,181,198
11368,2012-04-23,21,7,144,151
11369,2012-04-23,22,18,67,85
11370,2012-04-23,23,10,48,58
11371,2012-04-24,0,0,13,13
11372,2012-04-24,1,1,6,7
11373,2012-04-24,2,0,3,3
11374,2012-04-24,3,0,2,2
11375,2012-04-24,4,0,3,3
11376,2012-04-24,5,0,22,22
11377,2012-04-24,6,3,116,119
11378,2012-04-24,7,3,384,387
11379,2012-04-24,8,12,592,604
11380,2012-04-24,9,6,295,301
11381,2012-04-24,10,33,128,161
11382,2012-04-24,11,27,157,184
11383,2012-04-24,12,33,187,220
11384,2012-04-24,13,35,187,222
11385,2012-04-24,14,50,165,215
11386,2012-04-24,15,60,171,231
11387,2012-04-24,16,54,305,359
11388,2012-04-24,17,72,610,682
11389,2012-04-24,18,52,574,626
11390,2012-04-24,19,33,439,472
11391,2012-04-24,20,16,265,281
11392,2012-04-24,21,13,209,222
11393,2012-04-24,22,8,148,156
11394,2012-04-24,23,4,68,72
11395,2012-04-25,0,13,23,36
11396,2012-04-25,1,8,17,25
11397,2012-04-25,2,1,6,7
11398,2012-04-25,3,0,3,3
11399,2012-04-25,4,0,5,5
11400,2012-04-25,5,0,24,24
11401,2012-04-25,6,3,103,106
11402,2012-04-25,7,13,376,389
11403,2012-04-25,8,20,631,651
11404,2012-04-25,9,33,282,315
11405,2012-04-25,10,44,138,182
11406,2012-04-25,11,42,177,219
11407,2012-04-25,12,49,219,268
11408,2012-04-25,13,35,190,225
11409,2012-04-25,14,47,175,222
11410,2012-04-25,15,47,181,228
11411,2012-04-25,16,49,327,376
11412,2012-04-25,17,68,650,718
11413,2012-04-25,18,60,643,703
11414,2012-04-25,19,42,492,534
11415,2012-04-25,20,22,348,370
11416,2012-04-25,21,27,211,238
11417,2012-04-25,22,22,168,190
11418,2012-04-25,23,10,93,103
11419,2012-04-26,0,1,42,43
11420,2012-04-26,1,1,21,22
11421,2012-04-26,2,3,10,13
11422,2012-04-26,3,1,5,6
11423,2012-04-26,4,1,1,2
11424,2012-04-26,5,0,17,17
11425,2012-04-26,6,5,122,127
11426,2012-04-26,7,3,221,224
11427,2012-04-26,8,4,356,360
11428,2012-04-26,9,12,187,199
11429,2012-04-26,10,14,124,138
11430,2012-04-26,11,16,134,150
11431,2012-04-26,12,24,182,206
11432,2012-04-26,13,19,177,196
11433,2012-04-26,14,37,131,168
11434,2012-04-26,15,39,164,203
11435,2012-04-26,16,37,280,317
11436,2012-04-26,17,49,562,611
11437,2012-04-26,18,75,579,654
11438,2012-04-26,19,57,403,460
11439,2012-04-26,20,23,311,334
11440,2012-04-26,21,28,218,246
11441,2012-04-26,22,20,163,183
11442,2012-04-26,23,6,103,109
11443,2012-04-27,0,12,61,73
11444,2012-04-27,1,3,31,34
11445,2012-04-27,2,4,17,21
11446,2012-04-27,3,1,2,3
11447,2012-04-27,4,0,6,6
11448,2012-04-27,5,0,19,19
11449,2012-04-27,6,5,115,120
11450,2012-04-27,7,10,304,314
11451,2012-04-27,8,17,569,586
11452,2012-04-27,9,42,290,332
11453,2012-04-27,10,63,171,234
11454,2012-04-27,11,47,184,231
11455,2012-04-27,12,63,241,304
11456,2012-04-27,13,93,211,304
11457,2012-04-27,14,95,205,300
11458,2012-04-27,15,101,222,323
11459,2012-04-27,16,105,332,437
11460,2012-04-27,17,89,609,698
11461,2012-04-27,18,93,556,649
11462,2012-04-27,19,62,371,433
11463,2012-04-27,20,49,236,285
11464,2012-04-27,21,23,183,206
11465,2012-04-27,22,24,129,153
11466,2012-04-27,23,11,104,115
11467,2012-04-28,0,4,98,102
11468,2012-04-28,1,7,60,67
11469,2012-04-28,2,8,46,54
11470,2012-04-28,3,3,21,24
11471,2012-04-28,4,0,2,2
11472,2012-04-28,5,2,3,5
11473,2012-04-28,6,10,18,28
11474,2012-04-28,7,10,45,55
11475,2012-04-28,8,24,132,156
11476,2012-04-28,9,45,166,211
11477,2012-04-28,10,60,230,290
11478,2012-04-28,11,96,257,353
11479,2012-04-28,12,105,272,377
11480,2012-04-28,13,120,264,384
11481,2012-04-28,14,147,286,433
11482,2012-04-28,15,148,254,402
11483,2012-04-28,16,132,241,373
11484,2012-04-28,17,98,223,321
11485,2012-04-28,18,17,73,90
11486,2012-04-28,19,29,111,140
11487,2012-04-28,20,21,80,101
11488,2012-04-28,21,12,71,83
11489,2012-04-28,22,17,65,82
11490,2012-04-28,23,5,37,42
11491,2012-04-29,0,0,36,36
11492,2012-04-29,1,5,37,42
11493,2012-04-29,2,4,36,40
11494,2012-04-29,3,2,15,17
11495,2012-04-29,4,0,4,4
11496,2012-04-29,5,0,6,6
11497,2012-04-29,6,1,6,7
11498,2012-04-29,7,7,19,26
11499,2012-04-29,8,26,79,105
11500,2012-04-29,9,52,131,183
11501,2012-04-29,10,127,250,377
11502,2012-04-29,11,128,277,405
11503,2012-04-29,12,221,357,578
11504,2012-04-29,13,228,366,594
11505,2012-04-29,14,281,365,646
11506,2012-04-29,15,279,320,599
11507,2012-04-29,16,240,343,583
11508,2012-04-29,17,189,321,510
11509,2012-04-29,18,164,319,483
11510,2012-04-29,19,128,243,371
11511,2012-04-29,20,45,195,240
11512,2012-04-29,21,65,138,203
11513,2012-04-29,22,23,84,107
11514,2012-04-29,23,15,66,81
11515,2012-04-30,0,12,36,48
11516,2012-04-30,1,9,15,24
11517,2012-04-30,2,3,4,7
11518,2012-04-30,3,0,4,4
11519,2012-04-30,4,0,2,2
11520,2012-04-30,5,1,19,20
11521,2012-04-30,6,2,120,122
11522,2012-04-30,7,6,340,346
11523,2012-04-30,8,17,573,590
11524,2012-04-30,9,29,236,265
11525,2012-04-30,10,41,115,156
11526,2012-04-30,11,52,113,165
11527,2012-04-30,12,44,179,223
11528,2012-04-30,13,48,195,243
11529,2012-04-30,14,57,160,217
11530,2012-04-30,15,55,173,228
11531,2012-04-30,16,45,302,347
11532,2012-04-30,17,66,611,677
11533,2012-04-30,18,53,607,660
11534,2012-04-30,19,51,416,467
11535,2012-04-30,20,28,278,306
11536,2012-04-30,21,25,194,219
11537,2012-04-30,22,12,121,133
11538,2012-04-30,23,10,48,58
11539,2012-05-01,0,7,27,34
11540,2012-05-01,1,0,21,21
11541,2012-05-01,2,1,7,8
11542,2012-05-01,3,1,2,3
11543,2012-05-01,4,1,7,8
11544,2012-05-01,5,0,15,15
11545,2012-05-01,6,2,24,26
11546,2012-05-01,7,8,162,170
11547,2012-05-01,8,19,537,556
11548,2012-05-01,9,18,330,348
11549,2012-05-01,10,30,139,169
11550,2012-05-01,11,50,175,225
11551,2012-05-01,12,41,221,262
11552,2012-05-01,13,41,206,247
11553,2012-05-01,14,37,162,199
11554,2012-05-01,15,48,186,234
11555,2012-05-01,16,41,312,353
11556,2012-05-01,17,65,612,677
11557,2012-05-01,18,81,657,738
11558,2012-05-01,19,58,423,481
11559,2012-05-01,20,36,297,333
11560,2012-05-01,21,31,250,281
11561,2012-05-01,22,21,189,210
11562,2012-05-01,23,16,79,95
11563,2012-05-02,0,4,42,46
11564,2012-05-02,1,8,7,15
11565,2012-05-02,2,7,9,16
11566,2012-05-02,3,0,6,6
11567,2012-05-02,4,2,2,4
11568,2012-05-02,5,2,29,31
11569,2012-05-02,6,3,115,118
11570,2012-05-02,7,14,343,357
11571,2012-05-02,8,25,639,664
11572,2012-05-02,9,27,282,309
11573,2012-05-02,10,28,144,172
11574,2012-05-02,11,39,143,182
11575,2012-05-02,12,35,209,244
11576,2012-05-02,13,49,176,225
11577,2012-05-02,14,51,188,239
11578,2012-05-02,15,52,199,251
11579,2012-05-02,16,54,309,363
11580,2012-05-02,17,70,653,723
11581,2012-05-02,18,43,763,806
11582,2012-05-02,19,43,456,499
11583,2012-05-02,20,42,292,334
11584,2012-05-02,21,21,213,234
11585,2012-05-02,22,27,142,169
11586,2012-05-02,23,21,74,95
11587,2012-05-03,0,15,72,87
11588,2012-05-03,1,9,14,23
11589,2012-05-03,2,4,12,16
11590,2012-05-03,3,2,4,6
11591,2012-05-03,4,0,2,2
11592,2012-05-03,5,1,20,21
11593,2012-05-03,6,8,126,134
11594,2012-05-03,7,8,373,381
11595,2012-05-03,8,19,602,621
11596,2012-05-03,9,26,277,303
11597,2012-05-03,10,36,129,165
11598,2012-05-03,11,34,168,202
11599,2012-05-03,12,64,229,293
11600,2012-05-03,13,48,214,262
11601,2012-05-03,14,33,172,205
11602,2012-05-03,15,63,220,283
11603,2012-05-03,16,45,326,371
11604,2012-05-03,17,86,616,702
11605,2012-05-03,18,64,630,694
11606,2012-05-03,19,55,460,515
11607,2012-05-03,20,52,362,414
11608,2012-05-03,21,42,253,295
11609,2012-05-03,22,29,213,242
11610,2012-05-03,23,21,99,120
11611,2012-05-04,0,19,70,89
11612,2012-05-04,1,15,33,48
11613,2012-05-04,2,0,11,11
11614,2012-05-04,3,0,13,13
11615,2012-05-04,4,0,3,3
11616,2012-05-04,5,0,24,24
11617,2012-05-04,6,8,125,133
11618,2012-05-04,7,8,340,348
11619,2012-05-04,8,34,581,615
11620,2012-05-04,9,32,257,289
11621,2012-05-04,10,45,152,197
11622,2012-05-04,11,77,181,258
11623,2012-05-04,12,46,123,169
11624,2012-05-04,13,71,205,276
11625,2012-05-04,14,83,156,239
11626,2012-05-04,15,103,237,340
11627,2012-05-04,16,82,348,430
11628,2012-05-04,17,96,543,639
11629,2012-05-04,18,77,558,635
11630,2012-05-04,19,64,377,441
11631,2012-05-04,20,59,253,312
11632,2012-05-04,21,49,180,229
11633,2012-05-04,22,50,181,231
11634,2012-05-04,23,51,193,244
11635,2012-05-05,0,42,111,153
11636,2012-05-05,1,28,77,105
11637,2012-05-05,2,24,47,71
11638,2012-05-05,3,11,21,32
11639,2012-05-05,4,0,9,9
11640,2012-05-05,5,8,13,21
11641,2012-05-05,6,9,33,42
11642,2012-05-05,7,8,79,87
11643,2012-05-05,8,42,154,196
11644,2012-05-05,9,62,222,284
11645,2012-05-05,10,149,284,433
11646,2012-05-05,11,221,348,569
11647,2012-05-05,12,220,327,547
11648,2012-05-05,13,217,302,519
11649,2012-05-05,14,187,235,422
11650,2012-05-05,15,241,293,534
11651,2012-05-05,16,230,304,534
11652,2012-05-05,17,204,293,497
11653,2012-05-05,18,156,273,429
11654,2012-05-05,19,151,252,403
11655,2012-05-05,20,100,205,305
11656,2012-05-05,21,86,181,267
11657,2012-05-05,22,67,150,217
11658,2012-05-05,23,35,111,146
11659,2012-05-06,0,23,110,133
11660,2012-05-06,1,37,83,120
11661,2012-05-06,2,30,62,92
11662,2012-05-06,3,9,18,27
11663,2012-05-06,4,9,7,16
11664,2012-05-06,5,1,10,11
11665,2012-05-06,6,3,13,16
11666,2012-05-06,7,5,31,36
11667,2012-05-06,8,23,90,113
11668,2012-05-06,9,63,127,190
11669,2012-05-06,10,112,217,329
11670,2012-05-06,11,144,265,409
11671,2012-05-06,12,206,342,548
11672,2012-05-06,13,197,364,561
11673,2012-05-06,14,226,285,511
11674,2012-05-06,15,229,336,565
11675,2012-05-06,16,180,359,539
11676,2012-05-06,17,195,310,505
11677,2012-05-06,18,132,327,459
11678,2012-05-06,19,118,261,379
11679,2012-05-06,20,74,201,275
11680,2012-05-06,21,55,145,200
11681,2012-05-06,22,44,110,154
11682,2012-05-06,23,22,79,101
11683,2012-05-07,0,13,21,34
11684,2012-05-07,1,1,8,9
11685,2012-05-07,2,1,5,6
11686,2012-05-07,3,2,3,5
11687,2012-05-07,4,0,2,2
11688,2012-05-07,5,2,19,21
11689,2012-05-07,6,7,133,140
11690,2012-05-07,7,18,366,384
11691,2012-05-07,8,31,602,633
11692,2012-05-07,9,61,284,345
11693,2012-05-07,10,62,127,189
11694,2012-05-07,11,64,149,213
11695,2012-05-07,12,74,185,259
11696,2012-05-07,13,75,193,268
11697,2012-05-07,14,59,175,234
11698,2012-05-07,15,76,184,260
11699,2012-05-07,16,68,318,386
11700,2012-05-07,17,102,653,755
11701,2012-05-07,18,78,599,677
11702,2012-05-07,19,83,459,542
11703,2012-05-07,20,46,273,319
11704,2012-05-07,21,37,208,245
11705,2012-05-07,22,26,146,172
11706,2012-05-07,23,21,90,111
11707,2012-05-08,0,10,28,38
11708,2012-05-08,1,6,3,9
11709,2012-05-08,2,9,7,16
11710,2012-05-08,3,2,4,6
11711,2012-05-08,4,0,5,5
11712,2012-05-08,5,0,20,20
11713,2012-05-08,6,7,156,163
11714,2012-05-08,7,21,438,459
11715,2012-05-08,8,36,604,640
11716,2012-05-08,9,37,256,293
11717,2012-05-08,10,46,111,157
11718,2012-05-08,11,60,157,217
11719,2012-05-08,12,60,201,261
11720,2012-05-08,13,53,166,219
11721,2012-05-08,14,8,63,71
11722,2012-05-08,15,40,94,134
11723,2012-05-08,16,54,332,386
11724,2012-05-08,17,77,634,711
11725,2012-05-08,18,69,632,701
11726,2012-05-08,19,58,395,453
11727,2012-05-08,20,40,259,299
11728,2012-05-08,21,21,200,221
11729,2012-05-08,22,13,134,147
11730,2012-05-08,23,10,53,63
11731,2012-05-09,0,8,27,35
11732,2012-05-09,1,3,11,14
11733,2012-05-09,2,0,1,1
11734,2012-05-09,3,0,2,2
11735,2012-05-09,4,0,5,5
11736,2012-05-09,5,1,26,27
11737,2012-05-09,6,5,121,126
11738,2012-05-09,7,17,401,418
11739,2012-05-09,8,28,588,616
11740,2012-05-09,9,40,283,323
11741,2012-05-09,10,40,110,150
11742,2012-05-09,11,45,155,200
11743,2012-05-09,12,58,219,277
11744,2012-05-09,13,50,211,261
11745,2012-05-09,14,68,173,241
11746,2012-05-09,15,68,190,258
11747,2012-05-09,16,68,286,354
11748,2012-05-09,17,76,624,700
11749,2012-05-09,18,23,343,366
11750,2012-05-09,19,2,96,98
11751,2012-05-09,20,3,47,50
11752,2012-05-09,21,4,30,34
11753,2012-05-09,22,5,60,65
11754,2012-05-09,23,8,45,53
11755,2012-05-10,0,2,30,32
11756,2012-05-10,1,2,9,11
11757,2012-05-10,2,0,3,3
11758,2012-05-10,3,0,3,3
11759,2012-05-10,4,0,2,2
11760,2012-05-10,5,1,23,24
11761,2012-05-10,6,9,129,138
11762,2012-05-10,7,8,387,395
11763,2012-05-10,8,27,595,622
11764,2012-05-10,9,62,298,360
11765,2012-05-10,10,42,110,152
11766,2012-05-10,11,77,177,254
11767,2012-05-10,12,65,203,268
11768,2012-05-10,13,90,225,315
11769,2012-05-10,14,61,184,245
11770,2012-05-10,15,79,191,270
11771,2012-05-10,16,87,329,416
11772,2012-05-10,17,84,642,726
11773,2012-05-10,18,109,653,762
11774,2012-05-10,19,84,461,545
11775,2012-05-10,20,59,308,367
11776,2012-05-10,21,19,205,224
11777,2012-05-10,22,37,195,232
11778,2012-05-10,23,23,111,134
11779,2012-05-11,0,17,45,62
11780,2012-05-11,1,14,32,46
11781,2012-05-11,2,15,16,31
11782,2012-05-11,3,5,8,13
11783,2012-05-11,4,3,6,9
11784,2012-05-11,5,3,23,26
11785,2012-05-11,6,7,126,133
11786,2012-05-11,7,6,343,349
11787,2012-05-11,8,41,572,613
11788,2012-05-11,9,34,281,315
11789,2012-05-11,10,67,139,206
11790,2012-05-11,11,88,198,286
11791,2012-05-11,12,89,257,346
11792,2012-05-11,13,100,263,363
11793,2012-05-11,14,116,215,331
11794,2012-05-11,15,140,292,432
11795,2012-05-11,16,128,397,525
11796,2012-05-11,17,102,670,772
11797,2012-05-11,18,78,514,592
11798,2012-05-11,19,73,417,490
11799,2012-05-11,20,64,269,333
11800,2012-05-11,21,45,219,264
11801,2012-05-11,22,44,185,229
11802,2012-05-11,23,38,139,177
11803,2012-05-12,0,25,107,132
11804,2012-05-12,1,14,76,90
11805,2012-05-12,2,10,44,54
11806,2012-05-12,3,14,18,32
11807,2012-05-12,4,3,6,9
11808,2012-05-12,5,5,6,11
11809,2012-05-12,6,10,23,33
11810,2012-05-12,7,10,56,66
11811,2012-05-12,8,22,153,175
11812,2012-05-12,9,87,244,331
11813,2012-05-12,10,132,277,409
11814,2012-05-12,11,158,362,520
11815,2012-05-12,12,206,347,553
11816,2012-05-12,13,293,359,652
11817,2012-05-12,14,257,352,609
11818,2012-05-12,15,268,314,582
11819,2012-05-12,16,254,331,585
11820,2012-05-12,17,233,333,566
11821,2012-05-12,18,164,376,540
11822,2012-05-12,19,166,269,435
11823,2012-05-12,20,113,170,283
11824,2012-05-12,21,74,153,227
11825,2012-05-12,22,62,203,265
11826,2012-05-12,23,42,132,174
11827,2012-05-13,0,19,79,98
11828,2012-05-13,1,22,71,93
11829,2012-05-13,2,22,60,82
11830,2012-05-13,3,2,25,27
11831,2012-05-13,4,2,7,9
11832,2012-05-13,5,4,7,11
11833,2012-05-13,6,6,15,21
11834,2012-05-13,7,18,42,60
11835,2012-05-13,8,32,122,154
11836,2012-05-13,9,79,141,220
11837,2012-05-13,10,128,220,348
11838,2012-05-13,11,150,273,423
11839,2012-05-13,12,188,336,524
11840,2012-05-13,13,254,342,596
11841,2012-05-13,14,229,317,546
11842,2012-05-13,15,190,304,494
11843,2012-05-13,16,225,337,562
11844,2012-05-13,17,191,284,475
11845,2012-05-13,18,129,257,386
11846,2012-05-13,19,107,229,336
11847,2012-05-13,20,67,163,230
11848,2012-05-13,21,48,118,166
11849,2012-05-13,22,42,88,130
11850,2012-05-13,23,17,56,73
11851,2012-05-14,0,21,14,35
11852,2012-05-14,1,5,6,11
11853,2012-05-14,2,1,1,2
11854,2012-05-14,3,0,2,2
11855,2012-05-14,4,3,3,6
11856,2012-05-14,5,1,24,25
11857,2012-05-14,6,3,60,63
11858,2012-05-14,7,3,73,76
11859,2012-05-14,8,1,150,151
11860,2012-05-14,9,5,106,111
11861,2012-05-14,10,6,53,59
11862,2012-05-14,11,12,67,79
11863,2012-05-14,12,53,130,183
11864,2012-05-14,13,33,143,176
11865,2012-05-14,14,43,128,171
11866,2012-05-14,15,40,155,195
11867,2012-05-14,16,19,90,109
11868,2012-05-14,17,25,201,226
11869,2012-05-14,18,17,283,300
11870,2012-05-14,19,10,292,302
11871,2012-05-14,20,11,175,186
11872,2012-05-14,21,7,143,150
11873,2012-05-14,22,11,118,129
11874,2012-05-14,23,11,61,72
11875,2012-05-15,0,7,24,31
11876,2012-05-15,1,5,13,18
11877,2012-05-15,2,1,3,4
11878,2012-05-15,3,1,5,6
11879,2012-05-15,4,1,4,5
11880,2012-05-15,5,0,8,8
11881,2012-05-15,6,2,22,24
11882,2012-05-15,7,1,92,93
11883,2012-05-15,8,8,399,407
11884,2012-05-15,9,28,323,351
11885,2012-05-15,10,27,142,169
11886,2012-05-15,11,38,184,222
11887,2012-05-15,12,44,217,261
11888,2012-05-15,13,35,203,238
11889,2012-05-15,14,39,142,181
11890,2012-05-15,15,51,202,253
11891,2012-05-15,16,74,296,370
11892,2012-05-15,17,75,600,675
11893,2012-05-15,18,68,661,729
11894,2012-05-15,19,56,449,505
11895,2012-05-15,20,30,232,262
11896,2012-05-15,21,11,96,107
11897,2012-05-15,22,9,74,83
11898,2012-05-15,23,13,58,71
11899,2012-05-16,0,12,25,37
11900,2012-05-16,1,7,14,21
11901,2012-05-16,2,5,14,19
11902,2012-05-16,3,1,5,6
11903,2012-05-16,4,1,3,4
11904,2012-05-16,5,4,34,38
11905,2012-05-16,6,8,150,158
11906,2012-05-16,7,14,419,433
11907,2012-05-16,8,33,604,637
11908,2012-05-16,9,33,304,337
11909,2012-05-16,10,43,148,191
11910,2012-05-16,11,55,203,258
11911,2012-05-16,12,59,257,316
11912,2012-05-16,13,77,268,345
11913,2012-05-16,14,42,218,260
11914,2012-05-16,15,52,217,269
11915,2012-05-16,16,70,370,440
11916,2012-05-16,17,103,752,855
11917,2012-05-16,18,97,725,822
11918,2012-05-16,19,91,489,580
11919,2012-05-16,20,61,382,443
11920,2012-05-16,21,63,317,380
11921,2012-05-16,22,33,247,280
11922,2012-05-16,23,26,100,126
11923,2012-05-17,0,30,49,79
11924,2012-05-17,1,12,13,25
11925,2012-05-17,2,8,8,16
11926,2012-05-17,3,0,3,3
11927,2012-05-17,4,3,12,15
11928,2012-05-17,5,1,34,35
11929,2012-05-17,6,10,149,159
11930,2012-05-17,7,25,448,473
11931,2012-05-17,8,29,598,627
11932,2012-05-17,9,57,286,343
11933,2012-05-17,10,43,159,202
11934,2012-05-17,11,77,198,275
11935,2012-05-17,12,72,268,340
11936,2012-05-17,13,86,231,317
11937,2012-05-17,14,68,201,269
11938,2012-05-17,15,83,229,312
11939,2012-05-17,16,86,343,429
11940,2012-05-17,17,133,709,842
11941,2012-05-17,18,134,723,857
11942,2012-05-17,19,86,442,528
11943,2012-05-17,20,82,355,437
11944,2012-05-17,21,45,247,292
11945,2012-05-17,22,42,205,247
11946,2012-05-17,23,29,136,165
11947,2012-05-18,0,13,56,69
11948,2012-05-18,1,16,33,49
11949,2012-05-18,2,12,9,21
11950,2012-05-18,3,6,8,14
11951,2012-05-18,4,0,11,11
11952,2012-05-18,5,1,33,34
11953,2012-05-18,6,14,168,182
11954,2012-05-18,7,40,466,506
11955,2012-05-18,8,49,686,735
11956,2012-05-18,9,57,298,355
11957,2012-05-18,10,74,180,254
11958,2012-05-18,11,109,224,333
11959,2012-05-18,12,108,248,356
11960,2012-05-18,13,98,291,389
11961,2012-05-18,14,108,239,347
11962,2012-05-18,15,131,259,390
11963,2012-05-18,16,151,410,561
11964,2012-05-18,17,124,677,801
11965,2012-05-18,18,99,564,663
11966,2012-05-18,19,91,389,480
11967,2012-05-18,20,73,259,332
11968,2012-05-18,21,49,204,253
11969,2012-05-18,22,57,191,248
11970,2012-05-18,23,41,131,172
11971,2012-05-19,0,30,117,147
11972,2012-05-19,1,20,81,101
11973,2012-05-19,2,12,56,68
11974,2012-05-19,3,10,22,32
11975,2012-05-19,4,6,8,14
11976,2012-05-19,5,1,10,11
11977,2012-05-19,6,12,37,49
11978,2012-05-19,7,28,66,94
11979,2012-05-19,8,33,159,192
11980,2012-05-19,9,79,211,290
11981,2012-05-19,10,177,271,448
11982,2012-05-19,11,235,346,581
11983,2012-05-19,12,275,358,633
11984,2012-05-19,13,332,361,693
11985,2012-05-19,14,361,362,723
11986,2012-05-19,15,355,311,666
11987,2012-05-19,16,331,306,637
11988,2012-05-19,17,280,340,620
11989,2012-05-19,18,254,379,633
11990,2012-05-19,19,203,227,430
11991,2012-05-19,20,118,196,314
11992,2012-05-19,21,81,172,253
11993,2012-05-19,22,104,228,332
11994,2012-05-19,23,71,164,235
11995,2012-05-20,0,42,128,170
11996,2012-05-20,1,28,98,126
11997,2012-05-20,2,36,60,96
11998,2012-05-20,3,26,40,66
11999,2012-05-20,4,2,14,16
12000,2012-05-20,5,1,7,8
12001,2012-05-20,6,4,20,24
12002,2012-05-20,7,35,54,89
12003,2012-05-20,8,51,117,168
12004,2012-05-20,9,129,181,310
12005,2012-05-20,10,173,253,426
12006,2012-05-20,11,258,315,573
12007,2012-05-20,12,247,377,624
12008,2012-05-20,13,243,359,602
12009,2012-05-20,14,234,304,538
12010,2012-05-20,15,246,253,499
12011,2012-05-20,16,237,332,569
12012,2012-05-20,17,209,335,544
12013,2012-05-20,18,146,320,466
12014,2012-05-20,19,141,259,400
12015,2012-05-20,20,83,185,268
12016,2012-05-20,21,51,176,227
12017,2012-05-20,22,45,99,144
12018,2012-05-20,23,32,54,86
12019,2012-05-21,0,12,28,40
12020,2012-05-21,1,4,11,15
12021,2012-05-21,2,2,9,11
12022,2012-05-21,3,0,2,2
12023,2012-05-21,4,2,5,7
12024,2012-05-21,5,1,14,15
12025,2012-05-21,6,3,76,79
12026,2012-05-21,7,7,147,154
12027,2012-05-21,8,12,254,266
12028,2012-05-21,9,14,169,183
12029,2012-05-21,10,28,70,98
12030,2012-05-21,11,24,83,107
12031,2012-05-21,12,46,123,169
12032,2012-05-21,13,49,134,183
12033,2012-05-21,14,45,133,178
12034,2012-05-21,15,67,156,223
12035,2012-05-21,16,46,268,314
12036,2012-05-21,17,40,462,502
12037,2012-05-21,18,52,475,527
12038,2012-05-21,19,57,381,438
12039,2012-05-21,20,44,289,333
12040,2012-05-21,21,31,204,235
12041,2012-05-21,22,26,114,140
12042,2012-05-21,23,18,80,98
12043,2012-05-22,0,10,26,36
12044,2012-05-22,1,11,15,26
12045,2012-05-22,2,1,10,11
12046,2012-05-22,3,0,5,5
12047,2012-05-22,4,0,5,5
12048,2012-05-22,5,0,17,17
12049,2012-05-22,6,8,129,137
12050,2012-05-22,7,9,312,321
12051,2012-05-22,8,20,562,582
12052,2012-05-22,9,46,281,327
12053,2012-05-22,10,52,134,186
12054,2012-05-22,11,39,149,188
12055,2012-05-22,12,76,177,253
12056,2012-05-22,13,48,192,240
12057,2012-05-22,14,73,147,220
12058,2012-05-22,15,54,188,242
12059,2012-05-22,16,70,311,381
12060,2012-05-22,17,69,713,782
12061,2012-05-22,18,76,701,777
12062,2012-05-22,19,44,314,358
12063,2012-05-22,20,54,312,366
12064,2012-05-22,21,28,226,254
12065,2012-05-22,22,17,157,174
12066,2012-05-22,23,14,90,104
12067,2012-05-23,0,19,28,47
12068,2012-05-23,1,23,9,32
12069,2012-05-23,2,2,10,12
12070,2012-05-23,3,0,5,5
12071,2012-05-23,4,0,3,3
12072,2012-05-23,5,6,28,34
12073,2012-05-23,6,6,153,159
12074,2012-05-23,7,16,448,464
12075,2012-05-23,8,38,671,709
12076,2012-05-23,9,39,256,295
12077,2012-05-23,10,52,135,187
12078,2012-05-23,11,46,149,195
12079,2012-05-23,12,42,205,247
12080,2012-05-23,13,68,199,267
12081,2012-05-23,14,67,175,242
12082,2012-05-23,15,65,191,256
12083,2012-05-23,16,62,213,275
12084,2012-05-23,17,45,237,282
12085,2012-05-23,18,31,295,326
12086,2012-05-23,19,40,332,372
12087,2012-05-23,20,28,259,287
12088,2012-05-23,21,24,216,240
12089,2012-05-23,22,23,135,158
12090,2012-05-23,23,23,82,105
12091,2012-05-24,0,7,48,55
12092,2012-05-24,1,9,21,30
12093,2012-05-24,2,1,15,16
12094,2012-05-24,3,1,3,4
12095,2012-05-24,4,0,5,5
12096,2012-05-24,5,1,29,30
12097,2012-05-24,6,10,145,155
12098,2012-05-24,7,22,390,412
12099,2012-05-24,8,33,653,686
12100,2012-05-24,9,34,263,297
12101,2012-05-24,10,47,135,182
12102,2012-05-24,11,60,159,219
12103,2012-05-24,12,76,211,287
12104,2012-05-24,13,69,232,301
12105,2012-05-24,14,72,178,250
12106,2012-05-24,15,69,217,286
12107,2012-05-24,16,61,325,386
12108,2012-05-24,17,120,677,797
12109,2012-05-24,18,118,632,750
12110,2012-05-24,19,76,412,488
12111,2012-05-24,20,55,333,388
12112,2012-05-24,21,48,229,277
12113,2012-05-24,22,33,207,240
12114,2012-05-24,23,36,128,164
12115,2012-05-25,0,10,63,73
12116,2012-05-25,1,8,34,42
12117,2012-05-25,2,7,16,23
12118,2012-05-25,3,8,6,14
12119,2012-05-25,4,3,5,8
12120,2012-05-25,5,2,28,30
12121,2012-05-25,6,5,108,113
12122,2012-05-25,7,7,348,355
12123,2012-05-25,8,32,544,576
12124,2012-05-25,9,52,285,337
12125,2012-05-25,10,69,161,230
12126,2012-05-25,11,90,187,277
12127,2012-05-25,12,84,234,318
12128,2012-05-25,13,86,243,329
12129,2012-05-25,14,104,258,362
12130,2012-05-25,15,106,358,464
12131,2012-05-25,16,137,440,577
12132,2012-05-25,17,124,525,649
12133,2012-05-25,18,130,385,515
12134,2012-05-25,19,111,289,400
12135,2012-05-25,20,81,266,347
12136,2012-05-25,21,62,189,251
12137,2012-05-25,22,65,147,212
12138,2012-05-25,23,34,132,166
12139,2012-05-26,0,18,97,115
12140,2012-05-26,1,18,64,82
12141,2012-05-26,2,9,54,63
12142,2012-05-26,3,9,21,30
12143,2012-05-26,4,0,1,1
12144,2012-05-26,5,0,10,10
12145,2012-05-26,6,6,24,30
12146,2012-05-26,7,10,44,54
12147,2012-05-26,8,38,103,141
12148,2012-05-26,9,97,190,287
12149,2012-05-26,10,181,253,434
12150,2012-05-26,11,208,307,515
12151,2012-05-26,12,236,289,525
12152,2012-05-26,13,265,268,533
12153,2012-05-26,14,307,255,562
12154,2012-05-26,15,274,232,506
12155,2012-05-26,16,260,237,497
12156,2012-05-26,17,235,223,458
12157,2012-05-26,18,199,214,413
12158,2012-05-26,19,159,210,369
12159,2012-05-26,20,103,147,250
12160,2012-05-26,21,100,146,246
12161,2012-05-26,22,86,115,201
12162,2012-05-26,23,36,112,148
12163,2012-05-27,0,48,89,137
12164,2012-05-27,1,17,60,77
12165,2012-05-27,2,16,44,60
12166,2012-05-27,3,11,24,35
12167,2012-05-27,4,4,6,10
12168,2012-05-27,5,2,5,7
12169,2012-05-27,6,8,14,22
12170,2012-05-27,7,22,29,51
12171,2012-05-27,8,69,80,149
12172,2012-05-27,9,130,140,270
12173,2012-05-27,10,209,211,420
12174,2012-05-27,11,268,247,515
12175,2012-05-27,12,301,265,566
12176,2012-05-27,13,270,224,494
12177,2012-05-27,14,317,220,537
12178,2012-05-27,15,290,243,533
12179,2012-05-27,16,258,239,497
12180,2012-05-27,17,275,244,519
12181,2012-05-27,18,266,248,514
12182,2012-05-27,19,230,208,438
12183,2012-05-27,20,168,221,389
12184,2012-05-27,21,64,77,141
12185,2012-05-27,22,9,49,58
12186,2012-05-27,23,31,64,95
12187,2012-05-28,0,21,44,65
12188,2012-05-28,1,14,45,59
12189,2012-05-28,2,20,28,48
12190,2012-05-28,3,6,12,18
12191,2012-05-28,4,2,4,6
12192,2012-05-28,5,4,5,9
12193,2012-05-28,6,6,14,20
12194,2012-05-28,7,24,42,66
12195,2012-05-28,8,62,93,155
12196,2012-05-28,9,121,139,260
12197,2012-05-28,10,189,174,363
12198,2012-05-28,11,254,216,470
12199,2012-05-28,12,233,287,520
12200,2012-05-28,13,272,281,553
12201,2012-05-28,14,238,224,462
12202,2012-05-28,15,181,274,455
12203,2012-05-28,16,223,271,494
12204,2012-05-28,17,159,244,403
12205,2012-05-28,18,132,244,376
12206,2012-05-28,19,148,243,391
12207,2012-05-28,20,114,199,313
12208,2012-05-28,21,66,180,246
12209,2012-05-28,22,47,108,155
12210,2012-05-28,23,22,60,82
12211,2012-05-29,0,12,32,44
12212,2012-05-29,1,1,12,13
12213,2012-05-29,2,0,8,8
12214,2012-05-29,3,1,2,3
12215,2012-05-29,4,0,5,5
12216,2012-05-29,5,0,32,32
12217,2012-05-29,6,9,144,153
12218,2012-05-29,7,19,426,445
12219,2012-05-29,8,46,582,628
12220,2012-05-29,9,26,229,255
12221,2012-05-29,10,67,113,180
12222,2012-05-29,11,50,145,195
12223,2012-05-29,12,56,180,236
12224,2012-05-29,13,63,170,233
12225,2012-05-29,14,80,158,238
12226,2012-05-29,15,71,184,255
12227,2012-05-29,16,73,318,391
12228,2012-05-29,17,106,667,773
12229,2012-05-29,18,78,625,703
12230,2012-05-29,19,69,452,521
12231,2012-05-29,20,36,166,202
12232,2012-05-29,21,3,67,70
12233,2012-05-29,22,2,52,54
12234,2012-05-29,23,10,39,49
12235,2012-05-30,0,4,31,35
12236,2012-05-30,1,0,4,4
12237,2012-05-30,2,1,3,4
12238,2012-05-30,3,0,5,5
12239,2012-05-30,4,0,5,5
12240,2012-05-30,5,1,39,40
12241,2012-05-30,6,5,139,144
12242,2012-05-30,7,14,466,480
12243,2012-05-30,8,29,632,661
12244,2012-05-30,9,23,272,295
12245,2012-05-30,10,39,138,177
12246,2012-05-30,11,53,151,204
12247,2012-05-30,12,33,217,250
12248,2012-05-30,13,53,229,282
12249,2012-05-30,14,44,204,248
12250,2012-05-30,15,54,220,274
12251,2012-05-30,16,46,348,394
12252,2012-05-30,17,83,743,826
12253,2012-05-30,18,50,738,788
12254,2012-05-30,19,50,503,553
12255,2012-05-30,20,57,374,431
12256,2012-05-30,21,41,256,297
12257,2012-05-30,22,26,190,216
12258,2012-05-30,23,39,117,156
12259,2012-05-31,0,13,48,61
12260,2012-05-31,1,4,21,25
12261,2012-05-31,2,6,8,14
12262,2012-05-31,3,0,7,7
12263,2012-05-31,4,0,6,6
12264,2012-05-31,5,1,32,33
12265,2012-05-31,6,7,168,175
12266,2012-05-31,7,18,487,505
12267,2012-05-31,8,18,665,683
12268,2012-05-31,9,47,261,308
12269,2012-05-31,10,65,151,216
12270,2012-05-31,11,65,153,218
12271,2012-05-31,12,62,228,290
12272,2012-05-31,13,77,213,290
12273,2012-05-31,14,61,191,252
12274,2012-05-31,15,81,208,289
12275,2012-05-31,16,103,381,484
12276,2012-05-31,17,85,738,823
12277,2012-05-31,18,84,690,774
12278,2012-05-31,19,103,478,581
12279,2012-05-31,20,88,388,476
12280,2012-05-31,21,41,313,354
12281,2012-05-31,22,43,216,259
12282,2012-05-31,23,26,113,139
12283,2012-06-01,0,10,71,81
12284,2012-06-01,1,0,34,34
12285,2012-06-01,2,3,13,16
12286,2012-06-01,3,0,4,4
12287,2012-06-01,4,1,5,6
12288,2012-06-01,5,4,40,44
12289,2012-06-01,6,5,135,140
12290,2012-06-01,7,33,362,395
12291,2012-06-01,8,19,669,688
12292,2012-06-01,9,23,273,296
12293,2012-06-01,10,49,152,201
12294,2012-06-01,11,42,191,233
12295,2012-06-01,12,72,235,307
12296,2012-06-01,13,76,235,311
12297,2012-06-01,14,55,196,251
12298,2012-06-01,15,45,211,256
12299,2012-06-01,16,35,183,218
12300,2012-06-01,17,24,201,225
12301,2012-06-01,18,10,98,108
12302,2012-06-01,19,4,41,45
12303,2012-06-01,20,1,38,39
12304,2012-06-01,21,12,72,84
12305,2012-06-01,22,1,22,23
12306,2012-06-01,23,6,67,73
12307,2012-06-02,0,5,78,83
12308,2012-06-02,1,15,59,74
12309,2012-06-02,2,3,37,40
12310,2012-06-02,3,7,18,25
12311,2012-06-02,4,2,11,13
12312,2012-06-02,5,1,11,12
12313,2012-06-02,6,5,31,36
12314,2012-06-02,7,9,77,86
12315,2012-06-02,8,30,179,209
12316,2012-06-02,9,89,239,328
12317,2012-06-02,10,145,341,486
12318,2012-06-02,11,179,351,530
12319,2012-06-02,12,249,409,658
12320,2012-06-02,13,279,393,672
12321,2012-06-02,14,259,383,642
12322,2012-06-02,15,297,401,698
12323,2012-06-02,16,275,360,635
12324,2012-06-02,17,247,331,578
12325,2012-06-02,18,173,337,510
12326,2012-06-02,19,185,362,547
12327,2012-06-02,20,138,254,392
12328,2012-06-02,21,96,211,307
12329,2012-06-02,22,52,175,227
12330,2012-06-02,23,53,183,236
12331,2012-06-03,0,27,134,161
12332,2012-06-03,1,21,97,118
12333,2012-06-03,2,22,66,88
12334,2012-06-03,3,16,34,50
12335,2012-06-03,4,1,12,13
12336,2012-06-03,5,1,11,12
12337,2012-06-03,6,6,16,22
12338,2012-06-03,7,6,29,35
12339,2012-06-03,8,30,110,140
12340,2012-06-03,9,70,226,296
12341,2012-06-03,10,127,272,399
12342,2012-06-03,11,199,306,505
12343,2012-06-03,12,275,402,677
12344,2012-06-03,13,264,408,672
12345,2012-06-03,14,268,396,664
12346,2012-06-03,15,236,400,636
12347,2012-06-03,16,226,432,658
12348,2012-06-03,17,192,382,574
12349,2012-06-03,18,153,341,494
12350,2012-06-03,19,116,331,447
12351,2012-06-03,20,84,226,310
12352,2012-06-03,21,66,177,243
12353,2012-06-03,22,61,164,225
12354,2012-06-03,23,26,81,107
12355,2012-06-04,0,11,38,49
12356,2012-06-04,1,4,10,14
12357,2012-06-04,2,1,9,10
12358,2012-06-04,3,0,4,4
12359,2012-06-04,4,2,6,8
12360,2012-06-04,5,2,32,34
12361,2012-06-04,6,4,134,138
12362,2012-06-04,7,13,503,516
12363,2012-06-04,8,22,627,649
12364,2012-06-04,9,38,235,273
12365,2012-06-04,10,67,120,187
12366,2012-06-04,11,71,167,238
12367,2012-06-04,12,62,215,277
12368,2012-06-04,13,85,187,272
12369,2012-06-04,14,84,181,265
12370,2012-06-04,15,76,214,290
12371,2012-06-04,16,73,367,440
12372,2012-06-04,17,101,717,818
12373,2012-06-04,18,103,712,815
12374,2012-06-04,19,91,547,638
12375,2012-06-04,20,71,382,453
12376,2012-06-04,21,40,221,261
12377,2012-06-04,22,41,128,169
12378,2012-06-04,23,8,78,86
12379,2012-06-05,0,6,28,34
12380,2012-06-05,1,2,17,19
12381,2012-06-05,2,0,7,7
12382,2012-06-05,3,0,5,5
12383,2012-06-05,4,1,4,5
12384,2012-06-05,5,1,35,36
12385,2012-06-05,6,7,176,183
12386,2012-06-05,7,29,537,566
12387,2012-06-05,8,29,676,705
12388,2012-06-05,9,50,284,334
12389,2012-06-05,10,58,118,176
12390,2012-06-05,11,65,159,224
12391,2012-06-05,12,45,200,245
12392,2012-06-05,13,66,200,266
12393,2012-06-05,14,82,192,274
12394,2012-06-05,15,54,215,269
12395,2012-06-05,16,91,378,469
12396,2012-06-05,17,86,757,843
12397,2012-06-05,18,111,675,786
12398,2012-06-05,19,68,440,508
12399,2012-06-05,20,44,366,410
12400,2012-06-05,21,30,246,276
12401,2012-06-05,22,22,166,188
12402,2012-06-05,23,20,93,113
12403,2012-06-06,0,3,46,49
12404,2012-06-06,1,6,21,27
12405,2012-06-06,2,4,7,11
12406,2012-06-06,3,0,8,8
12407,2012-06-06,4,3,7,10
12408,2012-06-06,5,1,37,38
12409,2012-06-06,6,7,163,170
12410,2012-06-06,7,16,528,544
12411,2012-06-06,8,30,625,655
12412,2012-06-06,9,35,264,299
12413,2012-06-06,10,55,145,200
12414,2012-06-06,11,65,157,222
12415,2012-06-06,12,80,232,312
12416,2012-06-06,13,73,228,301
12417,2012-06-06,14,111,190,301
12418,2012-06-06,15,75,224,299
12419,2012-06-06,16,107,345,452
12420,2012-06-06,17,72,648,720
12421,2012-06-06,18,94,679,773
12422,2012-06-06,19,52,480,532
12423,2012-06-06,20,59,341,400
12424,2012-06-06,21,38,255,293
12425,2012-06-06,22,27,218,245
12426,2012-06-06,23,13,108,121
12427,2012-06-07,0,9,50,59
12428,2012-06-07,1,5,17,22
12429,2012-06-07,2,0,12,12
12430,2012-06-07,3,0,5,5
12431,2012-06-07,4,0,6,6
12432,2012-06-07,5,0,34,34
12433,2012-06-07,6,5,163,168
12434,2012-06-07,7,20,496,516
12435,2012-06-07,8,20,654,674
12436,2012-06-07,9,37,298,335
12437,2012-06-07,10,56,154,210
12438,2012-06-07,11,67,170,237
12439,2012-06-07,12,61,273,334
12440,2012-06-07,13,66,247,313
12441,2012-06-07,14,67,194,261
12442,2012-06-07,15,99,228,327
12443,2012-06-07,16,77,387,464
12444,2012-06-07,17,91,770,861
12445,2012-06-07,18,110,693,803
12446,2012-06-07,19,65,530,595
12447,2012-06-07,20,76,394,470
12448,2012-06-07,21,30,272,302
12449,2012-06-07,22,35,190,225
12450,2012-06-07,23,42,135,177
12451,2012-06-08,0,18,59,77
12452,2012-06-08,1,4,25,29
12453,2012-06-08,2,2,17,19
12454,2012-06-08,3,0,7,7
12455,2012-06-08,4,1,9,10
12456,2012-06-08,5,1,27,28
12457,2012-06-08,6,8,131,139
12458,2012-06-08,7,19,405,424
12459,2012-06-08,8,37,657,694
12460,2012-06-08,9,47,329,376
12461,2012-06-08,10,62,185,247
12462,2012-06-08,11,65,198,263
12463,2012-06-08,12,89,274,363
12464,2012-06-08,13,129,284,413
12465,2012-06-08,14,128,241,369
12466,2012-06-08,15,98,298,396
12467,2012-06-08,16,111,407,518
12468,2012-06-08,17,114,674,788
12469,2012-06-08,18,146,564,710
12470,2012-06-08,19,95,453,548
12471,2012-06-08,20,117,284,401
12472,2012-06-08,21,83,253,336
12473,2012-06-08,22,61,226,287
12474,2012-06-08,23,52,160,212
12475,2012-06-09,0,54,149,203
12476,2012-06-09,1,34,86,120
12477,2012-06-09,2,21,67,88
12478,2012-06-09,3,12,27,39
12479,2012-06-09,4,2,6,8
12480,2012-06-09,5,4,14,18
12481,2012-06-09,6,17,63,80
12482,2012-06-09,7,26,60,86
12483,2012-06-09,8,42,200,242
12484,2012-06-09,9,99,239,338
12485,2012-06-09,10,168,292,460
12486,2012-06-09,11,218,348,566
12487,2012-06-09,12,195,332,527
12488,2012-06-09,13,236,343,579
12489,2012-06-09,14,239,349,588
12490,2012-06-09,15,218,334,552
12491,2012-06-09,16,219,309,528
12492,2012-06-09,17,238,249,487
12493,2012-06-09,18,173,273,446
12494,2012-06-09,19,128,229,357
12495,2012-06-09,20,125,232,357
12496,2012-06-09,21,105,208,313
12497,2012-06-09,22,63,149,212
12498,2012-06-09,23,69,155,224
12499,2012-06-10,0,33,121,154
12500,2012-06-10,1,32,83,115
12501,2012-06-10,2,17,56,73
12502,2012-06-10,3,6,23,29
12503,2012-06-10,4,1,9,10
12504,2012-06-10,5,3,10,13
12505,2012-06-10,6,3,27,30
12506,2012-06-10,7,21,41,62
12507,2012-06-10,8,59,119,178
12508,2012-06-10,9,91,172,263
12509,2012-06-10,10,148,264,412
12510,2012-06-10,11,184,307,491
12511,2012-06-10,12,173,326,499
12512,2012-06-10,13,204,284,488
12513,2012-06-10,14,186,309,495
12514,2012-06-10,15,158,312,470
12515,2012-06-10,16,173,326,499
12516,2012-06-10,17,184,334,518
12517,2012-06-10,18,164,323,487
12518,2012-06-10,19,115,256,371
12519,2012-06-10,20,113,245,358
12520,2012-06-10,21,83,170,253
12521,2012-06-10,22,42,111,153
12522,2012-06-10,23,30,79,109
12523,2012-06-11,0,8,33,41
12524,2012-06-11,1,9,13,22
12525,2012-06-11,2,5,12,17
12526,2012-06-11,3,2,4,6
12527,2012-06-11,4,0,7,7
12528,2012-06-11,5,1,36,37
12529,2012-06-11,6,8,136,144
12530,2012-06-11,7,25,469,494
12531,2012-06-11,8,38,602,640
12532,2012-06-11,9,57,255,312
12533,2012-06-11,10,52,95,147
12534,2012-06-11,11,59,143,202
12535,2012-06-11,12,63,192,255
12536,2012-06-11,13,63,181,244
12537,2012-06-11,14,66,190,256
12538,2012-06-11,15,71,184,255
12539,2012-06-11,16,87,339,426
12540,2012-06-11,17,83,710,793
12541,2012-06-11,18,105,717,822
12542,2012-06-11,19,88,501,589
12543,2012-06-11,20,61,331,392
12544,2012-06-11,21,32,217,249
12545,2012-06-11,22,22,137,159
12546,2012-06-11,23,8,73,81
12547,2012-06-12,0,2,24,26
12548,2012-06-12,1,5,11,16
12549,2012-06-12,2,0,6,6
12550,2012-06-12,3,3,9,12
12551,2012-06-12,4,0,4,4
12552,2012-06-12,5,1,27,28
12553,2012-06-12,6,6,128,134
12554,2012-06-12,7,16,285,301
12555,2012-06-12,8,15,589,604
12556,2012-06-12,9,31,252,283
12557,2012-06-12,10,29,94,123
12558,2012-06-12,11,8,56,64
12559,2012-06-12,12,19,74,93
12560,2012-06-12,13,11,47,58
12561,2012-06-12,14,12,48,60
12562,2012-06-12,15,22,94,116
12563,2012-06-12,16,30,209,239
12564,2012-06-12,17,56,621,677
12565,2012-06-12,18,57,588,645
12566,2012-06-12,19,47,438,485
12567,2012-06-12,20,36,344,380
12568,2012-06-12,21,41,228,269
12569,2012-06-12,22,19,186,205
12570,2012-06-12,23,11,77,88
12571,2012-06-13,0,7,27,34
12572,2012-06-13,1,7,21,28
12573,2012-06-13,2,0,4,4
12574,2012-06-13,3,1,7,8
12575,2012-06-13,4,1,9,10
12576,2012-06-13,5,2,36,38
12577,2012-06-13,6,6,184,190
12578,2012-06-13,7,25,477,502
12579,2012-06-13,8,41,664,705
12580,2012-06-13,9,54,297,351
12581,2012-06-13,10,64,133,197
12582,2012-06-13,11,64,182,246
12583,2012-06-13,12,93,241,334
12584,2012-06-13,13,52,196,248
12585,2012-06-13,14,96,218,314
12586,2012-06-13,15,64,212,276
12587,2012-06-13,16,72,316,388
12588,2012-06-13,17,75,778,853
12589,2012-06-13,18,104,631,735
12590,2012-06-13,19,123,546,669
12591,2012-06-13,20,86,357,443
12592,2012-06-13,21,79,312,391
12593,2012-06-13,22,29,208,237
12594,2012-06-13,23,25,126,151
12595,2012-06-14,0,3,45,48
12596,2012-06-14,1,4,16,20
12597,2012-06-14,2,1,8,9
12598,2012-06-14,3,1,4,5
12599,2012-06-14,4,0,6,6
12600,2012-06-14,5,0,40,40
12601,2012-06-14,6,12,169,181
12602,2012-06-14,7,26,476,502
12603,2012-06-14,8,37,669,706
12604,2012-06-14,9,45,307,352
12605,2012-06-14,10,47,131,178
12606,2012-06-14,11,60,168,228
12607,2012-06-14,12,55,207,262
12608,2012-06-14,13,71,212,283
12609,2012-06-14,14,83,211,294
12610,2012-06-14,15,111,211,322
12611,2012-06-14,16,70,364,434
12612,2012-06-14,17,117,744,861
12613,2012-06-14,18,107,709,816
12614,2012-06-14,19,96,477,573
12615,2012-06-14,20,84,350,434
12616,2012-06-14,21,67,267,334
12617,2012-06-14,22,45,194,239
12618,2012-06-14,23,36,136,172
12619,2012-06-15,0,26,67,93
12620,2012-06-15,1,9,42,51
12621,2012-06-15,2,0,14,14
12622,2012-06-15,3,2,3,5
12623,2012-06-15,4,1,12,13
12624,2012-06-15,5,2,31,33
12625,2012-06-15,6,9,140,149
12626,2012-06-15,7,17,407,424
12627,2012-06-15,8,44,604,648
12628,2012-06-15,9,58,301,359
12629,2012-06-15,10,56,158,214
12630,2012-06-15,11,106,177,283
12631,2012-06-15,12,111,288,399
12632,2012-06-15,13,121,266,387
12633,2012-06-15,14,121,249,370
12634,2012-06-15,15,107,269,376
12635,2012-06-15,16,132,420,552
12636,2012-06-15,17,125,689,814
12637,2012-06-15,18,121,564,685
12638,2012-06-15,19,98,363,461
12639,2012-06-15,20,89,291,380
12640,2012-06-15,21,83,248,331
12641,2012-06-15,22,79,239,318
12642,2012-06-15,23,46,175,221
12643,2012-06-16,0,25,108,133
12644,2012-06-16,1,16,75,91
12645,2012-06-16,2,12,54,66
12646,2012-06-16,3,8,19,27
12647,2012-06-16,4,3,5,8
12648,2012-06-16,5,2,20,22
12649,2012-06-16,6,11,34,45
12650,2012-06-16,7,10,68,78
12651,2012-06-16,8,47,156,203
12652,2012-06-16,9,88,275,363
12653,2012-06-16,10,139,291,430
12654,2012-06-16,11,213,352,565
12655,2012-06-16,12,254,342,596
12656,2012-06-16,13,293,322,615
12657,2012-06-16,14,263,305,568
12658,2012-06-16,15,295,283,578
12659,2012-06-16,16,237,301,538
12660,2012-06-16,17,245,346,591
12661,2012-06-16,18,255,307,562
12662,2012-06-16,19,185,276,461
12663,2012-06-16,20,123,226,349
12664,2012-06-16,21,97,186,283
12665,2012-06-16,22,91,185,276
12666,2012-06-16,23,49,132,181
12667,2012-06-17,0,31,117,148
12668,2012-06-17,1,21,66,87
12669,2012-06-17,2,19,55,74
12670,2012-06-17,3,6,22,28
12671,2012-06-17,4,2,16,18
12672,2012-06-17,5,4,13,17
12673,2012-06-17,6,7,16,23
12674,2012-06-17,7,18,29,47
12675,2012-06-17,8,24,95,119
12676,2012-06-17,9,91,183,274
12677,2012-06-17,10,148,285,433
12678,2012-06-17,11,195,340,535
12679,2012-06-17,12,262,344,606
12680,2012-06-17,13,267,340,607
12681,2012-06-17,14,255,318,573
12682,2012-06-17,15,203,258,461
12683,2012-06-17,16,240,330,570
12684,2012-06-17,17,232,359,591
12685,2012-06-17,18,204,308,512
12686,2012-06-17,19,146,239,385
12687,2012-06-17,20,101,198,299
12688,2012-06-17,21,76,166,242
12689,2012-06-17,22,55,95,150
12690,2012-06-17,23,29,77,106
12691,2012-06-18,0,12,28,40
12692,2012-06-18,1,9,5,14
12693,2012-06-18,2,3,6,9
12694,2012-06-18,3,1,3,4
12695,2012-06-18,4,0,9,9
12696,2012-06-18,5,1,21,22
12697,2012-06-18,6,0,37,37
12698,2012-06-18,7,10,135,145
12699,2012-06-18,8,27,442,469
12700,2012-06-18,9,28,217,245
12701,2012-06-18,10,13,77,90
12702,2012-06-18,11,25,96,121
12703,2012-06-18,12,29,134,163
12704,2012-06-18,13,50,172,222
12705,2012-06-18,14,59,160,219
12706,2012-06-18,15,61,175,236
12707,2012-06-18,16,53,278,331
12708,2012-06-18,17,54,664,718
12709,2012-06-18,18,47,594,641
12710,2012-06-18,19,51,407,458
12711,2012-06-18,20,45,313,358
12712,2012-06-18,21,34,228,262
12713,2012-06-18,22,21,142,163
12714,2012-06-18,23,17,57,74
12715,2012-06-19,0,5,29,34
12716,2012-06-19,1,1,13,14
12717,2012-06-19,2,1,13,14
12718,2012-06-19,3,1,7,8
12719,2012-06-19,4,1,9,10
12720,2012-06-19,5,3,33,36
12721,2012-06-19,6,9,150,159
12722,2012-06-19,7,18,459,477
12723,2012-06-19,8,40,625,665
12724,2012-06-19,9,40,285,325
12725,2012-06-19,10,44,135,179
12726,2012-06-19,11,56,172,228
12727,2012-06-19,12,70,221,291
12728,2012-06-19,13,69,202,271
12729,2012-06-19,14,61,162,223
12730,2012-06-19,15,72,186,258
12731,2012-06-19,16,48,282,330
12732,2012-06-19,17,86,718,804
12733,2012-06-19,18,90,697,787
12734,2012-06-19,19,82,430,512
12735,2012-06-19,20,59,387,446
12736,2012-06-19,21,37,238,275
12737,2012-06-19,22,51,236,287
12738,2012-06-19,23,22,101,123
12739,2012-06-20,0,5,47,52
12740,2012-06-20,1,7,20,27
12741,2012-06-20,2,1,5,6
12742,2012-06-20,3,2,6,8
12743,2012-06-20,4,1,6,7
12744,2012-06-20,5,2,37,39
12745,2012-06-20,6,9,154,163
12746,2012-06-20,7,19,440,459
12747,2012-06-20,8,42,593,635
12748,2012-06-20,9,40,267,307
12749,2012-06-20,10,41,123,164
12750,2012-06-20,11,54,132,186
12751,2012-06-20,12,30,150,180
12752,2012-06-20,13,48,161,209
12753,2012-06-20,14,56,133,189
12754,2012-06-20,15,36,141,177
12755,2012-06-20,16,51,283,334
12756,2012-06-20,17,80,606,686
12757,2012-06-20,18,81,588,669
12758,2012-06-20,19,89,442,531
12759,2012-06-20,20,81,315,396
12760,2012-06-20,21,42,296,338
12761,2012-06-20,22,31,222,253
12762,2012-06-20,23,21,101,122
12763,2012-06-21,0,16,52,68
12764,2012-06-21,1,2,16,18
12765,2012-06-21,2,11,7,18
12766,2012-06-21,3,3,8,11
12767,2012-06-21,4,1,11,12
12768,2012-06-21,5,3,36,39
12769,2012-06-21,6,3,145,148
12770,2012-06-21,7,26,435,461
12771,2012-06-21,8,27,557,584
12772,2012-06-21,9,32,222,254
12773,2012-06-21,10,36,109,145
12774,2012-06-21,11,40,118,158
12775,2012-06-21,12,33,179,212
12776,2012-06-21,13,31,138,169
12777,2012-06-21,14,27,146,173
12778,2012-06-21,15,40,151,191
12779,2012-06-21,16,36,281,317
12780,2012-06-21,17,80,528,608
12781,2012-06-21,18,77,550,627
12782,2012-06-21,19,83,407,490
12783,2012-06-21,20,79,350,429
12784,2012-06-21,21,55,255,310
12785,2012-06-21,22,22,218,240
12786,2012-06-21,23,12,131,143
12787,2012-06-22,0,16,75,91
12788,2012-06-22,1,3,28,31
12789,2012-06-22,2,0,12,12
12790,2012-06-22,3,1,6,7
12791,2012-06-22,4,3,7,10
12792,2012-06-22,5,3,35,38
12793,2012-06-22,6,4,117,121
12794,2012-06-22,7,19,336,355
12795,2012-06-22,8,49,553,602
12796,2012-06-22,9,55,275,330
12797,2012-06-22,10,52,132,184
12798,2012-06-22,11,75,158,233
12799,2012-06-22,12,63,190,253
12800,2012-06-22,13,71,225,296
12801,2012-06-22,14,65,196,261
12802,2012-06-22,15,72,208,280
12803,2012-06-22,16,67,311,378
12804,2012-06-22,17,95,547,642
12805,2012-06-22,18,61,435,496
12806,2012-06-22,19,45,312,357
12807,2012-06-22,20,31,170,201
12808,2012-06-22,21,40,173,213
12809,2012-06-22,22,42,154,196
12810,2012-06-22,23,29,143,172
12811,2012-06-23,0,14,101,115
12812,2012-06-23,1,16,103,119
12813,2012-06-23,2,18,75,93
12814,2012-06-23,3,8,32,40
12815,2012-06-23,4,6,13,19
12816,2012-06-23,5,1,11,12
12817,2012-06-23,6,10,37,47
12818,2012-06-23,7,19,59,78
12819,2012-06-23,8,34,133,167
12820,2012-06-23,9,84,242,326
12821,2012-06-23,10,178,308,486
12822,2012-06-23,11,166,344,510
12823,2012-06-23,12,203,394,597
12824,2012-06-23,13,226,329,555
12825,2012-06-23,14,238,366,604
12826,2012-06-23,15,217,260,477
12827,2012-06-23,16,196,311,507
12828,2012-06-23,17,214,316,530
12829,2012-06-23,18,194,284,478
12830,2012-06-23,19,184,236,420
12831,2012-06-23,20,158,226,384
12832,2012-06-23,21,99,217,316
12833,2012-06-23,22,101,172,273
12834,2012-06-23,23,69,151,220
12835,2012-06-24,0,31,130,161
12836,2012-06-24,1,39,86,125
12837,2012-06-24,2,34,79,113
12838,2012-06-24,3,19,41,60
12839,2012-06-24,4,4,9,13
12840,2012-06-24,5,1,7,8
12841,2012-06-24,6,6,18,24
12842,2012-06-24,7,23,48,71
12843,2012-06-24,8,38,102,140
12844,2012-06-24,9,63,167,230
12845,2012-06-24,10,161,289,450
12846,2012-06-24,11,215,285,500
12847,2012-06-24,12,227,323,550
12848,2012-06-24,13,238,342,580
12849,2012-06-24,14,253,294,547
12850,2012-06-24,15,197,282,479
12851,2012-06-24,16,180,278,458
12852,2012-06-24,17,204,321,525
12853,2012-06-24,18,186,343,529
12854,2012-06-24,19,176,243,419
12855,2012-06-24,20,108,222,330
12856,2012-06-24,21,76,173,249
12857,2012-06-24,22,53,122,175
12858,2012-06-24,23,20,67,87
12859,2012-06-25,0,31,37,68
12860,2012-06-25,1,11,20,31
12861,2012-06-25,2,4,10,14
12862,2012-06-25,3,1,4,5
12863,2012-06-25,4,0,4,4
12864,2012-06-25,5,1,42,43
12865,2012-06-25,6,11,144,155
12866,2012-06-25,7,30,450,480
12867,2012-06-25,8,53,550,603
12868,2012-06-25,9,37,226,263
12869,2012-06-25,10,58,124,182
12870,2012-06-25,11,54,125,179
12871,2012-06-25,12,74,191,265
12872,2012-06-25,13,79,176,255
12873,2012-06-25,14,90,158,248
12874,2012-06-25,15,65,167,232
12875,2012-06-25,16,104,305,409
12876,2012-06-25,17,76,747,823
12877,2012-06-25,18,100,687,787
12878,2012-06-25,19,73,507,580
12879,2012-06-25,20,100,369,469
12880,2012-06-25,21,50,278,328
12881,2012-06-25,22,21,161,182
12882,2012-06-25,23,15,86,101
12883,2012-06-26,0,8,29,37
12884,2012-06-26,1,11,19,30
12885,2012-06-26,2,2,7,9
12886,2012-06-26,3,2,7,9
12887,2012-06-26,4,1,7,8
12888,2012-06-26,5,3,36,39
12889,2012-06-26,6,12,173,185
12890,2012-06-26,7,21,525,546
12891,2012-06-26,8,34,616,650
12892,2012-06-26,9,30,291,321
12893,2012-06-26,10,37,152,189
12894,2012-06-26,11,46,187,233
12895,2012-06-26,12,80,224,304
12896,2012-06-26,13,74,229,303
12897,2012-06-26,14,80,182,262
12898,2012-06-26,15,89,221,310
12899,2012-06-26,16,67,345,412
12900,2012-06-26,17,104,786,890
12901,2012-06-26,18,105,717,822
12902,2012-06-26,19,83,525,608
12903,2012-06-26,20,88,409,497
12904,2012-06-26,21,61,265,326
12905,2012-06-26,22,26,216,242
12906,2012-06-26,23,13,116,129
12907,2012-06-27,0,15,39,54
12908,2012-06-27,1,5,18,23
12909,2012-06-27,2,2,12,14
12910,2012-06-27,3,1,7,8
12911,2012-06-27,4,0,11,11
12912,2012-06-27,5,2,34,36
12913,2012-06-27,6,7,191,198
12914,2012-06-27,7,29,494,523
12915,2012-06-27,8,49,631,680
12916,2012-06-27,9,29,250,279
12917,2012-06-27,10,34,137,171
12918,2012-06-27,11,64,144,208
12919,2012-06-27,12,77,239,316
12920,2012-06-27,13,77,240,317
12921,2012-06-27,14,78,189,267
12922,2012-06-27,15,61,186,247
12923,2012-06-27,16,55,332,387
12924,2012-06-27,17,113,726,839
12925,2012-06-27,18,85,710,795
12926,2012-06-27,19,101,530,631
12927,2012-06-27,20,76,364,440
12928,2012-06-27,21,54,311,365
12929,2012-06-27,22,52,237,289
12930,2012-06-27,23,11,144,155
12931,2012-06-28,0,2,49,51
12932,2012-06-28,1,11,14,25
12933,2012-06-28,2,1,12,13
12934,2012-06-28,3,1,6,7
12935,2012-06-28,4,0,10,10
12936,2012-06-28,5,8,39,47
12937,2012-06-28,6,8,182,190
12938,2012-06-28,7,24,478,502
12939,2012-06-28,8,40,566,606
12940,2012-06-28,9,33,310,343
12941,2012-06-28,10,40,141,181
12942,2012-06-28,11,41,169,210
12943,2012-06-28,12,49,223,272
12944,2012-06-28,13,31,199,230
12945,2012-06-28,14,66,186,252
12946,2012-06-28,15,24,193,217
12947,2012-06-28,16,56,330,386
12948,2012-06-28,17,71,630,701
12949,2012-06-28,18,100,591,691
12950,2012-06-28,19,79,485,564
12951,2012-06-28,20,71,394,465
12952,2012-06-28,21,89,306,395
12953,2012-06-28,22,50,222,272
12954,2012-06-28,23,26,142,168
12955,2012-06-29,0,24,86,110
12956,2012-06-29,1,9,32,41
12957,2012-06-29,2,3,15,18
12958,2012-06-29,3,3,5,8
12959,2012-06-29,4,1,7,8
12960,2012-06-29,5,6,39,45
12961,2012-06-29,6,15,143,158
12962,2012-06-29,7,19,355,374
12963,2012-06-29,8,48,566,614
12964,2012-06-29,9,39,260,299
12965,2012-06-29,10,32,139,171
12966,2012-06-29,11,51,136,187
12967,2012-06-29,12,53,172,225
12968,2012-06-29,13,44,191,235
12969,2012-06-29,14,50,181,231
12970,2012-06-29,15,47,180,227
12971,2012-06-29,16,58,288,346
12972,2012-06-29,17,82,453,535
12973,2012-06-29,18,50,412,462
12974,2012-06-29,19,60,297,357
12975,2012-06-29,20,53,250,303
12976,2012-06-29,21,41,191,232
12977,2012-06-29,22,34,126,160
12978,2012-06-29,23,6,41,47
12979,2012-06-30,0,4,64,68
12980,2012-06-30,1,3,55,58
12981,2012-06-30,2,7,54,61
12982,2012-06-30,3,3,19,22
12983,2012-06-30,4,3,13,16
12984,2012-06-30,5,3,7,10
12985,2012-06-30,6,6,36,42
12986,2012-06-30,7,10,79,89
12987,2012-06-30,8,26,166,192
12988,2012-06-30,9,41,229,270
12989,2012-06-30,10,96,306,402
12990,2012-06-30,11,102,348,450
12991,2012-06-30,12,143,323,466
12992,2012-06-30,13,105,320,425
12993,2012-06-30,14,114,290,404
12994,2012-06-30,15,117,284,401
12995,2012-06-30,16,109,262,371
12996,2012-06-30,17,131,229,360
12997,2012-06-30,18,90,243,333
12998,2012-06-30,19,134,234,368
12999,2012-06-30,20,88,203,291
13000,2012-06-30,21,48,160,208
13001,2012-06-30,22,38,129,167
13002,2012-06-30,23,33,116,149
13003,2012-07-01,0,27,121,148
13004,2012-07-01,1,12,80,92
13005,2012-07-01,2,21,69,90
13006,2012-07-01,3,6,27,33
13007,2012-07-01,4,0,4,4
13008,2012-07-01,5,3,7,10
13009,2012-07-01,6,8,18,26
13010,2012-07-01,7,13,37,50
13011,2012-07-01,8,36,105,141
13012,2012-07-01,9,51,164,215
13013,2012-07-01,10,98,264,362
13014,2012-07-01,11,121,255,376
13015,2012-07-01,12,114,315,429
13016,2012-07-01,13,111,304,415
13017,2012-07-01,14,98,339,437
13018,2012-07-01,15,101,237,338
13019,2012-07-01,16,85,223,308
13020,2012-07-01,17,90,317,407
13021,2012-07-01,18,96,267,363
13022,2012-07-01,19,103,269,372
13023,2012-07-01,20,88,238,326
13024,2012-07-01,21,77,178,255
13025,2012-07-01,22,41,107,148
13026,2012-07-01,23,22,87,109
13027,2012-07-02,0,12,31,43
13028,2012-07-02,1,3,13,16
13029,2012-07-02,2,1,14,15
13030,2012-07-02,3,0,5,5
13031,2012-07-02,4,2,10,12
13032,2012-07-02,5,3,37,40
13033,2012-07-02,6,4,132,136
13034,2012-07-02,7,8,385,393
13035,2012-07-02,8,20,539,559
13036,2012-07-02,9,56,235,291
13037,2012-07-02,10,70,102,172
13038,2012-07-02,11,67,130,197
13039,2012-07-02,12,73,182,255
13040,2012-07-02,13,74,161,235
13041,2012-07-02,14,79,150,229
13042,2012-07-02,15,59,170,229
13043,2012-07-02,16,61,299,360
13044,2012-07-02,17,82,658,740
13045,2012-07-02,18,72,651,723
13046,2012-07-02,19,71,503,574
13047,2012-07-02,20,38,353,391
13048,2012-07-02,21,17,240,257
13049,2012-07-02,22,19,166,185
13050,2012-07-02,23,12,89,101
13051,2012-07-03,0,9,44,53
13052,2012-07-03,1,5,8,13
13053,2012-07-03,2,2,8,10
13054,2012-07-03,3,0,2,2
13055,2012-07-03,4,0,6,6
13056,2012-07-03,5,2,33,35
13057,2012-07-03,6,5,148,153
13058,2012-07-03,7,21,459,480
13059,2012-07-03,8,42,596,638
13060,2012-07-03,9,46,221,267
13061,2012-07-03,10,56,150,206
13062,2012-07-03,11,66,146,212
13063,2012-07-03,12,74,196,270
13064,2012-07-03,13,79,201,280
13065,2012-07-03,14,69,236,305
13066,2012-07-03,15,71,322,393
13067,2012-07-03,16,90,433,523
13068,2012-07-03,17,102,611,713
13069,2012-07-03,18,85,536,621
13070,2012-07-03,19,66,426,492
13071,2012-07-03,20,80,293,373
13072,2012-07-03,21,36,157,193
13073,2012-07-03,22,26,150,176
13074,2012-07-03,23,19,148,167
13075,2012-07-04,0,19,138,157
13076,2012-07-04,1,27,94,121
13077,2012-07-04,2,27,65,92
13078,2012-07-04,3,9,23,32
13079,2012-07-04,4,5,11,16
13080,2012-07-04,5,5,14,19
13081,2012-07-04,6,9,23,32
13082,2012-07-04,7,10,60,70
13083,2012-07-04,8,43,109,152
13084,2012-07-04,9,90,198,288
13085,2012-07-04,10,143,302,445
13086,2012-07-04,11,164,318,482
13087,2012-07-04,12,164,321,485
13088,2012-07-04,13,176,317,493
13089,2012-07-04,14,191,350,541
13090,2012-07-04,15,155,290,445
13091,2012-07-04,16,163,222,385
13092,2012-07-04,17,161,247,408
13093,2012-07-04,18,159,268,427
13094,2012-07-04,19,176,251,427
13095,2012-07-04,20,237,305,542
13096,2012-07-04,21,222,355,577
13097,2012-07-04,22,175,322,497
13098,2012-07-04,23,31,148,179
13099,2012-07-05,0,17,70,87
13100,2012-07-05,1,6,24,30
13101,2012-07-05,2,4,14,18
13102,2012-07-05,3,2,5,7
13103,2012-07-05,4,0,6,6
13104,2012-07-05,5,1,28,29
13105,2012-07-05,6,3,130,133
13106,2012-07-05,7,26,315,341
13107,2012-07-05,8,37,510,547
13108,2012-07-05,9,47,244,291
13109,2012-07-05,10,69,117,186
13110,2012-07-05,11,106,136,242
13111,2012-07-05,12,89,187,276
13112,2012-07-05,13,129,179,308
13113,2012-07-05,14,87,154,241
13114,2012-07-05,15,71,181,252
13115,2012-07-05,16,109,322,431
13116,2012-07-05,17,114,569,683
13117,2012-07-05,18,96,509,605
13118,2012-07-05,19,127,370,497
13119,2012-07-05,20,78,240,318
13120,2012-07-05,21,91,228,319
13121,2012-07-05,22,63,159,222
13122,2012-07-05,23,32,98,130
13123,2012-07-06,0,39,61,100
13124,2012-07-06,1,7,22,29
13125,2012-07-06,2,4,13,17
13126,2012-07-06,3,1,6,7
13127,2012-07-06,4,2,4,6
13128,2012-07-06,5,4,31,35
13129,2012-07-06,6,4,126,130
13130,2012-07-06,7,20,329,349
13131,2012-07-06,8,28,553,581
13132,2012-07-06,9,55,245,300
13133,2012-07-06,10,80,128,208
13134,2012-07-06,11,92,139,231
13135,2012-07-06,12,111,219,330
13136,2012-07-06,13,99,189,288
13137,2012-07-06,14,91,180,271
13138,2012-07-06,15,79,203,282
13139,2012-07-06,16,69,294,363
13140,2012-07-06,17,90,483,573
13141,2012-07-06,18,106,444,550
13142,2012-07-06,19,112,304,416
13143,2012-07-06,20,91,239,330
13144,2012-07-06,21,77,220,297
13145,2012-07-06,22,78,207,285
13146,2012-07-06,23,27,135,162
13147,2012-07-07,0,35,114,149
13148,2012-07-07,1,16,54,70
13149,2012-07-07,2,11,47,58
13150,2012-07-07,3,11,19,30
13151,2012-07-07,4,3,12,15
13152,2012-07-07,5,2,12,14
13153,2012-07-07,6,4,27,31
13154,2012-07-07,7,8,62,70
13155,2012-07-07,8,32,120,152
13156,2012-07-07,9,69,182,251
13157,2012-07-07,10,100,221,321
13158,2012-07-07,11,122,241,363
13159,2012-07-07,12,124,216,340
13160,2012-07-07,13,116,241,357
13161,2012-07-07,14,105,201,306
13162,2012-07-07,15,113,191,304
13163,2012-07-07,16,102,192,294
13164,2012-07-07,17,103,173,276
13165,2012-07-07,18,83,192,275
13166,2012-07-07,19,68,215,283
13167,2012-07-07,20,79,193,272
13168,2012-07-07,21,51,144,195
13169,2012-07-07,22,56,159,215
13170,2012-07-07,23,34,114,148
13171,2012-07-08,0,22,124,146
13172,2012-07-08,1,25,99,124
13173,2012-07-08,2,11,57,68
13174,2012-07-08,3,1,32,33
13175,2012-07-08,4,2,10,12
13176,2012-07-08,5,1,5,6
13177,2012-07-08,6,5,16,21
13178,2012-07-08,7,19,33,52
13179,2012-07-08,8,35,95,130
13180,2012-07-08,9,70,170,240
13181,2012-07-08,10,85,230,315
13182,2012-07-08,11,120,265,385
13183,2012-07-08,12,105,267,372
13184,2012-07-08,13,117,215,332
13185,2012-07-08,14,77,232,309
13186,2012-07-08,15,80,214,294
13187,2012-07-08,16,64,220,284
13188,2012-07-08,17,68,198,266
13189,2012-07-08,18,54,197,251
13190,2012-07-08,19,66,181,247
13191,2012-07-08,20,79,204,283
13192,2012-07-08,21,58,144,202
13193,2012-07-08,22,12,108,120
13194,2012-07-08,23,25,96,121
13195,2012-07-09,0,6,33,39
13196,2012-07-09,1,5,12,17
13197,2012-07-09,2,1,4,5
13198,2012-07-09,3,0,5,5
13199,2012-07-09,4,1,1,2
13200,2012-07-09,5,1,27,28
13201,2012-07-09,6,6,86,92
13202,2012-07-09,7,7,220,227
13203,2012-07-09,8,26,425,451
13204,2012-07-09,9,38,322,360
13205,2012-07-09,10,58,115,173
13206,2012-07-09,11,72,140,212
13207,2012-07-09,12,63,201,264
13208,2012-07-09,13,67,185,252
13209,2012-07-09,14,58,183,241
13210,2012-07-09,15,66,213,279
13211,2012-07-09,16,86,323,409
13212,2012-07-09,17,108,732,840
13213,2012-07-09,18,81,783,864
13214,2012-07-09,19,88,539,627
13215,2012-07-09,20,69,375,444
13216,2012-07-09,21,33,294,327
13217,2012-07-09,22,35,186,221
13218,2012-07-09,23,22,108,130
13219,2012-07-10,0,16,51,67
13220,2012-07-10,1,0,15,15
13221,2012-07-10,2,1,15,16
13222,2012-07-10,3,0,3,3
13223,2012-07-10,4,0,4,4
13224,2012-07-10,5,3,38,41
13225,2012-07-10,6,4,182,186
13226,2012-07-10,7,31,485,516
13227,2012-07-10,8,34,610,644
13228,2012-07-10,9,47,279,326
13229,2012-07-10,10,56,133,189
13230,2012-07-10,11,92,154,246
13231,2012-07-10,12,69,202,271
13232,2012-07-10,13,77,201,278
13233,2012-07-10,14,71,168,239
13234,2012-07-10,15,77,186,263
13235,2012-07-10,16,89,345,434
13236,2012-07-10,17,103,762,865
13237,2012-07-10,18,70,746,816
13238,2012-07-10,19,55,355,410
13239,2012-07-10,20,9,72,81
13240,2012-07-10,21,7,83,90
13241,2012-07-10,22,14,123,137
13242,2012-07-10,23,29,74,103
13243,2012-07-11,0,6,38,44
13244,2012-07-11,1,3,11,14
13245,2012-07-11,2,0,5,5
13246,2012-07-11,3,0,5,5
13247,2012-07-11,4,1,6,7
13248,2012-07-11,5,5,36,41
13249,2012-07-11,6,17,168,185
13250,2012-07-11,7,26,466,492
13251,2012-07-11,8,30,641,671
13252,2012-07-11,9,30,293,323
13253,2012-07-11,10,47,145,192
13254,2012-07-11,11,56,170,226
13255,2012-07-11,12,69,222,291
13256,2012-07-11,13,65,206,271
13257,2012-07-11,14,66,174,240
13258,2012-07-11,15,56,218,274
13259,2012-07-11,16,53,356,409
13260,2012-07-11,17,90,730,820
13261,2012-07-11,18,79,727,806
13262,2012-07-11,19,73,551,624
13263,2012-07-11,20,73,401,474
13264,2012-07-11,21,69,318,387
13265,2012-07-11,22,41,201,242
13266,2012-07-11,23,20,129,149
13267,2012-07-12,0,1,52,53
13268,2012-07-12,1,0,18,18
13269,2012-07-12,2,0,9,9
13270,2012-07-12,3,0,10,10
13271,2012-07-12,4,0,5,5
13272,2012-07-12,5,4,40,44
13273,2012-07-12,6,7,170,177
13274,2012-07-12,7,32,478,510
13275,2012-07-12,8,49,648,697
13276,2012-07-12,9,42,279,321
13277,2012-07-12,10,69,144,213
13278,2012-07-12,11,49,163,212
13279,2012-07-12,12,71,221,292
13280,2012-07-12,13,52,222,274
13281,2012-07-12,14,42,165,207
13282,2012-07-12,15,63,206,269
13283,2012-07-12,16,69,365,434
13284,2012-07-12,17,91,697,788
13285,2012-07-12,18,86,735,821
13286,2012-07-12,19,97,528,625
13287,2012-07-12,20,75,433,508
13288,2012-07-12,21,44,320,364
13289,2012-07-12,22,56,259,315
13290,2012-07-12,23,33,176,209
13291,2012-07-13,0,19,76,95
13292,2012-07-13,1,17,41,58
13293,2012-07-13,2,2,14,16
13294,2012-07-13,3,2,7,9
13295,2012-07-13,4,0,11,11
13296,2012-07-13,5,4,30,34
13297,2012-07-13,6,7,120,127
13298,2012-07-13,7,27,352,379
13299,2012-07-13,8,53,651,704
13300,2012-07-13,9,70,337,407
13301,2012-07-13,10,78,185,263
13302,2012-07-13,11,68,214,282
13303,2012-07-13,12,125,252,377
13304,2012-07-13,13,100,270,370
13305,2012-07-13,14,120,243,363
13306,2012-07-13,15,92,259,351
13307,2012-07-13,16,111,379,490
13308,2012-07-13,17,138,691,829
13309,2012-07-13,18,108,517,625
13310,2012-07-13,19,103,380,483
13311,2012-07-13,20,95,289,384
13312,2012-07-13,21,76,217,293
13313,2012-07-13,22,59,203,262
13314,2012-07-13,23,37,173,210
13315,2012-07-14,0,35,155,190
13316,2012-07-14,1,13,104,117
13317,2012-07-14,2,10,89,99
13318,2012-07-14,3,9,31,40
13319,2012-07-14,4,3,5,8
13320,2012-07-14,5,0,5,5
13321,2012-07-14,6,6,28,34
13322,2012-07-14,7,7,41,48
13323,2012-07-14,8,33,115,148
13324,2012-07-14,9,82,197,279
13325,2012-07-14,10,123,274,397
13326,2012-07-14,11,143,290,433
13327,2012-07-14,12,181,313,494
13328,2012-07-14,13,219,363,582
13329,2012-07-14,14,269,352,621
13330,2012-07-14,15,243,315,558
13331,2012-07-14,16,226,335,561
13332,2012-07-14,17,199,252,451
13333,2012-07-14,18,108,239,347
13334,2012-07-14,19,156,271,427
13335,2012-07-14,20,101,251,352
13336,2012-07-14,21,69,197,266
13337,2012-07-14,22,65,159,224
13338,2012-07-14,23,55,154,209
13339,2012-07-15,0,40,144,184
13340,2012-07-15,1,49,116,165
13341,2012-07-15,2,29,81,110
13342,2012-07-15,3,15,40,55
13343,2012-07-15,4,8,11,19
13344,2012-07-15,5,2,7,9
13345,2012-07-15,6,6,9,15
13346,2012-07-15,7,17,30,47
13347,2012-07-15,8,37,95,132
13348,2012-07-15,9,58,160,218
13349,2012-07-15,10,141,236,377
13350,2012-07-15,11,170,274,444
13351,2012-07-15,12,153,333,486
13352,2012-07-15,13,171,302,473
13353,2012-07-15,14,162,305,467
13354,2012-07-15,15,182,301,483
13355,2012-07-15,16,152,338,490
13356,2012-07-15,17,123,306,429
13357,2012-07-15,18,84,228,312
13358,2012-07-15,19,109,200,309
13359,2012-07-15,20,95,197,292
13360,2012-07-15,21,59,160,219
13361,2012-07-15,22,34,95,129
13362,2012-07-15,23,25,63,88
13363,2012-07-16,0,11,31,42
13364,2012-07-16,1,1,9,10
13365,2012-07-16,2,4,11,15
13366,2012-07-16,3,2,4,6
13367,2012-07-16,4,1,11,12
13368,2012-07-16,5,10,40,50
13369,2012-07-16,6,8,130,138
13370,2012-07-16,7,24,451,475
13371,2012-07-16,8,48,615,663
13372,2012-07-16,9,51,296,347
13373,2012-07-16,10,69,114,183
13374,2012-07-16,11,57,124,181
13375,2012-07-16,12,79,156,235
13376,2012-07-16,13,63,175,238
13377,2012-07-16,14,53,158,211
13378,2012-07-16,15,62,173,235
13379,2012-07-16,16,77,306,383
13380,2012-07-16,17,86,667,753
13381,2012-07-16,18,97,688,785
13382,2012-07-16,19,92,500,592
13383,2012-07-16,20,66,378,444
13384,2012-07-16,21,45,278,323
13385,2012-07-16,22,56,226,282
13386,2012-07-16,23,27,136,163
13387,2012-07-17,0,10,42,52
13388,2012-07-17,1,4,21,25
13389,2012-07-17,2,1,6,7
13390,2012-07-17,3,0,3,3
13391,2012-07-17,4,0,7,7
13392,2012-07-17,5,7,31,38
13393,2012-07-17,6,16,192,208
13394,2012-07-17,7,26,497,523
13395,2012-07-17,8,43,610,653
13396,2012-07-17,9,32,286,318
13397,2012-07-17,10,37,121,158
13398,2012-07-17,11,60,144,204
13399,2012-07-17,12,80,172,252
13400,2012-07-17,13,53,166,219
13401,2012-07-17,14,54,160,214
13402,2012-07-17,15,57,187,244
13403,2012-07-17,16,64,310,374
13404,2012-07-17,17,95,665,760
13405,2012-07-17,18,60,704,764
13406,2012-07-17,19,69,476,545
13407,2012-07-17,20,52,370,422
13408,2012-07-17,21,50,281,331
13409,2012-07-17,22,29,211,240
13410,2012-07-17,23,22,134,156
13411,2012-07-18,0,8,45,53
13412,2012-07-18,1,2,14,16
13413,2012-07-18,2,3,5,8
13414,2012-07-18,3,2,2,4
13415,2012-07-18,4,0,6,6
13416,2012-07-18,5,5,41,46
13417,2012-07-18,6,10,151,161
13418,2012-07-18,7,23,469,492
13419,2012-07-18,8,55,621,676
13420,2012-07-18,9,44,249,293
13421,2012-07-18,10,39,99,138
13422,2012-07-18,11,47,132,179
13423,2012-07-18,12,36,165,201
13424,2012-07-18,13,49,153,202
13425,2012-07-18,14,54,116,170
13426,2012-07-18,15,42,148,190
13427,2012-07-18,16,34,185,219
13428,2012-07-18,17,35,332,367
13429,2012-07-18,18,63,577,640
13430,2012-07-18,19,78,433,511
13431,2012-07-18,20,56,305,361
13432,2012-07-18,21,53,265,318
13433,2012-07-18,22,42,242,284
13434,2012-07-18,23,19,112,131
13435,2012-07-19,0,16,50,66
13436,2012-07-19,1,6,17,23
13437,2012-07-19,2,0,7,7
13438,2012-07-19,3,1,4,5
13439,2012-07-19,4,0,8,8
13440,2012-07-19,5,5,35,40
13441,2012-07-19,6,8,143,151
13442,2012-07-19,7,23,447,470
13443,2012-07-19,8,32,623,655
13444,2012-07-19,9,36,276,312
13445,2012-07-19,10,41,157,198
13446,2012-07-19,11,54,161,215
13447,2012-07-19,12,59,212,271
13448,2012-07-19,13,73,176,249
13449,2012-07-19,14,46,150,196
13450,2012-07-19,15,66,225,291
13451,2012-07-19,16,70,286,356
13452,2012-07-19,17,93,676,769
13453,2012-07-19,18,93,677,770
13454,2012-07-19,19,53,479,532
13455,2012-07-19,20,65,434,499
13456,2012-07-19,21,38,293,331
13457,2012-07-19,22,6,62,68
13458,2012-07-19,23,3,61,64
13459,2012-07-20,0,2,32,34
13460,2012-07-20,1,2,9,11
13461,2012-07-20,2,5,14,19
13462,2012-07-20,3,7,28,35
13463,2012-07-20,4,3,6,9
13464,2012-07-20,5,2,40,42
13465,2012-07-20,6,3,123,126
13466,2012-07-20,7,14,343,357
13467,2012-07-20,8,39,645,684
13468,2012-07-20,9,45,323,368
13469,2012-07-20,10,51,181,232
13470,2012-07-20,11,51,159,210
13471,2012-07-20,12,41,229,270
13472,2012-07-20,13,20,136,156
13473,2012-07-20,14,53,174,227
13474,2012-07-20,15,47,167,214
13475,2012-07-20,16,70,361,431
13476,2012-07-20,17,95,615,710
13477,2012-07-20,18,73,546,619
13478,2012-07-20,19,44,353,397
13479,2012-07-20,20,35,213,248
13480,2012-07-20,21,14,108,122
13481,2012-07-20,22,13,119,132
13482,2012-07-20,23,18,146,164
13483,2012-07-21,0,11,90,101
13484,2012-07-21,1,10,61,71
13485,2012-07-21,2,5,53,58
13486,2012-07-21,3,7,18,25
13487,2012-07-21,4,11,5,16
13488,2012-07-21,5,7,10,17
13489,2012-07-21,6,3,12,15
13490,2012-07-21,7,8,28,36
13491,2012-07-21,8,18,94,112
13492,2012-07-21,9,32,173,205
13493,2012-07-21,10,49,219,268
13494,2012-07-21,11,80,220,300
13495,2012-07-21,12,156,295,451
13496,2012-07-21,13,105,242,347
13497,2012-07-21,14,121,219,340
13498,2012-07-21,15,148,231,379
13499,2012-07-21,16,130,192,322
13500,2012-07-21,17,92,148,240
13501,2012-07-21,18,51,125,176
13502,2012-07-21,19,67,168,235
13503,2012-07-21,20,51,160,211
13504,2012-07-21,21,29,133,162
13505,2012-07-21,22,40,140,180
13506,2012-07-21,23,32,116,148
13507,2012-07-22,0,17,93,110
13508,2012-07-22,1,31,98,129
13509,2012-07-22,2,32,89,121
13510,2012-07-22,3,13,28,41
13511,2012-07-22,4,6,10,16
13512,2012-07-22,5,0,6,6
13513,2012-07-22,6,5,14,19
13514,2012-07-22,7,13,25,38
13515,2012-07-22,8,31,122,153
13516,2012-07-22,9,79,176,255
13517,2012-07-22,10,114,261,375
13518,2012-07-22,11,190,306,496
13519,2012-07-22,12,178,320,498
13520,2012-07-22,13,238,378,616
13521,2012-07-22,14,256,354,610
13522,2012-07-22,15,254,362,616
13523,2012-07-22,16,245,380,625
13524,2012-07-22,17,188,364,552
13525,2012-07-22,18,173,338,511
13526,2012-07-22,19,180,340,520
13527,2012-07-22,20,124,249,373
13528,2012-07-22,21,88,256,344
13529,2012-07-22,22,55,135,190
13530,2012-07-22,23,33,90,123
13531,2012-07-23,0,11,36,47
13532,2012-07-23,1,7,20,27
13533,2012-07-23,2,3,13,16
13534,2012-07-23,3,0,2,2
13535,2012-07-23,4,0,8,8
13536,2012-07-23,5,3,48,51
13537,2012-07-23,6,9,146,155
13538,2012-07-23,7,17,402,419
13539,2012-07-23,8,47,683,730
13540,2012-07-23,9,57,282,339
13541,2012-07-23,10,63,137,200
13542,2012-07-23,11,69,126,195
13543,2012-07-23,12,109,206,315
13544,2012-07-23,13,64,174,238
13545,2012-07-23,14,82,184,266
13546,2012-07-23,15,76,197,273
13547,2012-07-23,16,111,344,455
13548,2012-07-23,17,87,753,840
13549,2012-07-23,18,69,664,733
13550,2012-07-23,19,94,480,574
13551,2012-07-23,20,56,336,392
13552,2012-07-23,21,45,249,294
13553,2012-07-23,22,40,164,204
13554,2012-07-23,23,16,96,112
13555,2012-07-24,0,12,51,63
13556,2012-07-24,1,7,9,16
13557,2012-07-24,2,6,10,16
13558,2012-07-24,3,1,5,6
13559,2012-07-24,4,0,6,6
13560,2012-07-24,5,5,44,49
13561,2012-07-24,6,17,173,190
13562,2012-07-24,7,24,490,514
13563,2012-07-24,8,49,688,737
13564,2012-07-24,9,40,296,336
13565,2012-07-24,10,62,156,218
13566,2012-07-24,11,45,156,201
13567,2012-07-24,12,60,163,223
13568,2012-07-24,13,73,199,272
13569,2012-07-24,14,48,193,241
13570,2012-07-24,15,73,210,283
13571,2012-07-24,16,86,367,453
13572,2012-07-24,17,94,768,862
13573,2012-07-24,18,110,756,866
13574,2012-07-24,19,109,516,625
13575,2012-07-24,20,85,432,517
13576,2012-07-24,21,53,323,376
13577,2012-07-24,22,43,226,269
13578,2012-07-24,23,38,151,189
13579,2012-07-25,0,9,56,65
13580,2012-07-25,1,2,26,28
13581,2012-07-25,2,1,11,12
13582,2012-07-25,3,1,11,12
13583,2012-07-25,4,0,4,4
13584,2012-07-25,5,5,53,58
13585,2012-07-25,6,11,178,189
13586,2012-07-25,7,34,471,505
13587,2012-07-25,8,43,736,779
13588,2012-07-25,9,65,277,342
13589,2012-07-25,10,68,161,229
13590,2012-07-25,11,79,201,280
13591,2012-07-25,12,77,229,306
13592,2012-07-25,13,81,230,311
13593,2012-07-25,14,88,157,245
13594,2012-07-25,15,94,219,313
13595,2012-07-25,16,91,387,478
13596,2012-07-25,17,130,770,900
13597,2012-07-25,18,104,782,886
13598,2012-07-25,19,116,567,683
13599,2012-07-25,20,106,457,563
13600,2012-07-25,21,71,320,391
13601,2012-07-25,22,55,220,275
13602,2012-07-25,23,52,184,236
13603,2012-07-26,0,27,65,92
13604,2012-07-26,1,6,22,28
13605,2012-07-26,2,5,16,21
13606,2012-07-26,3,0,8,8
13607,2012-07-26,4,0,4,4
13608,2012-07-26,5,2,39,41
13609,2012-07-26,6,16,164,180
13610,2012-07-26,7,17,474,491
13611,2012-07-26,8,49,675,724
13612,2012-07-26,9,55,286,341
13613,2012-07-26,10,79,141,220
13614,2012-07-26,11,69,143,212
13615,2012-07-26,12,73,206,279
13616,2012-07-26,13,53,186,239
13617,2012-07-26,14,62,150,212
13618,2012-07-26,15,65,171,236
13619,2012-07-26,16,62,310,372
13620,2012-07-26,17,110,626,736
13621,2012-07-26,18,73,607,680
13622,2012-07-26,19,80,532,612
13623,2012-07-26,20,47,393,440
13624,2012-07-26,21,35,231,266
13625,2012-07-26,22,33,197,230
13626,2012-07-26,23,18,125,143
13627,2012-07-27,0,14,83,97
13628,2012-07-27,1,12,42,54
13629,2012-07-27,2,8,18,26
13630,2012-07-27,3,3,9,12
13631,2012-07-27,4,3,5,8
13632,2012-07-27,5,3,33,36
13633,2012-07-27,6,10,128,138
13634,2012-07-27,7,13,391,404
13635,2012-07-27,8,34,638,672
13636,2012-07-27,9,34,323,357
13637,2012-07-27,10,85,145,230
13638,2012-07-27,11,67,183,250
13639,2012-07-27,12,92,207,299
13640,2012-07-27,13,83,228,311
13641,2012-07-27,14,105,213,318
13642,2012-07-27,15,81,240,321
13643,2012-07-27,16,80,413,493
13644,2012-07-27,17,101,589,690
13645,2012-07-27,18,100,519,619
13646,2012-07-27,19,93,417,510
13647,2012-07-27,20,85,265,350
13648,2012-07-27,21,71,189,260
13649,2012-07-27,22,48,149,197
13650,2012-07-27,23,34,154,188
13651,2012-07-28,0,21,168,189
13652,2012-07-28,1,11,67,78
13653,2012-07-28,2,14,76,90
13654,2012-07-28,3,10,33,43
13655,2012-07-28,4,1,10,11
13656,2012-07-28,5,4,10,14
13657,2012-07-28,6,10,40,50
13658,2012-07-28,7,18,58,76
13659,2012-07-28,8,36,126,162
13660,2012-07-28,9,110,225,335
13661,2012-07-28,10,129,263,392
13662,2012-07-28,11,162,291,453
13663,2012-07-28,12,157,327,484
13664,2012-07-28,13,173,318,491
13665,2012-07-28,14,186,302,488
13666,2012-07-28,15,206,282,488
13667,2012-07-28,16,208,274,482
13668,2012-07-28,17,199,272,471
13669,2012-07-28,18,151,325,476
13670,2012-07-28,19,115,217,332
13671,2012-07-28,20,79,150,229
13672,2012-07-28,21,94,204,298
13673,2012-07-28,22,88,184,272
13674,2012-07-28,23,52,152,204
13675,2012-07-29,0,59,125,184
13676,2012-07-29,1,49,108,157
13677,2012-07-29,2,33,77,110
13678,2012-07-29,3,18,37,55
13679,2012-07-29,4,2,11,13
13680,2012-07-29,5,3,14,17
13681,2012-07-29,6,6,12,18
13682,2012-07-29,7,4,36,40
13683,2012-07-29,8,37,88,125
13684,2012-07-29,9,64,158,222
13685,2012-07-29,10,123,253,376
13686,2012-07-29,11,183,323,506
13687,2012-07-29,12,154,353,507
13688,2012-07-29,13,181,294,475
13689,2012-07-29,14,231,286,517
13690,2012-07-29,15,195,301,496
13691,2012-07-29,16,191,325,516
13692,2012-07-29,17,164,356,520
13693,2012-07-29,18,117,298,415
13694,2012-07-29,19,143,299,442
13695,2012-07-29,20,75,224,299
13696,2012-07-29,21,72,197,269
13697,2012-07-29,22,31,114,145
13698,2012-07-29,23,18,81,99
13699,2012-07-30,0,12,45,57
13700,2012-07-30,1,4,15,19
13701,2012-07-30,2,2,6,8
13702,2012-07-30,3,0,3,3
13703,2012-07-30,4,0,5,5
13704,2012-07-30,5,4,43,47
13705,2012-07-30,6,6,154,160
13706,2012-07-30,7,14,447,461
13707,2012-07-30,8,31,711,742
13708,2012-07-30,9,34,259,293
13709,2012-07-30,10,54,134,188
13710,2012-07-30,11,69,144,213
13711,2012-07-30,12,77,198,275
13712,2012-07-30,13,57,168,225
13713,2012-07-30,14,87,166,253
13714,2012-07-30,15,51,184,235
13715,2012-07-30,16,88,334,422
13716,2012-07-30,17,62,753,815
13717,2012-07-30,18,75,727,802
13718,2012-07-30,19,81,575,656
13719,2012-07-30,20,78,383,461
13720,2012-07-30,21,71,249,320
13721,2012-07-30,22,47,179,226
13722,2012-07-30,23,34,114,148
13723,2012-07-31,0,11,27,38
13724,2012-07-31,1,3,18,21
13725,2012-07-31,2,0,7,7
13726,2012-07-31,3,1,5,6
13727,2012-07-31,4,0,6,6
13728,2012-07-31,5,5,39,44
13729,2012-07-31,6,2,188,190
13730,2012-07-31,7,21,488,509
13731,2012-07-31,8,30,720,750
13732,2012-07-31,9,31,298,329
13733,2012-07-31,10,73,149,222
13734,2012-07-31,11,54,170,224
13735,2012-07-31,12,50,196,246
13736,2012-07-31,13,69,219,288
13737,2012-07-31,14,72,186,258
13738,2012-07-31,15,29,113,142
13739,2012-07-31,16,66,330,396
13740,2012-07-31,17,94,719,813
13741,2012-07-31,18,99,746,845
13742,2012-07-31,19,89,516,605
13743,2012-07-31,20,55,392,447
13744,2012-07-31,21,60,290,350
13745,2012-07-31,22,33,222,255
13746,2012-07-31,23,20,125,145
13747,2012-08-01,0,3,44,47
13748,2012-08-01,1,5,28,33
13749,2012-08-01,2,0,13,13
13750,2012-08-01,3,0,7,7
13751,2012-08-01,4,1,3,4
13752,2012-08-01,5,3,46,49
13753,2012-08-01,6,6,176,182
13754,2012-08-01,7,19,467,486
13755,2012-08-01,8,32,643,675
13756,2012-08-01,9,34,311,345
13757,2012-08-01,10,61,172,233
13758,2012-08-01,11,54,177,231
13759,2012-08-01,12,75,208,283
13760,2012-08-01,13,59,220,279
13761,2012-08-01,14,88,174,262
13762,2012-08-01,15,89,203,292
13763,2012-08-01,16,93,384,477
13764,2012-08-01,17,103,726,829
13765,2012-08-01,18,105,777,882
13766,2012-08-01,19,88,558,646
13767,2012-08-01,20,65,442,507
13768,2012-08-01,21,36,279,315
13769,2012-08-01,22,37,247,284
13770,2012-08-01,23,18,132,150
13771,2012-08-02,0,8,55,63
13772,2012-08-02,1,6,34,40
13773,2012-08-02,2,3,8,11
13774,2012-08-02,3,0,6,6
13775,2012-08-02,4,0,9,9
13776,2012-08-02,5,4,37,41
13777,2012-08-02,6,6,173,179
13778,2012-08-02,7,21,445,466
13779,2012-08-02,8,21,705,726
13780,2012-08-02,9,31,301,332
13781,2012-08-02,10,51,128,179
13782,2012-08-02,11,59,165,224
13783,2012-08-02,12,56,229,285
13784,2012-08-02,13,98,210,308
13785,2012-08-02,14,54,170,224
13786,2012-08-02,15,68,199,267
13787,2012-08-02,16,71,331,402
13788,2012-08-02,17,90,764,854
13789,2012-08-02,18,86,675,761
13790,2012-08-02,19,98,505,603
13791,2012-08-02,20,51,370,421
13792,2012-08-02,21,41,293,334
13793,2012-08-02,22,35,218,253
13794,2012-08-02,23,25,150,175
13795,2012-08-03,0,15,55,70
13796,2012-08-03,1,10,32,42
13797,2012-08-03,2,0,14,14
13798,2012-08-03,3,1,5,6
13799,2012-08-03,4,1,11,12
13800,2012-08-03,5,2,34,36
13801,2012-08-03,6,5,158,163
13802,2012-08-03,7,25,394,419
13803,2012-08-03,8,32,630,662
13804,2012-08-03,9,69,321,390
13805,2012-08-03,10,82,164,246
13806,2012-08-03,11,77,180,257
13807,2012-08-03,12,95,239,334
13808,2012-08-03,13,98,245,343
13809,2012-08-03,14,102,225,327
13810,2012-08-03,15,112,267,379
13811,2012-08-03,16,112,376,488
13812,2012-08-03,17,94,633,727
13813,2012-08-03,18,98,564,662
13814,2012-08-03,19,81,381,462
13815,2012-08-03,20,89,294,383
13816,2012-08-03,21,54,218,272
13817,2012-08-03,22,46,154,200
13818,2012-08-03,23,26,167,193
13819,2012-08-04,0,24,134,158
13820,2012-08-04,1,23,97,120
13821,2012-08-04,2,20,63,83
13822,2012-08-04,3,11,19,30
13823,2012-08-04,4,2,11,13
13824,2012-08-04,5,1,16,17
13825,2012-08-04,6,12,35,47
13826,2012-08-04,7,18,48,66
13827,2012-08-04,8,49,131,180
13828,2012-08-04,9,61,211,272
13829,2012-08-04,10,108,281,389
13830,2012-08-04,11,155,312,467
13831,2012-08-04,12,222,322,544
13832,2012-08-04,13,195,327,522
13833,2012-08-04,14,183,285,468
13834,2012-08-04,15,205,275,480
13835,2012-08-04,16,197,249,446
13836,2012-08-04,17,178,304,482
13837,2012-08-04,18,170,317,487
13838,2012-08-04,19,133,260,393
13839,2012-08-04,20,117,190,307
13840,2012-08-04,21,96,189,285
13841,2012-08-04,22,104,157,261
13842,2012-08-04,23,61,158,219
13843,2012-08-05,0,32,120,152
13844,2012-08-05,1,8,78,86
13845,2012-08-05,2,5,67,72
13846,2012-08-05,3,9,32,41
13847,2012-08-05,4,3,11,14
13848,2012-08-05,5,1,17,18
13849,2012-08-05,6,7,12,19
13850,2012-08-05,7,18,50,68
13851,2012-08-05,8,27,80,107
13852,2012-08-05,9,61,165,226
13853,2012-08-05,10,111,251,362
13854,2012-08-05,11,155,278,433
13855,2012-08-05,12,161,326,487
13856,2012-08-05,13,208,311,519
13857,2012-08-05,14,161,351,512
13858,2012-08-05,15,164,282,446
13859,2012-08-05,16,143,269,412
13860,2012-08-05,17,122,257,379
13861,2012-08-05,18,75,151,226
13862,2012-08-05,19,46,137,183
13863,2012-08-05,20,53,136,189
13864,2012-08-05,21,51,153,204
13865,2012-08-05,22,57,98,155
13866,2012-08-05,23,29,56,85
13867,2012-08-06,0,9,23,32
13868,2012-08-06,1,1,10,11
13869,2012-08-06,2,0,4,4
13870,2012-08-06,3,0,5,5
13871,2012-08-06,4,3,8,11
13872,2012-08-06,5,2,23,25
13873,2012-08-06,6,4,136,140
13874,2012-08-06,7,14,388,402
13875,2012-08-06,8,27,569,596
13876,2012-08-06,9,28,244,272
13877,2012-08-06,10,54,150,204
13878,2012-08-06,11,108,141,249
13879,2012-08-06,12,72,203,275
13880,2012-08-06,13,85,195,280
13881,2012-08-06,14,99,182,281
13882,2012-08-06,15,91,179,270
13883,2012-08-06,16,88,357,445
13884,2012-08-06,17,112,737,849
13885,2012-08-06,18,100,740,840
13886,2012-08-06,19,109,523,632
13887,2012-08-06,20,89,361,450
13888,2012-08-06,21,72,245,317
13889,2012-08-06,22,50,157,207
13890,2012-08-06,23,16,96,112
13891,2012-08-07,0,15,32,47
13892,2012-08-07,1,2,16,18
13893,2012-08-07,2,6,7,13
13894,2012-08-07,3,0,6,6
13895,2012-08-07,4,2,7,9
13896,2012-08-07,5,3,32,35
13897,2012-08-07,6,3,175,178
13898,2012-08-07,7,21,475,496
13899,2012-08-07,8,41,650,691
13900,2012-08-07,9,44,279,323
13901,2012-08-07,10,89,157,246
13902,2012-08-07,11,84,128,212
13903,2012-08-07,12,86,195,281
13904,2012-08-07,13,68,183,251
13905,2012-08-07,14,76,183,259
13906,2012-08-07,15,100,203,303
13907,2012-08-07,16,100,343,443
13908,2012-08-07,17,125,737,862
13909,2012-08-07,18,103,704,807
13910,2012-08-07,19,104,502,606
13911,2012-08-07,20,74,371,445
13912,2012-08-07,21,70,242,312
13913,2012-08-07,22,43,176,219
13914,2012-08-07,23,18,120,138
13915,2012-08-08,0,12,45,57
13916,2012-08-08,1,3,18,21
13917,2012-08-08,2,1,5,6
13918,2012-08-08,3,1,6,7
13919,2012-08-08,4,1,6,7
13920,2012-08-08,5,3,40,43
13921,2012-08-08,6,4,168,172
13922,2012-08-08,7,24,452,476
13923,2012-08-08,8,48,681,729
13924,2012-08-08,9,33,306,339
13925,2012-08-08,10,63,150,213
13926,2012-08-08,11,80,159,239
13927,2012-08-08,12,63,213,276
13928,2012-08-08,13,101,211,312
13929,2012-08-08,14,63,171,234
13930,2012-08-08,15,110,164,274
13931,2012-08-08,16,113,325,438
13932,2012-08-08,17,107,744,851
13933,2012-08-08,18,117,731,848
13934,2012-08-08,19,118,553,671
13935,2012-08-08,20,74,416,490
13936,2012-08-08,21,70,301,371
13937,2012-08-08,22,35,193,228
13938,2012-08-08,23,16,118,134
13939,2012-08-09,0,16,50,66
13940,2012-08-09,1,5,23,28
13941,2012-08-09,2,2,12,14
13942,2012-08-09,3,1,5,6
13943,2012-08-09,4,0,9,9
13944,2012-08-09,5,4,36,40
13945,2012-08-09,6,5,157,162
13946,2012-08-09,7,24,444,468
13947,2012-08-09,8,28,659,687
13948,2012-08-09,9,54,297,351
13949,2012-08-09,10,72,131,203
13950,2012-08-09,11,93,162,255
13951,2012-08-09,12,85,190,275
13952,2012-08-09,13,80,197,277
13953,2012-08-09,14,86,160,246
13954,2012-08-09,15,63,202,265
13955,2012-08-09,16,97,317,414
13956,2012-08-09,17,111,687,798
13957,2012-08-09,18,78,725,803
13958,2012-08-09,19,90,519,609
13959,2012-08-09,20,91,381,472
13960,2012-08-09,21,50,282,332
13961,2012-08-09,22,41,214,255
13962,2012-08-09,23,19,134,153
13963,2012-08-10,0,17,67,84
13964,2012-08-10,1,6,35,41
13965,2012-08-10,2,6,14,20
13966,2012-08-10,3,3,5,8
13967,2012-08-10,4,0,7,7
13968,2012-08-10,5,4,29,33
13969,2012-08-10,6,3,41,44
13970,2012-08-10,7,5,126,131
13971,2012-08-10,8,7,112,119
13972,2012-08-10,9,21,199,220
13973,2012-08-10,10,27,165,192
13974,2012-08-10,11,72,176,248
13975,2012-08-10,12,76,237,313
13976,2012-08-10,13,66,223,289
13977,2012-08-10,14,71,231,302
13978,2012-08-10,15,100,218,318
13979,2012-08-10,16,96,365,461
13980,2012-08-10,17,111,604,715
13981,2012-08-10,18,88,544,632
13982,2012-08-10,19,98,388,486
13983,2012-08-10,20,55,311,366
13984,2012-08-10,21,50,233,283
13985,2012-08-10,22,50,165,215
13986,2012-08-10,23,33,158,191
13987,2012-08-11,0,38,140,178
13988,2012-08-11,1,32,82,114
13989,2012-08-11,2,19,66,85
13990,2012-08-11,3,2,19,21
13991,2012-08-11,4,3,7,10
13992,2012-08-11,5,2,9,11
13993,2012-08-11,6,5,18,23
13994,2012-08-11,7,8,52,60
13995,2012-08-11,8,30,131,161
13996,2012-08-11,9,54,215,269
13997,2012-08-11,10,125,278,403
13998,2012-08-11,11,202,291,493
13999,2012-08-11,12,215,327,542
14000,2012-08-11,13,228,337,565
14001,2012-08-11,14,248,281,529
14002,2012-08-11,15,245,308,553
14003,2012-08-11,16,228,298,526
14004,2012-08-11,17,220,287,507
14005,2012-08-11,18,107,187,294
14006,2012-08-11,19,97,175,272
14007,2012-08-11,20,31,128,159
14008,2012-08-11,21,26,102,128
14009,2012-08-11,22,40,128,168
14010,2012-08-11,23,42,119,161
14011,2012-08-12,0,24,93,117
14012,2012-08-12,1,21,92,113
14013,2012-08-12,2,19,64,83
14014,2012-08-12,3,11,36,47
14015,2012-08-12,4,2,8,10
14016,2012-08-12,5,1,9,10
14017,2012-08-12,6,2,14,16
14018,2012-08-12,7,9,30,39
14019,2012-08-12,8,35,82,117
14020,2012-08-12,9,64,153,217
14021,2012-08-12,10,88,236,324
14022,2012-08-12,11,167,274,441
14023,2012-08-12,12,163,337,500
14024,2012-08-12,13,178,358,536
14025,2012-08-12,14,213,359,572
14026,2012-08-12,15,235,338,573
14027,2012-08-12,16,213,297,510
14028,2012-08-12,17,187,313,500
14029,2012-08-12,18,163,318,481
14030,2012-08-12,19,148,306,454
14031,2012-08-12,20,96,199,295
14032,2012-08-12,21,78,139,217
14033,2012-08-12,22,40,137,177
14034,2012-08-12,23,25,83,108
14035,2012-08-13,0,14,32,46
14036,2012-08-13,1,3,10,13
14037,2012-08-13,2,1,8,9
14038,2012-08-13,3,1,5,6
14039,2012-08-13,4,0,11,11
14040,2012-08-13,5,3,31,34
14041,2012-08-13,6,4,153,157
14042,2012-08-13,7,11,411,422
14043,2012-08-13,8,25,636,661
14044,2012-08-13,9,40,260,300
14045,2012-08-13,10,88,110,198
14046,2012-08-13,11,94,150,244
14047,2012-08-13,12,96,177,273
14048,2012-08-13,13,79,173,252
14049,2012-08-13,14,85,163,248
14050,2012-08-13,15,80,191,271
14051,2012-08-13,16,116,342,458
14052,2012-08-13,17,102,713,815
14053,2012-08-13,18,103,699,802
14054,2012-08-13,19,88,462,550
14055,2012-08-13,20,58,368,426
14056,2012-08-13,21,44,241,285
14057,2012-08-13,22,44,147,191
14058,2012-08-13,23,28,99,127
14059,2012-08-14,0,12,46,58
14060,2012-08-14,1,8,18,26
14061,2012-08-14,2,2,9,11
14062,2012-08-14,3,0,3,3
14063,2012-08-14,4,0,5,5
14064,2012-08-14,5,1,35,36
14065,2012-08-14,6,1,61,62
14066,2012-08-14,7,1,176,177
14067,2012-08-14,8,27,580,607
14068,2012-08-14,9,48,349,397
14069,2012-08-14,10,53,144,197
14070,2012-08-14,11,69,127,196
14071,2012-08-14,12,93,205,298
14072,2012-08-14,13,83,200,283
14073,2012-08-14,14,80,171,251
14074,2012-08-14,15,84,196,280
14075,2012-08-14,16,95,360,455
14076,2012-08-14,17,78,723,801
14077,2012-08-14,18,97,743,840
14078,2012-08-14,19,94,524,618
14079,2012-08-14,20,65,368,433
14080,2012-08-14,21,56,246,302
14081,2012-08-14,22,28,160,188
14082,2012-08-14,23,53,113,166
14083,2012-08-15,0,8,50,58
14084,2012-08-15,1,6,31,37
14085,2012-08-15,2,1,6,7
14086,2012-08-15,3,1,8,9
14087,2012-08-15,4,0,4,4
14088,2012-08-15,5,4,35,39
14089,2012-08-15,6,12,160,172
14090,2012-08-15,7,25,462,487
14091,2012-08-15,8,40,631,671
14092,2012-08-15,9,57,307,364
14093,2012-08-15,10,70,161,231
14094,2012-08-15,11,80,152,232
14095,2012-08-15,12,77,227,304
14096,2012-08-15,13,88,206,294
14097,2012-08-15,14,94,160,254
14098,2012-08-15,15,70,195,265
14099,2012-08-15,16,91,339,430
14100,2012-08-15,17,102,743,845
14101,2012-08-15,18,80,760,840
14102,2012-08-15,19,124,518,642
14103,2012-08-15,20,71,350,421
14104,2012-08-15,21,50,260,310
14105,2012-08-15,22,29,181,210
14106,2012-08-15,23,18,119,137
14107,2012-08-16,0,13,63,76
14108,2012-08-16,1,3,18,21
14109,2012-08-16,2,0,15,15
14110,2012-08-16,3,0,4,4
14111,2012-08-16,4,2,3,5
14112,2012-08-16,5,7,30,37
14113,2012-08-16,6,3,162,165
14114,2012-08-16,7,16,443,459
14115,2012-08-16,8,33,643,676
14116,2012-08-16,9,41,292,333
14117,2012-08-16,10,78,121,199
14118,2012-08-16,11,83,186,269
14119,2012-08-16,12,96,247,343
14120,2012-08-16,13,81,214,295
14121,2012-08-16,14,72,173,245
14122,2012-08-16,15,63,195,258
14123,2012-08-16,16,78,340,418
14124,2012-08-16,17,130,752,882
14125,2012-08-16,18,109,716,825
14126,2012-08-16,19,119,547,666
14127,2012-08-16,20,100,407,507
14128,2012-08-16,21,83,267,350
14129,2012-08-16,22,69,183,252
14130,2012-08-16,23,58,165,223
14131,2012-08-17,0,21,66,87
14132,2012-08-17,1,16,35,51
14133,2012-08-17,2,4,14,18
14134,2012-08-17,3,0,6,6
14135,2012-08-17,4,0,9,9
14136,2012-08-17,5,2,32,34
14137,2012-08-17,6,6,150,156
14138,2012-08-17,7,11,365,376
14139,2012-08-17,8,43,620,663
14140,2012-08-17,9,57,318,375
14141,2012-08-17,10,82,148,230
14142,2012-08-17,11,98,202,300
14143,2012-08-17,12,110,252,362
14144,2012-08-17,13,103,253,356
14145,2012-08-17,14,128,198,326
14146,2012-08-17,15,126,255,381
14147,2012-08-17,16,116,368,484
14148,2012-08-17,17,144,641,785
14149,2012-08-17,18,108,554,662
14150,2012-08-17,19,88,397,485
14151,2012-08-17,20,97,260,357
14152,2012-08-17,21,57,192,249
14153,2012-08-17,22,43,169,212
14154,2012-08-17,23,21,98,119
14155,2012-08-18,0,6,98,104
14156,2012-08-18,1,14,77,91
14157,2012-08-18,2,4,39,43
14158,2012-08-18,3,7,22,29
14159,2012-08-18,4,5,7,12
14160,2012-08-18,5,2,7,9
14161,2012-08-18,6,4,23,27
14162,2012-08-18,7,12,52,64
14163,2012-08-18,8,28,158,186
14164,2012-08-18,9,81,209,290
14165,2012-08-18,10,166,311,477
14166,2012-08-18,11,180,351,531
14167,2012-08-18,12,266,381,647
14168,2012-08-18,13,288,350,638
14169,2012-08-18,14,242,349,591
14170,2012-08-18,15,250,342,592
14171,2012-08-18,16,288,345,633
14172,2012-08-18,17,256,372,628
14173,2012-08-18,18,224,321,545
14174,2012-08-18,19,164,315,479
14175,2012-08-18,20,99,234,333
14176,2012-08-18,21,90,242,332
14177,2012-08-18,22,90,167,257
14178,2012-08-18,23,60,170,230
14179,2012-08-19,0,44,138,182
14180,2012-08-19,1,29,99,128
14181,2012-08-19,2,16,102,118
14182,2012-08-19,3,21,33,54
14183,2012-08-19,4,4,22,26
14184,2012-08-19,5,3,8,11
14185,2012-08-19,6,5,15,20
14186,2012-08-19,7,12,29,41
14187,2012-08-19,8,34,88,122
14188,2012-08-19,9,86,182,268
14189,2012-08-19,10,138,281,419
14190,2012-08-19,11,83,187,270
14191,2012-08-19,12,111,183,294
14192,2012-08-19,13,50,110,160
14193,2012-08-19,14,41,107,148
14194,2012-08-19,15,89,186,275
14195,2012-08-19,16,97,255,352
14196,2012-08-19,17,76,262,338
14197,2012-08-19,18,86,290,376
14198,2012-08-19,19,72,262,334
14199,2012-08-19,20,61,209,270
14200,2012-08-19,21,36,152,188
14201,2012-08-19,22,6,48,54
14202,2012-08-19,23,7,39,46
14203,2012-08-20,0,1,25,26
14204,2012-08-20,1,0,10,10
14205,2012-08-20,2,0,5,5
14206,2012-08-20,3,0,3,3
14207,2012-08-20,4,0,7,7
14208,2012-08-20,5,2,35,37
14209,2012-08-20,6,6,154,160
14210,2012-08-20,7,15,420,435
14211,2012-08-20,8,37,617,654
14212,2012-08-20,9,55,298,353
14213,2012-08-20,10,69,122,191
14214,2012-08-20,11,90,148,238
14215,2012-08-20,12,66,211,277
14216,2012-08-20,13,97,191,288
14217,2012-08-20,14,87,185,272
14218,2012-08-20,15,102,205,307
14219,2012-08-20,16,103,356,459
14220,2012-08-20,17,83,801,884
14221,2012-08-20,18,89,724,813
14222,2012-08-20,19,33,262,295
14223,2012-08-20,20,30,229,259
14224,2012-08-20,21,26,218,244
14225,2012-08-20,22,25,135,160
14226,2012-08-20,23,10,92,102
14227,2012-08-21,0,7,52,59
14228,2012-08-21,1,11,21,32
14229,2012-08-21,2,1,7,8
14230,2012-08-21,3,0,3,3
14231,2012-08-21,4,0,4,4
14232,2012-08-21,5,4,30,34
14233,2012-08-21,6,5,161,166
14234,2012-08-21,7,19,491,510
14235,2012-08-21,8,27,690,717
14236,2012-08-21,9,47,278,325
14237,2012-08-21,10,58,118,176
14238,2012-08-21,11,61,194,255
14239,2012-08-21,12,79,226,305
14240,2012-08-21,13,76,253,329
14241,2012-08-21,14,110,190,300
14242,2012-08-21,15,76,218,294
14243,2012-08-21,16,109,355,464
14244,2012-08-21,17,92,776,868
14245,2012-08-21,18,92,530,622
14246,2012-08-21,19,57,418,475
14247,2012-08-21,20,62,292,354
14248,2012-08-21,21,41,237,278
14249,2012-08-21,22,24,203,227
14250,2012-08-21,23,23,113,136
14251,2012-08-22,0,9,46,55
14252,2012-08-22,1,1,20,21
14253,2012-08-22,2,7,10,17
14254,2012-08-22,3,0,6,6
14255,2012-08-22,4,1,7,8
14256,2012-08-22,5,2,38,40
14257,2012-08-22,6,12,174,186
14258,2012-08-22,7,16,533,549
14259,2012-08-22,8,37,694,731
14260,2012-08-22,9,41,334,375
14261,2012-08-22,10,66,156,222
14262,2012-08-22,11,71,193,264
14263,2012-08-22,12,59,251,310
14264,2012-08-22,13,73,240,313
14265,2012-08-22,14,83,182,265
14266,2012-08-22,15,94,219,313
14267,2012-08-22,16,102,354,456
14268,2012-08-22,17,72,702,774
14269,2012-08-22,18,91,589,680
14270,2012-08-22,19,56,518,574
14271,2012-08-22,20,59,324,383
14272,2012-08-22,21,60,287,347
14273,2012-08-22,22,55,223,278
14274,2012-08-22,23,27,111,138
14275,2012-08-23,0,9,51,60
14276,2012-08-23,1,10,15,25
14277,2012-08-23,2,9,11,20
14278,2012-08-23,3,3,5,8
14279,2012-08-23,4,0,6,6
14280,2012-08-23,5,1,35,36
14281,2012-08-23,6,14,176,190
14282,2012-08-23,7,18,456,474
14283,2012-08-23,8,45,657,702
14284,2012-08-23,9,58,349,407
14285,2012-08-23,10,76,156,232
14286,2012-08-23,11,86,189,275
14287,2012-08-23,12,97,235,332
14288,2012-08-23,13,93,250,343
14289,2012-08-23,14,114,190,304
14290,2012-08-23,15,104,199,303
14291,2012-08-23,16,119,341,460
14292,2012-08-23,17,111,704,815
14293,2012-08-23,18,128,802,930
14294,2012-08-23,19,96,532,628
14295,2012-08-23,20,70,399,469
14296,2012-08-23,21,53,266,319
14297,2012-08-23,22,21,176,197
14298,2012-08-23,23,24,130,154
14299,2012-08-24,0,27,84,111
14300,2012-08-24,1,5,37,42
14301,2012-08-24,2,1,15,16
14302,2012-08-24,3,2,6,8
14303,2012-08-24,4,2,6,8
14304,2012-08-24,5,1,37,38
14305,2012-08-24,6,9,140,149
14306,2012-08-24,7,13,408,421
14307,2012-08-24,8,41,695,736
14308,2012-08-24,9,58,327,385
14309,2012-08-24,10,78,183,261
14310,2012-08-24,11,69,208,277
14311,2012-08-24,12,95,276,371
14312,2012-08-24,13,79,269,348
14313,2012-08-24,14,109,223,332
14314,2012-08-24,15,99,251,350
14315,2012-08-24,16,101,409,510
14316,2012-08-24,17,117,687,804
14317,2012-08-24,18,109,621,730
14318,2012-08-24,19,106,423,529
14319,2012-08-24,20,66,292,358
14320,2012-08-24,21,58,245,303
14321,2012-08-24,22,42,207,249
14322,2012-08-24,23,37,140,177
14323,2012-08-25,0,21,111,132
14324,2012-08-25,1,15,100,115
14325,2012-08-25,2,18,61,79
14326,2012-08-25,3,7,31,38
14327,2012-08-25,4,3,9,12
14328,2012-08-25,5,4,10,14
14329,2012-08-25,6,5,25,30
14330,2012-08-25,7,14,87,101
14331,2012-08-25,8,29,129,158
14332,2012-08-25,9,60,219,279
14333,2012-08-25,10,147,286,433
14334,2012-08-25,11,144,303,447
14335,2012-08-25,12,217,363,580
14336,2012-08-25,13,186,327,513
14337,2012-08-25,14,150,319,469
14338,2012-08-25,15,79,153,232
14339,2012-08-25,16,174,258,432
14340,2012-08-25,17,132,269,401
14341,2012-08-25,18,122,258,380
14342,2012-08-25,19,97,252,349
14343,2012-08-25,20,65,173,238
14344,2012-08-25,21,60,148,208
14345,2012-08-25,22,46,130,176
14346,2012-08-25,23,34,122,156
14347,2012-08-26,0,23,109,132
14348,2012-08-26,1,18,111,129
14349,2012-08-26,2,12,99,111
14350,2012-08-26,3,11,40,51
14351,2012-08-26,4,5,11,16
14352,2012-08-26,5,3,12,15
14353,2012-08-26,6,5,16,21
14354,2012-08-26,7,11,23,34
14355,2012-08-26,8,21,108,129
14356,2012-08-26,9,67,191,258
14357,2012-08-26,10,127,256,383
14358,2012-08-26,11,150,329,479
14359,2012-08-26,12,224,394,618
14360,2012-08-26,13,167,370,537
14361,2012-08-26,14,125,245,370
14362,2012-08-26,15,132,255,387
14363,2012-08-26,16,57,113,170
14364,2012-08-26,17,61,167,228
14365,2012-08-26,18,77,183,260
14366,2012-08-26,19,80,210,290
14367,2012-08-26,20,40,167,207
14368,2012-08-26,21,26,137,163
14369,2012-08-26,22,20,93,113
14370,2012-08-26,23,21,57,78
14371,2012-08-27,0,4,28,32
14372,2012-08-27,1,3,4,7
14373,2012-08-27,2,0,8,8
14374,2012-08-27,3,1,3,4
14375,2012-08-27,4,1,11,12
14376,2012-08-27,5,4,32,36
14377,2012-08-27,6,4,140,144
14378,2012-08-27,7,15,411,426
14379,2012-08-27,8,29,643,672
14380,2012-08-27,9,40,294,334
14381,2012-08-27,10,63,142,205
14382,2012-08-27,11,47,167,214
14383,2012-08-27,12,69,214,283
14384,2012-08-27,13,77,211,288
14385,2012-08-27,14,66,180,246
14386,2012-08-27,15,77,201,278
14387,2012-08-27,16,76,365,441
14388,2012-08-27,17,101,738,839
14389,2012-08-27,18,83,736,819
14390,2012-08-27,19,74,494,568
14391,2012-08-27,20,50,363,413
14392,2012-08-27,21,39,235,274
14393,2012-08-27,22,30,127,157
14394,2012-08-27,23,35,79,114
14395,2012-08-28,0,9,29,38
14396,2012-08-28,1,4,17,21
14397,2012-08-28,2,2,13,15
14398,2012-08-28,3,0,4,4
14399,2012-08-28,4,2,6,8
14400,2012-08-28,5,3,38,41
14401,2012-08-28,6,3,144,147
14402,2012-08-28,7,14,254,268
14403,2012-08-28,8,25,664,689
14404,2012-08-28,9,44,349,393
14405,2012-08-28,10,39,163,202
14406,2012-08-28,11,47,170,217
14407,2012-08-28,12,56,238,294
14408,2012-08-28,13,56,232,288
14409,2012-08-28,14,72,177,249
14410,2012-08-28,15,59,257,316
14411,2012-08-28,16,84,395,479
14412,2012-08-28,17,90,760,850
14413,2012-08-28,18,82,730,812
14414,2012-08-28,19,82,509,591
14415,2012-08-28,20,87,341,428
14416,2012-08-28,21,38,272,310
14417,2012-08-28,22,20,196,216
14418,2012-08-28,23,17,90,107
14419,2012-08-29,0,8,39,47
14420,2012-08-29,1,2,11,13
14421,2012-08-29,2,2,4,6
14422,2012-08-29,3,0,9,9
14423,2012-08-29,4,2,8,10
14424,2012-08-29,5,3,37,40
14425,2012-08-29,6,6,174,180
14426,2012-08-29,7,23,526,549
14427,2012-08-29,8,28,775,803
14428,2012-08-29,9,40,304,344
14429,2012-08-29,10,34,143,177
14430,2012-08-29,11,67,186,253
14431,2012-08-29,12,79,270,349
14432,2012-08-29,13,68,230,298
14433,2012-08-29,14,87,214,301
14434,2012-08-29,15,96,239,335
14435,2012-08-29,16,104,387,491
14436,2012-08-29,17,108,758,866
14437,2012-08-29,18,119,689,808
14438,2012-08-29,19,120,514,634
14439,2012-08-29,20,49,372,421
14440,2012-08-29,21,48,262,310
14441,2012-08-29,22,50,185,235
14442,2012-08-29,23,34,123,157
14443,2012-08-30,0,14,51,65
14444,2012-08-30,1,6,17,23
14445,2012-08-30,2,3,14,17
14446,2012-08-30,3,0,5,5
14447,2012-08-30,4,4,4,8
14448,2012-08-30,5,2,33,35
14449,2012-08-30,6,8,153,161
14450,2012-08-30,7,31,494,525
14451,2012-08-30,8,53,692,745
14452,2012-08-30,9,57,333,390
14453,2012-08-30,10,73,158,231
14454,2012-08-30,11,84,183,267
14455,2012-08-30,12,73,220,293
14456,2012-08-30,13,76,211,287
14457,2012-08-30,14,74,198,272
14458,2012-08-30,15,99,238,337
14459,2012-08-30,16,77,396,473
14460,2012-08-30,17,93,743,836
14461,2012-08-30,18,109,735,844
14462,2012-08-30,19,78,526,604
14463,2012-08-30,20,68,400,468
14464,2012-08-30,21,32,273,305
14465,2012-08-30,22,38,250,288
14466,2012-08-30,23,19,132,151
14467,2012-08-31,0,13,70,83
14468,2012-08-31,1,8,24,32
14469,2012-08-31,2,9,11,20
14470,2012-08-31,3,3,2,5
14471,2012-08-31,4,0,7,7
14472,2012-08-31,5,2,27,29
14473,2012-08-31,6,7,101,108
14474,2012-08-31,7,21,397,418
14475,2012-08-31,8,36,643,679
14476,2012-08-31,9,61,331,392
14477,2012-08-31,10,59,197,256
14478,2012-08-31,11,88,219,307
14479,2012-08-31,12,120,286,406
14480,2012-08-31,13,97,268,365
14481,2012-08-31,14,112,320,432
14482,2012-08-31,15,109,416,525
14483,2012-08-31,16,111,410,521
14484,2012-08-31,17,129,482,611
14485,2012-08-31,18,87,454,541
14486,2012-08-31,19,90,353,443
14487,2012-08-31,20,102,250,352
14488,2012-08-31,21,71,227,298
14489,2012-08-31,22,65,206,271
14490,2012-08-31,23,32,141,173
14491,2012-09-01,0,22,144,166
14492,2012-09-01,1,11,67,78
14493,2012-09-01,2,8,59,67
14494,2012-09-01,3,6,29,35
14495,2012-09-01,4,3,9,12
14496,2012-09-01,5,2,19,21
14497,2012-09-01,6,13,23,36
14498,2012-09-01,7,8,57,65
14499,2012-09-01,8,28,134,162
14500,2012-09-01,9,62,170,232
14501,2012-09-01,10,128,286,414
14502,2012-09-01,11,219,268,487
14503,2012-09-01,12,187,279,466
14504,2012-09-01,13,237,265,502
14505,2012-09-01,14,240,268,508
14506,2012-09-01,15,257,302,559
14507,2012-09-01,16,209,251,460
14508,2012-09-01,17,205,254,459
14509,2012-09-01,18,183,256,439
14510,2012-09-01,19,156,230,386
14511,2012-09-01,20,67,135,202
14512,2012-09-01,21,21,83,104
14513,2012-09-01,22,21,55,76
14514,2012-09-01,23,57,87,144
14515,2012-09-02,0,27,72,99
14516,2012-09-02,1,15,57,72
14517,2012-09-02,2,28,55,83
14518,2012-09-02,3,9,33,42
14519,2012-09-02,4,7,10,17
14520,2012-09-02,5,2,8,10
14521,2012-09-02,6,2,13,15
14522,2012-09-02,7,13,29,42
14523,2012-09-02,8,30,99,129
14524,2012-09-02,9,88,143,231
14525,2012-09-02,10,158,225,383
14526,2012-09-02,11,226,259,485
14527,2012-09-02,12,248,292,540
14528,2012-09-02,13,262,229,491
14529,2012-09-02,14,249,205,454
14530,2012-09-02,15,178,169,347
14531,2012-09-02,16,222,241,463
14532,2012-09-02,17,219,281,500
14533,2012-09-02,18,227,271,498
14534,2012-09-02,19,140,150,290
14535,2012-09-02,20,63,40,103
14536,2012-09-02,21,79,92,171
14537,2012-09-02,22,66,97,163
14538,2012-09-02,23,53,67,120
14539,2012-09-03,0,42,60,102
14540,2012-09-03,1,18,36,54
14541,2012-09-03,2,10,30,40
14542,2012-09-03,3,6,22,28
14543,2012-09-03,4,6,5,11
14544,2012-09-03,5,1,3,4
14545,2012-09-03,6,3,12,15
14546,2012-09-03,7,6,37,43
14547,2012-09-03,8,36,87,123
14548,2012-09-03,9,71,154,225
14549,2012-09-03,10,135,220,355
14550,2012-09-03,11,187,265,452
14551,2012-09-03,12,191,346,537
14552,2012-09-03,13,209,350,559
14553,2012-09-03,14,163,338,501
14554,2012-09-03,15,168,278,446
14555,2012-09-03,16,165,333,498
14556,2012-09-03,17,181,312,493
14557,2012-09-03,18,145,328,473
14558,2012-09-03,19,73,296,369
14559,2012-09-03,20,78,179,257
14560,2012-09-03,21,42,139,181
14561,2012-09-03,22,17,104,121
14562,2012-09-03,23,12,58,70
14563,2012-09-04,0,10,18,28
14564,2012-09-04,1,15,9,24
14565,2012-09-04,2,1,3,4
14566,2012-09-04,3,1,9,10
14567,2012-09-04,4,0,8,8
14568,2012-09-04,5,1,36,37
14569,2012-09-04,6,7,164,171
14570,2012-09-04,7,13,471,484
14571,2012-09-04,8,15,613,628
14572,2012-09-04,9,30,288,318
14573,2012-09-04,10,42,127,169
14574,2012-09-04,11,39,156,195
14575,2012-09-04,12,54,232,286
14576,2012-09-04,13,72,200,272
14577,2012-09-04,14,72,201,273
14578,2012-09-04,15,68,222,290
14579,2012-09-04,16,61,395,456
14580,2012-09-04,17,110,736,846
14581,2012-09-04,18,94,736,830
14582,2012-09-04,19,50,496,546
14583,2012-09-04,20,47,334,381
14584,2012-09-04,21,28,238,266
14585,2012-09-04,22,25,146,171
14586,2012-09-04,23,12,82,94
14587,2012-09-05,0,10,27,37
14588,2012-09-05,1,2,11,13
14589,2012-09-05,2,0,9,9
14590,2012-09-05,3,0,4,4
14591,2012-09-05,4,2,3,5
14592,2012-09-05,5,1,38,39
14593,2012-09-05,6,7,203,210
14594,2012-09-05,7,11,483,494
14595,2012-09-05,8,33,690,723
14596,2012-09-05,9,27,260,287
14597,2012-09-05,10,54,177,231
14598,2012-09-05,11,61,156,217
14599,2012-09-05,12,49,210,259
14600,2012-09-05,13,50,178,228
14601,2012-09-05,14,34,175,209
14602,2012-09-05,15,41,202,243
14603,2012-09-05,16,86,342,428
14604,2012-09-05,17,83,779,862
14605,2012-09-05,18,82,754,836
14606,2012-09-05,19,64,589,653
14607,2012-09-05,20,55,353,408
14608,2012-09-05,21,18,274,292
14609,2012-09-05,22,38,179,217
14610,2012-09-05,23,24,126,150
14611,2012-09-06,0,30,34,64
14612,2012-09-06,1,2,16,18
14613,2012-09-06,2,1,7,8
14614,2012-09-06,3,0,9,9
14615,2012-09-06,4,0,8,8
14616,2012-09-06,5,3,35,38
14617,2012-09-06,6,11,189,200
14618,2012-09-06,7,21,455,476
14619,2012-09-06,8,24,617,641
14620,2012-09-06,9,8,115,123
14621,2012-09-06,10,9,36,45
14622,2012-09-06,11,10,51,61
14623,2012-09-06,12,11,123,134
14624,2012-09-06,13,38,150,188
14625,2012-09-06,14,39,177,216
14626,2012-09-06,15,42,226,268
14627,2012-09-06,16,42,372,414
14628,2012-09-06,17,67,735,802
14629,2012-09-06,18,74,751,825
14630,2012-09-06,19,54,494,548
14631,2012-09-06,20,50,354,404
14632,2012-09-06,21,32,233,265
14633,2012-09-06,22,24,190,214
14634,2012-09-06,23,19,147,166
14635,2012-09-07,0,17,75,92
14636,2012-09-07,1,10,19,29
14637,2012-09-07,2,1,9,10
14638,2012-09-07,3,0,9,9
14639,2012-09-07,4,1,7,8
14640,2012-09-07,5,1,39,40
14641,2012-09-07,6,5,134,139
14642,2012-09-07,7,21,461,482
14643,2012-09-07,8,29,681,710
14644,2012-09-07,9,33,310,343
14645,2012-09-07,10,53,163,216
14646,2012-09-07,11,81,212,293
14647,2012-09-07,12,75,239,314
14648,2012-09-07,13,71,278,349
14649,2012-09-07,14,66,185,251
14650,2012-09-07,15,66,262,328
14651,2012-09-07,16,75,388,463
14652,2012-09-07,17,88,678,766
14653,2012-09-07,18,95,689,784
14654,2012-09-07,19,70,494,564
14655,2012-09-07,20,51,335,386
14656,2012-09-07,21,55,240,295
14657,2012-09-07,22,52,241,293
14658,2012-09-07,23,28,217,245
14659,2012-09-08,0,20,128,148
14660,2012-09-08,1,10,105,115
14661,2012-09-08,2,9,68,77
14662,2012-09-08,3,3,38,41
14663,2012-09-08,4,3,8,11
14664,2012-09-08,5,2,13,15
14665,2012-09-08,6,8,24,32
14666,2012-09-08,7,11,71,82
14667,2012-09-08,8,33,197,230
14668,2012-09-08,9,87,257,344
14669,2012-09-08,10,100,319,419
14670,2012-09-08,11,173,403,576
14671,2012-09-08,12,220,464,684
14672,2012-09-08,13,232,426,658
14673,2012-09-08,14,261,361,622
14674,2012-09-08,15,175,326,501
14675,2012-09-08,16,19,94,113
14676,2012-09-08,17,52,116,168
14677,2012-09-08,18,27,139,166
14678,2012-09-08,19,28,183,211
14679,2012-09-08,20,28,162,190
14680,2012-09-08,21,27,155,182
14681,2012-09-08,22,18,173,191
14682,2012-09-08,23,12,117,129
14683,2012-09-09,0,18,104,122
14684,2012-09-09,1,20,104,124
14685,2012-09-09,2,15,79,94
14686,2012-09-09,3,14,31,45
14687,2012-09-09,4,12,16,28
14688,2012-09-09,5,16,38,54
14689,2012-09-09,6,11,23,34
14690,2012-09-09,7,19,48,67
14691,2012-09-09,8,27,142,169
14692,2012-09-09,9,85,208,293
14693,2012-09-09,10,172,319,491
14694,2012-09-09,11,194,384,578
14695,2012-09-09,12,247,501,748
14696,2012-09-09,13,238,487,725
14697,2012-09-09,14,232,405,637
14698,2012-09-09,15,284,397,681
14699,2012-09-09,16,228,466,694
14700,2012-09-09,17,213,448,661
14701,2012-09-09,18,156,395,551
14702,2012-09-09,19,134,354,488
14703,2012-09-09,20,91,259,350
14704,2012-09-09,21,57,147,204
14705,2012-09-09,22,64,124,188
14706,2012-09-09,23,22,69,91
14707,2012-09-10,0,6,35,41
14708,2012-09-10,1,7,11,18
14709,2012-09-10,2,11,6,17
14710,2012-09-10,3,5,7,12
14711,2012-09-10,4,1,4,5
14712,2012-09-10,5,4,36,40
14713,2012-09-10,6,8,169,177
14714,2012-09-10,7,20,424,444
14715,2012-09-10,8,33,688,721
14716,2012-09-10,9,40,315,355
14717,2012-09-10,10,42,163,205
14718,2012-09-10,11,69,167,236
14719,2012-09-10,12,75,254,329
14720,2012-09-10,13,73,246,319
14721,2012-09-10,14,107,225,332
14722,2012-09-10,15,115,228,343
14723,2012-09-10,16,108,378,486
14724,2012-09-10,17,127,736,863
14725,2012-09-10,18,111,843,954
14726,2012-09-10,19,71,556,627
14727,2012-09-10,20,34,351,385
14728,2012-09-10,21,29,251,280
14729,2012-09-10,22,15,140,155
14730,2012-09-10,23,7,86,93
14731,2012-09-11,0,5,26,31
14732,2012-09-11,1,0,10,10
14733,2012-09-11,2,1,5,6
14734,2012-09-11,3,1,7,8
14735,2012-09-11,4,1,8,9
14736,2012-09-11,5,3,40,43
14737,2012-09-11,6,11,199,210
14738,2012-09-11,7,24,571,595
14739,2012-09-11,8,48,696,744
14740,2012-09-11,9,35,319,354
14741,2012-09-11,10,54,137,191
14742,2012-09-11,11,60,185,245
14743,2012-09-11,12,62,252,314
14744,2012-09-11,13,72,253,325
14745,2012-09-11,14,74,177,251
14746,2012-09-11,15,73,250,323
14747,2012-09-11,16,98,433,531
14748,2012-09-11,17,168,793,961
14749,2012-09-11,18,110,754,864
14750,2012-09-11,19,56,537,593
14751,2012-09-11,20,40,418,458
14752,2012-09-11,21,28,279,307
14753,2012-09-11,22,27,186,213
14754,2012-09-11,23,18,91,109
14755,2012-09-12,0,8,41,49
14756,2012-09-12,1,2,19,21
14757,2012-09-12,2,2,9,11
14758,2012-09-12,3,0,7,7
14759,2012-09-12,4,0,5,5
14760,2012-09-12,5,4,44,48
14761,2012-09-12,6,6,196,202
14762,2012-09-12,7,24,528,552
14763,2012-09-12,8,43,722,765
14764,2012-09-12,9,50,273,323
14765,2012-09-12,10,57,145,202
14766,2012-09-12,11,51,180,231
14767,2012-09-12,12,88,263,351
14768,2012-09-12,13,85,236,321
14769,2012-09-12,14,78,198,276
14770,2012-09-12,15,75,241,316
14771,2012-09-12,16,90,417,507
14772,2012-09-12,17,114,803,917
14773,2012-09-12,18,91,877,968
14774,2012-09-12,19,78,553,631
14775,2012-09-12,20,37,426,463
14776,2012-09-12,21,28,273,301
14777,2012-09-12,22,23,186,209
14778,2012-09-12,23,16,108,124
14779,2012-09-13,0,11,46,57
14780,2012-09-13,1,6,22,28
14781,2012-09-13,2,0,8,8
14782,2012-09-13,3,2,9,11
14783,2012-09-13,4,0,6,6
14784,2012-09-13,5,3,53,56
14785,2012-09-13,6,9,186,195
14786,2012-09-13,7,22,545,567
14787,2012-09-13,8,33,717,750
14788,2012-09-13,9,46,290,336
14789,2012-09-13,10,63,146,209
14790,2012-09-13,11,71,183,254
14791,2012-09-13,12,57,239,296
14792,2012-09-13,13,60,221,281
14793,2012-09-13,14,60,209,269
14794,2012-09-13,15,99,251,350
14795,2012-09-13,16,85,397,482
14796,2012-09-13,17,97,784,881
14797,2012-09-13,18,108,740,848
14798,2012-09-13,19,80,589,669
14799,2012-09-13,20,55,403,458
14800,2012-09-13,21,26,289,315
14801,2012-09-13,22,28,219,247
14802,2012-09-13,23,33,136,169
14803,2012-09-14,0,24,63,87
14804,2012-09-14,1,6,34,40
14805,2012-09-14,2,7,23,30
14806,2012-09-14,3,5,8,13
14807,2012-09-14,4,1,11,12
14808,2012-09-14,5,1,39,40
14809,2012-09-14,6,8,142,150
14810,2012-09-14,7,17,434,451
14811,2012-09-14,8,51,710,761
14812,2012-09-14,9,46,300,346
14813,2012-09-14,10,75,167,242
14814,2012-09-14,11,84,194,278
14815,2012-09-14,12,119,287,406
14816,2012-09-14,13,107,299,406
14817,2012-09-14,14,113,254,367
14818,2012-09-14,15,94,267,361
14819,2012-09-14,16,109,448,557
14820,2012-09-14,17,137,746,883
14821,2012-09-14,18,116,683,799
14822,2012-09-14,19,83,491,574
14823,2012-09-14,20,66,332,398
14824,2012-09-14,21,43,266,309
14825,2012-09-14,22,40,186,226
14826,2012-09-14,23,27,159,186
14827,2012-09-15,0,38,166,204
14828,2012-09-15,1,8,98,106
14829,2012-09-15,2,18,74,92
14830,2012-09-15,3,6,30,36
14831,2012-09-15,4,3,3,6
14832,2012-09-15,5,1,15,16
14833,2012-09-15,6,6,27,33
14834,2012-09-15,7,10,63,73
14835,2012-09-15,8,43,166,209
14836,2012-09-15,9,79,256,335
14837,2012-09-15,10,119,318,437
14838,2012-09-15,11,228,398,626
14839,2012-09-15,12,287,414,701
14840,2012-09-15,13,327,372,699
14841,2012-09-15,14,325,381,706
14842,2012-09-15,15,312,336,648
14843,2012-09-15,16,351,423,774
14844,2012-09-15,17,295,426,721
14845,2012-09-15,18,232,378,610
14846,2012-09-15,19,169,297,466
14847,2012-09-15,20,89,240,329
14848,2012-09-15,21,86,209,295
14849,2012-09-15,22,82,193,275
14850,2012-09-15,23,47,179,226
14851,2012-09-16,0,28,119,147
14852,2012-09-16,1,35,82,117
14853,2012-09-16,2,27,61,88
14854,2012-09-16,3,10,38,48
14855,2012-09-16,4,2,6,8
14856,2012-09-16,5,3,9,12
14857,2012-09-16,6,9,25,34
14858,2012-09-16,7,28,43,71
14859,2012-09-16,8,34,94,128
14860,2012-09-16,9,70,223,293
14861,2012-09-16,10,160,326,486
14862,2012-09-16,11,183,371,554
14863,2012-09-16,12,187,464,651
14864,2012-09-16,13,241,443,684
14865,2012-09-16,14,224,402,626
14866,2012-09-16,15,214,337,551
14867,2012-09-16,16,194,397,591
14868,2012-09-16,17,177,386,563
14869,2012-09-16,18,120,354,474
14870,2012-09-16,19,91,306,397
14871,2012-09-16,20,57,264,321
14872,2012-09-16,21,43,145,188
14873,2012-09-16,22,18,105,123
14874,2012-09-16,23,9,83,92
14875,2012-09-17,0,14,32,46
14876,2012-09-17,1,9,11,20
14877,2012-09-17,2,5,8,13
14878,2012-09-17,3,0,7,7
14879,2012-09-17,4,2,9,11
14880,2012-09-17,5,1,44,45
14881,2012-09-17,6,7,154,161
14882,2012-09-17,7,18,468,486
14883,2012-09-17,8,36,637,673
14884,2012-09-17,9,34,261,295
14885,2012-09-17,10,73,126,199
14886,2012-09-17,11,61,186,247
14887,2012-09-17,12,62,223,285
14888,2012-09-17,13,112,224,336
14889,2012-09-17,14,129,196,325
14890,2012-09-17,15,82,244,326
14891,2012-09-17,16,74,378,452
14892,2012-09-17,17,102,730,832
14893,2012-09-17,18,66,703,769
14894,2012-09-17,19,51,431,482
14895,2012-09-17,20,32,305,337
14896,2012-09-17,21,28,203,231
14897,2012-09-17,22,20,108,128
14898,2012-09-17,23,4,64,68
14899,2012-09-18,0,2,11,13
14900,2012-09-18,1,0,5,5
14901,2012-09-18,2,0,4,4
14902,2012-09-18,3,0,6,6
14903,2012-09-18,4,2,5,7
14904,2012-09-18,5,3,45,48
14905,2012-09-18,6,4,162,166
14906,2012-09-18,7,13,340,353
14907,2012-09-18,8,32,634,666
14908,2012-09-18,9,27,265,292
14909,2012-09-18,10,30,124,154
14910,2012-09-18,11,36,111,147
14911,2012-09-18,12,16,71,87
14912,2012-09-18,13,17,97,114
14913,2012-09-18,14,27,112,139
14914,2012-09-18,15,1,35,36
14915,2012-09-18,16,19,122,141
14916,2012-09-18,17,36,300,336
14917,2012-09-18,18,19,259,278
14918,2012-09-18,19,22,299,321
14919,2012-09-18,20,19,264,283
14920,2012-09-18,21,21,186,207
14921,2012-09-18,22,14,135,149
14922,2012-09-18,23,11,66,77
14923,2012-09-19,0,3,23,26
14924,2012-09-19,1,0,10,10
14925,2012-09-19,2,0,3,3
14926,2012-09-19,3,1,4,5
14927,2012-09-19,4,0,10,10
14928,2012-09-19,5,2,53,55
14929,2012-09-19,6,6,165,171
14930,2012-09-19,7,16,528,544
14931,2012-09-19,8,39,752,791
14932,2012-09-19,9,26,333,359
14933,2012-09-19,10,23,167,190
14934,2012-09-19,11,44,203,247
14935,2012-09-19,12,53,255,308
14936,2012-09-19,13,55,232,287
14937,2012-09-19,14,59,222,281
14938,2012-09-19,15,57,253,310
14939,2012-09-19,16,68,394,462
14940,2012-09-19,17,74,800,874
14941,2012-09-19,18,85,798,883
14942,2012-09-19,19,72,537,609
14943,2012-09-19,20,31,371,402
14944,2012-09-19,21,25,314,339
14945,2012-09-19,22,31,196,227
14946,2012-09-19,23,17,106,123
14947,2012-09-20,0,12,46,58
14948,2012-09-20,1,4,14,18
14949,2012-09-20,2,2,9,11
14950,2012-09-20,3,0,6,6
14951,2012-09-20,4,0,6,6
14952,2012-09-20,5,4,52,56
14953,2012-09-20,6,9,161,170
14954,2012-09-20,7,20,510,530
14955,2012-09-20,8,44,734,778
14956,2012-09-20,9,25,328,353
14957,2012-09-20,10,33,155,188
14958,2012-09-20,11,37,201,238
14959,2012-09-20,12,57,231,288
14960,2012-09-20,13,68,264,332
14961,2012-09-20,14,75,221,296
14962,2012-09-20,15,60,231,291
14963,2012-09-20,16,72,385,457
14964,2012-09-20,17,91,877,968
14965,2012-09-20,18,119,775,894
14966,2012-09-20,19,69,528,597
14967,2012-09-20,20,57,357,414
14968,2012-09-20,21,28,243,271
14969,2012-09-20,22,35,249,284
14970,2012-09-20,23,17,137,154
14971,2012-09-21,0,13,53,66
14972,2012-09-21,1,11,38,49
14973,2012-09-21,2,6,8,14
14974,2012-09-21,3,1,11,12
14975,2012-09-21,4,1,9,10
14976,2012-09-21,5,2,47,49
14977,2012-09-21,6,19,145,164
14978,2012-09-21,7,35,463,498
14979,2012-09-21,8,31,714,745
14980,2012-09-21,9,35,346,381
14981,2012-09-21,10,44,180,224
14982,2012-09-21,11,79,239,318
14983,2012-09-21,12,84,300,384
14984,2012-09-21,13,105,310,415
14985,2012-09-21,14,113,292,405
14986,2012-09-21,15,90,327,417
14987,2012-09-21,16,103,463,566
14988,2012-09-21,17,107,732,839
14989,2012-09-21,18,106,688,794
14990,2012-09-21,19,95,487,582
14991,2012-09-21,20,54,310,364
14992,2012-09-21,21,46,261,307
14993,2012-09-21,22,47,244,291
14994,2012-09-21,23,23,159,182
14995,2012-09-22,0,32,138,170
14996,2012-09-22,1,18,104,122
14997,2012-09-22,2,10,72,82
14998,2012-09-22,3,6,39,45
14999,2012-09-22,4,5,10,15
15000,2012-09-22,5,2,15,17
15001,2012-09-22,6,6,35,41
15002,2012-09-22,7,7,70,77
15003,2012-09-22,8,21,196,217
15004,2012-09-22,9,88,285,373
15005,2012-09-22,10,124,341,465
15006,2012-09-22,11,189,435,624
15007,2012-09-22,12,228,455,683
15008,2012-09-22,13,273,430,703
15009,2012-09-22,14,249,396,645
15010,2012-09-22,15,307,440,747
15011,2012-09-22,16,253,423,676
15012,2012-09-22,17,195,443,638
15013,2012-09-22,18,171,417,588
15014,2012-09-22,19,99,304,403
15015,2012-09-22,20,76,246,322
15016,2012-09-22,21,59,200,259
15017,2012-09-22,22,59,176,235
15018,2012-09-22,23,34,135,169
15019,2012-09-23,0,34,144,178
15020,2012-09-23,1,23,117,140
15021,2012-09-23,2,18,76,94
15022,2012-09-23,3,13,41,54
15023,2012-09-23,4,1,9,10
15024,2012-09-23,5,1,5,6
15025,2012-09-23,6,5,11,16
15026,2012-09-23,7,9,47,56
15027,2012-09-23,8,38,135,173
15028,2012-09-23,9,71,203,274
15029,2012-09-23,10,138,347,485
15030,2012-09-23,11,186,377,563
15031,2012-09-23,12,250,513,763
15032,2012-09-23,13,257,438,695
15033,2012-09-23,14,266,391,657
15034,2012-09-23,15,265,374,639
15035,2012-09-23,16,254,432,686
15036,2012-09-23,17,227,489,716
15037,2012-09-23,18,135,401,536
15038,2012-09-23,19,82,322,404
15039,2012-09-23,20,60,192,252
15040,2012-09-23,21,51,143,194
15041,2012-09-23,22,40,96,136
15042,2012-09-23,23,30,69,99
15043,2012-09-24,0,10,53,63
15044,2012-09-24,1,6,12,18
15045,2012-09-24,2,0,8,8
15046,2012-09-24,3,0,5,5
15047,2012-09-24,4,0,8,8
15048,2012-09-24,5,2,35,37
15049,2012-09-24,6,6,161,167
15050,2012-09-24,7,17,506,523
15051,2012-09-24,8,31,710,741
15052,2012-09-24,9,42,276,318
15053,2012-09-24,10,52,143,195
15054,2012-09-24,11,70,164,234
15055,2012-09-24,12,78,247,325
15056,2012-09-24,13,80,243,323
15057,2012-09-24,14,77,223,300
15058,2012-09-24,15,84,213,297
15059,2012-09-24,16,99,414,513
15060,2012-09-24,17,89,805,894
15061,2012-09-24,18,95,749,844
15062,2012-09-24,19,56,528,584
15063,2012-09-24,20,52,372,424
15064,2012-09-24,21,26,228,254
15065,2012-09-24,22,18,153,171
15066,2012-09-24,23,11,83,94
15067,2012-09-25,0,8,56,64
15068,2012-09-25,1,2,11,13
15069,2012-09-25,2,5,9,14
15070,2012-09-25,3,2,3,5
15071,2012-09-25,4,2,7,9
15072,2012-09-25,5,1,46,47
15073,2012-09-25,6,5,185,190
15074,2012-09-25,7,17,534,551
15075,2012-09-25,8,41,751,792
15076,2012-09-25,9,28,377,405
15077,2012-09-25,10,45,122,167
15078,2012-09-25,11,63,153,216
15079,2012-09-25,12,69,230,299
15080,2012-09-25,13,48,257,305
15081,2012-09-25,14,80,207,287
15082,2012-09-25,15,56,247,303
15083,2012-09-25,16,59,431,490
15084,2012-09-25,17,107,857,964
15085,2012-09-25,18,64,756,820
15086,2012-09-25,19,49,487,536
15087,2012-09-25,20,37,378,415
15088,2012-09-25,21,34,260,294
15089,2012-09-25,22,14,171,185
15090,2012-09-25,23,9,87,96
15091,2012-09-26,0,6,32,38
15092,2012-09-26,1,10,19,29
15093,2012-09-26,2,2,15,17
15094,2012-09-26,3,4,6,10
15095,2012-09-26,4,2,10,12
15096,2012-09-26,5,1,35,36
15097,2012-09-26,6,3,177,180
15098,2012-09-26,7,9,517,526
15099,2012-09-26,8,30,797,827
15100,2012-09-26,9,27,307,334
15101,2012-09-26,10,29,153,182
15102,2012-09-26,11,46,180,226
15103,2012-09-26,12,56,260,316
15104,2012-09-26,13,67,268,335
15105,2012-09-26,14,60,213,273
15106,2012-09-26,15,69,231,300
15107,2012-09-26,16,71,395,466
15108,2012-09-26,17,77,870,947
15109,2012-09-26,18,69,805,874
15110,2012-09-26,19,38,585,623
15111,2012-09-26,20,45,385,430
15112,2012-09-26,21,32,326,358
15113,2012-09-26,22,21,188,209
15114,2012-09-26,23,13,100,113
15115,2012-09-27,0,5,60,65
15116,2012-09-27,1,5,16,21
15117,2012-09-27,2,3,13,16
15118,2012-09-27,3,0,7,7
15119,2012-09-27,4,2,6,8
15120,2012-09-27,5,2,53,55
15121,2012-09-27,6,5,159,164
15122,2012-09-27,7,12,539,551
15123,2012-09-27,8,20,765,785
15124,2012-09-27,9,30,302,332
15125,2012-09-27,10,40,166,206
15126,2012-09-27,11,67,225,292
15127,2012-09-27,12,63,270,333
15128,2012-09-27,13,61,258,319
15129,2012-09-27,14,44,211,255
15130,2012-09-27,15,41,255,296
15131,2012-09-27,16,73,396,469
15132,2012-09-27,17,87,809,896
15133,2012-09-27,18,77,815,892
15134,2012-09-27,19,48,508,556
15135,2012-09-27,20,45,406,451
15136,2012-09-27,21,18,232,250
15137,2012-09-27,22,2,45,47
15138,2012-09-27,23,1,44,45
15139,2012-09-28,0,2,15,17
15140,2012-09-28,1,0,12,12
15141,2012-09-28,2,1,9,10
15142,2012-09-28,3,0,7,7
15143,2012-09-28,4,2,10,12
15144,2012-09-28,5,1,36,37
15145,2012-09-28,6,2,135,137
15146,2012-09-28,7,10,382,392
15147,2012-09-28,8,31,668,699
15148,2012-09-28,9,27,398,425
15149,2012-09-28,10,51,192,243
15150,2012-09-28,11,109,245,354
15151,2012-09-28,12,94,279,373
15152,2012-09-28,13,106,299,405
15153,2012-09-28,14,105,289,394
15154,2012-09-28,15,104,287,391
15155,2012-09-28,16,83,417,500
15156,2012-09-28,17,101,698,799
15157,2012-09-28,18,58,601,659
15158,2012-09-28,19,38,465,503
15159,2012-09-28,20,32,300,332
15160,2012-09-28,21,32,203,235
15161,2012-09-28,22,30,183,213
15162,2012-09-28,23,26,160,186
15163,2012-09-29,0,15,132,147
15164,2012-09-29,1,12,89,101
15165,2012-09-29,2,12,79,91
15166,2012-09-29,3,4,25,29
15167,2012-09-29,4,6,8,14
15168,2012-09-29,5,2,11,13
15169,2012-09-29,6,4,33,37
15170,2012-09-29,7,12,61,73
15171,2012-09-29,8,36,170,206
15172,2012-09-29,9,70,263,333
15173,2012-09-29,10,134,334,468
15174,2012-09-29,11,217,437,654
15175,2012-09-29,12,191,483,674
15176,2012-09-29,13,233,450,683
15177,2012-09-29,14,302,440,742
15178,2012-09-29,15,271,450,721
15179,2012-09-29,16,275,442,717
15180,2012-09-29,17,256,444,700
15181,2012-09-29,18,174,414,588
15182,2012-09-29,19,119,346,465
15183,2012-09-29,20,88,224,312
15184,2012-09-29,21,73,219,292
15185,2012-09-29,22,48,169,217
15186,2012-09-29,23,35,158,193
15187,2012-09-30,0,35,109,144
15188,2012-09-30,1,31,85,116
15189,2012-09-30,2,21,69,90
15190,2012-09-30,3,17,40,57
15191,2012-09-30,4,1,6,7
15192,2012-09-30,5,1,8,9
15193,2012-09-30,6,2,20,22
15194,2012-09-30,7,14,42,56
15195,2012-09-30,8,18,123,141
15196,2012-09-30,9,74,209,283
15197,2012-09-30,10,160,314,474
15198,2012-09-30,11,222,365,587
15199,2012-09-30,12,205,466,671
15200,2012-09-30,13,181,408,589
15201,2012-09-30,14,208,399,607
15202,2012-09-30,15,230,415,645
15203,2012-09-30,16,202,439,641
15204,2012-09-30,17,195,374,569
15205,2012-09-30,18,91,299,390
15206,2012-09-30,19,34,222,256
15207,2012-09-30,20,31,161,192
15208,2012-09-30,21,19,98,117
15209,2012-09-30,22,15,76,91
15210,2012-09-30,23,8,50,58
15211,2012-10-01,0,6,38,44
15212,2012-10-01,1,5,13,18
15213,2012-10-01,2,6,6,12
15214,2012-10-01,3,1,6,7
15215,2012-10-01,4,0,10,10
15216,2012-10-01,5,2,34,36
15217,2012-10-01,6,8,146,154
15218,2012-10-01,7,13,466,479
15219,2012-10-01,8,40,739,779
15220,2012-10-01,9,26,308,334
15221,2012-10-01,10,44,133,177
15222,2012-10-01,11,76,192,268
15223,2012-10-01,12,61,259,320
15224,2012-10-01,13,80,222,302
15225,2012-10-01,14,51,191,242
15226,2012-10-01,15,95,231,326
15227,2012-10-01,16,51,406,457
15228,2012-10-01,17,65,776,841
15229,2012-10-01,18,42,565,607
15230,2012-10-01,19,33,478,511
15231,2012-10-01,20,11,246,257
15232,2012-10-01,21,13,197,210
15233,2012-10-01,22,17,187,204
15234,2012-10-01,23,17,87,104
15235,2012-10-02,0,1,29,30
15236,2012-10-02,1,0,11,11
15237,2012-10-02,2,0,2,2
15238,2012-10-02,3,1,4,5
15239,2012-10-02,4,2,8,10
15240,2012-10-02,5,1,42,43
15241,2012-10-02,6,3,175,178
15242,2012-10-02,7,4,252,256
15243,2012-10-02,8,6,127,133
15244,2012-10-02,9,3,83,86
15245,2012-10-02,10,3,41,44
15246,2012-10-02,11,7,89,96
15247,2012-10-02,12,6,97,103
15248,2012-10-02,13,6,146,152
15249,2012-10-02,14,16,143,159
15250,2012-10-02,15,14,194,208
15251,2012-10-02,16,46,325,371
15252,2012-10-02,17,38,671,709
15253,2012-10-02,18,48,630,678
15254,2012-10-02,19,27,364,391
15255,2012-10-02,20,20,279,299
15256,2012-10-02,21,24,263,287
15257,2012-10-02,22,28,210,238
15258,2012-10-02,23,11,87,98
15259,2012-10-03,0,5,47,52
15260,2012-10-03,1,3,16,19
15261,2012-10-03,2,2,7,9
15262,2012-10-03,3,0,7,7
15263,2012-10-03,4,2,9,11
15264,2012-10-03,5,2,32,34
15265,2012-10-03,6,4,167,171
15266,2012-10-03,7,11,492,503
15267,2012-10-03,8,28,774,802
15268,2012-10-03,9,30,330,360
15269,2012-10-03,10,29,143,172
15270,2012-10-03,11,52,177,229
15271,2012-10-03,12,69,288,357
15272,2012-10-03,13,55,222,277
15273,2012-10-03,14,55,193,248
15274,2012-10-03,15,59,254,313
15275,2012-10-03,16,42,433,475
15276,2012-10-03,17,84,825,909
15277,2012-10-03,18,54,755,809
15278,2012-10-03,19,49,542,591
15279,2012-10-03,20,48,438,486
15280,2012-10-03,21,14,193,207
15281,2012-10-03,22,9,228,237
15282,2012-10-03,23,21,197,218
15283,2012-10-04,0,11,64,75
15284,2012-10-04,1,2,23,25
15285,2012-10-04,2,3,10,13
15286,2012-10-04,3,5,6,11
15287,2012-10-04,4,0,10,10
15288,2012-10-04,5,2,37,39
15289,2012-10-04,6,1,131,132
15290,2012-10-04,7,12,378,390
15291,2012-10-04,8,27,708,735
15292,2012-10-04,9,40,317,357
15293,2012-10-04,10,27,148,175
15294,2012-10-04,11,38,174,212
15295,2012-10-04,12,57,229,286
15296,2012-10-04,13,63,228,291
15297,2012-10-04,14,56,205,261
15298,2012-10-04,15,77,247,324
15299,2012-10-04,16,86,410,496
15300,2012-10-04,17,112,782,894
15301,2012-10-04,18,75,805,880
15302,2012-10-04,19,67,462,529
15303,2012-10-04,20,50,390,440
15304,2012-10-04,21,33,284,317
15305,2012-10-04,22,29,202,231
15306,2012-10-04,23,18,134,152
15307,2012-10-05,0,16,84,100
15308,2012-10-05,1,3,43,46
15309,2012-10-05,2,1,10,11
15310,2012-10-05,3,5,10,15
15311,2012-10-05,4,0,11,11
15312,2012-10-05,5,0,40,40
15313,2012-10-05,6,4,133,137
15314,2012-10-05,7,11,415,426
15315,2012-10-05,8,36,741,777
15316,2012-10-05,9,58,320,378
15317,2012-10-05,10,68,191,259
15318,2012-10-05,11,90,212,302
15319,2012-10-05,12,161,301,462
15320,2012-10-05,13,117,302,419
15321,2012-10-05,14,113,283,396
15322,2012-10-05,15,150,318,468
15323,2012-10-05,16,153,471,624
15324,2012-10-05,17,158,736,894
15325,2012-10-05,18,106,651,757
15326,2012-10-05,19,67,419,486
15327,2012-10-05,20,66,299,365
15328,2012-10-05,21,47,218,265
15329,2012-10-05,22,63,194,257
15330,2012-10-05,23,23,143,166
15331,2012-10-06,0,37,153,190
15332,2012-10-06,1,25,111,136
15333,2012-10-06,2,13,60,73
15334,2012-10-06,3,2,50,52
15335,2012-10-06,4,4,7,11
15336,2012-10-06,5,2,8,10
15337,2012-10-06,6,2,28,30
15338,2012-10-06,7,13,68,81
15339,2012-10-06,8,22,183,205
15340,2012-10-06,9,130,263,393
15341,2012-10-06,10,198,339,537
15342,2012-10-06,11,258,383,641
15343,2012-10-06,12,361,377,738
15344,2012-10-06,13,310,393,703
15345,2012-10-06,14,268,300,568
15346,2012-10-06,15,280,338,618
15347,2012-10-06,16,317,335,652
15348,2012-10-06,17,268,331,599
15349,2012-10-06,18,183,310,493
15350,2012-10-06,19,102,235,337
15351,2012-10-06,20,74,172,246
15352,2012-10-06,21,78,135,213
15353,2012-10-06,22,45,139,184
15354,2012-10-06,23,37,139,176
15355,2012-10-07,0,28,97,125
15356,2012-10-07,1,29,78,107
15357,2012-10-07,2,10,63,73
15358,2012-10-07,3,5,17,22
15359,2012-10-07,4,5,6,11
15360,2012-10-07,5,2,8,10
15361,2012-10-07,6,4,19,23
15362,2012-10-07,7,6,29,35
15363,2012-10-07,8,11,51,62
15364,2012-10-07,9,16,66,82
15365,2012-10-07,10,41,144,185
15366,2012-10-07,11,76,253,329
15367,2012-10-07,12,100,287,387
15368,2012-10-07,13,80,235,315
15369,2012-10-07,14,71,240,311
15370,2012-10-07,15,74,229,303
15371,2012-10-07,16,87,242,329
15372,2012-10-07,17,34,120,154
15373,2012-10-07,18,24,82,106
15374,2012-10-07,19,17,95,112
15375,2012-10-07,20,19,96,115
15376,2012-10-07,21,22,91,113
15377,2012-10-07,22,7,71,78
15378,2012-10-07,23,12,64,76
15379,2012-10-08,0,7,43,50
15380,2012-10-08,1,2,33,35
15381,2012-10-08,2,3,12,15
15382,2012-10-08,3,2,8,10
15383,2012-10-08,4,1,6,7
15384,2012-10-08,5,2,16,18
15385,2012-10-08,6,5,54,59
15386,2012-10-08,7,3,149,152
15387,2012-10-08,8,23,368,391
15388,2012-10-08,9,59,269,328
15389,2012-10-08,10,69,226,295
15390,2012-10-08,11,72,235,307
15391,2012-10-08,12,73,260,333
15392,2012-10-08,13,82,321,403
15393,2012-10-08,14,121,295,416
15394,2012-10-08,15,76,292,368
15395,2012-10-08,16,61,311,372
15396,2012-10-08,17,81,414,495
15397,2012-10-08,18,41,413,454
15398,2012-10-08,19,38,326,364
15399,2012-10-08,20,20,205,225
15400,2012-10-08,21,17,132,149
15401,2012-10-08,22,6,100,106
15402,2012-10-08,23,9,60,69
15403,2012-10-09,0,9,22,31
15404,2012-10-09,1,0,12,12
15405,2012-10-09,2,2,5,7
15406,2012-10-09,3,0,3,3
15407,2012-10-09,4,1,6,7
15408,2012-10-09,5,0,19,19
15409,2012-10-09,6,2,139,141
15410,2012-10-09,7,5,356,361
15411,2012-10-09,8,15,693,708
15412,2012-10-09,9,37,342,379
15413,2012-10-09,10,33,128,161
15414,2012-10-09,11,37,153,190
15415,2012-10-09,12,43,216,259
15416,2012-10-09,13,54,183,237
15417,2012-10-09,14,43,201,244
15418,2012-10-09,15,59,194,253
15419,2012-10-09,16,70,354,424
15420,2012-10-09,17,73,729,802
15421,2012-10-09,18,26,745,771
15422,2012-10-09,19,31,476,507
15423,2012-10-09,20,30,328,358
15424,2012-10-09,21,16,206,222
15425,2012-10-09,22,7,152,159
15426,2012-10-09,23,8,74,82
15427,2012-10-10,0,0,33,33
15428,2012-10-10,1,2,6,8
15429,2012-10-10,2,2,6,8
15430,2012-10-10,3,0,6,6
15431,2012-10-10,4,0,6,6
15432,2012-10-10,5,2,38,40
15433,2012-10-10,6,3,171,174
15434,2012-10-10,7,9,493,502
15435,2012-10-10,8,33,799,832
15436,2012-10-10,9,35,323,358
15437,2012-10-10,10,27,187,214
15438,2012-10-10,11,53,236,289
15439,2012-10-10,12,78,308,386
15440,2012-10-10,13,60,234,294
15441,2012-10-10,14,63,207,270
15442,2012-10-10,15,58,259,317
15443,2012-10-10,16,92,467,559
15444,2012-10-10,17,91,854,945
15445,2012-10-10,18,57,776,833
15446,2012-10-10,19,32,526,558
15447,2012-10-10,20,21,365,386
15448,2012-10-10,21,18,250,268
15449,2012-10-10,22,27,167,194
15450,2012-10-10,23,17,115,132
15451,2012-10-11,0,1,40,41
15452,2012-10-11,1,1,10,11
15453,2012-10-11,2,4,7,11
15454,2012-10-11,3,0,3,3
15455,2012-10-11,4,0,10,10
15456,2012-10-11,5,0,42,42
15457,2012-10-11,6,1,158,159
15458,2012-10-11,7,11,465,476
15459,2012-10-11,8,25,763,788
15460,2012-10-11,9,27,324,351
15461,2012-10-11,10,39,163,202
15462,2012-10-11,11,76,174,250
15463,2012-10-11,12,47,278,325
15464,2012-10-11,13,48,243,291
15465,2012-10-11,14,78,267,345
15466,2012-10-11,15,102,354,456
15467,2012-10-11,16,68,412,480
15468,2012-10-11,17,90,727,817
15469,2012-10-11,18,64,627,691
15470,2012-10-11,19,80,654,734
15471,2012-10-11,20,27,381,408
15472,2012-10-11,21,24,231,255
15473,2012-10-11,22,10,167,177
15474,2012-10-11,23,10,176,186
15475,2012-10-12,0,8,60,68
15476,2012-10-12,1,8,27,35
15477,2012-10-12,2,0,15,15
15478,2012-10-12,3,0,6,6
15479,2012-10-12,4,0,8,8
15480,2012-10-12,5,2,31,33
15481,2012-10-12,6,3,140,143
15482,2012-10-12,7,8,378,386
15483,2012-10-12,8,34,701,735
15484,2012-10-12,9,26,369,395
15485,2012-10-12,10,75,199,274
15486,2012-10-12,11,61,248,309
15487,2012-10-12,12,75,309,384
15488,2012-10-12,13,81,300,381
15489,2012-10-12,14,109,255,364
15490,2012-10-12,15,138,313,451
15491,2012-10-12,16,108,408,516
15492,2012-10-12,17,131,704,835
15493,2012-10-12,18,75,557,632
15494,2012-10-12,19,40,449,489
15495,2012-10-12,20,28,277,305
15496,2012-10-12,21,21,164,185
15497,2012-10-12,22,17,142,159
15498,2012-10-12,23,11,88,99
15499,2012-10-13,0,31,215,246
15500,2012-10-13,1,23,118,141
15501,2012-10-13,2,7,59,66
15502,2012-10-13,3,2,13,15
15503,2012-10-13,4,2,8,10
15504,2012-10-13,5,0,11,11
15505,2012-10-13,6,5,23,28
15506,2012-10-13,7,10,59,69
15507,2012-10-13,8,23,149,172
15508,2012-10-13,9,46,218,264
15509,2012-10-13,10,82,261,343
15510,2012-10-13,11,192,332,524
15511,2012-10-13,12,202,366,568
15512,2012-10-13,13,235,432,667
15513,2012-10-13,14,243,352,595
15514,2012-10-13,15,250,354,604
15515,2012-10-13,16,295,340,635
15516,2012-10-13,17,193,330,523
15517,2012-10-13,18,174,294,468
15518,2012-10-13,19,73,256,329
15519,2012-10-13,20,57,194,251
15520,2012-10-13,21,47,150,197
15521,2012-10-13,22,33,155,188
15522,2012-10-13,23,27,98,125
15523,2012-10-14,0,8,102,110
15524,2012-10-14,1,16,95,111
15525,2012-10-14,2,8,57,65
15526,2012-10-14,3,3,24,27
15527,2012-10-14,4,2,10,12
15528,2012-10-14,5,5,6,11
15529,2012-10-14,6,4,19,23
15530,2012-10-14,7,7,43,50
15531,2012-10-14,8,28,104,132
15532,2012-10-14,9,61,161,222
15533,2012-10-14,10,151,275,426
15534,2012-10-14,11,156,330,486
15535,2012-10-14,12,200,356,556
15536,2012-10-14,13,218,393,611
15537,2012-10-14,14,247,360,607
15538,2012-10-14,15,213,347,560
15539,2012-10-14,16,203,373,576
15540,2012-10-14,17,193,339,532
15541,2012-10-14,18,134,312,446
15542,2012-10-14,19,68,261,329
15543,2012-10-14,20,48,197,245
15544,2012-10-14,21,40,154,194
15545,2012-10-14,22,38,87,125
15546,2012-10-14,23,27,76,103
15547,2012-10-15,0,17,31,48
15548,2012-10-15,1,5,24,29
15549,2012-10-15,2,1,5,6
15550,2012-10-15,3,2,2,4
15551,2012-10-15,4,1,9,10
15552,2012-10-15,5,2,38,40
15553,2012-10-15,6,6,141,147
15554,2012-10-15,7,15,455,470
15555,2012-10-15,8,24,709,733
15556,2012-10-15,9,31,324,355
15557,2012-10-15,10,43,122,165
15558,2012-10-15,11,88,173,261
15559,2012-10-15,12,73,210,283
15560,2012-10-15,13,37,108,145
15561,2012-10-15,14,57,127,184
15562,2012-10-15,15,70,189,259
15563,2012-10-15,16,76,366,442
15564,2012-10-15,17,96,662,758
15565,2012-10-15,18,52,531,583
15566,2012-10-15,19,12,227,239
15567,2012-10-15,20,19,236,255
15568,2012-10-15,21,16,189,205
15569,2012-10-15,22,8,116,124
15570,2012-10-15,23,9,72,81
15571,2012-10-16,0,3,44,47
15572,2012-10-16,1,4,9,13
15573,2012-10-16,2,2,1,3
15574,2012-10-16,3,0,2,2
15575,2012-10-16,4,0,7,7
15576,2012-10-16,5,5,47,52
15577,2012-10-16,6,4,167,171
15578,2012-10-16,7,20,500,520
15579,2012-10-16,8,35,789,824
15580,2012-10-16,9,32,318,350
15581,2012-10-16,10,64,156,220
15582,2012-10-16,11,56,171,227
15583,2012-10-16,12,69,256,325
15584,2012-10-16,13,68,256,324
15585,2012-10-16,14,94,210,304
15586,2012-10-16,15,76,268,344
15587,2012-10-16,16,79,364,443
15588,2012-10-16,17,104,834,938
15589,2012-10-16,18,71,758,829
15590,2012-10-16,19,40,486,526
15591,2012-10-16,20,35,386,421
15592,2012-10-16,21,19,174,193
15593,2012-10-16,22,18,161,179
15594,2012-10-16,23,23,176,199
15595,2012-10-17,0,1,48,49
15596,2012-10-17,1,3,14,17
15597,2012-10-17,2,4,12,16
15598,2012-10-17,3,0,7,7
15599,2012-10-17,4,0,4,4
15600,2012-10-17,5,2,39,41
15601,2012-10-17,6,7,169,176
15602,2012-10-17,7,15,445,460
15603,2012-10-17,8,38,774,812
15604,2012-10-17,9,37,341,378
15605,2012-10-17,10,61,164,225
15606,2012-10-17,11,78,156,234
15607,2012-10-17,12,71,259,330
15608,2012-10-17,13,73,236,309
15609,2012-10-17,14,82,185,267
15610,2012-10-17,15,62,238,300
15611,2012-10-17,16,70,395,465
15612,2012-10-17,17,122,761,883
15613,2012-10-17,18,90,781,871
15614,2012-10-17,19,49,466,515
15615,2012-10-17,20,54,350,404
15616,2012-10-17,21,28,295,323
15617,2012-10-17,22,17,197,214
15618,2012-10-17,23,15,84,99
15619,2012-10-18,0,4,53,57
15620,2012-10-18,1,0,14,14
15621,2012-10-18,2,1,12,13
15622,2012-10-18,3,0,5,5
15623,2012-10-18,4,0,5,5
15624,2012-10-18,5,1,40,41
15625,2012-10-18,6,3,150,153
15626,2012-10-18,7,20,482,502
15627,2012-10-18,8,31,794,825
15628,2012-10-18,9,41,343,384
15629,2012-10-18,10,60,157,217
15630,2012-10-18,11,79,187,266
15631,2012-10-18,12,93,283,376
15632,2012-10-18,13,96,231,327
15633,2012-10-18,14,94,187,281
15634,2012-10-18,15,69,281,350
15635,2012-10-18,16,94,353,447
15636,2012-10-18,17,102,786,888
15637,2012-10-18,18,68,714,782
15638,2012-10-18,19,42,465,507
15639,2012-10-18,20,39,347,386
15640,2012-10-18,21,38,240,278
15641,2012-10-18,22,27,199,226
15642,2012-10-18,23,6,108,114
15643,2012-10-19,0,5,49,54
15644,2012-10-19,1,4,12,16
15645,2012-10-19,2,1,9,10
15646,2012-10-19,3,0,4,4
15647,2012-10-19,4,1,5,6
15648,2012-10-19,5,1,33,34
15649,2012-10-19,6,5,125,130
15650,2012-10-19,7,5,148,153
15651,2012-10-19,8,20,443,463
15652,2012-10-19,9,26,361,387
15653,2012-10-19,10,26,196,222
15654,2012-10-19,11,41,209,250
15655,2012-10-19,12,74,257,331
15656,2012-10-19,13,87,274,361
15657,2012-10-19,14,88,273,361
15658,2012-10-19,15,93,294,387
15659,2012-10-19,16,131,432,563
15660,2012-10-19,17,48,369,417
15661,2012-10-19,18,21,208,229
15662,2012-10-19,19,19,209,228
15663,2012-10-19,20,13,217,230
15664,2012-10-19,21,17,187,204
15665,2012-10-19,22,14,173,187
15666,2012-10-19,23,13,118,131
15667,2012-10-20,0,13,110,123
15668,2012-10-20,1,2,90,92
15669,2012-10-20,2,9,68,77
15670,2012-10-20,3,2,27,29
15671,2012-10-20,4,9,9,18
15672,2012-10-20,5,6,7,13
15673,2012-10-20,6,5,25,30
15674,2012-10-20,7,6,59,65
15675,2012-10-20,8,29,163,192
15676,2012-10-20,9,106,256,362
15677,2012-10-20,10,110,309,419
15678,2012-10-20,11,204,403,607
15679,2012-10-20,12,267,427,694
15680,2012-10-20,13,272,431,703
15681,2012-10-20,14,335,373,708
15682,2012-10-20,15,308,397,705
15683,2012-10-20,16,325,361,686
15684,2012-10-20,17,346,381,727
15685,2012-10-20,18,165,350,515
15686,2012-10-20,19,77,263,340
15687,2012-10-20,20,61,194,255
15688,2012-10-20,21,72,222,294
15689,2012-10-20,22,47,154,201
15690,2012-10-20,23,27,135,162
15691,2012-10-21,0,35,116,151
15692,2012-10-21,1,20,96,116
15693,2012-10-21,2,44,87,131
15694,2012-10-21,3,12,29,41
15695,2012-10-21,4,8,12,20
15696,2012-10-21,5,6,4,10
15697,2012-10-21,6,8,17,25
15698,2012-10-21,7,13,43,56
15699,2012-10-21,8,39,102,141
15700,2012-10-21,9,77,191,268
15701,2012-10-21,10,166,269,435
15702,2012-10-21,11,191,350,541
15703,2012-10-21,12,236,435,671
15704,2012-10-21,13,243,372,615
15705,2012-10-21,14,235,405,640
15706,2012-10-21,15,240,380,620
15707,2012-10-21,16,181,404,585
15708,2012-10-21,17,154,333,487
15709,2012-10-21,18,71,336,407
15710,2012-10-21,19,50,211,261
15711,2012-10-21,20,35,159,194
15712,2012-10-21,21,42,124,166
15713,2012-10-21,22,18,95,113
15714,2012-10-21,23,7,57,64
15715,2012-10-22,0,3,26,29
15716,2012-10-22,1,0,11,11
15717,2012-10-22,2,1,4,5
15718,2012-10-22,3,1,5,6
15719,2012-10-22,4,1,6,7
15720,2012-10-22,5,2,43,45
15721,2012-10-22,6,4,139,143
15722,2012-10-22,7,15,433,448
15723,2012-10-22,8,32,690,722
15724,2012-10-22,9,25,328,353
15725,2012-10-22,10,51,154,205
15726,2012-10-22,11,63,146,209
15727,2012-10-22,12,52,231,283
15728,2012-10-22,13,88,225,313
15729,2012-10-22,14,73,208,281
15730,2012-10-22,15,74,218,292
15731,2012-10-22,16,80,441,521
15732,2012-10-22,17,84,832,916
15733,2012-10-22,18,60,726,786
15734,2012-10-22,19,36,468,504
15735,2012-10-22,20,21,377,398
15736,2012-10-22,21,19,154,173
15737,2012-10-22,22,25,158,183
15738,2012-10-22,23,20,142,162
15739,2012-10-23,0,5,32,37
15740,2012-10-23,1,1,16,17
15741,2012-10-23,2,1,6,7
15742,2012-10-23,3,0,1,1
15743,2012-10-23,4,1,6,7
15744,2012-10-23,5,1,49,50
15745,2012-10-23,6,6,150,156
15746,2012-10-23,7,12,516,528
15747,2012-10-23,8,27,732,759
15748,2012-10-23,9,29,302,331
15749,2012-10-23,10,50,168,218
15750,2012-10-23,11,52,197,249
15751,2012-10-23,12,80,293,373
15752,2012-10-23,13,59,242,301
15753,2012-10-23,14,66,224,290
15754,2012-10-23,15,77,268,345
15755,2012-10-23,16,108,426,534
15756,2012-10-23,17,67,864,931
15757,2012-10-23,18,64,749,813
15758,2012-10-23,19,25,454,479
15759,2012-10-23,20,45,333,378
15760,2012-10-23,21,35,254,289
15761,2012-10-23,22,20,173,193
15762,2012-10-23,23,8,102,110
15763,2012-10-24,0,7,39,46
15764,2012-10-24,1,4,21,25
15765,2012-10-24,2,0,6,6
15766,2012-10-24,3,0,4,4
15767,2012-10-24,4,1,5,6
15768,2012-10-24,5,1,52,53
15769,2012-10-24,6,11,160,171
15770,2012-10-24,7,20,506,526
15771,2012-10-24,8,24,772,796
15772,2012-10-24,9,24,344,368
15773,2012-10-24,10,29,141,170
15774,2012-10-24,11,47,189,236
15775,2012-10-24,12,48,265,313
15776,2012-10-24,13,65,238,303
15777,2012-10-24,14,64,231,295
15778,2012-10-24,15,63,242,305
15779,2012-10-24,16,67,461,528
15780,2012-10-24,17,86,870,956
15781,2012-10-24,18,63,790,853
15782,2012-10-24,19,50,517,567
15783,2012-10-24,20,45,393,438
15784,2012-10-24,21,33,273,306
15785,2012-10-24,22,30,207,237
15786,2012-10-24,23,12,109,121
15787,2012-10-25,0,19,57,76
15788,2012-10-25,1,6,21,27
15789,2012-10-25,2,3,15,18
15790,2012-10-25,3,0,8,8
15791,2012-10-25,4,1,4,5
15792,2012-10-25,5,2,51,53
15793,2012-10-25,6,3,167,170
15794,2012-10-25,7,18,473,491
15795,2012-10-25,8,33,741,774
15796,2012-10-25,9,23,317,340
15797,2012-10-25,10,53,170,223
15798,2012-10-25,11,57,180,237
15799,2012-10-25,12,61,255,316
15800,2012-10-25,13,49,264,313
15801,2012-10-25,14,71,212,283
15802,2012-10-25,15,63,239,302
15803,2012-10-25,16,92,405,497
15804,2012-10-25,17,112,767,879
15805,2012-10-25,18,76,722,798
15806,2012-10-25,19,45,494,539
15807,2012-10-25,20,28,314,342
15808,2012-10-25,21,24,243,267
15809,2012-10-25,22,22,183,205
15810,2012-10-25,23,13,121,134
15811,2012-10-26,0,6,63,69
15812,2012-10-26,1,4,31,35
15813,2012-10-26,2,4,15,19
15814,2012-10-26,3,5,8,13
15815,2012-10-26,4,1,4,5
15816,2012-10-26,5,3,45,48
15817,2012-10-26,6,2,141,143
15818,2012-10-26,7,13,406,419
15819,2012-10-26,8,20,708,728
15820,2012-10-26,9,56,343,399
15821,2012-10-26,10,41,156,197
15822,2012-10-26,11,68,220,288
15823,2012-10-26,12,90,302,392
15824,2012-10-26,13,77,256,333
15825,2012-10-26,14,98,250,348
15826,2012-10-26,15,142,306,448
15827,2012-10-26,16,136,439,575
15828,2012-10-26,17,126,681,807
15829,2012-10-26,18,81,577,658
15830,2012-10-26,19,72,391,463
15831,2012-10-26,20,40,266,306
15832,2012-10-26,21,39,245,284
15833,2012-10-26,22,37,178,215
15834,2012-10-26,23,19,154,173
15835,2012-10-27,0,10,131,141
15836,2012-10-27,1,23,121,144
15837,2012-10-27,2,19,70,89
15838,2012-10-27,3,5,21,26
15839,2012-10-27,4,1,12,13
15840,2012-10-27,5,2,7,9
15841,2012-10-27,6,2,29,31
15842,2012-10-27,7,7,78,85
15843,2012-10-27,8,26,185,211
15844,2012-10-27,9,88,237,325
15845,2012-10-27,10,165,311,476
15846,2012-10-27,11,197,382,579
15847,2012-10-27,12,264,399,663
15848,2012-10-27,13,310,445,755
15849,2012-10-27,14,325,412,737
15850,2012-10-27,15,310,396,706
15851,2012-10-27,16,255,353,608
15852,2012-10-27,17,248,359,607
15853,2012-10-27,18,138,314,452
15854,2012-10-27,19,67,229,296
15855,2012-10-27,20,58,232,290
15856,2012-10-27,21,49,156,205
15857,2012-10-27,22,41,116,157
15858,2012-10-27,23,31,132,163
15859,2012-10-28,0,20,95,115
15860,2012-10-28,1,22,111,133
15861,2012-10-28,2,17,98,115
15862,2012-10-28,3,18,58,76
15863,2012-10-28,4,1,19,20
15864,2012-10-28,5,6,22,28
15865,2012-10-28,6,7,32,39
15866,2012-10-28,7,17,46,63
15867,2012-10-28,8,55,119,174
15868,2012-10-28,9,124,204,328
15869,2012-10-28,10,120,308,428
15870,2012-10-28,11,110,349,459
15871,2012-10-28,12,118,365,483
15872,2012-10-28,13,75,315,390
15873,2012-10-28,14,98,297,395
15874,2012-10-28,15,76,222,298
15875,2012-10-28,16,42,246,288
15876,2012-10-28,17,37,185,222
15877,2012-10-28,18,18,134,152
15878,2012-10-28,19,7,46,53
15879,2012-10-28,20,4,51,55
15880,2012-10-28,21,2,42,44
15881,2012-10-28,22,2,35,37
15882,2012-10-28,23,2,12,14
15883,2012-10-29,0,2,19,21
15884,2012-10-30,13,11,102,113
15885,2012-10-30,14,8,114,122
15886,2012-10-30,15,10,111,121
15887,2012-10-30,16,15,81,96
15888,2012-10-30,17,19,104,123
15889,2012-10-30,18,4,138,142
15890,2012-10-30,19,6,108,114
15891,2012-10-30,20,5,76,81
15892,2012-10-30,21,4,59,63
15893,2012-10-30,22,2,64,66
15894,2012-10-30,23,3,35,38
15895,2012-10-31,0,0,15,15
15896,2012-10-31,1,0,7,7
15897,2012-10-31,2,0,7,7
15898,2012-10-31,3,0,3,3
15899,2012-10-31,4,0,5,5
15900,2012-10-31,5,0,24,24
15901,2012-10-31,6,0,114,114
15902,2012-10-31,7,3,330,333
15903,2012-10-31,8,6,607,613
15904,2012-10-31,9,17,278,295
15905,2012-10-31,10,21,146,167
15906,2012-10-31,11,37,150,187
15907,2012-10-31,12,44,195,239
15908,2012-10-31,13,22,187,209
15909,2012-10-31,14,45,177,222
15910,2012-10-31,15,33,197,230
15911,2012-10-31,16,51,371,422
15912,2012-10-31,17,39,678,717
15913,2012-10-31,18,28,552,580
15914,2012-10-31,19,27,376,403
15915,2012-10-31,20,9,257,266
15916,2012-10-31,21,12,177,189
15917,2012-10-31,22,18,144,162
15918,2012-10-31,23,7,94,101
15919,2012-11-01,0,8,51,59
15920,2012-11-01,1,8,21,29
15921,2012-11-01,2,8,10,18
15922,2012-11-01,3,5,10,15
15923,2012-11-01,4,2,8,10
15924,2012-11-01,5,1,39,40
15925,2012-11-01,6,2,145,147
15926,2012-11-01,7,6,410,416
15927,2012-11-01,8,12,663,675
15928,2012-11-01,9,21,306,327
15929,2012-11-01,10,13,132,145
15930,2012-11-01,11,14,155,169
15931,2012-11-01,12,23,198,221
15932,2012-11-01,13,49,196,245
15933,2012-11-01,14,31,154,185
15934,2012-11-01,15,35,178,213
15935,2012-11-01,16,31,310,341
15936,2012-11-01,17,37,648,685
15937,2012-11-01,18,50,624,674
15938,2012-11-01,19,28,418,446
15939,2012-11-01,20,16,275,291
15940,2012-11-01,21,29,236,265
15941,2012-11-01,22,27,173,200
15942,2012-11-01,23,8,108,116
15943,2012-11-02,0,10,40,50
15944,2012-11-02,1,5,18,23
15945,2012-11-02,2,3,7,10
15946,2012-11-02,3,0,3,3
15947,2012-11-02,4,1,6,7
15948,2012-11-02,5,1,25,26
15949,2012-11-02,6,2,118,120
15950,2012-11-02,7,8,347,355
15951,2012-11-02,8,30,653,683
15952,2012-11-02,9,26,351,377
15953,2012-11-02,10,21,182,203
15954,2012-11-02,11,42,177,219
15955,2012-11-02,12,52,238,290
15956,2012-11-02,13,64,226,290
15957,2012-11-02,14,63,198,261
15958,2012-11-02,15,51,253,304
15959,2012-11-02,16,48,370,418
15960,2012-11-02,17,57,576,633
15961,2012-11-02,18,32,485,517
15962,2012-11-02,19,38,331,369
15963,2012-11-02,20,14,202,216
15964,2012-11-02,21,23,131,154
15965,2012-11-02,22,14,134,148
15966,2012-11-02,23,11,107,118
15967,2012-11-03,0,9,96,105
15968,2012-11-03,1,6,80,86
15969,2012-11-03,2,10,36,46
15970,2012-11-03,3,6,22,28
15971,2012-11-03,4,8,8,16
15972,2012-11-03,5,1,8,9
15973,2012-11-03,6,4,17,21
15974,2012-11-03,7,1,58,59
15975,2012-11-03,8,10,131,141
15976,2012-11-03,9,31,186,217
15977,2012-11-03,10,68,257,325
15978,2012-11-03,11,56,280,336
15979,2012-11-03,12,74,310,384
15980,2012-11-03,13,110,337,447
15981,2012-11-03,14,136,317,453
15982,2012-11-03,15,117,326,443
15983,2012-11-03,16,108,289,397
15984,2012-11-03,17,112,292,404
15985,2012-11-03,18,58,239,297
15986,2012-11-03,19,22,215,237
15987,2012-11-03,20,23,156,179
15988,2012-11-03,21,31,134,165
15989,2012-11-03,22,13,133,146
15990,2012-11-03,23,15,131,146
15991,2012-11-04,0,5,96,101
15992,2012-11-04,1,26,136,162
15993,2012-11-04,2,6,31,37
15994,2012-11-04,3,1,10,11
15995,2012-11-04,4,2,7,9
15996,2012-11-04,5,0,5,5
15997,2012-11-04,6,2,14,16
15998,2012-11-04,7,11,38,49
15999,2012-11-04,8,34,114,148
16000,2012-11-04,9,56,160,216
16001,2012-11-04,10,73,285,358
16002,2012-11-04,11,134,307,441
16003,2012-11-04,12,150,348,498
16004,2012-11-04,13,122,367,489
16005,2012-11-04,14,149,355,504
16006,2012-11-04,15,149,298,447
16007,2012-11-04,16,119,310,429
16008,2012-11-04,17,57,267,324
16009,2012-11-04,18,31,203,234
16010,2012-11-04,19,24,200,224
16011,2012-11-04,20,7,132,139
16012,2012-11-04,21,16,69,85
16013,2012-11-04,22,15,63,78
16014,2012-11-04,23,12,41,53
16015,2012-11-05,0,3,20,23
16016,2012-11-05,1,0,8,8
16017,2012-11-05,2,2,4,6
16018,2012-11-05,3,1,3,4
16019,2012-11-05,4,5,10,15
16020,2012-11-05,5,1,38,39
16021,2012-11-05,6,4,135,139
16022,2012-11-05,7,8,448,456
16023,2012-11-05,8,19,626,645
16024,2012-11-05,9,18,234,252
16025,2012-11-05,10,30,110,140
16026,2012-11-05,11,31,119,150
16027,2012-11-05,12,38,204,242
16028,2012-11-05,13,39,183,222
16029,2012-11-05,14,31,163,194
16030,2012-11-05,15,24,206,230
16031,2012-11-05,16,35,319,354
16032,2012-11-05,17,34,600,634
16033,2012-11-05,18,19,514,533
16034,2012-11-05,19,11,358,369
16035,2012-11-05,20,13,223,236
16036,2012-11-05,21,8,143,151
16037,2012-11-05,22,4,110,114
16038,2012-11-05,23,0,51,51
16039,2012-11-06,0,1,18,19
16040,2012-11-06,1,0,8,8
16041,2012-11-06,2,0,2,2
16042,2012-11-06,3,0,4,4
16043,2012-11-06,4,0,7,7
16044,2012-11-06,5,1,39,40
16045,2012-11-06,6,6,140,146
16046,2012-11-06,7,9,377,386
16047,2012-11-06,8,20,565,585
16048,2012-11-06,9,25,334,359
16049,2012-11-06,10,41,189,230
16050,2012-11-06,11,39,175,214
16051,2012-11-06,12,31,216,247
16052,2012-11-06,13,46,229,275
16053,2012-11-06,14,44,195,239
16054,2012-11-06,15,45,224,269
16055,2012-11-06,16,33,365,398
16056,2012-11-06,17,30,591,621
16057,2012-11-06,18,20,473,493
16058,2012-11-06,19,15,351,366
16059,2012-11-06,20,10,216,226
16060,2012-11-06,21,14,137,151
16061,2012-11-06,22,17,134,151
16062,2012-11-06,23,19,184,203
16063,2012-11-07,0,49,229,278
16064,2012-11-07,1,6,85,91
16065,2012-11-07,2,6,66,72
16066,2012-11-07,3,2,9,11
16067,2012-11-07,4,0,9,9
16068,2012-11-07,5,0,27,27
16069,2012-11-07,6,3,114,117
16070,2012-11-07,7,5,314,319
16071,2012-11-07,8,18,581,599
16072,2012-11-07,9,17,350,367
16073,2012-11-07,10,27,151,178
16074,2012-11-07,11,15,130,145
16075,2012-11-07,12,24,186,210
16076,2012-11-07,13,23,156,179
16077,2012-11-07,14,19,140,159
16078,2012-11-07,15,20,176,196
16079,2012-11-07,16,23,247,270
16080,2012-11-07,17,16,500,516
16081,2012-11-07,18,17,444,461
16082,2012-11-07,19,17,299,316
16083,2012-11-07,20,7,247,254
16084,2012-11-07,21,5,118,123
16085,2012-11-07,22,4,54,58
16086,2012-11-07,23,3,36,39
16087,2012-11-08,0,1,13,14
16088,2012-11-08,1,1,10,11
16089,2012-11-08,2,1,5,6
16090,2012-11-08,4,1,9,10
16091,2012-11-08,5,0,35,35
16092,2012-11-08,6,2,121,123
16093,2012-11-08,7,12,407,419
16094,2012-11-08,8,16,650,666
16095,2012-11-08,9,22,249,271
16096,2012-11-08,10,13,148,161
16097,2012-11-08,11,16,154,170
16098,2012-11-08,12,33,199,232
16099,2012-11-08,13,33,195,228
16100,2012-11-08,14,33,147,180
16101,2012-11-08,15,32,201,233
16102,2012-11-08,16,18,318,336
16103,2012-11-08,17,36,550,586
16104,2012-11-08,18,16,489,505
16105,2012-11-08,19,14,357,371
16106,2012-11-08,20,10,234,244
16107,2012-11-08,21,11,217,228
16108,2012-11-08,22,14,143,157
16109,2012-11-08,23,5,82,87
16110,2012-11-09,0,9,45,54
16111,2012-11-09,1,3,17,20
16112,2012-11-09,2,1,11,12
16113,2012-11-09,3,3,6,9
16114,2012-11-09,4,0,13,13
16115,2012-11-09,5,2,24,26
16116,2012-11-09,6,5,124,129
16117,2012-11-09,7,9,331,340
16118,2012-11-09,8,25,661,686
16119,2012-11-09,9,23,302,325
16120,2012-11-09,10,34,162,196
16121,2012-11-09,11,66,185,251
16122,2012-11-09,12,48,213,261
16123,2012-11-09,13,62,235,297
16124,2012-11-09,14,67,203,270
16125,2012-11-09,15,78,274,352
16126,2012-11-09,16,57,375,432
16127,2012-11-09,17,61,589,650
16128,2012-11-09,18,46,447,493
16129,2012-11-09,19,30,328,358
16130,2012-11-09,20,20,234,254
16131,2012-11-09,21,23,173,196
16132,2012-11-09,22,17,143,160
16133,2012-11-09,23,20,142,162
16134,2012-11-10,0,16,104,120
16135,2012-11-10,1,8,68,76
16136,2012-11-10,2,2,41,43
16137,2012-11-10,3,9,11,20
16138,2012-11-10,4,2,4,6
16139,2012-11-10,5,1,9,10
16140,2012-11-10,6,5,11,16
16141,2012-11-10,7,14,55,69
16142,2012-11-10,8,16,129,145
16143,2012-11-10,9,43,215,258
16144,2012-11-10,10,86,260,346
16145,2012-11-10,11,143,320,463
16146,2012-11-10,12,257,341,598
16147,2012-11-10,13,268,376,644
16148,2012-11-10,14,279,345,624
16149,2012-11-10,15,216,346,562
16150,2012-11-10,16,227,371,598
16151,2012-11-10,17,183,316,499
16152,2012-11-10,18,103,250,353
16153,2012-11-10,19,55,227,282
16154,2012-11-10,20,39,149,188
16155,2012-11-10,21,51,168,219
16156,2012-11-10,22,39,153,192
16157,2012-11-10,23,26,120,146
16158,2012-11-11,0,14,105,119
16159,2012-11-11,1,26,78,104
16160,2012-11-11,2,12,57,69
16161,2012-11-11,3,9,36,45
16162,2012-11-11,4,5,6,11
16163,2012-11-11,5,0,12,12
16164,2012-11-11,6,3,16,19
16165,2012-11-11,7,12,55,67
16166,2012-11-11,8,32,87,119
16167,2012-11-11,9,94,177,271
16168,2012-11-11,10,133,266,399
16169,2012-11-11,11,180,316,496
16170,2012-11-11,12,195,385,580
16171,2012-11-11,13,262,417,679
16172,2012-11-11,14,292,360,652
16173,2012-11-11,15,303,414,717
16174,2012-11-11,16,261,390,651
16175,2012-11-11,17,151,338,489
16176,2012-11-11,18,102,301,403
16177,2012-11-11,19,69,206,275
16178,2012-11-11,20,54,140,194
16179,2012-11-11,21,44,124,168
16180,2012-11-11,22,21,108,129
16181,2012-11-11,23,16,92,108
16182,2012-11-12,0,6,43,49
16183,2012-11-12,1,4,24,28
16184,2012-11-12,2,6,13,19
16185,2012-11-12,3,1,3,4
16186,2012-11-12,4,1,3,4
16187,2012-11-12,5,1,22,23
16188,2012-11-12,6,7,62,69
16189,2012-11-12,7,16,244,260
16190,2012-11-12,8,50,488,538
16191,2012-11-12,9,60,333,393
16192,2012-11-12,10,81,182,263
16193,2012-11-12,11,113,251,364
16194,2012-11-12,12,105,311,416
16195,2012-11-12,13,108,309,417
16196,2012-11-12,14,134,307,441
16197,2012-11-12,15,102,279,381
16198,2012-11-12,16,87,343,430
16199,2012-11-12,17,66,529,595
16200,2012-11-12,18,65,480,545
16201,2012-11-12,19,30,316,346
16202,2012-11-12,20,31,273,304
16203,2012-11-12,21,10,145,155
16204,2012-11-12,22,12,98,110
16205,2012-11-12,23,1,62,63
16206,2012-11-13,0,5,16,21
16207,2012-11-13,1,0,5,5
16208,2012-11-13,2,7,4,11
16209,2012-11-13,3,2,3,5
16210,2012-11-13,4,0,9,9
16211,2012-11-13,5,0,18,18
16212,2012-11-13,6,2,48,50
16213,2012-11-13,7,1,106,107
16214,2012-11-13,8,4,205,209
16215,2012-11-13,9,1,109,110
16216,2012-11-13,10,10,83,93
16217,2012-11-13,11,22,131,153
16218,2012-11-13,12,16,176,192
16219,2012-11-13,13,30,187,217
16220,2012-11-13,14,34,166,200
16221,2012-11-13,15,33,180,213
16222,2012-11-13,16,28,278,306
16223,2012-11-13,17,33,574,607
16224,2012-11-13,18,45,512,557
16225,2012-11-13,19,12,342,354
16226,2012-11-13,20,12,209,221
16227,2012-11-13,21,9,176,185
16228,2012-11-13,22,15,119,134
16229,2012-11-13,23,6,77,83
16230,2012-11-14,0,4,20,24
16231,2012-11-14,1,2,9,11
16232,2012-11-14,2,0,1,1
16233,2012-11-14,3,0,5,5
16234,2012-11-14,4,0,6,6
16235,2012-11-14,5,0,38,38
16236,2012-11-14,6,4,142,146
16237,2012-11-14,7,10,401,411
16238,2012-11-14,8,27,656,683
16239,2012-11-14,9,22,306,328
16240,2012-11-14,10,18,151,169
16241,2012-11-14,11,25,126,151
16242,2012-11-14,12,40,199,239
16243,2012-11-14,13,32,178,210
16244,2012-11-14,14,20,161,181
16245,2012-11-14,15,32,227,259
16246,2012-11-14,16,31,289,320
16247,2012-11-14,17,19,554,573
16248,2012-11-14,18,24,535,559
16249,2012-11-14,19,28,363,391
16250,2012-11-14,20,15,249,264
16251,2012-11-14,21,5,205,210
16252,2012-11-14,22,6,165,171
16253,2012-11-14,23,9,78,87
16254,2012-11-15,0,1,33,34
16255,2012-11-15,1,2,12,14
16256,2012-11-15,2,0,7,7
16257,2012-11-15,3,0,2,2
16258,2012-11-15,4,0,5,5
16259,2012-11-15,5,3,34,37
16260,2012-11-15,6,1,144,145
16261,2012-11-15,7,7,401,408
16262,2012-11-15,8,21,621,642
16263,2012-11-15,9,17,303,320
16264,2012-11-15,10,11,141,152
16265,2012-11-15,11,28,137,165
16266,2012-11-15,12,29,183,212
16267,2012-11-15,13,20,196,216
16268,2012-11-15,14,27,170,197
16269,2012-11-15,15,26,191,217
16270,2012-11-15,16,24,315,339
16271,2012-11-15,17,22,535,557
16272,2012-11-15,18,10,558,568
16273,2012-11-15,19,11,371,382
16274,2012-11-15,20,23,256,279
16275,2012-11-15,21,20,201,221
16276,2012-11-15,22,10,141,151
16277,2012-11-15,23,7,117,124
16278,2012-11-16,0,7,58,65
16279,2012-11-16,1,5,16,21
16280,2012-11-16,2,0,8,8
16281,2012-11-16,3,0,5,5
16282,2012-11-16,4,0,5,5
16283,2012-11-16,5,2,34,36
16284,2012-11-16,6,4,123,127
16285,2012-11-16,7,5,358,363
16286,2012-11-16,8,17,687,704
16287,2012-11-16,9,21,324,345
16288,2012-11-16,10,33,161,194
16289,2012-11-16,11,33,183,216
16290,2012-11-16,12,28,259,287
16291,2012-11-16,13,52,223,275
16292,2012-11-16,14,47,202,249
16293,2012-11-16,15,30,233,263
16294,2012-11-16,16,33,348,381
16295,2012-11-16,17,41,535,576
16296,2012-11-16,18,22,482,504
16297,2012-11-16,19,26,303,329
16298,2012-11-16,20,20,204,224
16299,2012-11-16,21,21,156,177
16300,2012-11-16,22,23,138,161
16301,2012-11-16,23,14,113,127
16302,2012-11-17,0,11,94,105
16303,2012-11-17,1,13,73,86
16304,2012-11-17,2,8,41,49
16305,2012-11-17,3,2,19,21
16306,2012-11-17,4,1,6,7
16307,2012-11-17,5,1,10,11
16308,2012-11-17,6,0,21,21
16309,2012-11-17,7,8,69,77
16310,2012-11-17,8,30,137,167
16311,2012-11-17,9,48,197,245
16312,2012-11-17,10,62,256,318
16313,2012-11-17,11,80,338,418
16314,2012-11-17,12,117,356,473
16315,2012-11-17,13,179,344,523
16316,2012-11-17,14,175,376,551
16317,2012-11-17,15,175,370,545
16318,2012-11-17,16,144,325,469
16319,2012-11-17,17,101,296,397
16320,2012-11-17,18,34,233,267
16321,2012-11-17,19,45,206,251
16322,2012-11-17,20,30,141,171
16323,2012-11-17,21,15,121,136
16324,2012-11-17,22,15,126,141
16325,2012-11-17,23,19,113,132
16326,2012-11-18,0,11,117,128
16327,2012-11-18,1,14,81,95
16328,2012-11-18,2,8,64,72
16329,2012-11-18,3,9,37,46
16330,2012-11-18,4,4,8,12
16331,2012-11-18,5,5,7,12
16332,2012-11-18,6,2,13,15
16333,2012-11-18,7,3,39,42
16334,2012-11-18,8,19,98,117
16335,2012-11-18,9,49,154,203
16336,2012-11-18,10,79,245,324
16337,2012-11-18,11,92,263,355
16338,2012-11-18,12,101,338,439
16339,2012-11-18,13,113,332,445
16340,2012-11-18,14,125,298,423
16341,2012-11-18,15,89,314,403
16342,2012-11-18,16,59,312,371
16343,2012-11-18,17,48,232,280
16344,2012-11-18,18,36,239,275
16345,2012-11-18,19,16,193,209
16346,2012-11-18,20,9,119,128
16347,2012-11-18,21,17,92,109
16348,2012-11-18,22,8,66,74
16349,2012-11-18,23,6,53,59
16350,2012-11-19,0,5,22,27
16351,2012-11-19,1,0,19,19
16352,2012-11-19,2,0,5,5
16353,2012-11-19,3,0,2,2
16354,2012-11-19,4,1,10,11
16355,2012-11-19,5,1,38,39
16356,2012-11-19,6,3,128,131
16357,2012-11-19,7,5,381,386
16358,2012-11-19,8,13,647,660
16359,2012-11-19,9,18,259,277
16360,2012-11-19,10,33,102,135
16361,2012-11-19,11,33,159,192
16362,2012-11-19,12,35,206,241
16363,2012-11-19,13,46,202,248
16364,2012-11-19,14,47,169,216
16365,2012-11-19,15,44,213,257
16366,2012-11-19,16,55,318,373
16367,2012-11-19,17,33,581,614
16368,2012-11-19,18,21,552,573
16369,2012-11-19,19,25,377,402
16370,2012-11-19,20,7,252,259
16371,2012-11-19,21,15,186,201
16372,2012-11-19,22,7,105,112
16373,2012-11-19,23,2,71,73
16374,2012-11-20,0,3,25,28
16375,2012-11-20,1,3,10,13
16376,2012-11-20,2,0,5,5
16377,2012-11-20,3,0,2,2
16378,2012-11-20,4,0,6,6
16379,2012-11-20,5,2,32,34
16380,2012-11-20,6,2,145,147
16381,2012-11-20,7,7,409,416
16382,2012-11-20,8,16,642,658
16383,2012-11-20,9,28,292,320
16384,2012-11-20,10,32,143,175
16385,2012-11-20,11,45,157,202
16386,2012-11-20,12,70,243,313
16387,2012-11-20,13,49,216,265
16388,2012-11-20,14,47,176,223
16389,2012-11-20,15,61,225,286
16390,2012-11-20,16,60,332,392
16391,2012-11-20,17,37,547,584
16392,2012-11-20,18,16,531,547
16393,2012-11-20,19,23,354,377
16394,2012-11-20,20,11,218,229
16395,2012-11-20,21,14,142,156
16396,2012-11-20,22,7,115,122
16397,2012-11-20,23,1,82,83
16398,2012-11-21,0,1,25,26
16399,2012-11-21,1,1,12,13
16400,2012-11-21,2,2,7,9
16401,2012-11-21,3,0,2,2
16402,2012-11-21,4,0,10,10
16403,2012-11-21,5,1,28,29
16404,2012-11-21,6,2,97,99
16405,2012-11-21,7,11,256,267
16406,2012-11-21,8,12,534,546
16407,2012-11-21,9,45,315,360
16408,2012-11-21,10,22,149,171
16409,2012-11-21,11,43,197,240
16410,2012-11-21,12,74,267,341
16411,2012-11-21,13,70,293,363
16412,2012-11-21,14,84,328,412
16413,2012-11-21,15,68,375,443
16414,2012-11-21,16,59,407,466
16415,2012-11-21,17,41,331,372
16416,2012-11-21,18,24,287,311
16417,2012-11-21,19,23,216,239
16418,2012-11-21,20,11,124,135
16419,2012-11-21,21,8,96,104
16420,2012-11-21,22,6,80,86
16421,2012-11-21,23,7,50,57
16422,2012-11-22,0,3,42,45
16423,2012-11-22,1,5,37,42
16424,2012-11-22,2,3,15,18
16425,2012-11-22,3,0,5,5
16426,2012-11-22,4,1,2,3
16427,2012-11-22,5,2,6,8
16428,2012-11-22,6,2,14,16
16429,2012-11-22,7,7,49,56
16430,2012-11-22,8,20,76,96
16431,2012-11-22,9,25,93,118
16432,2012-11-22,10,65,152,217
16433,2012-11-22,11,89,140,229
16434,2012-11-22,12,117,142,259
16435,2012-11-22,13,124,142,266
16436,2012-11-22,14,124,90,214
16437,2012-11-22,15,133,94,227
16438,2012-11-22,16,101,77,178
16439,2012-11-22,17,66,43,109
16440,2012-11-22,18,16,54,70
16441,2012-11-22,19,13,30,43
16442,2012-11-22,20,15,36,51
16443,2012-11-22,21,7,37,44
16444,2012-11-22,22,8,35,43
16445,2012-11-22,23,8,28,36
16446,2012-11-23,0,0,31,31
16447,2012-11-23,1,2,11,13
16448,2012-11-23,2,1,4,5
16449,2012-11-23,3,1,0,1
16450,2012-11-23,4,1,3,4
16451,2012-11-23,5,0,10,10
16452,2012-11-23,6,0,20,20
16453,2012-11-23,7,5,71,76
16454,2012-11-23,8,11,83,94
16455,2012-11-23,9,32,80,112
16456,2012-11-23,10,87,109,196
16457,2012-11-23,11,121,122,243
16458,2012-11-23,12,185,188,373
16459,2012-11-23,13,225,197,422
16460,2012-11-23,14,239,193,432
16461,2012-11-23,15,233,213,446
16462,2012-11-23,16,158,192,350
16463,2012-11-23,17,117,182,299
16464,2012-11-23,18,50,154,204
16465,2012-11-23,19,33,120,153
16466,2012-11-23,20,42,98,140
16467,2012-11-23,21,23,73,96
16468,2012-11-23,22,16,61,77
16469,2012-11-23,23,20,47,67
16470,2012-11-24,0,9,33,42
16471,2012-11-24,1,1,19,20
16472,2012-11-24,2,10,22,32
16473,2012-11-24,3,6,5,11
16474,2012-11-24,4,1,2,3
16475,2012-11-24,5,1,2,3
16476,2012-11-24,6,1,9,10
16477,2012-11-24,7,4,21,25
16478,2012-11-24,8,7,55,62
16479,2012-11-24,9,26,93,119
16480,2012-11-24,10,46,94,140
16481,2012-11-24,11,55,130,185
16482,2012-11-24,12,53,144,197
16483,2012-11-24,13,64,161,225
16484,2012-11-24,14,58,148,206
16485,2012-11-24,15,59,137,196
16486,2012-11-24,16,43,125,168
16487,2012-11-24,17,29,95,124
16488,2012-11-24,18,22,122,144
16489,2012-11-24,19,9,74,83
16490,2012-11-24,20,3,54,57
16491,2012-11-24,21,9,65,74
16492,2012-11-24,22,7,69,76
16493,2012-11-24,23,9,48,57
16494,2012-11-25,0,3,30,33
16495,2012-11-25,1,4,31,35
16496,2012-11-25,2,1,27,28
16497,2012-11-25,3,0,8,8
16498,2012-11-25,4,1,1,2
16499,2012-11-25,5,0,3,3
16500,2012-11-25,6,1,10,11
16501,2012-11-25,7,2,19,21
16502,2012-11-25,8,2,32,34
16503,2012-11-25,9,13,83,96
16504,2012-11-25,10,15,124,139
16505,2012-11-25,11,49,152,201
16506,2012-11-25,12,37,161,198
16507,2012-11-25,13,37,158,195
16508,2012-11-25,14,32,167,199
16509,2012-11-25,15,37,206,243
16510,2012-11-25,16,25,201,226
16511,2012-11-25,17,11,167,178
16512,2012-11-25,18,9,132,141
16513,2012-11-25,19,13,114,127
16514,2012-11-25,20,9,109,118
16515,2012-11-25,21,4,60,64
16516,2012-11-25,22,3,59,62
16517,2012-11-25,23,1,39,40
16518,2012-11-26,0,4,18,22
16519,2012-11-26,1,1,8,9
16520,2012-11-26,2,0,4,4
16521,2012-11-26,3,1,4,5
16522,2012-11-26,4,0,10,10
16523,2012-11-26,5,0,40,40
16524,2012-11-26,6,1,121,122
16525,2012-11-26,7,2,361,363
16526,2012-11-26,8,9,622,631
16527,2012-11-26,9,10,274,284
16528,2012-11-26,10,20,127,147
16529,2012-11-26,11,18,109,127
16530,2012-11-26,12,22,188,210
16531,2012-11-26,13,20,192,212
16532,2012-11-26,14,51,176,227
16533,2012-11-26,15,49,178,227
16534,2012-11-26,16,49,297,346
16535,2012-11-26,17,13,538,551
16536,2012-11-26,18,19,497,516
16537,2012-11-26,19,16,352,368
16538,2012-11-26,20,12,262,274
16539,2012-11-26,21,9,168,177
16540,2012-11-26,22,3,100,103
16541,2012-11-26,23,7,57,64
16542,2012-11-27,0,2,24,26
16543,2012-11-27,1,0,6,6
16544,2012-11-27,2,0,5,5
16545,2012-11-27,3,1,3,4
16546,2012-11-27,4,0,5,5
16547,2012-11-27,5,0,31,31
16548,2012-11-27,6,3,97,100
16549,2012-11-27,7,4,288,292
16550,2012-11-27,8,6,490,496
16551,2012-11-27,9,11,254,265
16552,2012-11-27,10,5,51,56
16553,2012-11-27,11,6,57,63
16554,2012-11-27,12,6,69,75
16555,2012-11-27,13,4,72,76
16556,2012-11-27,14,8,86,94
16557,2012-11-27,15,9,145,154
16558,2012-11-27,16,5,251,256
16559,2012-11-27,17,13,512,525
16560,2012-11-27,18,13,466,479
16561,2012-11-27,19,12,333,345
16562,2012-11-27,20,4,228,232
16563,2012-11-27,21,6,177,183
16564,2012-11-27,22,2,93,95
16565,2012-11-27,23,3,63,66
16566,2012-11-28,0,1,22,23
16567,2012-11-28,1,0,12,12
16568,2012-11-28,2,0,1,1
16569,2012-11-28,3,0,3,3
16570,2012-11-28,4,0,4,4
16571,2012-11-28,5,0,39,39
16572,2012-11-28,6,4,132,136
16573,2012-11-28,7,6,402,408
16574,2012-11-28,8,9,683,692
16575,2012-11-28,9,13,307,320
16576,2012-11-28,10,17,143,160
16577,2012-11-28,11,19,127,146
16578,2012-11-28,12,19,186,205
16579,2012-11-28,13,21,193,214
16580,2012-11-28,14,15,160,175
16581,2012-11-28,15,7,171,178
16582,2012-11-28,16,9,315,324
16583,2012-11-28,17,17,545,562
16584,2012-11-28,18,12,529,541
16585,2012-11-28,19,9,377,386
16586,2012-11-28,20,5,258,263
16587,2012-11-28,21,4,218,222
16588,2012-11-28,22,6,148,154
16589,2012-11-28,23,5,72,77
16590,2012-11-29,0,4,25,29
16591,2012-11-29,1,1,15,16
16592,2012-11-29,2,1,6,7
16593,2012-11-29,4,0,7,7
16594,2012-11-29,5,0,42,42
16595,2012-11-29,6,1,120,121
16596,2012-11-29,7,8,353,361
16597,2012-11-29,8,15,655,670
16598,2012-11-29,9,13,287,300
16599,2012-11-29,10,25,150,175
16600,2012-11-29,11,13,146,159
16601,2012-11-29,12,11,223,234
16602,2012-11-29,13,15,209,224
16603,2012-11-29,14,13,172,185
16604,2012-11-29,15,19,198,217
16605,2012-11-29,16,23,345,368
16606,2012-11-29,17,17,535,552
16607,2012-11-29,18,17,517,534
16608,2012-11-29,19,18,324,342
16609,2012-11-29,20,11,239,250
16610,2012-11-29,21,7,199,206
16611,2012-11-29,22,4,146,150
16612,2012-11-29,23,6,123,129
16613,2012-11-30,0,4,48,52
16614,2012-11-30,1,2,17,19
16615,2012-11-30,2,2,10,12
16616,2012-11-30,3,0,4,4
16617,2012-11-30,4,0,3,3
16618,2012-11-30,5,1,39,40
16619,2012-11-30,6,2,104,106
16620,2012-11-30,7,6,344,350
16621,2012-11-30,8,20,705,725
16622,2012-11-30,9,17,308,325
16623,2012-11-30,10,10,159,169
16624,2012-11-30,11,31,167,198
16625,2012-11-30,12,25,240,265
16626,2012-11-30,13,21,237,258
16627,2012-11-30,14,26,222,248
16628,2012-11-30,15,34,260,294
16629,2012-11-30,16,37,365,402
16630,2012-11-30,17,31,543,574
16631,2012-11-30,18,20,484,504
16632,2012-11-30,19,18,357,375
16633,2012-11-30,20,12,231,243
16634,2012-11-30,21,14,166,180
16635,2012-11-30,22,18,143,161
16636,2012-11-30,23,11,99,110
16637,2012-12-01,0,9,99,108
16638,2012-12-01,1,5,63,68
16639,2012-12-01,2,3,46,49
16640,2012-12-01,3,1,14,15
16641,2012-12-01,4,0,4,4
16642,2012-12-01,5,1,12,13
16643,2012-12-01,6,7,20,27
16644,2012-12-01,7,7,55,62
16645,2012-12-01,8,11,132,143
16646,2012-12-01,9,34,158,192
16647,2012-12-01,10,45,211,256
16648,2012-12-01,11,74,315,389
16649,2012-12-01,12,119,325,444
16650,2012-12-01,13,123,384,507
16651,2012-12-01,14,108,364,472
16652,2012-12-01,15,113,364,477
16653,2012-12-01,16,89,347,436
16654,2012-12-01,17,50,265,315
16655,2012-12-01,18,42,255,297
16656,2012-12-01,19,30,214,244
16657,2012-12-01,20,28,166,194
16658,2012-12-01,21,23,133,156
16659,2012-12-01,22,17,126,143
16660,2012-12-01,23,10,114,124
16661,2012-12-02,0,9,106,115
16662,2012-12-02,1,10,82,92
16663,2012-12-02,2,2,72,74
16664,2012-12-02,3,4,21,25
16665,2012-12-02,4,1,6,7
16666,2012-12-02,5,1,6,7
16667,2012-12-02,6,1,15,16
16668,2012-12-02,7,5,26,31
16669,2012-12-02,8,12,81,93
16670,2012-12-02,9,37,133,170
16671,2012-12-02,10,63,228,291
16672,2012-12-02,11,80,273,353
16673,2012-12-02,12,111,402,513
16674,2012-12-02,13,84,341,425
16675,2012-12-02,14,140,326,466
16676,2012-12-02,15,106,306,412
16677,2012-12-02,16,85,353,438
16678,2012-12-02,17,59,242,301
16679,2012-12-02,18,25,176,201
16680,2012-12-02,19,16,158,174
16681,2012-12-02,20,12,139,151
16682,2012-12-02,21,8,91,99
16683,2012-12-02,22,11,82,93
16684,2012-12-02,23,7,44,51
16685,2012-12-03,0,3,18,21
16686,2012-12-03,1,2,11,13
16687,2012-12-03,2,1,9,10
16688,2012-12-03,3,2,6,8
16689,2012-12-03,4,1,3,4
16690,2012-12-03,5,0,37,37
16691,2012-12-03,6,2,136,138
16692,2012-12-03,7,9,384,393
16693,2012-12-03,8,19,707,726
16694,2012-12-03,9,19,288,307
16695,2012-12-03,10,31,105,136
16696,2012-12-03,11,51,180,231
16697,2012-12-03,12,40,225,265
16698,2012-12-03,13,81,238,319
16699,2012-12-03,14,51,207,258
16700,2012-12-03,15,58,210,268
16701,2012-12-03,16,45,391,436
16702,2012-12-03,17,43,662,705
16703,2012-12-03,18,26,655,681
16704,2012-12-03,19,27,439,466
16705,2012-12-03,20,16,282,298
16706,2012-12-03,21,14,206,220
16707,2012-12-03,22,5,138,143
16708,2012-12-03,23,9,91,100
16709,2012-12-04,0,6,49,55
16710,2012-12-04,1,3,22,25
16711,2012-12-04,2,3,5,8
16712,2012-12-04,3,1,3,4
16713,2012-12-04,4,0,7,7
16714,2012-12-04,5,1,45,46
16715,2012-12-04,6,3,148,151
16716,2012-12-04,7,7,491,498
16717,2012-12-04,8,21,696,717
16718,2012-12-04,9,19,316,335
16719,2012-12-04,10,26,130,156
16720,2012-12-04,11,24,183,207
16721,2012-12-04,12,39,272,311
16722,2012-12-04,13,39,233,272
16723,2012-12-04,14,39,230,269
16724,2012-12-04,15,56,244,300
16725,2012-12-04,16,44,389,433
16726,2012-12-04,17,43,694,737
16727,2012-12-04,18,38,687,725
16728,2012-12-04,19,46,408,454
16729,2012-12-04,20,34,266,300
16730,2012-12-04,21,28,249,277
16731,2012-12-04,22,26,153,179
16732,2012-12-04,23,5,91,96
16733,2012-12-05,0,6,31,37
16734,2012-12-05,1,0,11,11
16735,2012-12-05,2,2,7,9
16736,2012-12-05,3,0,7,7
16737,2012-12-05,4,1,9,10
16738,2012-12-05,5,1,47,48
16739,2012-12-05,6,5,118,123
16740,2012-12-05,7,9,389,398
16741,2012-12-05,8,22,736,758
16742,2012-12-05,9,26,359,385
16743,2012-12-05,10,14,127,141
16744,2012-12-05,11,11,160,171
16745,2012-12-05,12,24,207,231
16746,2012-12-05,13,14,194,208
16747,2012-12-05,14,39,176,215
16748,2012-12-05,15,20,241,261
16749,2012-12-05,16,23,351,374
16750,2012-12-05,17,29,571,600
16751,2012-12-05,18,29,574,603
16752,2012-12-05,19,14,399,413
16753,2012-12-05,20,19,272,291
16754,2012-12-05,21,14,182,196
16755,2012-12-05,22,4,101,105
16756,2012-12-05,23,5,65,70
16757,2012-12-06,0,1,43,44
16758,2012-12-06,1,0,16,16
16759,2012-12-06,2,0,9,9
16760,2012-12-06,3,0,2,2
16761,2012-12-06,4,1,8,9
16762,2012-12-06,5,0,32,32
16763,2012-12-06,6,2,122,124
16764,2012-12-06,7,8,379,387
16765,2012-12-06,8,13,645,658
16766,2012-12-06,9,19,256,275
16767,2012-12-06,10,23,121,144
16768,2012-12-06,11,16,162,178
16769,2012-12-06,12,29,205,234
16770,2012-12-06,13,33,212,245
16771,2012-12-06,14,37,173,210
16772,2012-12-06,15,38,230,268
16773,2012-12-06,16,39,288,327
16774,2012-12-06,17,31,581,612
16775,2012-12-06,18,23,541,564
16776,2012-12-06,19,13,358,371
16777,2012-12-06,20,5,221,226
16778,2012-12-06,21,7,181,188
16779,2012-12-06,22,2,130,132
16780,2012-12-06,23,0,90,90
16781,2012-12-07,0,3,45,48
16782,2012-12-07,1,2,26,28
16783,2012-12-07,2,0,11,11
16784,2012-12-07,3,0,5,5
16785,2012-12-07,4,0,10,10
16786,2012-12-07,5,1,25,26
16787,2012-12-07,6,0,83,83
16788,2012-12-07,7,3,211,214
16789,2012-12-07,8,11,424,435
16790,2012-12-07,9,10,287,297
16791,2012-12-07,10,16,151,167
16792,2012-12-07,11,20,180,200
16793,2012-12-07,12,36,201,237
16794,2012-12-07,13,23,197,220
16795,2012-12-07,14,40,172,212
16796,2012-12-07,15,34,266,300
16797,2012-12-07,16,39,333,372
16798,2012-12-07,17,29,537,566
16799,2012-12-07,18,25,467,492
16800,2012-12-07,19,15,333,348
16801,2012-12-07,20,12,224,236
16802,2012-12-07,21,9,161,170
16803,2012-12-07,22,15,149,164
16804,2012-12-07,23,6,115,121
16805,2012-12-08,0,5,98,103
16806,2012-12-08,1,16,83,99
16807,2012-12-08,2,3,67,70
16808,2012-12-08,3,6,23,29
16809,2012-12-08,4,3,9,12
16810,2012-12-08,5,2,3,5
16811,2012-12-08,6,1,19,20
16812,2012-12-08,7,3,36,39
16813,2012-12-08,8,5,105,110
16814,2012-12-08,9,17,151,168
16815,2012-12-08,10,43,242,285
16816,2012-12-08,11,63,338,401
16817,2012-12-08,12,122,359,481
16818,2012-12-08,13,148,397,545
16819,2012-12-08,14,164,378,542
16820,2012-12-08,15,168,370,538
16821,2012-12-08,16,139,366,505
16822,2012-12-08,17,77,261,338
16823,2012-12-08,18,40,257,297
16824,2012-12-08,19,34,204,238
16825,2012-12-08,20,20,159,179
16826,2012-12-08,21,34,169,203
16827,2012-12-08,22,23,136,159
16828,2012-12-08,23,18,142,160
16829,2012-12-09,0,15,100,115
16830,2012-12-09,1,17,84,101
16831,2012-12-09,2,8,70,78
16832,2012-12-09,3,14,34,48
16833,2012-12-09,4,1,11,12
16834,2012-12-09,5,0,8,8
16835,2012-12-09,6,0,6,6
16836,2012-12-09,7,1,21,22
16837,2012-12-09,8,1,68,69
16838,2012-12-09,9,9,93,102
16839,2012-12-09,10,39,179,218
16840,2012-12-09,11,40,209,249
16841,2012-12-09,12,60,253,313
16842,2012-12-09,13,65,218,283
16843,2012-12-09,14,42,186,228
16844,2012-12-09,15,25,197,222
16845,2012-12-09,16,33,218,251
16846,2012-12-09,17,20,209,229
16847,2012-12-09,18,17,178,195
16848,2012-12-09,19,12,108,120
16849,2012-12-09,20,6,99,105
16850,2012-12-09,21,10,86,96
16851,2012-12-09,22,3,74,77
16852,2012-12-09,23,3,48,51
16853,2012-12-10,0,0,20,20
16854,2012-12-10,1,0,4,4
16855,2012-12-10,2,2,3,5
16856,2012-12-10,3,0,4,4
16857,2012-12-10,4,3,9,12
16858,2012-12-10,5,0,26,26
16859,2012-12-10,6,2,120,122
16860,2012-12-10,7,3,291,294
16861,2012-12-10,8,9,570,579
16862,2012-12-10,9,11,271,282
16863,2012-12-10,10,12,118,130
16864,2012-12-10,11,8,126,134
16865,2012-12-10,12,23,148,171
16866,2012-12-10,13,30,188,218
16867,2012-12-10,14,31,179,210
16868,2012-12-10,15,29,203,232
16869,2012-12-10,16,37,304,341
16870,2012-12-10,17,38,575,613
16871,2012-12-10,18,20,539,559
16872,2012-12-10,19,18,408,426
16873,2012-12-10,20,13,284,297
16874,2012-12-10,21,21,220,241
16875,2012-12-10,22,11,112,123
16876,2012-12-10,23,8,76,84
16877,2012-12-11,0,2,29,31
16878,2012-12-11,1,1,7,8
16879,2012-12-11,2,0,1,1
16880,2012-12-11,3,0,3,3
16881,2012-12-11,4,0,8,8
16882,2012-12-11,5,1,40,41
16883,2012-12-11,6,0,118,118
16884,2012-12-11,7,8,370,378
16885,2012-12-11,8,16,700,716
16886,2012-12-11,9,12,322,334
16887,2012-12-11,10,12,141,153
16888,2012-12-11,11,27,144,171
16889,2012-12-11,12,13,211,224
16890,2012-12-11,13,28,223,251
16891,2012-12-11,14,19,180,199
16892,2012-12-11,15,20,247,267
16893,2012-12-11,16,24,333,357
16894,2012-12-11,17,21,575,596
16895,2012-12-11,18,23,518,541
16896,2012-12-11,19,21,409,430
16897,2012-12-11,20,9,245,254
16898,2012-12-11,21,14,191,205
16899,2012-12-11,22,6,100,106
16900,2012-12-11,23,4,59,63
16901,2012-12-12,0,1,33,34
16902,2012-12-12,1,3,18,21
16903,2012-12-12,2,5,4,9
16904,2012-12-12,3,2,6,8
16905,2012-12-12,4,0,4,4
16906,2012-12-12,5,0,36,36
16907,2012-12-12,6,2,125,127
16908,2012-12-12,7,3,364,367
16909,2012-12-12,8,18,659,677
16910,2012-12-12,9,13,272,285
16911,2012-12-12,10,20,115,135
16912,2012-12-12,11,24,147,171
16913,2012-12-12,12,14,215,229
16914,2012-12-12,13,18,219,237
16915,2012-12-12,14,34,190,224
16916,2012-12-12,15,21,207,228
16917,2012-12-12,16,19,309,328
16918,2012-12-12,17,21,535,556
16919,2012-12-12,18,25,513,538
16920,2012-12-12,19,18,383,401
16921,2012-12-12,20,25,241,266
16922,2012-12-12,21,16,183,199
16923,2012-12-12,22,4,116,120
16924,2012-12-12,23,3,75,78
16925,2012-12-13,0,1,31,32
16926,2012-12-13,1,4,18,22
16927,2012-12-13,2,3,5,8
16928,2012-12-13,3,0,2,2
16929,2012-12-13,4,0,8,8
16930,2012-12-13,5,2,30,32
16931,2012-12-13,6,2,112,114
16932,2012-12-13,7,5,379,384
16933,2012-12-13,8,24,649,673
16934,2012-12-13,9,25,296,321
16935,2012-12-13,10,28,137,165
16936,2012-12-13,11,25,162,187
16937,2012-12-13,12,30,247,277
16938,2012-12-13,13,41,228,269
16939,2012-12-13,14,31,205,236
16940,2012-12-13,15,40,240,280
16941,2012-12-13,16,50,354,404
16942,2012-12-13,17,43,501,544
16943,2012-12-13,18,20,443,463
16944,2012-12-13,19,20,326,346
16945,2012-12-13,20,6,233,239
16946,2012-12-13,21,13,195,208
16947,2012-12-13,22,7,141,148
16948,2012-12-13,23,5,114,119
16949,2012-12-14,0,4,42,46
16950,2012-12-14,1,0,26,26
16951,2012-12-14,2,3,6,9
16952,2012-12-14,3,0,12,12
16953,2012-12-14,4,1,8,9
16954,2012-12-14,5,0,33,33
16955,2012-12-14,6,1,111,112
16956,2012-12-14,7,3,303,306
16957,2012-12-14,8,13,618,631
16958,2012-12-14,9,13,328,341
16959,2012-12-14,10,28,159,187
16960,2012-12-14,11,31,177,208
16961,2012-12-14,12,29,242,271
16962,2012-12-14,13,39,271,310
16963,2012-12-14,14,48,251,299
16964,2012-12-14,15,57,251,308
16965,2012-12-14,16,45,369,414
16966,2012-12-14,17,40,573,613
16967,2012-12-14,18,23,429,452
16968,2012-12-14,19,17,300,317
16969,2012-12-14,20,12,207,219
16970,2012-12-14,21,7,163,170
16971,2012-12-14,22,4,131,135
16972,2012-12-14,23,11,122,133
16973,2012-12-15,0,4,88,92
16974,2012-12-15,1,9,86,95
16975,2012-12-15,2,6,61,67
16976,2012-12-15,3,5,18,23
16977,2012-12-15,4,1,5,6
16978,2012-12-15,5,0,3,3
16979,2012-12-15,6,0,11,11
16980,2012-12-15,7,1,46,47
16981,2012-12-15,8,8,107,115
16982,2012-12-15,9,17,200,217
16983,2012-12-15,10,23,247,270
16984,2012-12-15,11,66,319,385
16985,2012-12-15,12,89,359,448
16986,2012-12-15,13,88,361,449
16987,2012-12-15,14,92,332,424
16988,2012-12-15,15,95,350,445
16989,2012-12-15,16,85,323,408
16990,2012-12-15,17,35,270,305
16991,2012-12-15,18,40,230,270
16992,2012-12-15,19,31,224,255
16993,2012-12-15,20,24,172,196
16994,2012-12-15,21,15,167,182
16995,2012-12-15,22,21,131,152
16996,2012-12-15,23,11,105,116
16997,2012-12-16,0,8,101,109
16998,2012-12-16,1,14,81,95
16999,2012-12-16,2,8,76,84
17000,2012-12-16,3,1,33,34
17001,2012-12-16,4,1,10,11
17002,2012-12-16,5,0,9,9
17003,2012-12-16,6,0,6,6
17004,2012-12-16,7,5,22,27
17005,2012-12-16,8,12,74,86
17006,2012-12-16,9,19,112,131
17007,2012-12-16,10,42,215,257
17008,2012-12-16,11,47,243,290
17009,2012-12-16,12,67,344,411
17010,2012-12-16,13,67,285,352
17011,2012-12-16,14,50,256,306
17012,2012-12-16,15,46,291,337
17013,2012-12-16,16,66,331,397
17014,2012-12-16,17,29,213,242
17015,2012-12-16,18,8,99,107
17016,2012-12-16,19,10,98,108
17017,2012-12-16,20,14,104,118
17018,2012-12-16,21,14,92,106
17019,2012-12-16,22,6,81,87
17020,2012-12-16,23,4,29,33
17021,2012-12-17,0,2,26,28
17022,2012-12-17,1,1,14,15
17023,2012-12-17,2,1,4,5
17024,2012-12-17,3,0,3,3
17025,2012-12-17,4,2,3,5
17026,2012-12-17,5,0,24,24
17027,2012-12-17,6,1,107,108
17028,2012-12-17,7,5,312,317
17029,2012-12-17,8,9,579,588
17030,2012-12-17,9,12,267,279
17031,2012-12-17,10,15,119,134
17032,2012-12-17,11,22,148,170
17033,2012-12-17,12,21,209,230
17034,2012-12-17,13,16,192,208
17035,2012-12-17,14,12,169,181
17036,2012-12-17,15,15,194,209
17037,2012-12-17,16,15,283,298
17038,2012-12-17,17,17,473,490
17039,2012-12-17,18,14,489,503
17040,2012-12-17,19,7,330,337
17041,2012-12-17,20,8,192,200
17042,2012-12-17,21,6,114,120
17043,2012-12-17,22,5,47,52
17044,2012-12-17,23,6,40,46
17045,2012-12-18,0,0,18,18
17046,2012-12-18,1,0,15,15
17047,2012-12-18,2,2,5,7
17048,2012-12-18,3,0,5,5
17049,2012-12-18,4,3,5,8
17050,2012-12-18,5,0,36,36
17051,2012-12-18,6,1,116,117
17052,2012-12-18,7,4,349,353
17053,2012-12-18,8,10,648,658
17054,2012-12-18,9,19,306,325
17055,2012-12-18,10,22,161,183
17056,2012-12-18,11,58,207,265
17057,2012-12-18,12,49,258,307
17058,2012-12-18,13,51,234,285
17059,2012-12-18,14,56,187,243
17060,2012-12-18,15,28,218,246
17061,2012-12-18,16,40,321,361
17062,2012-12-18,17,39,530,569
17063,2012-12-18,18,13,511,524
17064,2012-12-18,19,19,330,349
17065,2012-12-18,20,4,262,266
17066,2012-12-18,21,9,155,164
17067,2012-12-18,22,5,125,130
17068,2012-12-18,23,1,78,79
17069,2012-12-19,0,6,35,41
17070,2012-12-19,1,1,14,15
17071,2012-12-19,2,1,2,3
17072,2012-12-19,3,0,5,5
17073,2012-12-19,4,1,6,7
17074,2012-12-19,5,2,29,31
17075,2012-12-19,6,3,109,112
17076,2012-12-19,7,3,359,362
17077,2012-12-19,8,13,656,669
17078,2012-12-19,9,8,310,318
17079,2012-12-19,10,17,146,163
17080,2012-12-19,11,31,167,198
17081,2012-12-19,12,33,203,236
17082,2012-12-19,13,30,183,213
17083,2012-12-19,14,33,185,218
17084,2012-12-19,15,28,208,236
17085,2012-12-19,16,37,295,332
17086,2012-12-19,17,26,531,557
17087,2012-12-19,18,23,541,564
17088,2012-12-19,19,7,326,333
17089,2012-12-19,20,10,230,240
17090,2012-12-19,21,4,163,167
17091,2012-12-19,22,12,115,127
17092,2012-12-19,23,4,83,87
17093,2012-12-20,0,2,40,42
17094,2012-12-20,1,1,19,20
17095,2012-12-20,2,2,6,8
17096,2012-12-20,3,1,3,4
17097,2012-12-20,4,0,6,6
17098,2012-12-20,5,0,34,34
17099,2012-12-20,6,4,113,117
17100,2012-12-20,7,4,340,344
17101,2012-12-20,8,14,583,597
17102,2012-12-20,9,14,301,315
17103,2012-12-20,10,23,137,160
17104,2012-12-20,11,22,166,188
17105,2012-12-20,12,31,179,210
17106,2012-12-20,13,46,171,217
17107,2012-12-20,14,43,170,213
17108,2012-12-20,15,33,211,244
17109,2012-12-20,16,21,281,302
17110,2012-12-20,17,25,445,470
17111,2012-12-20,18,22,356,378
17112,2012-12-20,19,3,115,118
17113,2012-12-20,20,1,49,50
17114,2012-12-20,21,1,25,26
17115,2012-12-20,22,1,20,21
17116,2012-12-20,23,0,13,13
17117,2012-12-21,0,0,17,17
17118,2012-12-21,1,2,7,9
17119,2012-12-21,2,0,3,3
17120,2012-12-21,3,0,3,3
17121,2012-12-21,4,1,5,6
17122,2012-12-21,5,0,13,13
17123,2012-12-21,6,4,75,79
17124,2012-12-21,7,3,202,205
17125,2012-12-21,8,8,458,466
17126,2012-12-21,9,2,260,262
17127,2012-12-21,10,8,144,152
17128,2012-12-21,11,12,150,162
17129,2012-12-21,12,25,197,222
17130,2012-12-21,13,26,212,238
17131,2012-12-21,14,20,196,216
17132,2012-12-21,15,29,233,262
17133,2012-12-21,16,28,248,276
17134,2012-12-21,17,24,293,317
17135,2012-12-21,18,7,231,238
17136,2012-12-21,19,5,148,153
17137,2012-12-21,20,8,104,112
17138,2012-12-21,21,2,68,70
17139,2012-12-21,22,6,57,63
17140,2012-12-21,23,1,39,40
17141,2012-12-22,0,1,30,31
17142,2012-12-22,1,1,34,35
17143,2012-12-22,2,0,23,23
17144,2012-12-22,3,0,7,7
17145,2012-12-22,4,3,2,5
17146,2012-12-22,5,0,5,5
17147,2012-12-22,6,0,13,13
17148,2012-12-22,7,2,18,20
17149,2012-12-22,8,0,29,29
17150,2012-12-22,9,13,77,90
17151,2012-12-22,10,13,104,117
17152,2012-12-22,11,29,129,158
17153,2012-12-22,12,18,127,145
17154,2012-12-22,13,23,133,156
17155,2012-12-22,14,20,140,160
17156,2012-12-22,15,14,136,150
17157,2012-12-22,16,23,123,146
17158,2012-12-22,17,15,99,114
17159,2012-12-22,18,7,74,81
17160,2012-12-22,19,9,50,59
17161,2012-12-22,20,6,53,59
17162,2012-12-22,21,4,48,52
17163,2012-12-22,22,1,37,38
17164,2012-12-22,23,3,36,39
17165,2012-12-23,0,3,25,28
17166,2012-12-23,1,1,19,20
17167,2012-12-23,2,1,17,18
17168,2012-12-23,3,0,9,9
17169,2012-12-23,4,1,3,4
17170,2012-12-23,5,0,6,6
17171,2012-12-23,6,4,5,9
17172,2012-12-23,7,3,15,18
17173,2012-12-23,8,5,43,48
17174,2012-12-23,9,7,49,56
17175,2012-12-23,10,26,67,93
17176,2012-12-23,11,48,99,147
17177,2012-12-23,12,52,141,193
17178,2012-12-23,13,63,122,185
17179,2012-12-23,14,57,116,173
17180,2012-12-23,15,39,96,135
17181,2012-12-23,16,53,137,190
17182,2012-12-23,17,21,91,112
17183,2012-12-23,18,8,84,92
17184,2012-12-23,19,4,51,55
17185,2012-12-23,20,0,50,50
17186,2012-12-23,21,4,38,42
17187,2012-12-23,22,5,53,58
17188,2012-12-23,23,3,22,25
17189,2012-12-24,0,0,12,12
17190,2012-12-24,1,0,11,11
17191,2012-12-24,2,0,5,5
17192,2012-12-24,3,1,2,3
17193,2012-12-24,5,0,9,9
17194,2012-12-24,6,1,15,16
17195,2012-12-24,7,3,27,30
17196,2012-12-24,8,4,62,66
17197,2012-12-24,9,17,68,85
17198,2012-12-24,10,21,79,100
17199,2012-12-24,11,20,102,122
17200,2012-12-24,12,22,113,135
17201,2012-12-24,13,16,54,70
17202,2012-12-24,14,13,32,45
17203,2012-12-24,15,6,26,32
17204,2012-12-24,16,6,26,32
17205,2012-12-24,17,7,19,26
17206,2012-12-24,18,6,19,25
17207,2012-12-24,19,4,13,17
17208,2012-12-24,20,6,17,23
17209,2012-12-24,21,13,9,22
17210,2012-12-24,22,7,5,12
17211,2012-12-24,23,1,10,11
17212,2012-12-25,0,3,10,13
17213,2012-12-25,1,0,13,13
17214,2012-12-25,2,0,7,7
17215,2012-12-25,4,0,1,1
17216,2012-12-25,5,2,1,3
17217,2012-12-25,6,1,6,7
17218,2012-12-25,7,0,6,6
17219,2012-12-25,8,1,10,11
17220,2012-12-25,9,7,20,27
17221,2012-12-25,10,11,21,32
17222,2012-12-25,11,43,42,85
17223,2012-12-25,12,62,51,113
17224,2012-12-25,13,75,44,119
17225,2012-12-25,14,58,67,125
17226,2012-12-25,15,51,54,105
17227,2012-12-25,16,48,37,85
17228,2012-12-25,17,16,34,50
17229,2012-12-25,18,20,23,43
17230,2012-12-25,19,16,20,36
17231,2012-12-25,20,11,29,40
17232,2012-12-25,21,8,26,34
17233,2012-12-25,22,3,16,19
17234,2012-12-25,23,4,26,30
17235,2012-12-26,0,1,7,8
17236,2012-12-26,1,0,7,7
17237,2012-12-26,2,0,1,1
17238,2012-12-26,3,0,2,2
17239,2012-12-26,4,0,2,2
17240,2012-12-26,5,0,11,11
17241,2012-12-26,6,0,36,36
17242,2012-12-26,7,0,26,26
17243,2012-12-26,8,0,30,30
17244,2012-12-26,9,1,22,23
17245,2012-12-26,10,0,8,8
17246,2012-12-26,11,0,10,10
17247,2012-12-26,12,0,9,9
17248,2012-12-26,13,0,14,14
17249,2012-12-26,14,0,20,20
17250,2012-12-26,15,0,13,13
17251,2012-12-26,16,0,13,13
17252,2012-12-26,17,2,50,52
17253,2012-12-26,18,1,42,43
17254,2012-12-26,19,2,33,35
17255,2012-12-26,20,0,32,32
17256,2012-12-26,21,0,20,20
17257,2012-12-26,22,0,11,11
17258,2012-12-26,23,2,7,9
17259,2012-12-27,0,0,3,3
17260,2012-12-27,1,0,5,5
17261,2012-12-27,2,0,2,2
17262,2012-12-27,3,0,1,1
17263,2012-12-27,4,0,3,3
17264,2012-12-27,5,1,10,11
17265,2012-12-27,6,0,44,44
17266,2012-12-27,7,0,90,90
17267,2012-12-27,8,2,202,204
17268,2012-12-27,9,6,127,133
17269,2012-12-27,10,8,66,74
17270,2012-12-27,11,23,80,103
17271,2012-12-27,12,22,85,107
17272,2012-12-27,13,19,99,118
17273,2012-12-27,14,25,94,119
17274,2012-12-27,15,31,87,118
17275,2012-12-27,16,23,150,173
17276,2012-12-27,17,30,225,255
17277,2012-12-27,18,9,187,196
17278,2012-12-27,19,11,106,117
17279,2012-12-27,20,12,76,88
17280,2012-12-27,21,12,50,62
17281,2012-12-27,22,11,33,44
17282,2012-12-27,23,2,24,26
17283,2012-12-28,0,3,22,25
17284,2012-12-28,1,0,9,9
17285,2012-12-28,2,0,5,5
17286,2012-12-28,3,0,2,2
17287,2012-12-28,4,0,4,4
17288,2012-12-28,5,0,15,15
17289,2012-12-28,6,2,49,51
17290,2012-12-28,7,1,110,111
17291,2012-12-28,8,1,238,239
17292,2012-12-28,9,18,171,189
17293,2012-12-28,10,77,84,161
17294,2012-12-28,11,71,106,177
17295,2012-12-28,12,72,149,221
17296,2012-12-28,13,76,143,219
17297,2012-12-28,14,84,172,256
17298,2012-12-28,15,74,150,224
17299,2012-12-28,16,42,205,247
17300,2012-12-28,17,43,222,265
17301,2012-12-28,18,16,196,212
17302,2012-12-28,19,15,112,127
17303,2012-12-28,20,14,83,97
17304,2012-12-28,21,17,74,91
17305,2012-12-28,22,13,48,61
17306,2012-12-28,23,5,54,59
17307,2012-12-29,0,1,24,25
17308,2012-12-29,1,6,31,37
17309,2012-12-29,2,1,18,19
17310,2012-12-29,3,1,5,6
17311,2012-12-29,4,0,3,3
17312,2012-12-29,5,0,3,3
17313,2012-12-29,6,0,7,7
17314,2012-12-29,7,1,16,17
17315,2012-12-29,8,9,35,44
17316,2012-12-29,9,16,33,49
17317,2012-12-29,10,6,33,39
17318,2012-12-29,11,7,38,45
17319,2012-12-29,12,5,43,48
17320,2012-12-29,13,13,69,82
17321,2012-12-29,14,10,88,98
17322,2012-12-29,15,18,110,128
17323,2012-12-29,16,22,125,147
17324,2012-12-29,17,18,98,116
17325,2012-12-29,18,8,102,110
17326,2012-12-29,19,7,89,96
17327,2012-12-29,20,2,64,66
17328,2012-12-29,21,4,54,58
17329,2012-12-29,22,3,51,54
17330,2012-12-29,23,0,31,31
17331,2012-12-30,0,0,41,41
17332,2012-12-30,1,1,27,28
17333,2012-12-30,2,0,19,19
17334,2012-12-30,3,1,14,15
17335,2012-12-30,4,0,7,7
17336,2012-12-30,5,0,2,2
17337,2012-12-30,6,1,7,8
17338,2012-12-30,7,0,13,13
17339,2012-12-30,8,1,32,33
17340,2012-12-30,9,9,64,73
17341,2012-12-30,10,31,90,121
17342,2012-12-30,11,33,103,136
17343,2012-12-30,12,47,96,143
17344,2012-12-30,13,49,120,169
17345,2012-12-30,14,39,120,159
17346,2012-12-30,15,37,99,136
17347,2012-12-30,16,31,102,133
17348,2012-12-30,17,26,96,122
17349,2012-12-30,18,12,107,119
17350,2012-12-30,19,16,84,100
17351,2012-12-30,20,9,63,72
17352,2012-12-30,21,5,42,47
17353,2012-12-30,22,6,29,35
17354,2012-12-30,23,10,39,49
17355,2012-12-31,0,4,30,34
17356,2012-12-31,1,6,13,19
17357,2012-12-31,2,3,8,11
17358,2012-12-31,3,0,1,1
17359,2012-12-31,4,0,3,3
17360,2012-12-31,5,0,9,9
17361,2012-12-31,6,0,39,39
17362,2012-12-31,7,2,83,85
17363,2012-12-31,8,9,184,193
17364,2012-12-31,9,13,142,155
17365,2012-12-31,10,33,88,121
17366,2012-12-31,11,43,113,156
17367,2012-12-31,12,52,169,221
17368,2012-12-31,13,38,164,202
17369,2012-12-31,14,62,185,247
17370,2012-12-31,15,69,244,313
17371,2012-12-31,16,30,184,214
17372,2012-12-31,17,14,146,160
17373,2012-12-31,18,10,110,120
17374,2012-12-31,19,11,107,118
17375,2012-12-31,20,8,81,89
17376,2012-12-31,21,7,83,90
17377,2012-12-31,22,13,48,61
17378,2012-12-31,23,12,38,50
17379,2013-01-01,0,9,33,42
17380,2013-01-01,1,27,84,111
17381,2013-01-01,2,27,102,129
17382,2013-01-01,3,16,42,58
17383,2013-01-01,4,4,15,19
17384,2013-01-01,5,0,5,5
17385,2013-01-01,6,4,9,13
17386,2013-01-01,7,0,5,5
17387,2013-01-01,8,3,12,15
17388,2013-01-01,9,7,25,32
17389,2013-01-01,10,5,48,53
17390,2013-01-01,11,17,97,114
17391,2013-01-01,12,42,110,152
17392,2013-01-01,13,21,120,141
17393,2013-01-01,14,61,112,173
17394,2013-01-01,15,37,123,160
17395,2013-01-01,16,45,120,165
17396,2013-01-01,17,23,117,140
17397,2013-01-01,18,12,105,117
17398,2013-01-01,19,20,89,109
17399,2013-01-01,20,7,63,70
17400,2013-01-01,21,9,47,56
17401,2013-01-01,22,19,33,52
17402,2013-01-01,23,6,27,33
17403,2013-01-02,0,0,9,9
17404,2013-01-02,1,2,6,8
17405,2013-01-02,2,0,2,2
17406,2013-01-02,3,0,3,3
17407,2013-01-02,4,0,4,4
17408,2013-01-02,5,1,28,29
17409,2013-01-02,6,2,91,93
17410,2013-01-02,7,3,242,245
17411,2013-01-02,8,6,485,491
17412,2013-01-02,9,5,224,229
17413,2013-01-02,10,35,92,127
17414,2013-01-02,11,32,113,145
17415,2013-01-02,12,25,143,168
17416,2013-01-02,13,23,141,164
17417,2013-01-02,14,14,117,131
17418,2013-01-02,15,26,168,194
17419,2013-01-02,16,30,237,267
17420,2013-01-02,17,30,416,446
17421,2013-01-02,18,19,345,364
17422,2013-01-02,19,8,233,241
17423,2013-01-02,20,5,117,122
17424,2013-01-02,21,9,85,94
17425,2013-01-02,22,5,51,56
17426,2013-01-02,23,4,37,41
17427,2013-01-03,0,1,15,16
17428,2013-01-03,1,0,6,6
17429,2013-01-03,2,0,2,2
17430,2013-01-03,3,0,3,3
17431,2013-01-03,4,0,2,2
17432,2013-01-03,5,0,26,26
17433,2013-01-03,6,3,96,99
17434,2013-01-03,7,2,219,221
17435,2013-01-03,8,10,512,522
17436,2013-01-03,9,18,257,275
17437,2013-01-03,10,16,118,134
17438,2013-01-03,11,21,109,130
17439,2013-01-03,12,30,142,172
17440,2013-01-03,13,37,126,163
17441,2013-01-03,14,25,131,156
17442,2013-01-03,15,35,134,169
17443,2013-01-03,16,31,231,262
17444,2013-01-03,17,34,453,487
17445,2013-01-03,18,15,381,396
17446,2013-01-03,19,5,235,240
17447,2013-01-03,20,5,128,133
17448,2013-01-03,21,2,96,98
17449,2013-01-03,22,1,78,79
17450,2013-01-03,23,6,47,53
17451,2013-01-04,0,6,17,23
17452,2013-01-04,1,0,8,8
17453,2013-01-04,2,1,3,4
17454,2013-01-04,3,0,2,2
17455,2013-01-04,4,0,7,7
17456,2013-01-04,5,1,24,25
17457,2013-01-04,6,4,81,85
17458,2013-01-04,7,3,224,227
17459,2013-01-04,8,7,523,530
17460,2013-01-04,9,17,273,290
17461,2013-01-04,10,12,117,129
17462,2013-01-04,11,16,106,122
17463,2013-01-04,12,26,171,197
17464,2013-01-04,13,29,172,201
17465,2013-01-04,14,50,149,199
17466,2013-01-04,15,27,174,201
17467,2013-01-04,16,23,254,277
17468,2013-01-04,17,23,464,487
17469,2013-01-04,18,14,371,385
17470,2013-01-04,19,13,231,244
17471,2013-01-04,20,13,151,164
17472,2013-01-04,21,6,101,107
17473,2013-01-04,22,5,88,93
17474,2013-01-04,23,1,70,71
17475,2013-01-05,0,3,49,52
17476,2013-01-05,1,2,31,33
17477,2013-01-05,2,5,27,32
17478,2013-01-05,3,0,8,8
17479,2013-01-05,4,0,7,7
17480,2013-01-05,5,0,1,1
17481,2013-01-05,6,2,10,12
17482,2013-01-05,7,1,26,27
17483,2013-01-05,8,6,64,70
17484,2013-01-05,9,10,106,116
17485,2013-01-05,10,24,167,191
17486,2013-01-05,11,35,218,253
17487,2013-01-05,12,51,265,316
17488,2013-01-05,13,58,310,368
17489,2013-01-05,14,60,277,337
17490,2013-01-05,15,70,246,316
17491,2013-01-05,16,64,246,310
17492,2013-01-05,17,36,195,231
17493,2013-01-05,18,17,202,219
17494,2013-01-05,19,14,179,193
17495,2013-01-05,20,25,136,161
17496,2013-01-05,21,14,89,103
17497,2013-01-05,22,5,92,97
17498,2013-01-05,23,7,55,62
17499,2013-01-06,0,7,68,75
17500,2013-01-06,1,4,52,56
17501,2013-01-06,2,1,45,46
17502,2013-01-06,3,5,12,17
17503,2013-01-06,4,0,5,5
17504,2013-01-06,5,0,6,6
17505,2013-01-06,6,1,10,11
17506,2013-01-06,7,0,21,21
17507,2013-01-06,8,2,59,61
17508,2013-01-06,9,5,89,94
17509,2013-01-06,10,27,222,249
17510,2013-01-06,11,49,233,282
17511,2013-01-06,12,52,315,367
17512,2013-01-06,13,78,324,402
17513,2013-01-06,14,97,282,379
17514,2013-01-06,15,97,312,409
17515,2013-01-06,16,59,299,358
17516,2013-01-06,17,37,201,238
17517,2013-01-06,18,10,167,177
17518,2013-01-06,19,8,168,176
17519,2013-01-06,20,8,119,127
17520,2013-01-06,21,12,70,82
17521,2013-01-06,22,17,57,74
17522,2013-01-06,23,9,30,39
17523,2013-01-07,0,2,15,17
17524,2013-01-07,1,2,9,11
17525,2013-01-07,2,0,4,4
17526,2013-01-07,3,0,3,3
17527,2013-01-07,4,0,7,7
17528,2013-01-07,5,3,30,33
17529,2013-01-07,6,2,124,126
17530,2013-01-07,7,6,324,330
17531,2013-01-07,8,11,609,620
17532,2013-01-07,9,11,258,269
17533,2013-01-07,10,8,89,97
17534,2013-01-07,11,17,93,110
17535,2013-01-07,12,25,176,201
17536,2013-01-07,13,38,151,189
17537,2013-01-07,14,40,133,173
17538,2013-01-07,15,29,179,208
17539,2013-01-07,16,34,310,344
17540,2013-01-07,17,44,552,596
17541,2013-01-07,18,23,515,538
17542,2013-01-07,19,13,334,347
17543,2013-01-07,20,9,211,220
17544,2013-01-07,21,11,135,146
17545,2013-01-07,22,3,91,94
17546,2013-01-07,23,1,57,58
17547,2013-01-08,0,0,21,21
17548,2013-01-08,1,0,14,14
17549,2013-01-08,2,3,1,4
17550,2013-01-08,3,0,4,4
17551,2013-01-08,4,0,4,4
17552,2013-01-08,5,2,32,34
17553,2013-01-08,6,1,99,100
17554,2013-01-08,7,2,316,318
17555,2013-01-08,8,14,658,672
17556,2013-01-08,9,16,268,284
17557,2013-01-08,10,32,113,145
17558,2013-01-08,11,17,158,175
17559,2013-01-08,12,46,185,231
17560,2013-01-08,13,38,205,243
17561,2013-01-08,14,38,163,201
17562,2013-01-08,15,46,200,246
17563,2013-01-08,16,50,311,361
17564,2013-01-08,17,39,577,616
17565,2013-01-08,18,37,568,605
17566,2013-01-08,19,21,395,416
17567,2013-01-08,20,23,220,243
17568,2013-01-08,21,4,150,154
17569,2013-01-08,22,9,93,102
17570,2013-01-08,23,4,77,81
17571,2013-01-09,0,0,27,27
17572,2013-01-09,1,0,10,10
17573,2013-01-09,2,0,5,5
17574,2013-01-09,3,0,4,4
17575,2013-01-09,4,0,8,8
17576,2013-01-09,5,1,42,43
17577,2013-01-09,6,3,127,130
17578,2013-01-09,7,6,343,349
17579,2013-01-09,8,19,675,694
17580,2013-01-09,9,7,306,313
17581,2013-01-09,10,14,119,133
17582,2013-01-09,11,31,149,180
17583,2013-01-09,12,45,180,225
17584,2013-01-09,13,18,166,184
17585,2013-01-09,14,32,133,165
17586,2013-01-09,15,21,140,161
17587,2013-01-09,16,32,257,289
17588,2013-01-09,17,33,584,617
17589,2013-01-09,18,18,546,564
17590,2013-01-09,19,22,358,380
17591,2013-01-09,20,13,240,253
17592,2013-01-09,21,11,154,165
17593,2013-01-09,22,17,107,124
17594,2013-01-09,23,13,74,87
17595,2013-01-10,0,1,30,31
17596,2013-01-10,1,2,14,16
17597,2013-01-10,2,1,7,8
17598,2013-01-10,3,0,1,1
17599,2013-01-10,4,1,4,5
17600,2013-01-10,5,1,27,28
17601,2013-01-10,6,2,101,103
17602,2013-01-10,7,3,340,343
17603,2013-01-10,8,17,673,690
17604,2013-01-10,9,19,290,309
17605,2013-01-10,10,17,136,153
17606,2013-01-10,11,23,158,181
17607,2013-01-10,12,24,213,237
17608,2013-01-10,13,28,215,243
17609,2013-01-10,14,27,167,194
17610,2013-01-10,15,32,208,240
17611,2013-01-10,16,34,329,363
17612,2013-01-10,17,43,629,672
17613,2013-01-10,18,24,515,539
17614,2013-01-10,19,27,342,369
17615,2013-01-10,20,15,264,279
17616,2013-01-10,21,7,188,195
17617,2013-01-10,22,8,114,122
17618,2013-01-10,23,3,58,61
17619,2013-01-11,0,3,36,39
17620,2013-01-11,1,0,19,19
17621,2013-01-11,2,0,7,7
17622,2013-01-11,3,0,8,8
17623,2013-01-11,4,0,5,5
17624,2013-01-11,5,0,44,44
17625,2013-01-11,6,1,100,101
17626,2013-01-11,7,8,295,303
17627,2013-01-11,8,21,649,670
17628,2013-01-11,9,20,311,331
17629,2013-01-11,10,23,135,158
17630,2013-01-11,11,28,140,168
17631,2013-01-11,12,15,164,179
17632,2013-01-11,13,14,141,155
17633,2013-01-11,14,21,189,210
17634,2013-01-11,15,17,159,176
17635,2013-01-11,16,10,163,173
17636,2013-01-11,17,12,256,268
17637,2013-01-11,18,13,326,339
17638,2013-01-11,19,9,225,234
17639,2013-01-11,20,9,165,174
17640,2013-01-11,21,15,117,132
17641,2013-01-11,22,9,103,112
17642,2013-01-11,23,6,83,89
17643,2013-01-12,0,3,74,77
17644,2013-01-12,1,2,58,60
17645,2013-01-12,2,3,45,48
17646,2013-01-12,3,5,17,22
17647,2013-01-12,4,0,3,3
17648,2013-01-12,5,1,10,11
17649,2013-01-12,6,4,17,21
17650,2013-01-12,7,6,42,48
17651,2013-01-12,8,13,106,119
17652,2013-01-12,9,27,177,204
17653,2013-01-12,10,36,250,286
17654,2013-01-12,11,92,324,416
17655,2013-01-12,12,121,362,483
17656,2013-01-12,13,157,378,535
17657,2013-01-12,14,222,426,648
17658,2013-01-12,15,178,404,582
17659,2013-01-12,16,132,377,509
17660,2013-01-12,17,93,284,377
17661,2013-01-12,18,53,233,286
17662,2013-01-12,19,19,180,199
17663,2013-01-12,20,19,183,202
17664,2013-01-12,21,30,148,178
17665,2013-01-12,22,13,120,133
17666,2013-01-12,23,9,115,124
17667,2013-01-13,0,4,91,95
17668,2013-01-13,1,5,99,104
17669,2013-01-13,2,7,63,70
17670,2013-01-13,3,2,11,13
17671,2013-01-13,4,1,5,6
17672,2013-01-13,5,1,6,7
17673,2013-01-13,6,2,12,14
17674,2013-01-13,7,3,25,28
17675,2013-01-13,8,15,69,84
17676,2013-01-13,9,30,145,175
17677,2013-01-13,10,52,239,291
17678,2013-01-13,11,81,284,365
17679,2013-01-13,12,126,302,428
17680,2013-01-13,13,101,296,397
17681,2013-01-13,14,87,287,374
17682,2013-01-13,15,77,242,319
17683,2013-01-13,16,83,283,366
17684,2013-01-13,17,62,182,244
17685,2013-01-13,18,15,148,163
17686,2013-01-13,19,13,168,181
17687,2013-01-13,20,27,133,160
17688,2013-01-13,21,21,76,97
17689,2013-01-13,22,12,64,76
17690,2013-01-13,23,7,48,55
17691,2013-01-14,0,2,11,13
17692,2013-01-14,1,2,6,8
17693,2013-01-14,2,2,4,6
17694,2013-01-14,3,1,2,3
17695,2013-01-14,4,0,6,6
17696,2013-01-14,5,0,39,39
17697,2013-01-14,6,0,135,135
17698,2013-01-14,7,20,301,321
17699,2013-01-14,8,18,596,614
17700,2013-01-14,9,26,302,328
17701,2013-01-14,10,40,149,189
17702,2013-01-14,11,31,130,161
17703,2013-01-14,12,44,181,225
17704,2013-01-14,13,35,176,211
17705,2013-01-14,14,35,163,198
17706,2013-01-14,15,37,188,225
17707,2013-01-14,16,30,279,309
17708,2013-01-14,17,39,591,630
17709,2013-01-14,18,28,557,585
17710,2013-01-14,19,21,373,394
17711,2013-01-14,20,15,211,226
17712,2013-01-14,21,6,99,105
17713,2013-01-14,22,10,47,57
17714,2013-01-14,23,2,33,35
17715,2013-01-15,0,0,15,15
17716,2013-01-15,1,1,2,3
17717,2013-01-15,3,1,2,3
17718,2013-01-15,4,0,9,9
17719,2013-01-15,5,2,20,22
17720,2013-01-15,6,1,80,81
17721,2013-01-15,7,7,148,155
17722,2013-01-15,8,8,281,289
17723,2013-01-15,9,10,163,173
17724,2013-01-15,10,11,60,71
17725,2013-01-15,11,14,56,70
17726,2013-01-15,12,18,92,110
17727,2013-01-15,13,25,143,168
17728,2013-01-15,14,14,88,102
17729,2013-01-15,15,24,145,169
17730,2013-01-15,16,26,212,238
17731,2013-01-15,17,21,400,421
17732,2013-01-15,18,14,423,437
17733,2013-01-15,19,12,153,165
17734,2013-01-15,20,3,88,91
17735,2013-01-15,21,6,42,48
17736,2013-01-15,22,5,36,41
17737,2013-01-15,23,1,15,16
17738,2013-01-16,0,0,7,7
17739,2013-01-16,1,1,3,4
17740,2013-01-16,2,1,2,3
17741,2013-01-16,3,0,1,1
17742,2013-01-16,4,0,6,6
17743,2013-01-16,5,0,22,22
17744,2013-01-16,6,0,72,72
17745,2013-01-16,7,7,257,264
17746,2013-01-16,8,21,401,422
17747,2013-01-16,9,5,166,171
17748,2013-01-16,10,5,75,80
17749,2013-01-16,11,13,75,88
17750,2013-01-16,12,18,122,140
17751,2013-01-16,13,19,121,140
17752,2013-01-16,14,18,85,103
17753,2013-01-16,15,6,99,105
17754,2013-01-16,16,12,164,176
17755,2013-01-16,17,12,401,413
17756,2013-01-16,18,14,417,431
17757,2013-01-16,19,13,283,296
17758,2013-01-16,20,8,202,210
17759,2013-01-16,21,12,169,181
17760,2013-01-16,22,8,89,97
17761,2013-01-16,23,4,41,45
17762,2013-01-17,0,8,31,39
17763,2013-01-17,1,6,10,16
17764,2013-01-17,2,1,1,2
17765,2013-01-17,3,0,3,3
17766,2013-01-17,4,0,5,5
17767,2013-01-17,5,2,29,31
17768,2013-01-17,6,3,109,112
17769,2013-01-17,7,9,313,322
17770,2013-01-17,8,17,569,586
17771,2013-01-17,9,24,317,341
17772,2013-01-17,10,29,122,151
17773,2013-01-17,11,17,159,176
17774,2013-01-17,12,41,175,216
17775,2013-01-17,13,33,147,180
17776,2013-01-17,14,35,158,193
17777,2013-01-17,15,26,166,192
17778,2013-01-17,16,23,258,281
17779,2013-01-17,17,37,512,549
17780,2013-01-17,18,16,461,477
17781,2013-01-17,19,11,296,307
17782,2013-01-17,20,6,204,210
17783,2013-01-17,21,4,176,180
17784,2013-01-17,22,3,107,110
17785,2013-01-17,23,10,80,90
17786,2013-01-18,0,4,35,39
17787,2013-01-18,1,0,16,16
17788,2013-01-18,2,6,9,15
17789,2013-01-18,3,1,4,5
17790,2013-01-18,4,0,5,5
17791,2013-01-18,5,0,26,26
17792,2013-01-18,6,0,81,81
17793,2013-01-18,7,5,257,262
17794,2013-01-18,8,16,521,537
17795,2013-01-18,9,15,309,324
17796,2013-01-18,10,23,136,159
17797,2013-01-18,11,22,139,161
17798,2013-01-18,12,25,174,199
17799,2013-01-18,13,28,193,221
17800,2013-01-18,14,46,171,217
17801,2013-01-18,15,39,186,225
17802,2013-01-18,16,37,306,343
17803,2013-01-18,17,18,441,459
17804,2013-01-18,18,17,402,419
17805,2013-01-18,19,9,249,258
17806,2013-01-18,20,10,176,186
17807,2013-01-18,21,9,110,119
17808,2013-01-18,22,4,111,115
17809,2013-01-18,23,6,75,81
17810,2013-01-19,0,1,59,60
17811,2013-01-19,1,3,47,50
17812,2013-01-19,2,3,33,36
17813,2013-01-19,3,2,12,14
17814,2013-01-19,4,2,8,10
17815,2013-01-19,5,1,9,10
17816,2013-01-19,6,0,15,15
17817,2013-01-19,7,5,43,48
17818,2013-01-19,8,7,79,86
17819,2013-01-19,9,21,158,179
17820,2013-01-19,10,38,212,250
17821,2013-01-19,11,79,259,338
17822,2013-01-19,12,124,288,412
17823,2013-01-19,13,136,322,458
17824,2013-01-19,14,189,388,577
17825,2013-01-19,15,152,350,502
17826,2013-01-19,16,181,325,506
17827,2013-01-19,17,110,264,374
17828,2013-01-19,18,55,220,275
17829,2013-01-19,19,28,185,213
17830,2013-01-19,20,21,125,146
17831,2013-01-19,21,14,114,128
17832,2013-01-19,22,9,104,113
17833,2013-01-19,23,18,95,113
17834,2013-01-20,0,9,77,86
17835,2013-01-20,1,6,85,91
17836,2013-01-20,2,7,65,72
17837,2013-01-20,3,7,34,41
17838,2013-01-20,4,3,10,13
17839,2013-01-20,5,0,11,11
17840,2013-01-20,6,3,8,11
17841,2013-01-20,7,1,30,31
17842,2013-01-20,8,10,67,77
17843,2013-01-20,9,28,121,149
17844,2013-01-20,10,54,234,288
17845,2013-01-20,11,122,302,424
17846,2013-01-20,12,186,356,542
17847,2013-01-20,13,207,331,538
17848,2013-01-20,14,254,382,636
17849,2013-01-20,15,254,411,665
17850,2013-01-20,16,182,330,512
17851,2013-01-20,17,134,266,400
17852,2013-01-20,18,67,269,336
17853,2013-01-20,19,38,183,221
17854,2013-01-20,20,28,134,162
17855,2013-01-20,21,22,112,134
17856,2013-01-20,22,14,130,144
17857,2013-01-20,23,20,95,115
17858,2013-01-21,0,16,74,90
17859,2013-01-21,1,7,46,53
17860,2013-01-21,2,13,28,41
17861,2013-01-21,3,6,10,16
17862,2013-01-21,4,5,22,27
17863,2013-01-21,5,5,27,32
17864,2013-01-21,6,28,58,86
17865,2013-01-21,7,56,129,185
17866,2013-01-21,8,77,188,265
17867,2013-01-21,9,81,222,303
17868,2013-01-21,10,89,238,327
17869,2013-01-21,11,46,200,246
17870,2013-01-21,12,123,313,436
17871,2013-01-21,13,120,343,463
17872,2013-01-21,14,89,252,341
17873,2013-01-21,15,60,228,288
17874,2013-01-21,16,97,274,371
17875,2013-01-21,17,42,242,284
17876,2013-01-21,18,18,180,198
17877,2013-01-21,19,13,140,153
17878,2013-01-21,20,11,105,116
17879,2013-01-21,21,9,90,99
17880,2013-01-21,22,11,52,63
17881,2013-01-21,23,4,38,42
17882,2013-01-22,0,7,37,44
17883,2013-01-22,1,2,7,9
17884,2013-01-22,2,0,3,3
17885,2013-01-22,3,2,6,8
17886,2013-01-22,4,1,7,8
17887,2013-01-22,5,0,28,28
17888,2013-01-22,6,2,78,80
17889,2013-01-22,7,6,232,238
17890,2013-01-22,8,5,446,451
17891,2013-01-22,9,9,203,212
17892,2013-01-22,10,4,78,82
17893,2013-01-22,11,7,63,70
17894,2013-01-22,12,4,101,105
17895,2013-01-22,13,5,85,90
17896,2013-01-22,14,7,71,78
17897,2013-01-22,15,6,106,112
17898,2013-01-22,16,3,183,186
17899,2013-01-22,17,5,322,327
17900,2013-01-22,18,8,285,293
17901,2013-01-22,19,3,207,210
17902,2013-01-22,20,2,121,123
17903,2013-01-22,21,0,94,94
17904,2013-01-22,22,1,56,57
17905,2013-01-22,23,0,23,23
17906,2013-01-23,0,0,15,15
17907,2013-01-23,1,0,7,7
17908,2013-01-23,2,2,3,5
17909,2013-01-23,3,0,2,2
17910,2013-01-23,4,0,2,2
17911,2013-01-23,5,0,18,18
17912,2013-01-23,6,0,88,88
17913,2013-01-23,7,2,226,228
17914,2013-01-23,8,10,408,418
17915,2013-01-23,9,3,199,202
17916,2013-01-23,10,4,77,81
17917,2013-01-23,11,6,93,99
17918,2013-01-23,12,5,115,120
17919,2013-01-23,13,5,130,135
17920,2013-01-23,14,7,93,100
17921,2013-01-23,15,5,110,115
17922,2013-01-23,16,0,197,197
17923,2013-01-23,17,5,370,375
17924,2013-01-23,18,3,326,329
17925,2013-01-23,19,3,260,263
17926,2013-01-23,20,4,165,169
17927,2013-01-23,21,2,115,117
17928,2013-01-23,22,2,65,67
17929,2013-01-23,23,1,30,31
17930,2013-01-24,0,1,13,14
17931,2013-01-24,1,0,6,6
17932,2013-01-24,2,0,1,1
17933,2013-01-24,3,0,1,1
17934,2013-01-24,4,0,3,3
17935,2013-01-24,5,0,19,19
17936,2013-01-24,6,0,43,43
17937,2013-01-24,7,0,90,90
17938,2013-01-24,8,3,217,220
17939,2013-01-24,9,4,154,158
17940,2013-01-24,10,2,65,67
17941,2013-01-24,11,1,81,82
17942,2013-01-24,12,0,104,104
17943,2013-01-24,13,1,91,92
17944,2013-01-24,14,0,80,80
17945,2013-01-24,15,1,108,109
17946,2013-01-24,16,0,144,144
17947,2013-01-24,17,1,320,321
17948,2013-01-24,18,4,283,287
17949,2013-01-24,19,1,199,200
17950,2013-01-24,20,1,127,128
17951,2013-01-24,21,0,125,125
17952,2013-01-24,22,0,89,89
17953,2013-01-24,23,0,42,42
17954,2013-01-25,0,0,10,10
17955,2013-01-25,1,1,6,7
17956,2013-01-25,2,0,2,2
17957,2013-01-25,3,0,2,2
17958,2013-01-25,4,0,6,6
17959,2013-01-25,5,0,26,26
17960,2013-01-25,6,0,72,72
17961,2013-01-25,7,3,170,173
17962,2013-01-25,8,2,377,379
17963,2013-01-25,9,3,247,250
17964,2013-01-25,10,8,94,102
17965,2013-01-25,11,1,115,116
17966,2013-01-25,12,6,115,121
17967,2013-01-25,13,5,118,123
17968,2013-01-25,14,4,81,85
17969,2013-01-25,15,1,83,84
17970,2013-01-25,16,1,113,114
17971,2013-01-25,17,3,170,173
17972,2013-01-25,18,0,134,134
17973,2013-01-25,19,1,116,117
17974,2013-01-25,20,2,70,72
17975,2013-01-25,21,1,77,78
17976,2013-01-25,22,1,58,59
17977,2013-01-25,23,1,48,49
17978,2013-01-26,0,0,32,32
17979,2013-01-26,1,2,27,29
17980,2013-01-26,2,0,19,19
17981,2013-01-26,3,1,9,10
17982,2013-01-26,4,0,4,4
17983,2013-01-26,5,0,2,2
17984,2013-01-26,6,2,5,7
17985,2013-01-26,7,1,13,14
17986,2013-01-26,8,1,46,47
17987,2013-01-26,9,5,119,124
17988,2013-01-26,10,7,138,145
17989,2013-01-26,11,10,173,183
17990,2013-01-26,12,15,221,236
17991,2013-01-26,13,16,213,229
17992,2013-01-26,14,21,209,230
17993,2013-01-26,15,11,208,219
17994,2013-01-26,16,15,224,239
17995,2013-01-26,17,18,195,213
17996,2013-01-26,18,11,203,214
17997,2013-01-26,19,7,165,172
17998,2013-01-26,20,11,109,120
17999,2013-01-26,21,6,87,93
18000,2013-01-26,22,6,70,76
18001,2013-01-26,23,13,68,81
18002,2013-01-27,0,3,58,61
18003,2013-01-27,1,3,66,69
18004,2013-01-27,2,0,47,47
18005,2013-01-27,3,3,27,30
18006,2013-01-27,4,1,5,6
18007,2013-01-27,5,1,5,6
18008,2013-01-27,6,0,11,11
18009,2013-01-27,7,0,19,19
18010,2013-01-27,8,1,45,46
18011,2013-01-27,9,7,87,94
18012,2013-01-27,10,9,173,182
18013,2013-01-27,11,21,178,199
18014,2013-01-27,12,32,253,285
18015,2013-01-27,13,35,224,259
18016,2013-01-27,14,49,230,279
18017,2013-01-27,15,38,273,311
18018,2013-01-27,16,28,242,270
18019,2013-01-27,17,13,227,240
18020,2013-01-27,18,8,197,205
18021,2013-01-27,19,6,116,122
18022,2013-01-27,20,1,96,97
18023,2013-01-27,21,2,57,59
18024,2013-01-27,22,2,63,65
18025,2013-01-27,23,0,27,27
18026,2013-01-28,0,2,20,22
18027,2013-01-28,1,0,7,7
18028,2013-01-28,2,0,4,4
18029,2013-01-28,3,0,2,2
18030,2013-01-28,4,0,5,5
18031,2013-01-28,5,0,14,14
18032,2013-01-28,6,0,29,29
18033,2013-01-28,7,1,69,70
18034,2013-01-28,8,2,118,120
18035,2013-01-28,9,0,75,75
18036,2013-01-28,10,1,50,51
18037,2013-01-28,11,2,101,103
18038,2013-01-28,12,1,78,79
18039,2013-01-28,13,3,84,87
18040,2013-01-28,14,4,90,94
18041,2013-01-28,15,8,126,134
18042,2013-01-28,16,5,173,178
18043,2013-01-28,17,6,404,410
18044,2013-01-28,18,8,390,398
18045,2013-01-28,19,5,290,295
18046,2013-01-28,20,3,207,210
18047,2013-01-28,21,3,168,171
18048,2013-01-28,22,8,85,93
18049,2013-01-28,23,3,58,61
18050,2013-01-29,0,0,17,17
18051,2013-01-29,1,4,12,16
18052,2013-01-29,2,0,2,2
18053,2013-01-29,3,0,2,2
18054,2013-01-29,4,0,4,4
18055,2013-01-29,5,0,31,31
18056,2013-01-29,6,0,121,121
18057,2013-01-29,7,3,334,337
18058,2013-01-29,8,9,704,713
18059,2013-01-29,9,9,328,337
18060,2013-01-29,10,20,139,159
18061,2013-01-29,11,24,157,181
18062,2013-01-29,12,30,210,240
18063,2013-01-29,13,36,217,253
18064,2013-01-29,14,31,170,201
18065,2013-01-29,15,46,234,280
18066,2013-01-29,16,20,321,341
18067,2013-01-29,17,39,680,719
18068,2013-01-29,18,21,618,639
18069,2013-01-29,19,11,400,411
18070,2013-01-29,20,4,309,313
18071,2013-01-29,21,8,240,248
18072,2013-01-29,22,4,143,147
18073,2013-01-29,23,2,77,79
18074,2013-01-30,0,0,32,32
18075,2013-01-30,1,1,16,17
18076,2013-01-30,2,3,7,10
18077,2013-01-30,3,1,2,3
18078,2013-01-30,4,0,6,6
18079,2013-01-30,5,0,26,26
18080,2013-01-30,6,0,135,135
18081,2013-01-30,7,6,401,407
18082,2013-01-30,8,5,731,736
18083,2013-01-30,9,9,313,322
18084,2013-01-30,10,13,143,156
18085,2013-01-30,11,14,133,147
18086,2013-01-30,12,13,209,222
18087,2013-01-30,13,23,168,191
18088,2013-01-30,14,24,170,194
18089,2013-01-30,15,15,185,200
18090,2013-01-30,16,5,232,237
18091,2013-01-30,17,16,528,544
18092,2013-01-30,18,21,507,528
18093,2013-01-30,19,10,348,358
18094,2013-01-30,20,0,79,79
18095,2013-01-30,21,1,46,47
18096,2013-01-30,22,1,21,22
18097,2013-01-30,23,1,22,23
18098,2013-01-31,0,0,9,9
18099,2013-01-31,1,0,6,6
18100,2013-01-31,2,0,5,5
18101,2013-01-31,3,0,3,3
18102,2013-01-31,4,0,10,10
18103,2013-01-31,5,0,27,27
18104,2013-01-31,6,3,107,110
18105,2013-01-31,7,7,302,309
18106,2013-01-31,8,9,594,603
18107,2013-01-31,9,6,315,321
18108,2013-01-31,10,4,106,110
18109,2013-01-31,11,12,153,165
18110,2013-01-31,12,8,172,180
18111,2013-01-31,13,9,142,151
18112,2013-01-31,14,15,115,130
18113,2013-01-31,15,9,140,149
18114,2013-01-31,16,3,233,236
18115,2013-01-31,17,12,532,544
18116,2013-01-31,18,5,433,438
18117,2013-01-31,19,5,278,283
18118,2013-01-31,20,4,231,235
18119,2013-01-31,21,3,157,160
18120,2013-01-31,22,3,78,81
18121,2013-01-31,23,3,57,60
18122,2013-02-01,0,1,32,33
18123,2013-02-01,1,1,17,18
18124,2013-02-01,2,0,10,10
18125,2013-02-01,3,0,2,2
18126,2013-02-01,4,1,5,6
18127,2013-02-01,5,1,30,31
18128,2013-02-01,6,2,63,65
18129,2013-02-01,7,2,151,153
18130,2013-02-01,8,5,395,400
18131,2013-02-01,9,5,261,266
18132,2013-02-01,10,6,94,100
18133,2013-02-01,11,6,115,121
18134,2013-02-01,12,6,136,142
18135,2013-02-01,13,11,119,130
18136,2013-02-01,14,7,110,117
18137,2013-02-01,15,8,118,126
18138,2013-02-01,16,6,216,222
18139,2013-02-01,17,7,382,389
18140,2013-02-01,18,6,298,304
18141,2013-02-01,19,1,182,183
18142,2013-02-01,20,1,126,127
18143,2013-02-01,21,0,89,89
18144,2013-02-01,22,0,74,74
18145,2013-02-01,23,1,52,53
18146,2013-02-02,0,0,37,37
18147,2013-02-02,1,0,31,31
18148,2013-02-02,2,1,22,23
18149,2013-02-02,3,1,8,9
18150,2013-02-02,4,0,6,6
18151,2013-02-02,5,0,2,2
18152,2013-02-02,6,1,11,12
18153,2013-02-02,7,2,35,37
18154,2013-02-02,8,6,95,101
18155,2013-02-02,9,14,120,134
18156,2013-02-02,10,12,176,188
18157,2013-02-02,11,18,180,198
18158,2013-02-02,12,29,203,232
18159,2013-02-02,13,29,193,222
18160,2013-02-02,14,28,189,217
18161,2013-02-02,15,27,233,260
18162,2013-02-02,16,21,179,200
18163,2013-02-02,17,17,120,137
18164,2013-02-02,18,9,83,92
18165,2013-02-02,19,4,67,71
18166,2013-02-02,20,3,72,75
18167,2013-02-02,21,4,54,58
18168,2013-02-02,22,1,52,53
18169,2013-02-02,23,6,49,55
18170,2013-02-03,0,2,42,44
18171,2013-02-03,1,3,40,43
18172,2013-02-03,2,2,46,48
18173,2013-02-03,3,1,17,18
18174,2013-02-03,4,1,5,6
18175,2013-02-03,5,0,3,3
18176,2013-02-03,6,0,10,10
18177,2013-02-03,7,0,16,16
18178,2013-02-03,8,1,44,45
18179,2013-02-03,9,6,71,77
18180,2013-02-03,10,11,138,149
18181,2013-02-03,11,21,187,208
18182,2013-02-03,12,29,211,240
18183,2013-02-03,13,19,191,210
18184,2013-02-03,14,12,177,189
18185,2013-02-03,15,11,176,187
18186,2013-02-03,16,23,177,200
18187,2013-02-03,17,22,239,261
18188,2013-02-03,18,9,170,179
18189,2013-02-03,19,4,68,72
18190,2013-02-03,20,1,59,60
18191,2013-02-03,21,0,63,63
18192,2013-02-03,22,3,88,91
18193,2013-02-03,23,4,132,136
18194,2013-02-04,0,0,17,17
18195,2013-02-04,1,0,5,5
18196,2013-02-04,2,0,1,1
18197,2013-02-04,3,0,4,4
18198,2013-02-04,4,0,4,4
18199,2013-02-04,5,0,20,20
18200,2013-02-04,6,0,87,87
18201,2013-02-04,7,1,278,279
18202,2013-02-04,8,6,509,515
18203,2013-02-04,9,8,279,287
18204,2013-02-04,10,2,93,95
18205,2013-02-04,11,15,96,111
18206,2013-02-04,12,9,121,130
18207,2013-02-04,13,12,124,136
18208,2013-02-04,14,13,114,127
18209,2013-02-04,15,11,135,146
18210,2013-02-04,16,7,229,236
18211,2013-02-04,17,12,482,494
18212,2013-02-04,18,6,445,451
18213,2013-02-04,19,8,300,308
18214,2013-02-04,20,5,194,199
18215,2013-02-04,21,4,142,146
18216,2013-02-04,22,0,71,71
18217,2013-02-04,23,3,47,50
18218,2013-02-05,0,0,20,20
18219,2013-02-05,1,0,7,7
18220,2013-02-05,2,1,1,2
18221,2013-02-05,3,0,3,3
18222,2013-02-05,4,0,4,4
18223,2013-02-05,5,2,21,23
18224,2013-02-05,6,1,113,114
18225,2013-02-05,7,3,307,310
18226,2013-02-05,8,6,589,595
18227,2013-02-05,9,8,279,287
18228,2013-02-05,10,13,102,115
18229,2013-02-05,11,13,142,155
18230,2013-02-05,12,14,164,178
18231,2013-02-05,13,10,172,182
18232,2013-02-05,14,17,125,142
18233,2013-02-05,15,12,149,161
18234,2013-02-05,16,8,303,311
18235,2013-02-05,17,9,526,535
18236,2013-02-05,18,14,511,525
18237,2013-02-05,19,5,335,340
18238,2013-02-05,20,6,240,246
18239,2013-02-05,21,3,153,156
18240,2013-02-05,22,3,104,107
18241,2013-02-05,23,3,57,60
18242,2013-02-06,0,0,21,21
18243,2013-02-06,1,2,6,8
18244,2013-02-06,2,0,3,3
18245,2013-02-06,3,0,1,1
18246,2013-02-06,4,0,5,5
18247,2013-02-06,5,2,37,39
18248,2013-02-06,6,0,135,135
18249,2013-02-06,7,4,352,356
18250,2013-02-06,8,14,664,678
18251,2013-02-06,9,16,288,304
18252,2013-02-06,10,15,113,128
18253,2013-02-06,11,8,114,122
18254,2013-02-06,12,15,174,189
18255,2013-02-06,13,14,172,186
18256,2013-02-06,14,9,136,145
18257,2013-02-06,15,11,187,198
18258,2013-02-06,16,23,282,305
18259,2013-02-06,17,11,550,561
18260,2013-02-06,18,10,523,533
18261,2013-02-06,19,6,348,354
18262,2013-02-06,20,6,236,242
18263,2013-02-06,21,4,182,186
18264,2013-02-06,22,9,105,114
18265,2013-02-06,23,0,58,58
18266,2013-02-07,0,0,16,16
18267,2013-02-07,1,0,4,4
18268,2013-02-07,2,1,3,4
18269,2013-02-07,3,0,4,4
18270,2013-02-07,4,0,5,5
18271,2013-02-07,5,2,25,27
18272,2013-02-07,6,1,111,112
18273,2013-02-07,7,3,315,318
18274,2013-02-07,8,14,612,626
18275,2013-02-07,9,11,251,262
18276,2013-02-07,10,13,130,143
18277,2013-02-07,11,22,122,144
18278,2013-02-07,12,18,159,177
18279,2013-02-07,13,17,167,184
18280,2013-02-07,14,6,127,133
18281,2013-02-07,15,14,150,164
18282,2013-02-07,16,10,234,244
18283,2013-02-07,17,16,524,540
18284,2013-02-07,18,10,464,474
18285,2013-02-07,19,3,309,312
18286,2013-02-07,20,5,237,242
18287,2013-02-07,21,6,142,148
18288,2013-02-07,22,0,89,89
18289,2013-02-07,23,3,63,66
18290,2013-02-08,0,0,33,33
18291,2013-02-08,1,0,18,18
18292,2013-02-08,2,0,7,7
18293,2013-02-08,3,0,2,2
18294,2013-02-08,4,0,5,5
18295,2013-02-08,5,2,19,21
18296,2013-02-08,6,1,48,49
18297,2013-02-08,7,2,89,91
18298,2013-02-08,8,3,242,245
18299,2013-02-08,9,5,204,209
18300,2013-02-08,10,8,120,128
18301,2013-02-08,11,11,113,124
18302,2013-02-08,12,12,144,156
18303,2013-02-08,13,7,143,150
18304,2013-02-08,14,16,158,174
18305,2013-02-08,15,11,154,165
18306,2013-02-08,16,9,206,215
18307,2013-02-08,17,16,453,469
18308,2013-02-08,18,9,351,360
18309,2013-02-08,19,10,246,256
18310,2013-02-08,20,8,177,185
18311,2013-02-08,21,5,129,134
18312,2013-02-08,22,5,75,80
18313,2013-02-08,23,6,69,75
18314,2013-02-09,0,1,57,58
18315,2013-02-09,1,1,47,48
18316,2013-02-09,2,0,40,40
18317,2013-02-09,3,2,8,10
18318,2013-02-09,4,0,4,4
18319,2013-02-09,6,0,8,8
18320,2013-02-09,7,1,35,36
18321,2013-02-09,8,3,68,71
18322,2013-02-09,9,11,139,150
18323,2013-02-09,10,24,167,191
18324,2013-02-09,11,27,254,281
18325,2013-02-09,12,42,235,277
18326,2013-02-09,13,56,256,312
18327,2013-02-09,14,56,228,284
18328,2013-02-09,15,51,233,284
18329,2013-02-09,16,49,255,304
18330,2013-02-09,17,44,229,273
18331,2013-02-09,18,20,220,240
18332,2013-02-09,19,8,140,148
18333,2013-02-09,20,10,123,133
18334,2013-02-09,21,10,96,106
18335,2013-02-09,22,3,73,76
18336,2013-02-09,23,5,88,93
18337,2013-02-10,0,8,65,73
18338,2013-02-10,1,5,50,55
18339,2013-02-10,2,2,45,47
18340,2013-02-10,3,1,25,26
18341,2013-02-10,4,0,6,6
18342,2013-02-10,5,1,2,3
18343,2013-02-10,6,3,12,15
18344,2013-02-10,7,1,22,23
18345,2013-02-10,8,2,62,64
18346,2013-02-10,9,17,106,123
18347,2013-02-10,10,20,208,228
18348,2013-02-10,11,35,245,280
18349,2013-02-10,12,47,270,317
18350,2013-02-10,13,60,266,326
18351,2013-02-10,14,75,285,360
18352,2013-02-10,15,74,277,351
18353,2013-02-10,16,61,266,327
18354,2013-02-10,17,43,238,281
18355,2013-02-10,18,14,200,214
18356,2013-02-10,19,15,142,157
18357,2013-02-10,20,5,93,98
18358,2013-02-10,21,10,99,109
18359,2013-02-10,22,0,54,54
18360,2013-02-10,23,2,37,39
18361,2013-02-11,0,0,13,13
18362,2013-02-11,1,0,9,9
18363,2013-02-11,2,1,5,6
18364,2013-02-11,3,0,2,2
18365,2013-02-11,4,0,1,1
18366,2013-02-11,5,0,14,14
18367,2013-02-11,6,1,40,41
18368,2013-02-11,7,3,191,194
18369,2013-02-11,8,5,451,456
18370,2013-02-11,9,9,251,260
18371,2013-02-11,10,3,113,116
18372,2013-02-11,11,10,96,106
18373,2013-02-11,12,12,137,149
18374,2013-02-11,13,11,135,146
18375,2013-02-11,14,7,151,158
18376,2013-02-11,15,22,148,170
18377,2013-02-11,16,20,297,317
18378,2013-02-11,17,11,532,543
18379,2013-02-11,18,18,520,538
18380,2013-02-11,19,4,377,381
18381,2013-02-11,20,5,229,234
18382,2013-02-11,21,9,191,200
18383,2013-02-11,22,0,117,117
18384,2013-02-11,23,0,51,51
18385,2013-02-12,0,0,21,21
18386,2013-02-12,1,0,5,5
18387,2013-02-12,2,1,3,4
18388,2013-02-12,3,2,0,2
18389,2013-02-12,4,1,5,6
18390,2013-02-12,5,0,37,37
18391,2013-02-12,6,0,143,143
18392,2013-02-12,7,4,405,409
18393,2013-02-12,8,13,658,671
18394,2013-02-12,9,11,275,286
18395,2013-02-12,10,12,132,144
18396,2013-02-12,11,15,154,169
18397,2013-02-12,12,14,226,240
18398,2013-02-12,13,13,215,228
18399,2013-02-12,14,22,163,185
18400,2013-02-12,15,31,224,255
18401,2013-02-12,16,37,343,380
18402,2013-02-12,17,37,645,682
18403,2013-02-12,18,19,610,629
18404,2013-02-12,19,19,377,396
18405,2013-02-12,20,10,298,308
18406,2013-02-12,21,5,172,177
18407,2013-02-12,22,6,128,134
18408,2013-02-12,23,9,103,112
18409,2013-02-13,0,1,24,25
18410,2013-02-13,1,1,17,18
18411,2013-02-13,2,0,5,5
18412,2013-02-13,3,0,4,4
18413,2013-02-13,4,1,7,8
18414,2013-02-13,5,1,38,39
18415,2013-02-13,6,0,120,120
18416,2013-02-13,7,5,355,360
18417,2013-02-13,8,15,738,753
18418,2013-02-13,9,11,327,338
18419,2013-02-13,10,15,132,147
18420,2013-02-13,11,3,148,151
18421,2013-02-13,12,30,198,228
18422,2013-02-13,13,31,169,200
18423,2013-02-13,14,16,149,165
18424,2013-02-13,15,14,139,153
18425,2013-02-13,16,9,145,154
18426,2013-02-13,17,6,165,171
18427,2013-02-13,18,5,153,158
18428,2013-02-13,19,2,108,110
18429,2013-02-13,20,0,74,74
18430,2013-02-13,21,3,59,62
18431,2013-02-13,22,1,53,54
18432,2013-02-13,23,1,35,36
18433,2013-02-14,0,0,15,15
18434,2013-02-14,1,1,14,15
18435,2013-02-14,2,0,4,4
18436,2013-02-14,3,0,2,2
18437,2013-02-14,4,0,3,3
18438,2013-02-14,5,2,30,32
18439,2013-02-14,6,1,102,103
18440,2013-02-14,7,4,340,344
18441,2013-02-14,8,8,584,592
18442,2013-02-14,9,22,266,288
18443,2013-02-14,10,21,135,156
18444,2013-02-14,11,20,145,165
18445,2013-02-14,12,36,212,248
18446,2013-02-14,13,58,223,281
18447,2013-02-14,14,30,208,238
18448,2013-02-14,15,18,232,250
18449,2013-02-14,16,32,351,383
18450,2013-02-14,17,44,607,651
18451,2013-02-14,18,30,506,536
18452,2013-02-14,19,10,330,340
18453,2013-02-14,20,3,179,182
18454,2013-02-14,21,4,116,120
18455,2013-02-14,22,9,100,109
18456,2013-02-14,23,2,58,60
18457,2013-02-15,0,5,41,46
18458,2013-02-15,1,0,13,13
18459,2013-02-15,2,2,9,11
18460,2013-02-15,3,1,3,4
18461,2013-02-15,4,0,6,6
18462,2013-02-15,5,1,27,28
18463,2013-02-15,6,1,105,106
18464,2013-02-15,7,3,302,305
18465,2013-02-15,8,18,658,676
18466,2013-02-15,9,38,304,342
18467,2013-02-15,10,47,159,206
18468,2013-02-15,11,72,178,250
18469,2013-02-15,12,74,244,318
18470,2013-02-15,13,90,262,352
18471,2013-02-15,14,67,234,301
18472,2013-02-15,15,104,240,344
18473,2013-02-15,16,62,365,427
18474,2013-02-15,17,38,556,594
18475,2013-02-15,18,27,392,419
18476,2013-02-15,19,13,256,269
18477,2013-02-15,20,9,154,163
18478,2013-02-15,21,5,47,52
18479,2013-02-15,22,5,40,45
18480,2013-02-15,23,1,37,38
18481,2013-02-16,0,1,33,34
18482,2013-02-16,1,2,22,24
18483,2013-02-16,2,3,26,29
18484,2013-02-16,3,0,11,11
18485,2013-02-16,4,0,4,4
18486,2013-02-16,5,0,6,6
18487,2013-02-16,6,1,19,20
18488,2013-02-16,7,0,30,30
18489,2013-02-16,8,4,77,81
18490,2013-02-16,9,24,121,145
18491,2013-02-16,10,46,185,231
18492,2013-02-16,11,62,189,251
18493,2013-02-16,12,72,218,290
18494,2013-02-16,13,85,210,295
18495,2013-02-16,14,79,191,270
18496,2013-02-16,15,82,205,287
18497,2013-02-16,16,61,183,244
18498,2013-02-16,17,60,182,242
18499,2013-02-16,18,27,177,204
18500,2013-02-16,19,20,136,156
18501,2013-02-16,20,18,92,110
18502,2013-02-16,21,13,86,99
18503,2013-02-16,22,11,71,82
18504,2013-02-16,23,7,52,59
18505,2013-02-17,0,6,42,48
18506,2013-02-17,1,1,60,61
18507,2013-02-17,2,5,39,44
18508,2013-02-17,3,3,17,20
18509,2013-02-17,4,0,5,5
18510,2013-02-17,5,0,6,6
18511,2013-02-17,6,4,6,10
18512,2013-02-17,7,8,24,32
18513,2013-02-17,8,10,50,60
18514,2013-02-17,9,22,96,118
18515,2013-02-17,10,54,142,196
18516,2013-02-17,11,65,178,243
18517,2013-02-17,12,68,162,230
18518,2013-02-17,13,43,169,212
18519,2013-02-17,14,36,178,214
18520,2013-02-17,15,30,174,204
18521,2013-02-17,16,51,145,196
18522,2013-02-17,17,27,118,145
18523,2013-02-17,18,21,100,121
18524,2013-02-17,19,14,105,119
18525,2013-02-17,20,0,62,62
18526,2013-02-17,21,4,51,55
18527,2013-02-17,22,10,32,42
18528,2013-02-17,23,1,42,43
18529,2013-02-18,0,0,28,28
18530,2013-02-18,1,1,13,14
18531,2013-02-18,2,4,10,14
18532,2013-02-18,3,0,2,2
18533,2013-02-18,4,0,2,2
18534,2013-02-18,5,0,7,7
18535,2013-02-18,6,0,23,23
18536,2013-02-18,7,3,64,67
18537,2013-02-18,8,4,120,124
18538,2013-02-18,9,25,126,151
18539,2013-02-18,10,20,122,142
18540,2013-02-18,11,34,153,187
18541,2013-02-18,12,56,170,226
18542,2013-02-18,13,57,207,264
18543,2013-02-18,14,70,234,304
18544,2013-02-18,15,65,218,283
18545,2013-02-18,16,62,238,300
18546,2013-02-18,17,79,297,376
18547,2013-02-18,18,27,234,261
18548,2013-02-18,19,11,175,186
18549,2013-02-18,20,10,136,146
18550,2013-02-18,21,2,101,103
18551,2013-02-18,22,0,69,69
18552,2013-02-18,23,4,36,40
18553,2013-02-19,0,2,15,17
18554,2013-02-19,1,1,10,11
18555,2013-02-19,2,1,4,5
18556,2013-02-19,3,1,4,5
18557,2013-02-19,4,0,8,8
18558,2013-02-19,5,1,33,34
18559,2013-02-19,6,0,122,122
18560,2013-02-19,7,5,346,351
18561,2013-02-19,8,15,590,605
18562,2013-02-19,9,8,191,199
18563,2013-02-19,10,7,62,69
18564,2013-02-19,11,2,31,33
18565,2013-02-19,12,3,58,61
18566,2013-02-19,13,16,77,93
18567,2013-02-19,14,11,92,103
18568,2013-02-19,15,21,117,138
18569,2013-02-19,16,13,218,231
18570,2013-02-19,17,15,471,486
18571,2013-02-19,18,11,498,509
18572,2013-02-19,19,9,333,342
18573,2013-02-19,20,5,201,206
18574,2013-02-19,21,8,150,158
18575,2013-02-19,22,2,79,81
18576,2013-02-19,23,6,59,65
18577,2013-02-20,0,3,25,28
18578,2013-02-20,1,0,8,8
18579,2013-02-20,2,0,4,4
18580,2013-02-20,3,0,3,3
18581,2013-02-20,4,0,6,6
18582,2013-02-20,5,0,28,28
18583,2013-02-20,6,1,136,137
18584,2013-02-20,7,2,307,309
18585,2013-02-20,8,11,642,653
18586,2013-02-20,9,20,256,276
18587,2013-02-20,10,6,98,104
18588,2013-02-20,11,15,125,140
18589,2013-02-20,12,15,168,183
18590,2013-02-20,13,24,152,176
18591,2013-02-20,14,25,119,144
18592,2013-02-20,15,18,155,173
18593,2013-02-20,16,10,226,236
18594,2013-02-20,17,14,480,494
18595,2013-02-20,18,4,450,454
18596,2013-02-20,19,2,283,285
18597,2013-02-20,20,10,201,211
18598,2013-02-20,21,4,154,158
18599,2013-02-20,22,5,92,97
18600,2013-02-20,23,1,44,45
18601,2013-02-21,0,0,14,14
18602,2013-02-21,1,1,8,9
18603,2013-02-21,2,0,3,3
18604,2013-02-21,3,0,4,4
18605,2013-02-21,4,0,4,4
18606,2013-02-21,5,1,26,27
18607,2013-02-21,6,3,101,104
18608,2013-02-21,7,5,301,306
18609,2013-02-21,8,15,541,556
18610,2013-02-21,9,17,223,240
18611,2013-02-21,10,8,100,108
18612,2013-02-21,11,17,96,113
18613,2013-02-21,12,13,139,152
18614,2013-02-21,13,16,156,172
18615,2013-02-21,14,13,105,118
18616,2013-02-21,15,15,140,155
18617,2013-02-21,16,16,275,291
18618,2013-02-21,17,17,461,478
18619,2013-02-21,18,13,447,460
18620,2013-02-21,19,0,249,249
18621,2013-02-21,20,8,209,217
18622,2013-02-21,21,5,165,170
18623,2013-02-21,22,2,99,101
18624,2013-02-21,23,2,56,58
18625,2013-02-22,0,4,30,34
18626,2013-02-22,1,0,19,19
18627,2013-02-22,2,1,10,11
18628,2013-02-22,3,0,7,7
18629,2013-02-22,4,0,7,7
18630,2013-02-22,5,0,28,28
18631,2013-02-22,6,0,106,106
18632,2013-02-22,7,5,278,283
18633,2013-02-22,8,11,568,579
18634,2013-02-22,9,6,304,310
18635,2013-02-22,10,9,124,133
18636,2013-02-22,11,11,135,146
18637,2013-02-22,12,6,130,136
18638,2013-02-22,13,8,76,84
18639,2013-02-22,14,4,97,101
18640,2013-02-22,15,13,120,133
18641,2013-02-22,16,11,190,201
18642,2013-02-22,17,11,329,340
18643,2013-02-22,18,7,258,265
18644,2013-02-22,19,3,186,189
18645,2013-02-22,20,5,132,137
18646,2013-02-22,21,4,111,115
18647,2013-02-22,22,4,95,99
18648,2013-02-22,23,0,63,63
18649,2013-02-23,0,5,42,47
18650,2013-02-23,1,2,42,44
18651,2013-02-23,2,2,29,31
18652,2013-02-23,3,2,10,12
18653,2013-02-23,4,0,6,6
18654,2013-02-23,5,0,1,1
18655,2013-02-23,6,1,6,7
18656,2013-02-23,7,3,32,35
18657,2013-02-23,8,3,62,65
18658,2013-02-23,9,5,88,93
18659,2013-02-23,10,7,106,113
18660,2013-02-23,11,12,99,111
18661,2013-02-23,12,13,113,126
18662,2013-02-23,13,14,136,150
18663,2013-02-23,14,10,159,169
18664,2013-02-23,15,37,210,247
18665,2013-02-23,16,31,212,243
18666,2013-02-23,17,13,227,240
18667,2013-02-23,18,13,179,192
18668,2013-02-23,19,6,168,174
18669,2013-02-23,20,14,118,132
18670,2013-02-23,21,10,104,114
18671,2013-02-23,22,4,108,112
18672,2013-02-23,23,4,79,83
18673,2013-02-24,0,7,77,84
18674,2013-02-24,1,0,79,79
18675,2013-02-24,2,7,59,66
18676,2013-02-24,3,7,22,29
18677,2013-02-24,4,2,6,8
18678,2013-02-24,5,1,6,7
18679,2013-02-24,6,0,11,11
18680,2013-02-24,7,1,36,37
18681,2013-02-24,8,5,75,80
18682,2013-02-24,9,22,130,152
18683,2013-02-24,10,58,212,270
18684,2013-02-24,11,52,242,294
18685,2013-02-24,12,88,329,417
18686,2013-02-24,13,133,332,465
18687,2013-02-24,14,127,365,492
18688,2013-02-24,15,137,357,494
18689,2013-02-24,16,89,316,405
18690,2013-02-24,17,56,274,330
18691,2013-02-24,18,27,171,198
18692,2013-02-24,19,16,138,154
18693,2013-02-24,20,5,95,100
18694,2013-02-24,21,1,55,56
18695,2013-02-24,22,1,68,69
18696,2013-02-24,23,4,24,28
18697,2013-02-25,0,3,53,56
18698,2013-02-25,1,0,8,8
18699,2013-02-25,2,0,2,2
18700,2013-02-25,4,0,5,5
18701,2013-02-25,5,1,26,27
18702,2013-02-25,6,0,107,107
18703,2013-02-25,7,5,306,311
18704,2013-02-25,8,9,604,613
18705,2013-02-25,9,15,293,308
18706,2013-02-25,10,21,110,131
18707,2013-02-25,11,18,106,124
18708,2013-02-25,12,26,162,188
18709,2013-02-25,13,44,152,196
18710,2013-02-25,14,28,174,202
18711,2013-02-25,15,32,206,238
18712,2013-02-25,16,26,305,331
18713,2013-02-25,17,36,597,633
18714,2013-02-25,18,15,515,530
18715,2013-02-25,19,22,355,377
18716,2013-02-25,20,7,242,249
18717,2013-02-25,21,11,156,167
18718,2013-02-25,22,7,91,98
18719,2013-02-25,23,5,42,47
18720,2013-02-26,0,1,16,17
18721,2013-02-26,1,0,10,10
18722,2013-02-26,2,1,2,3
18723,2013-02-26,3,0,8,8
18724,2013-02-26,4,0,4,4
18725,2013-02-26,5,2,31,33
18726,2013-02-26,6,3,128,131
18727,2013-02-26,7,3,397,400
18728,2013-02-26,8,23,616,639
18729,2013-02-26,9,22,284,306
18730,2013-02-26,10,9,119,128
18731,2013-02-26,11,18,82,100
18732,2013-02-26,12,8,63,71
18733,2013-02-26,13,7,56,63
18734,2013-02-26,14,6,37,43
18735,2013-02-26,15,11,30,41
18736,2013-02-26,16,9,72,81
18737,2013-02-26,17,10,255,265
18738,2013-02-26,18,8,134,142
18739,2013-02-26,19,0,111,111
18740,2013-02-26,20,2,46,48
18741,2013-02-26,21,4,45,49
18742,2013-02-26,22,0,27,27
18743,2013-02-26,23,2,20,22
18744,2013-02-27,0,0,11,11
18745,2013-02-27,1,0,7,7
18746,2013-02-27,2,0,3,3
18747,2013-02-27,3,0,2,2
18748,2013-02-27,4,0,4,4
18749,2013-02-27,5,0,36,36
18750,2013-02-27,6,2,112,114
18751,2013-02-27,7,5,329,334
18752,2013-02-27,8,12,622,634
18753,2013-02-27,9,21,295,316
18754,2013-02-27,10,26,144,170
18755,2013-02-27,11,14,150,164
18756,2013-02-27,12,30,208,238
18757,2013-02-27,13,31,190,221
18758,2013-02-27,14,40,166,206
18759,2013-02-27,15,29,183,212
18760,2013-02-27,16,22,332,354
18761,2013-02-27,17,48,608,656
18762,2013-02-27,18,25,564,589
18763,2013-02-27,19,12,362,374
18764,2013-02-27,20,18,281,299
18765,2013-02-27,21,13,222,235
18766,2013-02-27,22,7,134,141
18767,2013-02-27,23,8,60,68
18768,2013-02-28,0,0,31,31
18769,2013-02-28,1,2,21,23
18770,2013-02-28,2,0,9,9
18771,2013-02-28,4,0,3,3
18772,2013-02-28,5,1,29,30
18773,2013-02-28,6,2,127,129
18774,2013-02-28,7,8,348,356
18775,2013-02-28,8,16,689,705
18776,2013-02-28,9,19,297,316
18777,2013-02-28,10,25,143,168
18778,2013-02-28,11,28,170,198
18779,2013-02-28,12,27,204,231
18780,2013-02-28,13,19,179,198
18781,2013-02-28,14,22,148,170
18782,2013-02-28,15,18,177,195
18783,2013-02-28,16,21,255,276
18784,2013-02-28,17,26,511,537
18785,2013-02-28,18,26,524,550
18786,2013-02-28,19,13,318,331
18787,2013-02-28,20,13,225,238
18788,2013-02-28,21,5,180,185
18789,2013-02-28,22,2,131,133
18790,2013-02-28,23,3,69,72
18791,2013-03-01,0,0,27,27
18792,2013-03-01,1,1,22,23
18793,2013-03-01,2,2,10,12
18794,2013-03-01,3,0,7,7
18795,2013-03-01,4,2,9,11
18796,2013-03-01,5,1,30,31
18797,2013-03-01,6,1,125,126
18798,2013-03-01,7,4,335,339
18799,2013-03-01,8,21,663,684
18800,2013-03-01,9,19,299,318
18801,2013-03-01,10,21,157,178
18802,2013-03-01,11,30,176,206
18803,2013-03-01,12,27,195,222
18804,2013-03-01,13,23,178,201
18805,2013-03-01,14,26,157,183
18806,2013-03-01,15,30,197,227
18807,2013-03-01,16,24,306,330
18808,2013-03-01,17,38,505,543
18809,2013-03-01,18,24,406,430
18810,2013-03-01,19,10,276,286
18811,2013-03-01,20,5,172,177
18812,2013-03-01,21,14,119,133
18813,2013-03-01,22,3,112,115
18814,2013-03-01,23,3,74,77
18815,2013-03-02,0,6,59,65
18816,2013-03-02,1,7,53,60
18817,2013-03-02,2,2,45,47
18818,2013-03-02,3,3,19,22
18819,2013-03-02,4,2,7,9
18820,2013-03-02,5,0,3,3
18821,2013-03-02,6,1,13,14
18822,2013-03-02,7,5,49,54
18823,2013-03-02,8,10,110,120
18824,2013-03-02,9,17,158,175
18825,2013-03-02,10,30,203,233
18826,2013-03-02,11,61,203,264
18827,2013-03-02,12,50,293,343
18828,2013-03-02,13,47,258,305
18829,2013-03-02,14,84,203,287
18830,2013-03-02,15,71,238,309
18831,2013-03-02,16,73,177,250
18832,2013-03-02,17,62,205,267
18833,2013-03-02,18,63,190,253
18834,2013-03-02,19,26,149,175
18835,2013-03-02,20,16,120,136
18836,2013-03-02,21,17,108,125
18837,2013-03-02,22,18,83,101
18838,2013-03-02,23,3,86,89
18839,2013-03-03,0,1,54,55
18840,2013-03-03,1,4,51,55
18841,2013-03-03,2,4,34,38
18842,2013-03-03,3,2,22,24
18843,2013-03-03,4,2,8,10
18844,2013-03-03,5,1,3,4
18845,2013-03-03,6,0,11,11
18846,2013-03-03,7,3,26,29
18847,2013-03-03,8,7,62,69
18848,2013-03-03,9,18,102,120
18849,2013-03-03,10,39,152,191
18850,2013-03-03,11,38,208,246
18851,2013-03-03,12,54,214,268
18852,2013-03-03,13,52,202,254
18853,2013-03-03,14,37,216,253
18854,2013-03-03,15,50,227,277
18855,2013-03-03,16,45,225,270
18856,2013-03-03,17,38,205,243
18857,2013-03-03,18,35,190,225
18858,2013-03-03,19,12,120,132
18859,2013-03-03,20,9,89,98
18860,2013-03-03,21,14,78,92
18861,2013-03-03,22,4,52,56
18862,2013-03-03,23,6,22,28
18863,2013-03-04,0,2,7,9
18864,2013-03-04,1,0,6,6
18865,2013-03-04,2,0,4,4
18866,2013-03-04,3,0,1,1
18867,2013-03-04,4,0,5,5
18868,2013-03-04,5,0,31,31
18869,2013-03-04,6,1,97,98
18870,2013-03-04,7,7,299,306
18871,2013-03-04,8,18,548,566
18872,2013-03-04,9,19,229,248
18873,2013-03-04,10,17,113,130
18874,2013-03-04,11,37,108,145
18875,2013-03-04,12,27,150,177
18876,2013-03-04,13,25,131,156
18877,2013-03-04,14,21,117,138
18878,2013-03-04,15,31,145,176
18879,2013-03-04,16,25,291,316
18880,2013-03-04,17,26,518,544
18881,2013-03-04,18,8,465,473
18882,2013-03-04,19,7,341,348
18883,2013-03-04,20,7,219,226
18884,2013-03-04,21,11,134,145
18885,2013-03-04,22,19,94,113
18886,2013-03-04,23,3,48,51
18887,2013-03-05,0,4,31,35
18888,2013-03-05,1,1,10,11
18889,2013-03-05,2,0,9,9
18890,2013-03-05,3,0,1,1
18891,2013-03-05,4,0,4,4
18892,2013-03-05,5,1,39,40
18893,2013-03-05,6,3,118,121
18894,2013-03-05,7,31,364,395
18895,2013-03-05,8,30,684,714
18896,2013-03-05,9,21,274,295
18897,2013-03-05,10,22,134,156
18898,2013-03-05,11,18,129,147
18899,2013-03-05,12,16,193,209
18900,2013-03-05,13,36,180,216
18901,2013-03-05,14,42,149,191
18902,2013-03-05,15,48,166,214
18903,2013-03-05,16,43,294,337
18904,2013-03-05,17,38,563,601
18905,2013-03-05,18,18,538,556
18906,2013-03-05,19,23,322,345
18907,2013-03-05,20,11,215,226
18908,2013-03-05,21,16,168,184
18909,2013-03-05,22,19,102,121
18910,2013-03-05,23,3,50,53
18911,2013-03-06,0,1,17,18
18912,2013-03-06,1,3,7,10
18913,2013-03-06,2,1,4,5
18914,2013-03-06,3,0,1,1
18915,2013-03-06,4,0,3,3
18916,2013-03-06,5,0,5,5
18917,2013-03-06,6,0,10,10
18918,2013-03-06,7,5,33,38
18919,2013-03-06,8,4,56,60
18920,2013-03-06,9,0,47,47
18921,2013-03-06,10,1,32,33
18922,2013-03-06,11,2,39,41
18923,2013-03-06,12,1,29,30
18924,2013-03-06,13,6,40,46
18925,2013-03-06,14,1,45,46
18926,2013-03-06,15,1,26,27
18927,2013-03-06,16,3,48,51
18928,2013-03-06,17,4,87,91
18929,2013-03-06,18,4,109,113
18930,2013-03-06,19,14,114,128
18931,2013-03-06,20,15,88,103
18932,2013-03-06,21,4,95,99
18933,2013-03-06,22,5,66,71
18934,2013-03-06,23,4,45,49
18935,2013-03-07,0,2,16,18
18936,2013-03-07,1,3,8,11
18937,2013-03-07,2,2,0,2
18938,2013-03-07,3,0,2,2
18939,2013-03-07,4,0,6,6
18940,2013-03-07,5,0,34,34
18941,2013-03-07,6,0,110,110
18942,2013-03-07,7,13,327,340
18943,2013-03-07,8,21,661,682
18944,2013-03-07,9,16,266,282
18945,2013-03-07,10,20,142,162
18946,2013-03-07,11,23,128,151
18947,2013-03-07,12,29,191,220
18948,2013-03-07,13,21,168,189
18949,2013-03-07,14,27,160,187
18950,2013-03-07,15,28,180,208
18951,2013-03-07,16,22,282,304
18952,2013-03-07,17,20,566,586
18953,2013-03-07,18,19,531,550
18954,2013-03-07,19,14,327,341
18955,2013-03-07,20,15,223,238
18956,2013-03-07,21,8,189,197
18957,2013-03-07,22,6,122,128
18958,2013-03-07,23,6,52,58
18959,2013-03-08,0,7,38,45
18960,2013-03-08,1,5,20,25
18961,2013-03-08,2,4,4,8
18962,2013-03-08,3,0,2,2
18963,2013-03-08,4,1,6,7
18964,2013-03-08,5,1,36,37
18965,2013-03-08,6,0,109,109
18966,2013-03-08,7,7,333,340
18967,2013-03-08,8,9,602,611
18968,2013-03-08,9,17,269,286
18969,2013-03-08,10,21,120,141
18970,2013-03-08,11,26,145,171
18971,2013-03-08,12,30,189,219
18972,2013-03-08,13,44,170,214
18973,2013-03-08,14,41,165,206
18974,2013-03-08,15,27,205,232
18975,2013-03-08,16,46,303,349
18976,2013-03-08,17,35,525,560
18977,2013-03-08,18,21,417,438
18978,2013-03-08,19,22,279,301
18979,2013-03-08,20,5,183,188
18980,2013-03-08,21,13,143,156
18981,2013-03-08,22,15,88,103
18982,2013-03-08,23,13,74,87
18983,2013-03-09,0,5,72,77
18984,2013-03-09,1,5,62,67
18985,2013-03-09,2,4,35,39
18986,2013-03-09,3,1,9,10
18987,2013-03-09,4,2,4,6
18988,2013-03-09,5,1,4,5
18989,2013-03-09,6,1,15,16
18990,2013-03-09,7,5,49,54
18991,2013-03-09,8,15,103,118
18992,2013-03-09,9,40,194,234
18993,2013-03-09,10,80,283,363
18994,2013-03-09,11,151,316,467
18995,2013-03-09,12,164,366,530
18996,2013-03-09,13,254,367,621
18997,2013-03-09,14,300,440,740
18998,2013-03-09,15,274,429,703
18999,2013-03-09,16,296,434,730
19000,2013-03-09,17,247,357,604
19001,2013-03-09,18,120,278,398
19002,2013-03-09,19,83,214,297
19003,2013-03-09,20,42,184,226
19004,2013-03-09,21,36,134,170
19005,2013-03-09,22,26,133,159
19006,2013-03-09,23,16,117,133
19007,2013-03-10,0,2,91,93
19008,2013-03-10,1,10,74,84
19009,2013-03-10,3,11,55,66
19010,2013-03-10,4,3,27,30
19011,2013-03-10,5,1,4,5
19012,2013-03-10,6,1,6,7
19013,2013-03-10,7,4,35,39
19014,2013-03-10,8,11,87,98
19015,2013-03-10,9,36,119,155
19016,2013-03-10,10,86,246,332
19017,2013-03-10,11,133,304,437
19018,2013-03-10,12,193,386,579
19019,2013-03-10,13,264,421,685
19020,2013-03-10,14,298,429,727
19021,2013-03-10,15,314,418,732
19022,2013-03-10,16,295,437,732
19023,2013-03-10,17,276,401,677
19024,2013-03-10,18,161,317,478
19025,2013-03-10,19,92,220,312
19026,2013-03-10,20,66,142,208
19027,2013-03-10,21,44,114,158
19028,2013-03-10,22,16,63,79
19029,2013-03-10,23,11,40,51
19030,2013-03-11,0,4,23,27
19031,2013-03-11,1,2,6,8
19032,2013-03-11,2,2,6,8
19033,2013-03-11,3,0,3,3
19034,2013-03-11,4,0,6,6
19035,2013-03-11,5,4,32,36
19036,2013-03-11,6,4,108,112
19037,2013-03-11,7,11,328,339
19038,2013-03-11,8,22,604,626
19039,2013-03-11,9,39,285,324
19040,2013-03-11,10,41,111,152
19041,2013-03-11,11,84,115,199
19042,2013-03-11,12,95,161,256
19043,2013-03-11,13,79,173,252
19044,2013-03-11,14,82,146,228
19045,2013-03-11,15,120,177,297
19046,2013-03-11,16,122,290,412
19047,2013-03-11,17,131,681,812
19048,2013-03-11,18,64,649,713
19049,2013-03-11,19,44,425,469
19050,2013-03-11,20,30,288,318
19051,2013-03-11,21,26,202,228
19052,2013-03-11,22,12,123,135
19053,2013-03-11,23,8,71,79
19054,2013-03-12,0,2,21,23
19055,2013-03-12,1,2,11,13
19056,2013-03-12,2,4,6,10
19057,2013-03-12,3,0,5,5
19058,2013-03-12,4,0,5,5
19059,2013-03-12,5,0,15,15
19060,2013-03-12,6,0,61,61
19061,2013-03-12,7,1,58,59
19062,2013-03-12,8,10,257,267
19063,2013-03-12,9,20,234,254
19064,2013-03-12,10,7,26,33
19065,2013-03-12,11,1,22,23
19066,2013-03-12,12,11,50,61
19067,2013-03-12,13,17,125,142
19068,2013-03-12,14,40,140,180
19069,2013-03-12,15,62,210,272
19070,2013-03-12,16,40,311,351
19071,2013-03-12,17,61,641,702
19072,2013-03-12,18,39,595,634
19073,2013-03-12,19,43,380,423
19074,2013-03-12,20,30,252,282
19075,2013-03-12,21,30,208,238
19076,2013-03-12,22,23,101,124
19077,2013-03-12,23,6,62,68
19078,2013-03-13,0,3,22,25
19079,2013-03-13,1,0,11,11
19080,2013-03-13,2,0,4,4
19081,2013-03-13,3,0,3,3
19082,2013-03-13,4,0,8,8
19083,2013-03-13,5,2,31,33
19084,2013-03-13,6,0,109,109
19085,2013-03-13,7,10,357,367
19086,2013-03-13,8,14,698,712
19087,2013-03-13,9,19,327,346
19088,2013-03-13,10,40,134,174
19089,2013-03-13,11,86,146,232
19090,2013-03-13,12,50,214,264
19091,2013-03-13,13,49,185,234
19092,2013-03-13,14,71,174,245
19093,2013-03-13,15,61,173,234
19094,2013-03-13,16,46,289,335
19095,2013-03-13,17,58,605,663
19096,2013-03-13,18,40,579,619
19097,2013-03-13,19,28,402,430
19098,2013-03-13,20,24,239,263
19099,2013-03-13,21,6,201,207
19100,2013-03-13,22,14,98,112
19101,2013-03-13,23,3,59,62
19102,2013-03-14,0,3,24,27
19103,2013-03-14,1,0,12,12
19104,2013-03-14,2,1,6,7
19105,2013-03-14,3,0,3,3
19106,2013-03-14,4,0,5,5
19107,2013-03-14,5,1,36,37
19108,2013-03-14,6,2,94,96
19109,2013-03-14,7,9,305,314
19110,2013-03-14,8,19,597,616
19111,2013-03-14,9,7,299,306
19112,2013-03-14,10,25,115,140
19113,2013-03-14,11,21,140,161
19114,2013-03-14,12,43,173,216
19115,2013-03-14,13,43,186,229
19116,2013-03-14,14,46,161,207
19117,2013-03-14,15,47,150,197
19118,2013-03-14,16,50,249,299
19119,2013-03-14,17,31,488,519
19120,2013-03-14,18,34,481,515
19121,2013-03-14,19,19,307,326
19122,2013-03-14,20,17,230,247
19123,2013-03-14,21,10,161,171
19124,2013-03-14,22,7,93,100
19125,2013-03-14,23,5,71,76
19126,2013-03-15,0,5,36,41
19127,2013-03-15,1,1,16,17
19128,2013-03-15,2,1,8,9
19129,2013-03-15,3,0,8,8
19130,2013-03-15,4,0,9,9
19131,2013-03-15,5,0,35,35
19132,2013-03-15,6,1,94,95
19133,2013-03-15,7,2,275,277
19134,2013-03-15,8,15,596,611
19135,2013-03-15,9,18,330,348
19136,2013-03-15,10,38,148,186
19137,2013-03-15,11,68,159,227
19138,2013-03-15,12,64,238,302
19139,2013-03-15,13,105,222,327
19140,2013-03-15,14,152,199,351
19141,2013-03-15,15,165,273,438
19142,2013-03-15,16,158,346,504
19143,2013-03-15,17,145,598,743
19144,2013-03-15,18,108,560,668
19145,2013-03-15,19,48,339,387
19146,2013-03-15,20,33,234,267
19147,2013-03-15,21,34,167,201
19148,2013-03-15,22,31,138,169
19149,2013-03-15,23,9,101,110
19150,2013-03-16,0,19,85,104
19151,2013-03-16,1,2,57,59
19152,2013-03-16,2,4,60,64
19153,2013-03-16,3,5,28,33
19154,2013-03-16,4,1,4,5
19155,2013-03-16,5,2,23,25
19156,2013-03-16,6,16,92,108
19157,2013-03-16,7,36,93,129
19158,2013-03-16,8,45,169,214
19159,2013-03-16,9,75,244,319
19160,2013-03-16,10,120,315,435
19161,2013-03-16,11,161,355,516
19162,2013-03-16,12,182,369,551
19163,2013-03-16,13,194,360,554
19164,2013-03-16,14,183,330,513
19165,2013-03-16,15,217,354,571
19166,2013-03-16,16,172,249,421
19167,2013-03-16,17,120,185,305
19168,2013-03-16,18,84,220,304
19169,2013-03-16,19,71,213,284
19170,2013-03-16,20,32,163,195
19171,2013-03-16,21,23,143,166
19172,2013-03-16,22,26,139,165
19173,2013-03-16,23,19,107,126
19174,2013-03-17,0,12,79,91
19175,2013-03-17,1,7,74,81
19176,2013-03-17,2,6,64,70
19177,2013-03-17,3,1,24,25
19178,2013-03-17,4,0,5,5
19179,2013-03-17,5,1,5,6
19180,2013-03-17,6,5,7,12
19181,2013-03-17,7,8,24,32
19182,2013-03-17,8,18,65,83
19183,2013-03-17,9,51,108,159
19184,2013-03-17,10,70,201,271
19185,2013-03-17,11,110,279,389
19186,2013-03-17,12,111,273,384
19187,2013-03-17,13,91,243,334
19188,2013-03-17,14,89,220,309
19189,2013-03-17,15,104,227,331
19190,2013-03-17,16,74,253,327
19191,2013-03-17,17,85,213,298
19192,2013-03-17,18,42,167,209
19193,2013-03-17,19,29,140,169
19194,2013-03-17,20,39,99,138
19195,2013-03-17,21,17,84,101
19196,2013-03-17,22,9,74,83
19197,2013-03-17,23,3,32,35
19198,2013-03-18,0,6,20,26
19199,2013-03-18,1,2,7,9
19200,2013-03-18,2,0,6,6
19201,2013-03-18,3,0,4,4
19202,2013-03-18,4,0,7,7
19203,2013-03-18,5,2,31,33
19204,2013-03-18,6,1,93,94
19205,2013-03-18,7,6,259,265
19206,2013-03-18,8,9,508,517
19207,2013-03-18,9,19,217,236
19208,2013-03-18,10,22,93,115
19209,2013-03-18,11,16,97,113
19210,2013-03-18,12,22,154,176
19211,2013-03-18,13,34,102,136
19212,2013-03-18,14,22,87,109
19213,2013-03-18,15,21,90,111
19214,2013-03-18,16,18,98,116
19215,2013-03-18,17,13,164,177
19216,2013-03-18,18,7,122,129
19217,2013-03-18,19,6,114,120
19218,2013-03-18,20,7,82,89
19219,2013-03-18,21,11,71,82
19220,2013-03-18,22,2,44,46
19221,2013-03-18,23,1,29,30
19222,2013-03-19,0,3,19,22
19223,2013-03-19,1,0,7,7
19224,2013-03-19,2,1,5,6
19225,2013-03-19,3,0,2,2
19226,2013-03-19,4,0,8,8
19227,2013-03-19,5,0,33,33
19228,2013-03-19,6,0,102,102
19229,2013-03-19,7,4,332,336
19230,2013-03-19,8,11,629,640
19231,2013-03-19,9,9,310,319
19232,2013-03-19,10,22,135,157
19233,2013-03-19,11,42,162,204
19234,2013-03-19,12,50,206,256
19235,2013-03-19,13,49,220,269
19236,2013-03-19,14,83,189,272
19237,2013-03-19,15,86,189,275
19238,2013-03-19,16,88,326,414
19239,2013-03-19,17,78,664,742
19240,2013-03-19,18,53,687,740
19241,2013-03-19,19,28,414,442
19242,2013-03-19,20,24,258,282
19243,2013-03-19,21,16,204,220
19244,2013-03-19,22,14,113,127
19245,2013-03-19,23,13,54,67
19246,2013-03-20,0,0,16,16
19247,2013-03-20,1,0,6,6
19248,2013-03-20,2,0,5,5
19249,2013-03-20,3,0,3,3
19250,2013-03-20,4,0,4,4
19251,2013-03-20,5,1,34,35
19252,2013-03-20,6,5,133,138
19253,2013-03-20,7,9,368,377
19254,2013-03-20,8,19,718,737
19255,2013-03-20,9,20,323,343
19256,2013-03-20,10,39,146,185
19257,2013-03-20,11,35,156,191
19258,2013-03-20,12,41,217,258
19259,2013-03-20,13,54,187,241
19260,2013-03-20,14,49,174,223
19261,2013-03-20,15,43,174,217
19262,2013-03-20,16,73,296,369
19263,2013-03-20,17,52,633,685
19264,2013-03-20,18,40,571,611
19265,2013-03-20,19,22,397,419
19266,2013-03-20,20,21,270,291
19267,2013-03-20,21,23,226,249
19268,2013-03-20,22,8,126,134
19269,2013-03-20,23,2,67,69
19270,2013-03-21,0,0,31,31
19271,2013-03-21,1,1,12,13
19272,2013-03-21,2,1,6,7
19273,2013-03-21,3,0,2,2
19274,2013-03-21,4,0,8,8
19275,2013-03-21,5,0,23,23
19276,2013-03-21,6,1,88,89
19277,2013-03-21,7,8,298,306
19278,2013-03-21,8,15,614,629
19279,2013-03-21,9,19,304,323
19280,2013-03-21,10,20,143,163
19281,2013-03-21,11,36,141,177
19282,2013-03-21,12,21,136,157
19283,2013-03-21,13,36,183,219
19284,2013-03-21,14,13,114,127
19285,2013-03-21,15,29,153,182
19286,2013-03-21,16,25,231,256
19287,2013-03-21,17,29,480,509
19288,2013-03-21,18,18,432,450
19289,2013-03-21,19,19,285,304
19290,2013-03-21,20,12,200,212
19291,2013-03-21,21,2,158,160
19292,2013-03-21,22,2,111,113
19293,2013-03-21,23,1,47,48
19294,2013-03-22,0,4,32,36
19295,2013-03-22,1,0,13,13
19296,2013-03-22,2,3,7,10
19297,2013-03-22,3,0,3,3
19298,2013-03-22,4,0,8,8
19299,2013-03-22,5,0,26,26
19300,2013-03-22,6,2,96,98
19301,2013-03-22,7,4,243,247
19302,2013-03-22,8,26,601,627
19303,2013-03-22,9,11,311,322
19304,2013-03-22,10,30,142,172
19305,2013-03-22,11,49,147,196
19306,2013-03-22,12,52,209,261
19307,2013-03-22,13,54,192,246
19308,2013-03-22,14,62,187,249
19309,2013-03-22,15,87,212,299
19310,2013-03-22,16,65,326,391
19311,2013-03-22,17,74,608,682
19312,2013-03-22,18,58,471,529
19313,2013-03-22,19,47,339,386
19314,2013-03-22,20,20,210,230
19315,2013-03-22,21,15,158,173
19316,2013-03-22,22,11,108,119
19317,2013-03-22,23,8,76,84
19318,2013-03-23,0,4,69,73
19319,2013-03-23,1,4,56,60
19320,2013-03-23,2,7,39,46
19321,2013-03-23,3,0,9,9
19322,2013-03-23,4,1,7,8
19323,2013-03-23,5,0,8,8
19324,2013-03-23,6,3,18,21
19325,2013-03-23,7,7,58,65
19326,2013-03-23,8,14,106,120
19327,2013-03-23,9,45,171,216
19328,2013-03-23,10,67,240,307
19329,2013-03-23,11,160,275,435
19330,2013-03-23,12,198,330,528
19331,2013-03-23,13,287,328,615
19332,2013-03-23,14,308,315,623
19333,2013-03-23,15,364,357,721
19334,2013-03-23,16,326,311,637
19335,2013-03-23,17,263,307,570
19336,2013-03-23,18,184,293,477
19337,2013-03-23,19,105,224,329
19338,2013-03-23,20,48,154,202
19339,2013-03-23,21,27,132,159
19340,2013-03-23,22,39,110,149
19341,2013-03-23,23,12,88,100
19342,2013-03-24,0,6,77,83
19343,2013-03-24,1,4,62,66
19344,2013-03-24,2,1,48,49
19345,2013-03-24,3,1,26,27
19346,2013-03-24,4,5,6,11
19347,2013-03-24,5,1,2,3
19348,2013-03-24,6,2,7,9
19349,2013-03-24,7,2,21,23
19350,2013-03-24,8,14,72,86
19351,2013-03-24,9,61,107,168
19352,2013-03-24,10,72,183,255
19353,2013-03-24,11,79,227,306
19354,2013-03-24,12,135,295,430
19355,2013-03-24,13,157,270,427
19356,2013-03-24,14,166,263,429
19357,2013-03-24,15,108,204,312
19358,2013-03-24,16,130,198,328
19359,2013-03-24,17,58,212,270
19360,2013-03-24,18,62,176,238
19361,2013-03-24,19,26,123,149
19362,2013-03-24,20,8,74,82
19363,2013-03-24,21,4,41,45
19364,2013-03-24,22,5,36,41
19365,2013-03-24,23,2,17,19
19366,2013-03-25,0,4,16,20
19367,2013-03-25,1,0,9,9
19368,2013-03-25,2,0,1,1
19369,2013-03-25,3,0,2,2
19370,2013-03-25,4,0,5,5
19371,2013-03-25,5,0,9,9
19372,2013-03-25,6,0,28,28
19373,2013-03-25,7,2,80,82
19374,2013-03-25,8,3,187,190
19375,2013-03-25,9,4,129,133
19376,2013-03-25,10,4,52,56
19377,2013-03-25,11,0,52,52
19378,2013-03-25,12,3,47,50
19379,2013-03-25,13,12,57,69
19380,2013-03-25,14,11,42,53
19381,2013-03-25,15,6,73,79
19382,2013-03-25,16,4,138,142
19383,2013-03-25,17,9,232,241
19384,2013-03-25,18,3,204,207
19385,2013-03-25,19,10,157,167
19386,2013-03-25,20,1,112,113
19387,2013-03-25,21,4,92,96
19388,2013-03-25,22,4,58,62
19389,2013-03-25,23,0,46,46
19390,2013-03-26,0,0,12,12
19391,2013-03-26,1,0,9,9
19392,2013-03-26,2,0,3,3
19393,2013-03-26,3,0,3,3
19394,2013-03-26,4,0,10,10
19395,2013-03-26,5,1,32,33
19396,2013-03-26,6,3,95,98
19397,2013-03-26,7,3,297,300
19398,2013-03-26,8,11,657,668
19399,2013-03-26,9,23,325,348
19400,2013-03-26,10,50,117,167
19401,2013-03-26,11,42,154,196
19402,2013-03-26,12,54,205,259
19403,2013-03-26,13,67,189,256
19404,2013-03-26,14,62,128,190
19405,2013-03-26,15,48,165,213
19406,2013-03-26,16,64,312,376
19407,2013-03-26,17,75,636,711
19408,2013-03-26,18,52,583,635
19409,2013-03-26,19,52,394,446
19410,2013-03-26,20,27,248,275
19411,2013-03-26,21,5,172,177
19412,2013-03-26,22,4,120,124
19413,2013-03-26,23,3,70,73
19414,2013-03-27,0,0,46,46
19415,2013-03-27,1,0,13,13
19416,2013-03-27,2,0,4,4
19417,2013-03-27,3,0,8,8
19418,2013-03-27,4,0,7,7
19419,2013-03-27,5,0,32,32
19420,2013-03-27,6,2,110,112
19421,2013-03-27,7,6,336,342
19422,2013-03-27,8,21,726,747
19423,2013-03-27,9,11,309,320
19424,2013-03-27,10,47,146,193
19425,2013-03-27,11,53,170,223
19426,2013-03-27,12,57,213,270
19427,2013-03-27,13,44,175,219
19428,2013-03-27,14,88,187,275
19429,2013-03-27,15,59,161,220
19430,2013-03-27,16,44,310,354
19431,2013-03-27,17,65,606,671
19432,2013-03-27,18,53,619,672
19433,2013-03-27,19,39,376,415
19434,2013-03-27,20,24,237,261
19435,2013-03-27,21,12,189,201
19436,2013-03-27,22,17,109,126
19437,2013-03-27,23,4,65,69
19438,2013-03-28,0,0,36,36
19439,2013-03-28,1,2,9,11
19440,2013-03-28,2,1,7,8
19441,2013-03-28,3,0,2,2
19442,2013-03-28,4,0,6,6
19443,2013-03-28,5,0,35,35
19444,2013-03-28,6,6,89,95
19445,2013-03-28,7,6,344,350
19446,2013-03-28,8,26,686,712
19447,2013-03-28,9,25,336,361
19448,2013-03-28,10,43,127,170
19449,2013-03-28,11,63,159,222
19450,2013-03-28,12,53,198,251
19451,2013-03-28,13,59,174,233
19452,2013-03-28,14,61,129,190
19453,2013-03-28,15,80,174,254
19454,2013-03-28,16,54,268,322
19455,2013-03-28,17,58,615,673
19456,2013-03-28,18,62,528,590
19457,2013-03-28,19,39,324,363
19458,2013-03-28,20,30,245,275
19459,2013-03-28,21,8,192,200
19460,2013-03-28,22,16,122,138
19461,2013-03-28,23,7,79,86
19462,2013-03-29,0,7,81,88
19463,2013-03-29,1,3,20,23
19464,2013-03-29,2,2,18,20
19465,2013-03-29,3,0,5,5
19466,2013-03-29,4,0,7,7
19467,2013-03-29,5,0,31,31
19468,2013-03-29,6,4,90,94
19469,2013-03-29,7,11,265,276
19470,2013-03-29,8,20,603,623
19471,2013-03-29,9,51,373,424
19472,2013-03-29,10,94,189,283
19473,2013-03-29,11,113,222,335
19474,2013-03-29,12,202,320,522
19475,2013-03-29,13,173,289,462
19476,2013-03-29,14,182,256,438
19477,2013-03-29,15,239,287,526
19478,2013-03-29,16,206,386,592
19479,2013-03-29,17,195,591,786
19480,2013-03-29,18,149,442,591
19481,2013-03-29,19,108,356,464
19482,2013-03-29,20,84,234,318
19483,2013-03-29,21,75,153,228
19484,2013-03-29,22,30,135,165
19485,2013-03-29,23,20,63,83
19486,2013-03-30,0,20,85,105
19487,2013-03-30,1,9,58,67
19488,2013-03-30,2,10,44,54
19489,2013-03-30,3,5,16,21
19490,2013-03-30,4,0,3,3
19491,2013-03-30,5,1,4,5
19492,2013-03-30,6,3,16,19
19493,2013-03-30,7,7,48,55
19494,2013-03-30,8,28,114,142
19495,2013-03-30,9,93,178,271
19496,2013-03-30,10,279,252,531
19497,2013-03-30,11,398,366,764
19498,2013-03-30,12,490,397,887
19499,2013-03-30,13,549,452,1001
19500,2013-03-30,14,548,372,920
19501,2013-03-30,15,565,380,945
19502,2013-03-30,16,498,388,886
19503,2013-03-30,17,472,346,818
19504,2013-03-30,18,366,315,681
19505,2013-03-30,19,284,247,531
19506,2013-03-30,20,173,138,311
19507,2013-03-30,21,77,135,212
19508,2013-03-30,22,80,132,212
19509,2013-03-30,23,50,103,153
19510,2013-03-31,0,27,86,113
19511,2013-03-31,1,20,56,76
19512,2013-03-31,2,14,48,62
19513,2013-03-31,3,10,29,39
19514,2013-03-31,4,8,8,16
19515,2013-03-31,5,6,6,12
19516,2013-03-31,6,12,14,26
19517,2013-03-31,7,16,33,49
19518,2013-03-31,8,41,95,136
19519,2013-03-31,9,85,127,212
19520,2013-03-31,10,147,206,353
19521,2013-03-31,11,178,265,443
19522,2013-03-31,12,191,172,363
19523,2013-03-31,13,86,164,250
19524,2013-03-31,14,97,101,198
19525,2013-03-31,15,64,122,186
19526,2013-03-31,16,89,137,226
19527,2013-03-31,17,74,145,219
19528,2013-03-31,18,64,116,180
19529,2013-03-31,19,73,138,211
19530,2013-03-31,20,34,119,153
19531,2013-03-31,21,29,78,107
19532,2013-03-31,22,27,78,105
19533,2013-03-31,23,9,41,50
19534,2013-04-01,0,3,17,20
19535,2013-04-01,1,2,4,6
19536,2013-04-01,2,0,9,9
19537,2013-04-01,3,0,3,3
19538,2013-04-01,4,2,12,14
19539,2013-04-01,5,2,32,34
19540,2013-04-01,6,7,114,121
19541,2013-04-01,7,16,323,339
19542,2013-04-01,8,25,641,666
19543,2013-04-01,9,58,305,363
19544,2013-04-01,10,106,157,263
19545,2013-04-01,11,161,198,359
19546,2013-04-01,12,160,237,397
19547,2013-04-01,13,143,219,362
19548,2013-04-01,14,129,169,298
19549,2013-04-01,15,109,243,352
19550,2013-04-01,16,101,337,438
19551,2013-04-01,17,83,651,734
19552,2013-04-01,18,56,530,586
19553,2013-04-01,19,42,387,429
19554,2013-04-01,20,46,197,243
19555,2013-04-01,21,31,143,174
19556,2013-04-01,22,15,85,100
19557,2013-04-01,23,6,52,58
19558,2013-04-02,0,1,19,20
19559,2013-04-02,1,0,7,7
19560,2013-04-02,2,0,5,5
19561,2013-04-02,3,0,3,3
19562,2013-04-02,4,1,3,4
19563,2013-04-02,5,1,26,27
19564,2013-04-02,6,3,113,116
19565,2013-04-02,7,9,363,372
19566,2013-04-02,8,22,695,717
19567,2013-04-02,9,27,325,352
19568,2013-04-02,10,56,138,194
19569,2013-04-02,11,83,147,230
19570,2013-04-02,12,56,203,259
19571,2013-04-02,13,60,207,267
19572,2013-04-02,14,74,179,253
19573,2013-04-02,15,57,163,220
19574,2013-04-02,16,95,335,430
19575,2013-04-02,17,61,652,713
19576,2013-04-02,18,58,567,625
19577,2013-04-02,19,35,399,434
19578,2013-04-02,20,20,274,294
19579,2013-04-02,21,9,191,200
19580,2013-04-02,22,7,106,113
19581,2013-04-02,23,3,44,47
19582,2013-04-03,0,1,25,26
19583,2013-04-03,1,1,18,19
19584,2013-04-03,2,0,3,3
19585,2013-04-03,3,0,2,2
19586,2013-04-03,4,0,4,4
19587,2013-04-03,5,0,39,39
19588,2013-04-03,6,2,135,137
19589,2013-04-03,7,16,337,353
19590,2013-04-03,8,29,730,759
19591,2013-04-03,9,39,306,345
19592,2013-04-03,10,61,145,206
19593,2013-04-03,11,62,156,218
19594,2013-04-03,12,64,228,292
19595,2013-04-03,13,107,213,320
19596,2013-04-03,14,74,177,251
19597,2013-04-03,15,111,181,292
19598,2013-04-03,16,113,349,462
19599,2013-04-03,17,108,671,779
19600,2013-04-03,18,50,591,641
19601,2013-04-03,19,46,403,449
19602,2013-04-03,20,15,207,222
19603,2013-04-03,21,18,185,203
19604,2013-04-03,22,11,124,135
19605,2013-04-03,23,1,68,69
19606,2013-04-04,0,3,22,25
19607,2013-04-04,1,1,17,18
19608,2013-04-04,2,2,2,4
19609,2013-04-04,3,0,4,4
19610,2013-04-04,4,1,7,8
19611,2013-04-04,5,1,24,25
19612,2013-04-04,6,2,97,99
19613,2013-04-04,7,20,326,346
19614,2013-04-04,8,23,660,683
19615,2013-04-04,9,38,315,353
19616,2013-04-04,10,73,139,212
19617,2013-04-04,11,67,150,217
19618,2013-04-04,12,81,215,296
19619,2013-04-04,13,95,196,291
19620,2013-04-04,14,133,184,317
19621,2013-04-04,15,91,187,278
19622,2013-04-04,16,56,307,363
19623,2013-04-04,17,92,579,671
19624,2013-04-04,18,63,605,668
19625,2013-04-04,19,30,371,401
19626,2013-04-04,20,13,235,248
19627,2013-04-04,21,13,191,204
19628,2013-04-04,22,3,61,64
19629,2013-04-04,23,3,31,34
19630,2013-04-05,0,0,20,20
19631,2013-04-05,1,1,9,10
19632,2013-04-05,2,0,8,8
19633,2013-04-05,3,0,1,1
19634,2013-04-05,4,1,7,8
19635,2013-04-05,5,3,18,21
19636,2013-04-05,6,5,83,88
19637,2013-04-05,7,5,226,231
19638,2013-04-05,8,11,694,705
19639,2013-04-05,9,31,372,403
19640,2013-04-05,10,50,179,229
19641,2013-04-05,11,110,215,325
19642,2013-04-05,12,131,317,448
19643,2013-04-05,13,147,260,407
19644,2013-04-05,14,187,231,418
19645,2013-04-05,15,161,268,429
19646,2013-04-05,16,165,486,651
19647,2013-04-05,17,162,720,882
19648,2013-04-05,18,139,650,789
19649,2013-04-05,19,83,499,582
19650,2013-04-05,20,56,294,350
19651,2013-04-05,21,61,210,271
19652,2013-04-05,22,30,150,180
19653,2013-04-05,23,20,112,132
19654,2013-04-06,0,6,89,95
19655,2013-04-06,1,14,57,71
19656,2013-04-06,2,7,39,46
19657,2013-04-06,3,9,12,21
19658,2013-04-06,4,2,9,11
19659,2013-04-06,5,6,6,12
19660,2013-04-06,6,3,22,25
19661,2013-04-06,7,34,70,104
19662,2013-04-06,8,45,171,216
19663,2013-04-06,9,67,229,296
19664,2013-04-06,10,186,317,503
19665,2013-04-06,11,363,377,740
19666,2013-04-06,12,427,504,931
19667,2013-04-06,13,496,390,886
19668,2013-04-06,14,443,388,831
19669,2013-04-06,15,478,479,957
19670,2013-04-06,16,492,402,894
19671,2013-04-06,17,438,425,863
19672,2013-04-06,18,273,397,670
19673,2013-04-06,19,145,270,415
19674,2013-04-06,20,64,165,229
19675,2013-04-06,21,52,147,199
19676,2013-04-06,22,32,123,155
19677,2013-04-06,23,17,83,100
19678,2013-04-07,0,15,78,93
19679,2013-04-07,1,9,64,73
19680,2013-04-07,2,4,43,47
19681,2013-04-07,3,5,20,25
19682,2013-04-07,4,2,7,9
19683,2013-04-07,5,2,14,16
19684,2013-04-07,6,24,124,148
19685,2013-04-07,7,23,89,112
19686,2013-04-07,8,75,126,201
19687,2013-04-07,9,144,239,383
19688,2013-04-07,10,242,363,605
19689,2013-04-07,11,401,416,817
19690,2013-04-07,12,419,412,831
19691,2013-04-07,13,490,422,912
19692,2013-04-07,14,539,420,959
19693,2013-04-07,15,513,478,991
19694,2013-04-07,16,464,397,861
19695,2013-04-07,17,366,449,815
19696,2013-04-07,18,299,352,651
19697,2013-04-07,19,211,341,552
19698,2013-04-07,20,72,196,268
19699,2013-04-07,21,63,143,206
19700,2013-04-07,22,36,101,137
19701,2013-04-07,23,10,39,49
19702,2013-04-08,0,8,27,35
19703,2013-04-08,1,4,8,12
19704,2013-04-08,2,5,10,15
19705,2013-04-08,3,3,7,10
19706,2013-04-08,4,4,7,11
19707,2013-04-08,5,5,42,47
19708,2013-04-08,6,13,155,168
19709,2013-04-08,7,35,500,535
19710,2013-04-08,8,63,717,780
19711,2013-04-08,9,69,313,382
19712,2013-04-08,10,125,123,248
19713,2013-04-08,11,166,165,331
19714,2013-04-08,12,168,237,405
19715,2013-04-08,13,140,233,373
19716,2013-04-08,14,148,189,337
19717,2013-04-08,15,150,248,398
19718,2013-04-08,16,155,436,591
19719,2013-04-08,17,203,840,1043
19720,2013-04-08,18,211,832,1043
19721,2013-04-08,19,121,568,689
19722,2013-04-08,20,70,387,457
19723,2013-04-08,21,32,220,252
19724,2013-04-08,22,34,149,183
19725,2013-04-08,23,17,102,119
19726,2013-04-09,0,8,48,56
19727,2013-04-09,1,6,17,23
19728,2013-04-09,2,10,5,15
19729,2013-04-09,3,4,5,9
19730,2013-04-09,4,0,11,11
19731,2013-04-09,5,2,43,45
19732,2013-04-09,6,13,190,203
19733,2013-04-09,7,28,585,613
19734,2013-04-09,8,71,772,843
19735,2013-04-09,9,68,386,454
19736,2013-04-09,10,93,173,266
19737,2013-04-09,11,121,219,340
19738,2013-04-09,12,144,291,435
19739,2013-04-09,13,143,285,428
19740,2013-04-09,14,148,221,369
19741,2013-04-09,15,170,279,449
19742,2013-04-09,16,209,432,641
19743,2013-04-09,17,208,917,1125
19744,2013-04-09,18,234,906,1140
19745,2013-04-09,19,172,657,829
19746,2013-04-09,20,109,416,525
19747,2013-04-09,21,86,332,418
19748,2013-04-09,22,58,261,319
19749,2013-04-09,23,32,161,193
19750,2013-04-10,0,4,57,61
19751,2013-04-10,1,3,20,23
19752,2013-04-10,2,7,10,17
19753,2013-04-10,3,1,3,4
19754,2013-04-10,4,4,10,14
19755,2013-04-10,5,4,58,62
19756,2013-04-10,6,18,224,242
19757,2013-04-10,7,53,582,635
19758,2013-04-10,8,56,810,866
19759,2013-04-10,9,65,346,411
19760,2013-04-10,10,76,157,233
19761,2013-04-10,11,111,182,293
19762,2013-04-10,12,112,295,407
19763,2013-04-10,13,154,252,406
19764,2013-04-10,14,140,240,380
19765,2013-04-10,15,134,241,375
19766,2013-04-10,16,153,427,580
19767,2013-04-10,17,208,903,1111
19768,2013-04-10,18,210,922,1132
19769,2013-04-10,19,206,672,878
19770,2013-04-10,20,85,418,503
19771,2013-04-10,21,77,342,419
19772,2013-04-10,22,51,272,323
19773,2013-04-10,23,32,144,176
19774,2013-04-11,0,14,50,64
19775,2013-04-11,1,2,21,23
19776,2013-04-11,2,1,10,11
19777,2013-04-11,3,2,4,6
19778,2013-04-11,4,0,6,6
19779,2013-04-11,5,1,43,44
19780,2013-04-11,6,22,195,217
19781,2013-04-11,7,46,577,623
19782,2013-04-11,8,60,798,858
19783,2013-04-11,9,68,359,427
19784,2013-04-11,10,107,181,288
19785,2013-04-11,11,125,204,329
19786,2013-04-11,12,107,280,387
19787,2013-04-11,13,137,297,434
19788,2013-04-11,14,168,230,398
19789,2013-04-11,15,147,243,390
19790,2013-04-11,16,135,413,548
19791,2013-04-11,17,170,842,1012
19792,2013-04-11,18,194,897,1091
19793,2013-04-11,19,169,580,749
19794,2013-04-11,20,76,357,433
19795,2013-04-11,21,56,301,357
19796,2013-04-11,22,53,207,260
19797,2013-04-11,23,25,110,135
19798,2013-04-12,0,10,44,54
19799,2013-04-12,1,1,20,21
19800,2013-04-12,2,7,11,18
19801,2013-04-12,3,0,3,3
19802,2013-04-12,4,0,9,9
19803,2013-04-12,5,2,22,24
19804,2013-04-12,6,4,87,91
19805,2013-04-12,7,2,53,55
19806,2013-04-12,8,7,121,128
19807,2013-04-12,9,8,125,133
19808,2013-04-12,10,20,80,100
19809,2013-04-12,11,39,138,177
19810,2013-04-12,12,57,202,259
19811,2013-04-12,13,78,246,324
19812,2013-04-12,14,89,237,326
19813,2013-04-12,15,132,297,429
19814,2013-04-12,16,126,444,570
19815,2013-04-12,17,151,772,923
19816,2013-04-12,18,141,646,787
19817,2013-04-12,19,106,414,520
19818,2013-04-12,20,55,287,342
19819,2013-04-12,21,58,210,268
19820,2013-04-12,22,37,203,240
19821,2013-04-12,23,43,153,196
19822,2013-04-13,0,31,88,119
19823,2013-04-13,1,15,62,77
19824,2013-04-13,2,3,43,46
19825,2013-04-13,3,3,24,27
19826,2013-04-13,4,0,4,4
19827,2013-04-13,5,5,9,14
19828,2013-04-13,6,11,27,38
19829,2013-04-13,7,23,76,99
19830,2013-04-13,8,68,180,248
19831,2013-04-13,9,180,304,484
19832,2013-04-13,10,274,373,647
19833,2013-04-13,11,370,492,862
19834,2013-04-13,12,497,468,965
19835,2013-04-13,13,500,455,955
19836,2013-04-13,14,583,455,1038
19837,2013-04-13,15,692,439,1131
19838,2013-04-13,16,583,428,1011
19839,2013-04-13,17,484,438,922
19840,2013-04-13,18,372,437,809
19841,2013-04-13,19,261,327,588
19842,2013-04-13,20,170,239,409
19843,2013-04-13,21,131,216,347
19844,2013-04-13,22,69,192,261
19845,2013-04-13,23,49,115,164
19846,2013-04-14,0,57,124,181
19847,2013-04-14,1,23,94,117
19848,2013-04-14,2,14,71,85
19849,2013-04-14,3,10,28,38
19850,2013-04-14,4,6,9,15
19851,2013-04-14,5,1,6,7
19852,2013-04-14,6,14,11,25
19853,2013-04-14,7,26,66,92
19854,2013-04-14,8,87,120,207
19855,2013-04-14,9,189,237,426
19856,2013-04-14,10,278,329,607
19857,2013-04-14,11,334,382,716
19858,2013-04-14,12,441,438,879
19859,2013-04-14,13,465,429,894
19860,2013-04-14,14,541,372,913
19861,2013-04-14,15,535,439,974
19862,2013-04-14,16,419,468,887
19863,2013-04-14,17,345,431,776
19864,2013-04-14,18,199,336,535
19865,2013-04-14,19,168,295,463
19866,2013-04-14,20,88,215,303
19867,2013-04-14,21,59,142,201
19868,2013-04-14,22,42,111,153
19869,2013-04-14,23,28,80,108
19870,2013-04-15,0,9,27,36
19871,2013-04-15,1,4,7,11
19872,2013-04-15,2,1,4,5
19873,2013-04-15,3,2,3,5
19874,2013-04-15,4,1,6,7
19875,2013-04-15,5,1,42,43
19876,2013-04-15,6,11,97,108
19877,2013-04-15,7,10,312,322
19878,2013-04-15,8,28,646,674
19879,2013-04-15,9,53,323,376
19880,2013-04-15,10,61,132,193
19881,2013-04-15,11,100,162,262
19882,2013-04-15,12,100,230,330
19883,2013-04-15,13,87,219,306
19884,2013-04-15,14,144,193,337
19885,2013-04-15,15,118,207,325
19886,2013-04-15,16,133,372,505
19887,2013-04-15,17,108,757,865
19888,2013-04-15,18,85,676,761
19889,2013-04-15,19,66,494,560
19890,2013-04-15,20,48,289,337
19891,2013-04-15,21,67,229,296
19892,2013-04-15,22,31,127,158
19893,2013-04-15,23,20,65,85
19894,2013-04-16,0,2,31,33
19895,2013-04-16,1,2,5,7
19896,2013-04-16,2,4,5,9
19897,2013-04-16,3,0,5,5
19898,2013-04-16,4,3,7,10
19899,2013-04-16,5,1,34,35
19900,2013-04-16,6,3,180,183
19901,2013-04-16,7,34,485,519
19902,2013-04-16,8,27,753,780
19903,2013-04-16,9,51,298,349
19904,2013-04-16,10,50,172,222
19905,2013-04-16,11,101,172,273
19906,2013-04-16,12,106,271,377
19907,2013-04-16,13,117,292,409
19908,2013-04-16,14,151,216,367
19909,2013-04-16,15,143,257,400
19910,2013-04-16,16,142,412,554
19911,2013-04-16,17,159,821,980
19912,2013-04-16,18,140,799,939
19913,2013-04-16,19,99,546,645
19914,2013-04-16,20,65,358,423
19915,2013-04-16,21,50,309,359
19916,2013-04-16,22,41,206,247
19917,2013-04-16,23,28,94,122
19918,2013-04-17,0,1,28,29
19919,2013-04-17,1,0,24,24
19920,2013-04-17,2,1,11,12
19921,2013-04-17,3,3,3,6
19922,2013-04-17,4,1,3,4
19923,2013-04-17,5,5,54,59
19924,2013-04-17,6,10,166,176
19925,2013-04-17,7,38,558,596
19926,2013-04-17,8,37,827,864
19927,2013-04-17,9,58,372,430
19928,2013-04-17,10,80,164,244
19929,2013-04-17,11,108,191,299
19930,2013-04-17,12,87,283,370
19931,2013-04-17,13,99,250,349
19932,2013-04-17,14,120,220,340
19933,2013-04-17,15,114,239,353
19934,2013-04-17,16,108,424,532
19935,2013-04-17,17,126,895,1021
19936,2013-04-17,18,125,844,969
19937,2013-04-17,19,102,576,678
19938,2013-04-17,20,56,373,429
19939,2013-04-17,21,38,290,328
19940,2013-04-17,22,30,194,224
19941,2013-04-17,23,16,125,141
19942,2013-04-18,0,5,47,52
19943,2013-04-18,1,1,15,16
19944,2013-04-18,2,6,5,11
19945,2013-04-18,3,3,7,10
19946,2013-04-18,4,0,8,8
19947,2013-04-18,5,1,45,46
19948,2013-04-18,6,7,161,168
19949,2013-04-18,7,27,364,391
19950,2013-04-18,8,34,675,709
19951,2013-04-18,9,25,259,284
19952,2013-04-18,10,46,137,183
19953,2013-04-18,11,47,144,191
19954,2013-04-18,12,77,218,295
19955,2013-04-18,13,91,220,311
19956,2013-04-18,14,86,224,310
19957,2013-04-18,15,98,258,356
19958,2013-04-18,16,108,416,524
19959,2013-04-18,17,107,863,970
19960,2013-04-18,18,116,817,933
19961,2013-04-18,19,106,518,624
19962,2013-04-18,20,71,418,489
19963,2013-04-18,21,55,310,365
19964,2013-04-18,22,50,219,269
19965,2013-04-18,23,24,145,169
19966,2013-04-19,0,14,73,87
19967,2013-04-19,1,1,26,27
19968,2013-04-19,2,1,15,16
19969,2013-04-19,3,0,10,10
19970,2013-04-19,4,0,5,5
19971,2013-04-19,5,1,47,48
19972,2013-04-19,6,7,117,124
19973,2013-04-19,7,15,315,330
19974,2013-04-19,8,40,785,825
19975,2013-04-19,9,48,395,443
19976,2013-04-19,10,71,194,265
19977,2013-04-19,11,113,215,328
19978,2013-04-19,12,100,296,396
19979,2013-04-19,13,107,287,394
19980,2013-04-19,14,122,229,351
19981,2013-04-19,15,108,289,397
19982,2013-04-19,16,118,407,525
19983,2013-04-19,17,113,640,753
19984,2013-04-19,18,76,474,550
19985,2013-04-19,19,8,88,96
19986,2013-04-19,20,17,65,82
19987,2013-04-19,21,1,22,23
19988,2013-04-19,22,1,26,27
19989,2013-04-19,23,0,15,15
19990,2013-04-20,0,0,49,49
19991,2013-04-20,1,4,34,38
19992,2013-04-20,2,2,32,34
19993,2013-04-20,3,0,11,11
19994,2013-04-20,4,1,8,9
19995,2013-04-20,5,1,12,13
19996,2013-04-20,6,10,23,33
19997,2013-04-20,7,20,75,95
19998,2013-04-20,8,36,184,220
19999,2013-04-20,9,67,235,302
20000,2013-04-20,10,190,314,504
20001,2013-04-20,11,192,386,578
20002,2013-04-20,12,276,434,710
20003,2013-04-20,13,335,437,772
20004,2013-04-20,14,420,432,852
20005,2013-04-20,15,425,490,915
20006,2013-04-20,16,349,451,800
20007,2013-04-20,17,387,405,792
20008,2013-04-20,18,277,387,664
20009,2013-04-20,19,170,297,467
20010,2013-04-20,20,114,249,363
20011,2013-04-20,21,54,189,243
20012,2013-04-20,22,50,132,182
20013,2013-04-20,23,30,114,144
20014,2013-04-21,0,12,96,108
20015,2013-04-21,1,19,85,104
20016,2013-04-21,2,20,57,77
20017,2013-04-21,3,11,28,39
20018,2013-04-21,4,2,5,7
20019,2013-04-21,5,0,10,10
20020,2013-04-21,6,4,13,17
20021,2013-04-21,7,5,40,45
20022,2013-04-21,8,33,111,144
20023,2013-04-21,9,88,182,270
20024,2013-04-21,10,165,269,434
20025,2013-04-21,11,198,336,534
20026,2013-04-21,12,272,388,660
20027,2013-04-21,13,239,401,640
20028,2013-04-21,14,289,445,734
20029,2013-04-21,15,319,440,759
20030,2013-04-21,16,265,425,690
20031,2013-04-21,17,207,378,585
20032,2013-04-21,18,150,353,503
20033,2013-04-21,19,98,285,383
20034,2013-04-21,20,52,185,237
20035,2013-04-21,21,26,125,151
20036,2013-04-21,22,23,104,127
20037,2013-04-21,23,13,57,70
20038,2013-04-22,0,7,22,29
20039,2013-04-22,1,2,10,12
20040,2013-04-22,2,0,7,7
20041,2013-04-22,3,1,2,3
20042,2013-04-22,4,0,3,3
20043,2013-04-22,5,1,34,35
20044,2013-04-22,6,0,130,130
20045,2013-04-22,7,13,418,431
20046,2013-04-22,8,40,784,824
20047,2013-04-22,9,36,296,332
20048,2013-04-22,10,62,141,203
20049,2013-04-22,11,61,154,215
20050,2013-04-22,12,71,226,297
20051,2013-04-22,13,78,202,280
20052,2013-04-22,14,69,181,250
20053,2013-04-22,15,62,217,279
20054,2013-04-22,16,45,418,463
20055,2013-04-22,17,55,799,854
20056,2013-04-22,18,65,785,850
20057,2013-04-22,19,38,438,476
20058,2013-04-22,20,24,291,315
20059,2013-04-22,21,20,208,228
20060,2013-04-22,22,19,142,161
20061,2013-04-22,23,10,50,60
20062,2013-04-23,0,3,20,23
20063,2013-04-23,1,0,8,8
20064,2013-04-23,2,0,3,3
20065,2013-04-23,3,0,4,4
20066,2013-04-23,4,0,9,9
20067,2013-04-23,5,2,34,36
20068,2013-04-23,6,3,142,145
20069,2013-04-23,7,13,493,506
20070,2013-04-23,8,29,778,807
20071,2013-04-23,9,24,307,331
20072,2013-04-23,10,35,144,179
20073,2013-04-23,11,51,163,214
20074,2013-04-23,12,60,229,289
20075,2013-04-23,13,53,258,311
20076,2013-04-23,14,89,207,296
20077,2013-04-23,15,92,226,318
20078,2013-04-23,16,69,417,486
20079,2013-04-23,17,110,821,931
20080,2013-04-23,18,115,814,929
20081,2013-04-23,19,84,515,599
20082,2013-04-23,20,43,355,398
20083,2013-04-23,21,45,264,309
20084,2013-04-23,22,21,199,220
20085,2013-04-23,23,5,78,83
20086,2013-04-24,0,7,41,48
20087,2013-04-24,1,2,12,14
20088,2013-04-24,2,3,4,7
20089,2013-04-24,3,1,6,7
20090,2013-04-24,4,1,4,5
20091,2013-04-24,5,2,45,47
20092,2013-04-24,6,2,165,167
20093,2013-04-24,7,25,527,552
20094,2013-04-24,8,37,842,879
20095,2013-04-24,9,49,378,427
20096,2013-04-24,10,85,161,246
20097,2013-04-24,11,72,211,283
20098,2013-04-24,12,100,290,390
20099,2013-04-24,13,110,294,404
20100,2013-04-24,14,120,243,363
20101,2013-04-24,15,125,247,372
20102,2013-04-24,16,120,442,562
20103,2013-04-24,17,102,866,968
20104,2013-04-24,18,107,813,920
20105,2013-04-24,19,82,561,643
20106,2013-04-24,20,70,391,461
20107,2013-04-24,21,38,265,303
20108,2013-04-24,22,38,214,252
20109,2013-04-24,23,8,132,140
20110,2013-04-25,0,6,40,46
20111,2013-04-25,1,1,21,22
20112,2013-04-25,2,1,5,6
20113,2013-04-25,3,3,6,9
20114,2013-04-25,4,3,3,6
20115,2013-04-25,5,2,37,39
20116,2013-04-25,6,5,155,160
20117,2013-04-25,7,20,482,502
20118,2013-04-25,8,45,767,812
20119,2013-04-25,9,60,317,377
20120,2013-04-25,10,67,173,240
20121,2013-04-25,11,79,188,267
20122,2013-04-25,12,76,304,380
20123,2013-04-25,13,78,267,345
20124,2013-04-25,14,115,230,345
20125,2013-04-25,15,102,288,390
20126,2013-04-25,16,96,421,517
20127,2013-04-25,17,179,867,1046
20128,2013-04-25,18,140,810,950
20129,2013-04-25,19,84,531,615
20130,2013-04-25,20,66,343,409
20131,2013-04-25,21,47,339,386
20132,2013-04-25,22,46,200,246
20133,2013-04-25,23,28,118,146
20134,2013-04-26,0,23,55,78
20135,2013-04-26,1,8,33,41
20136,2013-04-26,2,8,21,29
20137,2013-04-26,3,0,11,11
20138,2013-04-26,4,1,10,11
20139,2013-04-26,5,3,36,39
20140,2013-04-26,6,2,145,147
20141,2013-04-26,7,20,460,480
20142,2013-04-26,8,36,748,784
20143,2013-04-26,9,52,381,433
20144,2013-04-26,10,69,166,235
20145,2013-04-26,11,107,256,363
20146,2013-04-26,12,122,334,456
20147,2013-04-26,13,182,343,525
20148,2013-04-26,14,162,318,480
20149,2013-04-26,15,185,379,564
20150,2013-04-26,16,181,515,696
20151,2013-04-26,17,180,845,1025
20152,2013-04-26,18,142,740,882
20153,2013-04-26,19,109,442,551
20154,2013-04-26,20,86,284,370
20155,2013-04-26,21,81,281,362
20156,2013-04-26,22,50,197,247
20157,2013-04-26,23,34,152,186
20158,2013-04-27,0,20,114,134
20159,2013-04-27,1,22,93,115
20160,2013-04-27,2,17,53,70
20161,2013-04-27,3,10,23,33
20162,2013-04-27,4,2,8,10
20163,2013-04-27,5,6,2,8
20164,2013-04-27,6,19,29,48
20165,2013-04-27,7,27,82,109
20166,2013-04-27,8,39,171,210
20167,2013-04-27,9,151,284,435
20168,2013-04-27,10,294,360,654
20169,2013-04-27,11,402,416,818
20170,2013-04-27,12,458,500,958
20171,2013-04-27,13,511,455,966
20172,2013-04-27,14,519,420,939
20173,2013-04-27,15,483,416,899
20174,2013-04-27,16,523,446,969
20175,2013-04-27,17,421,392,813
20176,2013-04-27,18,350,435,785
20177,2013-04-27,19,270,353,623
20178,2013-04-27,20,139,255,394
20179,2013-04-27,21,115,220,335
20180,2013-04-27,22,79,197,276
20181,2013-04-27,23,69,149,218
20182,2013-04-28,0,38,117,155
20183,2013-04-28,1,21,83,104
20184,2013-04-28,2,14,80,94
20185,2013-04-28,3,6,28,34
20186,2013-04-28,4,5,11,16
20187,2013-04-28,5,13,10,23
20188,2013-04-28,6,63,25,88
20189,2013-04-28,7,147,80,227
20190,2013-04-28,8,146,197,343
20191,2013-04-28,9,158,205,363
20192,2013-04-28,10,266,344,610
20193,2013-04-28,11,341,358,699
20194,2013-04-28,12,441,430,871
20195,2013-04-28,13,344,387,731
20196,2013-04-28,14,297,370,667
20197,2013-04-28,15,152,240,392
20198,2013-04-28,16,203,271,474
20199,2013-04-28,17,210,340,550
20200,2013-04-28,18,158,307,465
20201,2013-04-28,19,128,221,349
20202,2013-04-28,20,68,144,212
20203,2013-04-28,21,67,130,197
20204,2013-04-28,22,33,87,120
20205,2013-04-28,23,16,49,65
20206,2013-04-29,0,7,28,35
20207,2013-04-29,1,2,15,17
20208,2013-04-29,2,0,6,6
20209,2013-04-29,3,0,2,2
20210,2013-04-29,4,2,3,5
20211,2013-04-29,5,0,19,19
20212,2013-04-29,6,1,61,62
20213,2013-04-29,7,2,148,150
20214,2013-04-29,8,20,216,236
20215,2013-04-29,9,27,208,235
20216,2013-04-29,10,19,58,77
20217,2013-04-29,11,18,47,65
20218,2013-04-29,12,16,97,113
20219,2013-04-29,13,20,99,119
20220,2013-04-29,14,28,91,119
20221,2013-04-29,15,25,137,162
20222,2013-04-29,16,48,278,326
20223,2013-04-29,17,59,578,637
20224,2013-04-29,18,67,589,656
20225,2013-04-29,19,44,453,497
20226,2013-04-29,20,26,291,317
20227,2013-04-29,21,25,196,221
20228,2013-04-29,22,11,114,125
20229,2013-04-29,23,13,74,87
20230,2013-04-30,0,2,31,33
20231,2013-04-30,1,0,6,6
20232,2013-04-30,2,0,5,5
20233,2013-04-30,3,2,0,2
20234,2013-04-30,4,2,5,7
20235,2013-04-30,5,2,34,36
20236,2013-04-30,6,2,136,138
20237,2013-04-30,7,7,301,308
20238,2013-04-30,8,34,592,626
20239,2013-04-30,9,45,282,327
20240,2013-04-30,10,30,114,144
20241,2013-04-30,11,36,149,185
20242,2013-04-30,12,25,100,125
20243,2013-04-30,13,57,105,162
20244,2013-04-30,14,47,125,172
20245,2013-04-30,15,38,165,203
20246,2013-04-30,16,30,234,264
20247,2013-04-30,17,61,461,522
20248,2013-04-30,18,41,590,631
20249,2013-04-30,19,54,464,518
20250,2013-04-30,20,37,354,391
20251,2013-04-30,21,31,246,277
20252,2013-04-30,22,10,184,194
20253,2013-04-30,23,10,72,82
20254,2013-05-01,0,7,43,50
20255,2013-05-01,1,5,20,25
20256,2013-05-01,2,0,4,4
20257,2013-05-01,3,0,4,4
20258,2013-05-01,4,1,9,10
20259,2013-05-01,5,4,40,44
20260,2013-05-01,6,6,171,177
20261,2013-05-01,7,23,556,579
20262,2013-05-01,8,31,860,891
20263,2013-05-01,9,39,367,406
20264,2013-05-01,10,69,176,245
20265,2013-05-01,11,84,210,294
20266,2013-05-01,12,76,329,405
20267,2013-05-01,13,86,272,358
20268,2013-05-01,14,74,220,294
20269,2013-05-01,15,108,261,369
20270,2013-05-01,16,86,420,506
20271,2013-05-01,17,123,970,1093
20272,2013-05-01,18,133,841,974
20273,2013-05-01,19,104,620,724
20274,2013-05-01,20,50,402,452
20275,2013-05-01,21,48,309,357
20276,2013-05-01,22,22,183,205
20277,2013-05-01,23,18,123,141
20278,2013-05-02,0,6,45,51
20279,2013-05-02,1,2,14,16
20280,2013-05-02,2,2,10,12
20281,2013-05-02,3,0,2,2
20282,2013-05-02,4,1,7,8
20283,2013-05-02,5,6,39,45
20284,2013-05-02,6,10,158,168
20285,2013-05-02,7,21,503,524
20286,2013-05-02,8,34,754,788
20287,2013-05-02,9,41,349,390
20288,2013-05-02,10,69,178,247
20289,2013-05-02,11,70,228,298
20290,2013-05-02,12,106,289,395
20291,2013-05-02,13,92,254,346
20292,2013-05-02,14,112,226,338
20293,2013-05-02,15,115,243,358
20294,2013-05-02,16,103,438,541
20295,2013-05-02,17,144,958,1102
20296,2013-05-02,18,137,847,984
20297,2013-05-02,19,87,550,637
20298,2013-05-02,20,55,364,419
20299,2013-05-02,21,49,307,356
20300,2013-05-02,22,44,236,280
20301,2013-05-02,23,17,168,185
20302,2013-05-03,0,21,59,80
20303,2013-05-03,1,3,29,32
20304,2013-05-03,2,8,8,16
20305,2013-05-03,3,0,6,6
20306,2013-05-03,4,2,4,6
20307,2013-05-03,5,7,45,52
20308,2013-05-03,6,6,161,167
20309,2013-05-03,7,26,435,461
20310,2013-05-03,8,29,823,852
20311,2013-05-03,9,62,378,440
20312,2013-05-03,10,78,209,287
20313,2013-05-03,11,152,231,383
20314,2013-05-03,12,133,311,444
20315,2013-05-03,13,127,322,449
20316,2013-05-03,14,172,262,434
20317,2013-05-03,15,159,308,467
20318,2013-05-03,16,166,505,671
20319,2013-05-03,17,193,853,1046
20320,2013-05-03,18,168,692,860
20321,2013-05-03,19,110,433,543
20322,2013-05-03,20,53,288,341
20323,2013-05-03,21,35,219,254
20324,2013-05-03,22,35,173,208
20325,2013-05-03,23,29,127,156
20326,2013-05-04,0,24,113,137
20327,2013-05-04,1,7,80,87
20328,2013-05-04,2,7,40,47
20329,2013-05-04,3,8,15,23
20330,2013-05-04,4,1,3,4
20331,2013-05-04,5,3,11,14
20332,2013-05-04,6,12,21,33
20333,2013-05-04,7,18,89,107
20334,2013-05-04,8,44,176,220
20335,2013-05-04,9,115,308,423
20336,2013-05-04,10,213,364,577
20337,2013-05-04,11,230,444,674
20338,2013-05-04,12,312,518,830
20339,2013-05-04,13,373,493,866
20340,2013-05-04,14,362,410,772
20341,2013-05-04,15,384,470,854
20342,2013-05-04,16,353,453,806
20343,2013-05-04,17,383,434,817
20344,2013-05-04,18,237,346,583
20345,2013-05-04,19,243,324,567
20346,2013-05-04,20,117,218,335
20347,2013-05-04,21,93,192,285
20348,2013-05-04,22,61,163,224
20349,2013-05-04,23,50,135,185
20350,2013-05-05,0,14,142,156
20351,2013-05-05,1,13,87,100
20352,2013-05-05,2,4,53,57
20353,2013-05-05,3,6,31,37
20354,2013-05-05,4,5,7,12
20355,2013-05-05,5,4,5,9
20356,2013-05-05,6,11,23,34
20357,2013-05-05,7,20,48,68
20358,2013-05-05,8,47,117,164
20359,2013-05-05,9,78,189,267
20360,2013-05-05,10,195,293,488
20361,2013-05-05,11,211,346,557
20362,2013-05-05,12,280,393,673
20363,2013-05-05,13,280,431,711
20364,2013-05-05,14,359,406,765
20365,2013-05-05,15,278,420,698
20366,2013-05-05,16,322,441,763
20367,2013-05-05,17,241,459,700
20368,2013-05-05,18,205,367,572
20369,2013-05-05,19,125,287,412
20370,2013-05-05,20,89,208,297
20371,2013-05-05,21,74,141,215
20372,2013-05-05,22,37,102,139
20373,2013-05-05,23,32,57,89
20374,2013-05-06,0,4,32,36
20375,2013-05-06,1,2,14,16
20376,2013-05-06,2,0,6,6
20377,2013-05-06,3,1,5,6
20378,2013-05-06,4,5,6,11
20379,2013-05-06,5,5,39,44
20380,2013-05-06,6,9,141,150
20381,2013-05-06,7,22,439,461
20382,2013-05-06,8,37,687,724
20383,2013-05-06,9,36,281,317
20384,2013-05-06,10,51,117,168
20385,2013-05-06,11,72,153,225
20386,2013-05-06,12,94,202,296
20387,2013-05-06,13,97,199,296
20388,2013-05-06,14,80,173,253
20389,2013-05-06,15,96,199,295
20390,2013-05-06,16,88,401,489
20391,2013-05-06,17,113,741,854
20392,2013-05-06,18,76,535,611
20393,2013-05-06,19,53,394,447
20394,2013-05-06,20,43,291,334
20395,2013-05-06,21,34,191,225
20396,2013-05-06,22,25,126,151
20397,2013-05-06,23,22,68,90
20398,2013-05-07,0,10,38,48
20399,2013-05-07,1,4,9,13
20400,2013-05-07,2,1,14,15
20401,2013-05-07,3,1,3,4
20402,2013-05-07,4,3,3,6
20403,2013-05-07,5,3,31,34
20404,2013-05-07,6,5,132,137
20405,2013-05-07,7,13,416,429
20406,2013-05-07,8,17,481,498
20407,2013-05-07,9,10,101,111
20408,2013-05-07,10,6,39,45
20409,2013-05-07,11,9,39,48
20410,2013-05-07,12,14,67,81
20411,2013-05-07,13,22,97,119
20412,2013-05-07,14,16,67,83
20413,2013-05-07,15,21,77,98
20414,2013-05-07,16,11,212,223
20415,2013-05-07,17,36,577,613
20416,2013-05-07,18,45,591,636
20417,2013-05-07,19,43,404,447
20418,2013-05-07,20,16,293,309
20419,2013-05-07,21,17,199,216
20420,2013-05-07,22,14,103,117
20421,2013-05-07,23,7,82,89
20422,2013-05-08,0,4,36,40
20423,2013-05-08,1,4,18,22
20424,2013-05-08,2,6,9,15
20425,2013-05-08,3,1,3,4
20426,2013-05-08,4,3,6,9
20427,2013-05-08,5,5,50,55
20428,2013-05-08,6,12,159,171
20429,2013-05-08,7,17,492,509
20430,2013-05-08,8,33,828,861
20431,2013-05-08,9,37,351,388
20432,2013-05-08,10,59,158,217
20433,2013-05-08,11,44,183,227
20434,2013-05-08,12,90,297,387
20435,2013-05-08,13,67,248,315
20436,2013-05-08,14,96,231,327
20437,2013-05-08,15,89,292,381
20438,2013-05-08,16,37,287,324
20439,2013-05-08,17,49,414,463
20440,2013-05-08,18,37,442,479
20441,2013-05-08,19,33,343,376
20442,2013-05-08,20,29,333,362
20443,2013-05-08,21,21,252,273
20444,2013-05-08,22,30,214,244
20445,2013-05-08,23,18,119,137
20446,2013-05-09,0,5,36,41
20447,2013-05-09,1,7,27,34
20448,2013-05-09,2,4,10,14
20449,2013-05-09,3,2,5,7
20450,2013-05-09,4,0,8,8
20451,2013-05-09,5,5,38,43
20452,2013-05-09,6,11,171,182
20453,2013-05-09,7,33,526,559
20454,2013-05-09,8,28,844,872
20455,2013-05-09,9,33,371,404
20456,2013-05-09,10,50,172,222
20457,2013-05-09,11,57,201,258
20458,2013-05-09,12,78,256,334
20459,2013-05-09,13,108,270,378
20460,2013-05-09,14,89,218,307
20461,2013-05-09,15,88,296,384
20462,2013-05-09,16,95,322,417
20463,2013-05-09,17,97,738,835
20464,2013-05-09,18,114,857,971
20465,2013-05-09,19,109,528,637
20466,2013-05-09,20,39,234,273
20467,2013-05-09,21,35,236,271
20468,2013-05-09,22,17,177,194
20469,2013-05-09,23,18,130,148
20470,2013-05-10,0,10,74,84
20471,2013-05-10,1,6,39,45
20472,2013-05-10,2,7,24,31
20473,2013-05-10,3,4,7,11
20474,2013-05-10,4,1,6,7
20475,2013-05-10,5,3,47,50
20476,2013-05-10,6,10,158,168
20477,2013-05-10,7,18,453,471
20478,2013-05-10,8,33,738,771
20479,2013-05-10,9,81,434,515
20480,2013-05-10,10,97,201,298
20481,2013-05-10,11,168,240,408
20482,2013-05-10,12,168,312,480
20483,2013-05-10,13,184,314,498
20484,2013-05-10,14,127,271,398
20485,2013-05-10,15,184,316,500
20486,2013-05-10,16,192,516,708
20487,2013-05-10,17,187,803,990
20488,2013-05-10,18,161,720,881
20489,2013-05-10,19,135,445,580
20490,2013-05-10,20,88,306,394
20491,2013-05-10,21,91,256,347
20492,2013-05-10,22,17,140,157
20493,2013-05-10,23,7,71,78
20494,2013-05-11,0,15,73,88
20495,2013-05-11,1,10,58,68
20496,2013-05-11,2,7,51,58
20497,2013-05-11,3,2,23,25
20498,2013-05-11,4,1,3,4
20499,2013-05-11,5,2,8,10
20500,2013-05-11,6,5,29,34
20501,2013-05-11,7,12,86,98
20502,2013-05-11,8,34,163,197
20503,2013-05-11,9,59,200,259
20504,2013-05-11,10,91,270,361
20505,2013-05-11,11,152,354,506
20506,2013-05-11,12,230,420,650
20507,2013-05-11,13,262,322,584
20508,2013-05-11,14,238,426,664
20509,2013-05-11,15,146,260,406
20510,2013-05-11,16,192,333,525
20511,2013-05-11,17,199,345,544
20512,2013-05-11,18,168,285,453
20513,2013-05-11,19,171,229,400
20514,2013-05-11,20,38,94,132
20515,2013-05-11,21,7,59,66
20516,2013-05-11,22,30,138,168
20517,2013-05-11,23,28,126,154
20518,2013-05-12,0,21,100,121
20519,2013-05-12,1,14,84,98
20520,2013-05-12,2,16,51,67
20521,2013-05-12,3,11,22,33
20522,2013-05-12,4,7,10,17
20523,2013-05-12,5,4,6,10
20524,2013-05-12,6,5,14,19
20525,2013-05-12,7,32,44,76
20526,2013-05-12,8,48,128,176
20527,2013-05-12,9,94,220,314
20528,2013-05-12,10,197,291,488
20529,2013-05-12,11,244,409,653
20530,2013-05-12,12,331,396,727
20531,2013-05-12,13,286,469,755
20532,2013-05-12,14,298,410,708
20533,2013-05-12,15,345,380,725
20534,2013-05-12,16,326,382,708
20535,2013-05-12,17,258,406,664
20536,2013-05-12,18,214,372,586
20537,2013-05-12,19,154,248,402
20538,2013-05-12,20,75,201,276
20539,2013-05-12,21,57,122,179
20540,2013-05-12,22,28,96,124
20541,2013-05-12,23,19,64,83
20542,2013-05-13,0,11,38,49
20543,2013-05-13,1,6,11,17
20544,2013-05-13,2,0,7,7
20545,2013-05-13,3,0,7,7
20546,2013-05-13,4,0,3,3
20547,2013-05-13,5,2,45,47
20548,2013-05-13,6,6,143,149
20549,2013-05-13,7,11,470,481
20550,2013-05-13,8,26,784,810
20551,2013-05-13,9,49,309,358
20552,2013-05-13,10,62,142,204
20553,2013-05-13,11,79,158,237
20554,2013-05-13,12,89,247,336
20555,2013-05-13,13,84,225,309
20556,2013-05-13,14,84,178,262
20557,2013-05-13,15,106,228,334
20558,2013-05-13,16,111,395,506
20559,2013-05-13,17,76,847,923
20560,2013-05-13,18,87,768,855
20561,2013-05-13,19,73,500,573
20562,2013-05-13,20,51,296,347
20563,2013-05-13,21,25,254,279
20564,2013-05-13,22,18,178,196
20565,2013-05-13,23,8,84,92
20566,2013-05-14,0,8,37,45
20567,2013-05-14,1,3,14,17
20568,2013-05-14,2,3,5,8
20569,2013-05-14,3,0,4,4
20570,2013-05-14,4,0,6,6
20571,2013-05-14,5,2,38,40
20572,2013-05-14,6,7,167,174
20573,2013-05-14,7,16,497,513
20574,2013-05-14,8,39,865,904
20575,2013-05-14,9,52,343,395
20576,2013-05-14,10,52,175,227
20577,2013-05-14,11,72,192,264
20578,2013-05-14,12,100,265,365
20579,2013-05-14,13,65,281,346
20580,2013-05-14,14,99,229,328
20581,2013-05-14,15,98,248,346
20582,2013-05-14,16,131,412,543
20583,2013-05-14,17,163,853,1016
20584,2013-05-14,18,138,780,918
20585,2013-05-14,19,67,501,568
20586,2013-05-14,20,62,388,450
20587,2013-05-14,21,31,255,286
20588,2013-05-14,22,39,153,192
20589,2013-05-14,23,17,89,106
20590,2013-05-15,0,14,44,58
20591,2013-05-15,1,3,20,23
20592,2013-05-15,2,1,8,9
20593,2013-05-15,3,3,2,5
20594,2013-05-15,4,0,9,9
20595,2013-05-15,5,3,39,42
20596,2013-05-15,6,15,186,201
20597,2013-05-15,7,15,540,555
20598,2013-05-15,8,32,872,904
20599,2013-05-15,9,35,319,354
20600,2013-05-15,10,64,151,215
20601,2013-05-15,11,67,199,266
20602,2013-05-15,12,76,280,356
20603,2013-05-15,13,87,278,365
20604,2013-05-15,14,119,252,371
20605,2013-05-15,15,100,265,365
20606,2013-05-15,16,116,430,546
20607,2013-05-15,17,131,923,1054
20608,2013-05-15,18,151,848,999
20609,2013-05-15,19,94,598,692
20610,2013-05-15,20,76,420,496
20611,2013-05-15,21,51,360,411
20612,2013-05-15,22,40,250,290
20613,2013-05-15,23,28,141,169
20614,2013-05-16,0,19,64,83
20615,2013-05-16,1,7,49,56
20616,2013-05-16,2,15,22,37
20617,2013-05-16,3,0,5,5
20618,2013-05-16,4,2,6,8
20619,2013-05-16,5,2,43,45
20620,2013-05-16,6,14,190,204
20621,2013-05-16,7,23,557,580
20622,2013-05-16,8,49,792,841
20623,2013-05-16,9,51,355,406
20624,2013-05-16,10,57,151,208
20625,2013-05-16,11,96,203,299
20626,2013-05-16,12,106,279,385
20627,2013-05-16,13,91,239,330
20628,2013-05-16,14,150,240,390
20629,2013-05-16,15,111,271,382
20630,2013-05-16,16,119,402,521
20631,2013-05-16,17,142,871,1013
20632,2013-05-16,18,164,891,1055
20633,2013-05-16,19,112,545,657
20634,2013-05-16,20,77,469,546
20635,2013-05-16,21,56,327,383
20636,2013-05-16,22,37,242,279
20637,2013-05-16,23,22,159,181
20638,2013-05-17,0,32,93,125
20639,2013-05-17,1,13,54,67
20640,2013-05-17,2,2,22,24
20641,2013-05-17,3,0,10,10
20642,2013-05-17,4,4,10,14
20643,2013-05-17,5,8,43,51
20644,2013-05-17,6,16,192,208
20645,2013-05-17,7,56,624,680
20646,2013-05-17,8,57,808,865
20647,2013-05-17,9,104,343,447
20648,2013-05-17,10,146,191,337
20649,2013-05-17,11,153,252,405
20650,2013-05-17,12,198,311,509
20651,2013-05-17,13,207,318,525
20652,2013-05-17,14,204,319,523
20653,2013-05-17,15,220,384,604
20654,2013-05-17,16,231,524,755
20655,2013-05-17,17,201,843,1044
20656,2013-05-17,18,156,698,854
20657,2013-05-17,19,156,448,604
20658,2013-05-17,20,136,309,445
20659,2013-05-17,21,95,271,366
20660,2013-05-17,22,95,257,352
20661,2013-05-17,23,53,179,232
20662,2013-05-18,0,38,149,187
20663,2013-05-18,1,19,122,141
20664,2013-05-18,2,15,64,79
20665,2013-05-18,3,11,30,41
20666,2013-05-18,4,4,10,14
20667,2013-05-18,5,8,9,17
20668,2013-05-18,6,10,43,53
20669,2013-05-18,7,17,87,104
20670,2013-05-18,8,55,144,199
20671,2013-05-18,9,72,234,306
20672,2013-05-18,10,168,319,487
20673,2013-05-18,11,130,273,403
20674,2013-05-18,12,55,163,218
20675,2013-05-18,13,174,274,448
20676,2013-05-18,14,197,270,467
20677,2013-05-18,15,151,282,433
20678,2013-05-18,16,174,307,481
20679,2013-05-18,17,145,333,478
20680,2013-05-18,18,124,333,457
20681,2013-05-18,19,104,263,367
20682,2013-05-18,20,68,230,298
20683,2013-05-18,21,75,173,248
20684,2013-05-18,22,58,129,187
20685,2013-05-18,23,53,165,218
20686,2013-05-19,0,26,108,134
20687,2013-05-19,1,17,97,114
20688,2013-05-19,2,10,53,63
20689,2013-05-19,3,8,22,30
20690,2013-05-19,4,2,13,15
20691,2013-05-19,5,9,4,13
20692,2013-05-19,6,6,26,32
20693,2013-05-19,7,8,62,70
20694,2013-05-19,8,30,113,143
20695,2013-05-19,9,33,130,163
20696,2013-05-19,10,93,185,278
20697,2013-05-19,11,120,284,404
20698,2013-05-19,12,154,347,501
20699,2013-05-19,13,178,381,559
20700,2013-05-19,14,163,391,554
20701,2013-05-19,15,215,425,640
20702,2013-05-19,16,230,405,635
20703,2013-05-19,17,243,362,605
20704,2013-05-19,18,210,382,592
20705,2013-05-19,19,123,289,412
20706,2013-05-19,20,67,171,238
20707,2013-05-19,21,51,153,204
20708,2013-05-19,22,55,112,167
20709,2013-05-19,23,26,82,108
20710,2013-05-20,0,11,33,44
20711,2013-05-20,1,5,8,13
20712,2013-05-20,2,3,6,9
20713,2013-05-20,3,2,5,7
20714,2013-05-20,4,1,6,7
20715,2013-05-20,5,1,44,45
20716,2013-05-20,6,8,176,184
20717,2013-05-20,7,25,504,529
20718,2013-05-20,8,45,746,791
20719,2013-05-20,9,48,312,360
20720,2013-05-20,10,82,152,234
20721,2013-05-20,11,105,191,296
20722,2013-05-20,12,115,248,363
20723,2013-05-20,13,134,222,356
20724,2013-05-20,14,153,172,325
20725,2013-05-20,15,110,219,329
20726,2013-05-20,16,139,377,516
20727,2013-05-20,17,158,917,1075
20728,2013-05-20,18,134,815,949
20729,2013-05-20,19,124,613,737
20730,2013-05-20,20,101,447,548
20731,2013-05-20,21,60,282,342
20732,2013-05-20,22,33,181,214
20733,2013-05-20,23,27,82,109
20734,2013-05-21,0,29,34,63
20735,2013-05-21,1,6,20,26
20736,2013-05-21,2,6,5,11
20737,2013-05-21,3,4,8,12
20738,2013-05-21,4,6,11,17
20739,2013-05-21,5,4,48,52
20740,2013-05-21,6,10,189,199
20741,2013-05-21,7,28,604,632
20742,2013-05-21,8,47,797,844
20743,2013-05-21,9,51,343,394
20744,2013-05-21,10,86,153,239
20745,2013-05-21,11,104,197,301
20746,2013-05-21,12,95,240,335
20747,2013-05-21,13,104,244,348
20748,2013-05-21,14,135,237,372
20749,2013-05-21,15,125,258,383
20750,2013-05-21,16,106,422,528
20751,2013-05-21,17,182,900,1082
20752,2013-05-21,18,160,908,1068
20753,2013-05-21,19,121,638,759
20754,2013-05-21,20,104,477,581
20755,2013-05-21,21,67,322,389
20756,2013-05-21,22,44,226,270
20757,2013-05-21,23,24,113,137
20758,2013-05-22,0,11,50,61
20759,2013-05-22,1,4,33,37
20760,2013-05-22,2,1,10,11
20761,2013-05-22,3,5,4,9
20762,2013-05-22,4,3,8,11
20763,2013-05-22,5,0,57,57
20764,2013-05-22,6,17,188,205
20765,2013-05-22,7,36,574,610
20766,2013-05-22,8,36,769,805
20767,2013-05-22,9,43,401,444
20768,2013-05-22,10,74,149,223
20769,2013-05-22,11,83,200,283
20770,2013-05-22,12,75,291,366
20771,2013-05-22,13,107,247,354
20772,2013-05-22,14,98,222,320
20773,2013-05-22,15,134,281,415
20774,2013-05-22,16,120,441,561
20775,2013-05-22,17,142,901,1043
20776,2013-05-22,18,122,898,1020
20777,2013-05-22,19,98,626,724
20778,2013-05-22,20,79,474,553
20779,2013-05-22,21,53,294,347
20780,2013-05-22,22,48,257,305
20781,2013-05-22,23,12,119,131
20782,2013-05-23,0,14,57,71
20783,2013-05-23,1,6,21,27
20784,2013-05-23,2,16,10,26
20785,2013-05-23,3,2,9,11
20786,2013-05-23,4,2,6,8
20787,2013-05-23,5,2,36,38
20788,2013-05-23,6,7,156,163
20789,2013-05-23,7,32,535,567
20790,2013-05-23,8,36,828,864
20791,2013-05-23,9,54,366,420
20792,2013-05-23,10,62,148,210
20793,2013-05-23,11,87,186,273
20794,2013-05-23,12,86,245,331
20795,2013-05-23,13,102,247,349
20796,2013-05-23,14,106,210,316
20797,2013-05-23,15,104,286,390
20798,2013-05-23,16,105,441,546
20799,2013-05-23,17,127,819,946
20800,2013-05-23,18,120,783,903
20801,2013-05-23,19,65,528,593
20802,2013-05-23,20,81,385,466
20803,2013-05-23,21,42,270,312
20804,2013-05-23,22,20,145,165
20805,2013-05-23,23,10,46,56
20806,2013-05-24,0,8,32,40
20807,2013-05-24,1,2,30,32
20808,2013-05-24,2,3,15,18
20809,2013-05-24,3,4,6,10
20810,2013-05-24,4,4,4,8
20811,2013-05-24,5,3,37,40
20812,2013-05-24,6,5,102,107
20813,2013-05-24,7,10,299,309
20814,2013-05-24,8,26,697,723
20815,2013-05-24,9,35,362,397
20816,2013-05-24,10,60,140,200
20817,2013-05-24,11,67,185,252
20818,2013-05-24,12,71,291,362
20819,2013-05-24,13,89,270,359
20820,2013-05-24,14,93,319,412
20821,2013-05-24,15,91,407,498
20822,2013-05-24,16,127,462,589
20823,2013-05-24,17,71,578,649
20824,2013-05-24,18,61,447,508
20825,2013-05-24,19,62,322,384
20826,2013-05-24,20,46,222,268
20827,2013-05-24,21,30,165,195
20828,2013-05-24,22,18,125,143
20829,2013-05-24,23,18,106,124
20830,2013-05-25,0,12,76,88
20831,2013-05-25,1,13,61,74
20832,2013-05-25,2,16,31,47
20833,2013-05-25,3,8,17,25
20834,2013-05-25,4,5,9,14
20835,2013-05-25,5,7,13,20
20836,2013-05-25,6,7,32,39
20837,2013-05-25,7,14,55,69
20838,2013-05-25,8,22,114,136
20839,2013-05-25,9,94,183,277
20840,2013-05-25,10,186,248,434
20841,2013-05-25,11,270,280,550
20842,2013-05-25,12,277,311,588
20843,2013-05-25,13,378,373,751
20844,2013-05-25,14,366,344,710
20845,2013-05-25,15,374,316,690
20846,2013-05-25,16,343,312,655
20847,2013-05-25,17,402,346,748
20848,2013-05-25,18,264,293,557
20849,2013-05-25,19,204,263,467
20850,2013-05-25,20,140,166,306
20851,2013-05-25,21,101,176,277
20852,2013-05-25,22,68,179,247
20853,2013-05-25,23,49,125,174
20854,2013-05-26,0,27,80,107
20855,2013-05-26,1,18,60,78
20856,2013-05-26,2,8,53,61
20857,2013-05-26,3,6,15,21
20858,2013-05-26,4,1,5,6
20859,2013-05-26,5,7,6,13
20860,2013-05-26,6,8,20,28
20861,2013-05-26,7,15,42,57
20862,2013-05-26,8,44,84,128
20863,2013-05-26,9,125,139,264
20864,2013-05-26,10,262,226,488
20865,2013-05-26,11,407,309,716
20866,2013-05-26,12,414,349,763
20867,2013-05-26,13,507,319,826
20868,2013-05-26,14,568,348,916
20869,2013-05-26,15,601,374,975
20870,2013-05-26,16,582,304,886
20871,2013-05-26,17,520,322,842
20872,2013-05-26,18,422,283,705
20873,2013-05-26,19,428,236,664
20874,2013-05-26,20,260,210,470
20875,2013-05-26,21,189,195,384
20876,2013-05-26,22,121,161,282
20877,2013-05-26,23,111,96,207
20878,2013-05-27,0,47,68,115
20879,2013-05-27,1,17,49,66
20880,2013-05-27,2,20,32,52
20881,2013-05-27,3,14,13,27
20882,2013-05-27,4,4,4,8
20883,2013-05-27,5,6,7,13
20884,2013-05-27,6,2,18,20
20885,2013-05-27,7,27,42,69
20886,2013-05-27,8,68,94,162
20887,2013-05-27,9,146,164,310
20888,2013-05-27,10,313,243,556
20889,2013-05-27,11,405,342,747
20890,2013-05-27,12,462,390,852
20891,2013-05-27,13,464,379,843
20892,2013-05-27,14,408,348,756
20893,2013-05-27,15,432,384,816
20894,2013-05-27,16,423,390,813
20895,2013-05-27,17,343,361,704
20896,2013-05-27,18,256,314,570
20897,2013-05-27,19,199,280,479
20898,2013-05-27,20,162,224,386
20899,2013-05-27,21,96,169,265
20900,2013-05-27,22,73,123,196
20901,2013-05-27,23,64,75,139
20902,2013-05-28,0,53,18,71
20903,2013-05-28,1,12,8,20
20904,2013-05-28,2,8,7,15
20905,2013-05-28,3,6,4,10
20906,2013-05-28,4,1,4,5
20907,2013-05-28,5,5,33,38
20908,2013-05-28,6,7,180,187
20909,2013-05-28,7,31,511,542
20910,2013-05-28,8,30,699,729
20911,2013-05-28,9,42,310,352
20912,2013-05-28,10,96,166,262
20913,2013-05-28,11,104,197,301
20914,2013-05-28,12,168,278,446
20915,2013-05-28,13,120,254,374
20916,2013-05-28,14,171,247,418
20917,2013-05-28,15,133,248,381
20918,2013-05-28,16,170,431,601
20919,2013-05-28,17,163,871,1034
20920,2013-05-28,18,94,522,616
20921,2013-05-28,19,46,236,282
20922,2013-05-28,20,49,285,334
20923,2013-05-28,21,35,187,222
20924,2013-05-28,22,30,146,176
20925,2013-05-28,23,13,122,135
20926,2013-05-29,0,14,36,50
20927,2013-05-29,1,21,17,38
20928,2013-05-29,2,7,6,13
20929,2013-05-29,3,13,2,15
20930,2013-05-29,4,0,5,5
20931,2013-05-29,5,2,50,52
20932,2013-05-29,6,4,193,197
20933,2013-05-29,7,23,585,608
20934,2013-05-29,8,38,848,886
20935,2013-05-29,9,65,347,412
20936,2013-05-29,10,112,165,277
20937,2013-05-29,11,119,194,313
20938,2013-05-29,12,132,268,400
20939,2013-05-29,13,117,242,359
20940,2013-05-29,14,125,237,362
20941,2013-05-29,15,138,235,373
20942,2013-05-29,16,110,433,543
20943,2013-05-29,17,124,916,1040
20944,2013-05-29,18,162,926,1088
20945,2013-05-29,19,147,644,791
20946,2013-05-29,20,95,457,552
20947,2013-05-29,21,77,384,461
20948,2013-05-29,22,53,223,276
20949,2013-05-29,23,38,126,164
20950,2013-05-30,0,23,63,86
20951,2013-05-30,1,6,26,32
20952,2013-05-30,2,0,13,13
20953,2013-05-30,3,3,4,7
20954,2013-05-30,4,1,2,3
20955,2013-05-30,5,4,46,50
20956,2013-05-30,6,8,201,209
20957,2013-05-30,7,30,590,620
20958,2013-05-30,8,37,823,860
20959,2013-05-30,9,74,325,399
20960,2013-05-30,10,68,150,218
20961,2013-05-30,11,88,202,290
20962,2013-05-30,12,83,253,336
20963,2013-05-30,13,72,253,325
20964,2013-05-30,14,94,198,292
20965,2013-05-30,15,92,266,358
20966,2013-05-30,16,67,391,458
20967,2013-05-30,17,116,920,1036
20968,2013-05-30,18,109,872,981
20969,2013-05-30,19,143,588,731
20970,2013-05-30,20,88,463,551
20971,2013-05-30,21,77,303,380
20972,2013-05-30,22,45,261,306
20973,2013-05-30,23,38,161,199
20974,2013-05-31,0,26,81,107
20975,2013-05-31,1,15,31,46
20976,2013-05-31,2,7,9,16
20977,2013-05-31,3,2,5,7
20978,2013-05-31,4,1,8,9
20979,2013-05-31,5,1,63,64
20980,2013-05-31,6,6,182,188
20981,2013-05-31,7,23,513,536
20982,2013-05-31,8,51,757,808
20983,2013-05-31,9,77,404,481
20984,2013-05-31,10,89,180,269
20985,2013-05-31,11,98,261,359
20986,2013-05-31,12,128,298,426
20987,2013-05-31,13,125,314,439
20988,2013-05-31,14,130,259,389
20989,2013-05-31,15,156,277,433
20990,2013-05-31,16,130,461,591
20991,2013-05-31,17,161,760,921
20992,2013-05-31,18,172,719,891
20993,2013-05-31,19,127,527,654
20994,2013-05-31,20,89,381,470
20995,2013-05-31,21,89,334,423
20996,2013-05-31,22,73,245,318
20997,2013-05-31,23,59,198,257
20998,2013-06-01,0,38,148,186
20999,2013-06-01,1,22,104,126
21000,2013-06-01,2,14,62,76
21001,2013-06-01,3,10,28,38
21002,2013-06-01,4,5,9,14
21003,2013-06-01,5,7,15,22
21004,2013-06-01,6,11,31,42
21005,2013-06-01,7,24,93,117
21006,2013-06-01,8,61,188,249
21007,2013-06-01,9,108,320,428
21008,2013-06-01,10,177,368,545
21009,2013-06-01,11,274,422,696
21010,2013-06-01,12,293,459,752
21011,2013-06-01,13,303,407,710
21012,2013-06-01,14,326,382,708
21013,2013-06-01,15,295,352,647
21014,2013-06-01,16,332,372,704
21015,2013-06-01,17,308,376,684
21016,2013-06-01,18,245,381,626
21017,2013-06-01,19,272,374,646
21018,2013-06-01,20,178,298,476
21019,2013-06-01,21,144,242,386
21020,2013-06-01,22,112,184,296
21021,2013-06-01,23,98,182,280
21022,2013-06-02,0,55,156,211
21023,2013-06-02,1,30,89,119
21024,2013-06-02,2,42,74,116
21025,2013-06-02,3,21,50,71
21026,2013-06-02,4,8,14,22
21027,2013-06-02,5,10,7,17
21028,2013-06-02,6,6,32,38
21029,2013-06-02,7,19,49,68
21030,2013-06-02,8,51,138,189
21031,2013-06-02,9,155,245,400
21032,2013-06-02,10,245,319,564
21033,2013-06-02,11,353,421,774
21034,2013-06-02,12,295,398,693
21035,2013-06-02,13,292,408,700
21036,2013-06-02,14,262,290,552
21037,2013-06-02,15,233,370,603
21038,2013-06-02,16,274,403,677
21039,2013-06-02,17,281,406,687
21040,2013-06-02,18,115,181,296
21041,2013-06-02,19,66,146,212
21042,2013-06-02,20,71,157,228
21043,2013-06-02,21,52,142,194
21044,2013-06-02,22,45,115,160
21045,2013-06-02,23,16,56,72
21046,2013-06-03,0,12,33,45
21047,2013-06-03,1,2,11,13
21048,2013-06-03,2,0,6,6
21049,2013-06-03,3,1,7,8
21050,2013-06-03,4,3,0,3
21051,2013-06-03,5,0,20,20
21052,2013-06-03,6,2,51,53
21053,2013-06-03,7,6,156,162
21054,2013-06-03,8,20,449,469
21055,2013-06-03,9,36,366,402
21056,2013-06-03,10,60,152,212
21057,2013-06-03,11,94,186,280
21058,2013-06-03,12,107,253,360
21059,2013-06-03,13,135,271,406
21060,2013-06-03,14,112,225,337
21061,2013-06-03,15,135,196,331
21062,2013-06-03,16,72,302,374
21063,2013-06-03,17,123,809,932
21064,2013-06-03,18,125,826,951
21065,2013-06-03,19,103,583,686
21066,2013-06-03,20,97,446,543
21067,2013-06-03,21,70,304,374
21068,2013-06-03,22,84,193,277
21069,2013-06-03,23,42,106,148
21070,2013-06-04,0,20,43,63
21071,2013-06-04,1,11,15,26
21072,2013-06-04,2,5,8,13
21073,2013-06-04,3,1,5,6
21074,2013-06-04,4,1,2,3
21075,2013-06-04,5,3,64,67
21076,2013-06-04,6,11,216,227
21077,2013-06-04,7,29,620,649
21078,2013-06-04,8,71,873,944
21079,2013-06-04,9,72,344,416
21080,2013-06-04,10,99,186,285
21081,2013-06-04,11,134,219,353
21082,2013-06-04,12,128,310,438
21083,2013-06-04,13,128,274,402
21084,2013-06-04,14,153,282,435
21085,2013-06-04,15,151,299,450
21086,2013-06-04,16,125,476,601
21087,2013-06-04,17,148,1009,1157
21088,2013-06-04,18,152,984,1136
21089,2013-06-04,19,162,613,775
21090,2013-06-04,20,102,452,554
21091,2013-06-04,21,65,402,467
21092,2013-06-04,22,55,253,308
21093,2013-06-04,23,25,124,149
21094,2013-06-05,0,12,50,62
21095,2013-06-05,1,3,30,33
21096,2013-06-05,2,1,10,11
21097,2013-06-05,3,3,5,8
21098,2013-06-05,4,1,5,6
21099,2013-06-05,5,2,54,56
21100,2013-06-05,6,16,228,244
21101,2013-06-05,7,39,634,673
21102,2013-06-05,8,85,782,867
21103,2013-06-05,9,66,405,471
21104,2013-06-05,10,92,162,254
21105,2013-06-05,11,99,204,303
21106,2013-06-05,12,130,286,416
21107,2013-06-05,13,128,297,425
21108,2013-06-05,14,138,253,391
21109,2013-06-05,15,141,280,421
21110,2013-06-05,16,173,438,611
21111,2013-06-05,17,187,1029,1216
21112,2013-06-05,18,150,913,1063
21113,2013-06-05,19,157,624,781
21114,2013-06-05,20,113,535,648
21115,2013-06-05,21,82,421,503
21116,2013-06-05,22,70,296,366
21117,2013-06-05,23,22,134,156
21118,2013-06-06,0,10,72,82
21119,2013-06-06,1,7,22,29
21120,2013-06-06,2,9,8,17
21121,2013-06-06,3,2,4,6
21122,2013-06-06,4,1,2,3
21123,2013-06-06,5,3,50,53
21124,2013-06-06,6,23,223,246
21125,2013-06-06,7,33,579,612
21126,2013-06-06,8,50,889,939
21127,2013-06-06,9,64,378,442
21128,2013-06-06,10,86,163,249
21129,2013-06-06,11,104,200,304
21130,2013-06-06,12,97,250,347
21131,2013-06-06,13,100,248,348
21132,2013-06-06,14,114,232,346
21133,2013-06-06,15,135,273,408
21134,2013-06-06,16,127,405,532
21135,2013-06-06,17,140,726,866
21136,2013-06-06,18,70,365,435
21137,2013-06-06,19,15,152,167
21138,2013-06-06,20,3,78,81
21139,2013-06-06,21,9,128,137
21140,2013-06-06,22,9,116,125
21141,2013-06-06,23,12,68,80
21142,2013-06-07,0,2,13,15
21143,2013-06-07,1,1,5,6
21144,2013-06-07,2,0,11,11
21145,2013-06-07,3,0,5,5
21146,2013-06-07,4,0,3,3
21147,2013-06-07,5,2,23,25
21148,2013-06-07,6,3,52,55
21149,2013-06-07,7,7,129,136
21150,2013-06-07,8,11,180,191
21151,2013-06-07,9,11,107,118
21152,2013-06-07,10,5,41,46
21153,2013-06-07,11,6,45,51
21154,2013-06-07,12,10,38,48
21155,2013-06-07,13,9,42,51
21156,2013-06-07,14,13,51,64
21157,2013-06-07,15,16,69,85
21158,2013-06-07,16,16,104,120
21159,2013-06-07,17,22,255,277
21160,2013-06-07,18,10,225,235
21161,2013-06-07,19,24,204,228
21162,2013-06-07,20,19,205,224
21163,2013-06-07,21,17,155,172
21164,2013-06-07,22,12,139,151
21165,2013-06-07,23,26,134,160
21166,2013-06-08,0,17,110,127
21167,2013-06-08,1,9,86,95
21168,2013-06-08,2,21,79,100
21169,2013-06-08,3,6,34,40
21170,2013-06-08,4,3,8,11
21171,2013-06-08,5,3,11,14
21172,2013-06-08,6,15,55,70
21173,2013-06-08,7,9,96,105
21174,2013-06-08,8,28,191,219
21175,2013-06-08,9,99,267,366
21176,2013-06-08,10,131,338,469
21177,2013-06-08,11,176,378,554
21178,2013-06-08,12,254,420,674
21179,2013-06-08,13,317,477,794
21180,2013-06-08,14,355,459,814
21181,2013-06-08,15,369,504,873
21182,2013-06-08,16,362,414,776
21183,2013-06-08,17,320,354,674
21184,2013-06-08,18,264,394,658
21185,2013-06-08,19,262,420,682
21186,2013-06-08,20,200,364,564
21187,2013-06-08,21,150,280,430
21188,2013-06-08,22,113,253,366
21189,2013-06-08,23,89,193,282
21190,2013-06-09,0,56,143,199
21191,2013-06-09,1,34,141,175
21192,2013-06-09,2,22,88,110
21193,2013-06-09,3,14,48,62
21194,2013-06-09,4,3,20,23
21195,2013-06-09,5,3,22,25
21196,2013-06-09,6,9,23,32
21197,2013-06-09,7,18,53,71
21198,2013-06-09,8,51,114,165
21199,2013-06-09,9,125,231,356
21200,2013-06-09,10,205,363,568
21201,2013-06-09,11,286,409,695
21202,2013-06-09,12,306,495,801
21203,2013-06-09,13,336,437,773
21204,2013-06-09,14,348,429,777
21205,2013-06-09,15,336,392,728
21206,2013-06-09,16,334,444,778
21207,2013-06-09,17,288,489,777
21208,2013-06-09,18,238,409,647
21209,2013-06-09,19,166,371,537
21210,2013-06-09,20,127,244,371
21211,2013-06-09,21,62,165,227
21212,2013-06-09,22,41,170,211
21213,2013-06-09,23,23,85,108
21214,2013-06-10,0,21,43,64
21215,2013-06-10,1,9,30,39
21216,2013-06-10,2,6,5,11
21217,2013-06-10,3,1,1,2
21218,2013-06-10,4,1,3,4
21219,2013-06-10,5,1,34,35
21220,2013-06-10,6,3,141,144
21221,2013-06-10,7,16,216,232
21222,2013-06-10,8,29,470,499
21223,2013-06-10,9,45,252,297
21224,2013-06-10,10,49,100,149
21225,2013-06-10,11,62,127,189
21226,2013-06-10,12,91,168,259
21227,2013-06-10,13,66,162,228
21228,2013-06-10,14,21,55,76
21229,2013-06-10,15,22,63,85
21230,2013-06-10,16,76,282,358
21231,2013-06-10,17,71,590,661
21232,2013-06-10,18,53,405,458
21233,2013-06-10,19,45,239,284
21234,2013-06-10,20,4,59,63
21235,2013-06-10,21,9,81,90
21236,2013-06-10,22,6,88,94
21237,2013-06-10,23,6,41,47
21238,2013-06-11,0,5,18,23
21239,2013-06-11,1,2,10,12
21240,2013-06-11,2,1,9,10
21241,2013-06-11,3,3,4,7
21242,2013-06-11,4,3,0,3
21243,2013-06-11,5,0,42,42
21244,2013-06-11,6,10,189,199
21245,2013-06-11,7,24,566,590
21246,2013-06-11,8,34,840,874
21247,2013-06-11,9,72,308,380
21248,2013-06-11,10,86,155,241
21249,2013-06-11,11,79,209,288
21250,2013-06-11,12,123,276,399
21251,2013-06-11,13,112,263,375
21252,2013-06-11,14,140,242,382
21253,2013-06-11,15,138,271,409
21254,2013-06-11,16,159,458,617
21255,2013-06-11,17,168,932,1100
21256,2013-06-11,18,155,894,1049
21257,2013-06-11,19,130,571,701
21258,2013-06-11,20,111,472,583
21259,2013-06-11,21,89,354,443
21260,2013-06-11,22,67,239,306
21261,2013-06-11,23,26,134,160
21262,2013-06-12,0,5,59,64
21263,2013-06-12,1,13,18,31
21264,2013-06-12,2,4,14,18
21265,2013-06-12,3,5,2,7
21266,2013-06-12,4,3,4,7
21267,2013-06-12,5,2,54,56
21268,2013-06-12,6,11,208,219
21269,2013-06-12,7,28,615,643
21270,2013-06-12,8,47,813,860
21271,2013-06-12,9,71,322,393
21272,2013-06-12,10,76,181,257
21273,2013-06-12,11,84,205,289
21274,2013-06-12,12,108,256,364
21275,2013-06-12,13,95,248,343
21276,2013-06-12,14,106,238,344
21277,2013-06-12,15,144,274,418
21278,2013-06-12,16,86,396,482
21279,2013-06-12,17,145,877,1022
21280,2013-06-12,18,122,948,1070
21281,2013-06-12,19,145,632,777
21282,2013-06-12,20,106,484,590
21283,2013-06-12,21,66,349,415
21284,2013-06-12,22,61,253,314
21285,2013-06-12,23,52,145,197
21286,2013-06-13,0,19,64,83
21287,2013-06-13,1,9,29,38
21288,2013-06-13,2,3,11,14
21289,2013-06-13,3,3,5,8
21290,2013-06-13,4,0,1,1
21291,2013-06-13,5,3,34,37
21292,2013-06-13,6,11,193,204
21293,2013-06-13,7,21,578,599
21294,2013-06-13,8,39,754,793
21295,2013-06-13,9,20,163,183
21296,2013-06-13,10,61,127,188
21297,2013-06-13,11,66,174,240
21298,2013-06-13,12,58,225,283
21299,2013-06-13,13,96,205,301
21300,2013-06-13,14,87,223,310
21301,2013-06-13,15,92,295,387
21302,2013-06-13,16,69,305,374
21303,2013-06-13,17,130,580,710
21304,2013-06-13,18,91,678,769
21305,2013-06-13,19,109,457,566
21306,2013-06-13,20,76,357,433
21307,2013-06-13,21,41,275,316
21308,2013-06-13,22,28,207,235
21309,2013-06-13,23,30,157,187
21310,2013-06-14,0,17,76,93
21311,2013-06-14,1,5,34,39
21312,2013-06-14,2,7,17,24
21313,2013-06-14,3,1,11,12
21314,2013-06-14,4,0,2,2
21315,2013-06-14,5,3,42,45
21316,2013-06-14,6,6,104,110
21317,2013-06-14,7,20,362,382
21318,2013-06-14,8,42,803,845
21319,2013-06-14,9,66,403,469
21320,2013-06-14,10,88,205,293
21321,2013-06-14,11,153,258,411
21322,2013-06-14,12,150,352,502
21323,2013-06-14,13,166,346,512
21324,2013-06-14,14,192,317,509
21325,2013-06-14,15,177,383,560
21326,2013-06-14,16,170,530,700
21327,2013-06-14,17,200,826,1026
21328,2013-06-14,18,189,708,897
21329,2013-06-14,19,191,506,697
21330,2013-06-14,20,133,438,571
21331,2013-06-14,21,90,353,443
21332,2013-06-14,22,77,269,346
21333,2013-06-14,23,66,229,295
21334,2013-06-15,0,24,135,159
21335,2013-06-15,1,16,120,136
21336,2013-06-15,2,7,79,86
21337,2013-06-15,3,2,36,38
21338,2013-06-15,4,3,8,11
21339,2013-06-15,5,2,18,20
21340,2013-06-15,6,13,41,54
21341,2013-06-15,7,17,100,117
21342,2013-06-15,8,50,221,271
21343,2013-06-15,9,154,288,442
21344,2013-06-15,10,201,385,586
21345,2013-06-15,11,249,442,691
21346,2013-06-15,12,342,525,867
21347,2013-06-15,13,380,510,890
21348,2013-06-15,14,431,444,875
21349,2013-06-15,15,389,406,795
21350,2013-06-15,16,372,384,756
21351,2013-06-15,17,345,415,760
21352,2013-06-15,18,310,410,720
21353,2013-06-15,19,268,359,627
21354,2013-06-15,20,251,320,571
21355,2013-06-15,21,171,246,417
21356,2013-06-15,22,128,212,340
21357,2013-06-15,23,74,141,215
21358,2013-06-16,0,71,161,232
21359,2013-06-16,1,36,134,170
21360,2013-06-16,2,32,98,130
21361,2013-06-16,3,12,36,48
21362,2013-06-16,4,1,7,8
21363,2013-06-16,5,3,11,14
21364,2013-06-16,6,3,20,23
21365,2013-06-16,7,29,60,89
21366,2013-06-16,8,38,147,185
21367,2013-06-16,9,106,203,309
21368,2013-06-16,10,256,334,590
21369,2013-06-16,11,331,370,701
21370,2013-06-16,12,321,412,733
21371,2013-06-16,13,355,388,743
21372,2013-06-16,14,377,395,772
21373,2013-06-16,15,338,347,685
21374,2013-06-16,16,288,378,666
21375,2013-06-16,17,262,343,605
21376,2013-06-16,18,184,334,518
21377,2013-06-16,19,173,327,500
21378,2013-06-16,20,140,239,379
21379,2013-06-16,21,83,189,272
21380,2013-06-16,22,62,148,210
21381,2013-06-16,23,32,95,127
21382,2013-06-17,0,17,34,51
21383,2013-06-17,1,7,15,22
21384,2013-06-17,2,0,15,15
21385,2013-06-17,3,0,4,4
21386,2013-06-17,4,0,2,2
21387,2013-06-17,5,2,48,50
21388,2013-06-17,6,4,189,193
21389,2013-06-17,7,31,549,580
21390,2013-06-17,8,70,776,846
21391,2013-06-17,9,73,323,396
21392,2013-06-17,10,142,140,282
21393,2013-06-17,11,149,157,306
21394,2013-06-17,12,128,241,369
21395,2013-06-17,13,118,232,350
21396,2013-06-17,14,112,200,312
21397,2013-06-17,15,122,237,359
21398,2013-06-17,16,125,384,509
21399,2013-06-17,17,136,763,899
21400,2013-06-17,18,122,818,940
21401,2013-06-17,19,134,663,797
21402,2013-06-17,20,89,447,536
21403,2013-06-17,21,64,325,389
21404,2013-06-17,22,53,215,268
21405,2013-06-17,23,31,107,138
21406,2013-06-18,0,14,43,57
21407,2013-06-18,1,3,14,17
21408,2013-06-18,2,0,3,3
21409,2013-06-18,3,0,6,6
21410,2013-06-18,4,0,2,2
21411,2013-06-18,5,2,63,65
21412,2013-06-18,6,8,238,246
21413,2013-06-18,7,27,626,653
21414,2013-06-18,8,42,916,958
21415,2013-06-18,9,58,337,395
21416,2013-06-18,10,46,120,166
21417,2013-06-18,11,88,171,259
21418,2013-06-18,12,83,197,280
21419,2013-06-18,13,39,83,122
21420,2013-06-18,14,17,39,56
21421,2013-06-18,15,21,97,118
21422,2013-06-18,16,53,181,234
21423,2013-06-18,17,51,645,696
21424,2013-06-18,18,72,737,809
21425,2013-06-18,19,67,565,632
21426,2013-06-18,20,101,466,567
21427,2013-06-18,21,59,339,398
21428,2013-06-18,22,53,207,260
21429,2013-06-18,23,36,105,141
21430,2013-06-19,0,19,109,128
21431,2013-06-19,1,2,23,25
21432,2013-06-19,2,3,7,10
21433,2013-06-19,3,0,9,9
21434,2013-06-19,4,2,13,15
21435,2013-06-19,5,3,60,63
21436,2013-06-19,6,14,239,253
21437,2013-06-19,7,44,622,666
21438,2013-06-19,8,56,910,966
21439,2013-06-19,9,60,372,432
21440,2013-06-19,10,107,203,310
21441,2013-06-19,11,123,226,349
21442,2013-06-19,12,113,284,397
21443,2013-06-19,13,106,253,359
21444,2013-06-19,14,132,231,363
21445,2013-06-19,15,162,265,427
21446,2013-06-19,16,113,436,549
21447,2013-06-19,17,185,975,1160
21448,2013-06-19,18,132,938,1070
21449,2013-06-19,19,143,685,828
21450,2013-06-19,20,115,553,668
21451,2013-06-19,21,85,404,489
21452,2013-06-19,22,57,262,319
21453,2013-06-19,23,26,157,183
21454,2013-06-20,0,19,46,65
21455,2013-06-20,1,15,20,35
21456,2013-06-20,2,8,10,18
21457,2013-06-20,3,2,6,8
21458,2013-06-20,4,0,4,4
21459,2013-06-20,5,3,58,61
21460,2013-06-20,6,16,208,224
21461,2013-06-20,7,29,600,629
21462,2013-06-20,8,59,941,1000
21463,2013-06-20,9,59,387,446
21464,2013-06-20,10,86,207,293
21465,2013-06-20,11,103,213,316
21466,2013-06-20,12,138,297,435
21467,2013-06-20,13,132,301,433
21468,2013-06-20,14,112,260,372
21469,2013-06-20,15,126,275,401
21470,2013-06-20,16,125,438,563
21471,2013-06-20,17,187,994,1181
21472,2013-06-20,18,182,935,1117
21473,2013-06-20,19,121,655,776
21474,2013-06-20,20,90,601,691
21475,2013-06-20,21,87,399,486
21476,2013-06-20,22,62,294,356
21477,2013-06-20,23,34,203,237
21478,2013-06-21,0,37,155,192
21479,2013-06-21,1,29,43,72
21480,2013-06-21,2,3,20,23
21481,2013-06-21,3,4,11,15
21482,2013-06-21,4,0,4,4
21483,2013-06-21,5,9,41,50
21484,2013-06-21,6,9,180,189
21485,2013-06-21,7,25,526,551
21486,2013-06-21,8,69,861,930
21487,2013-06-21,9,61,379,440
21488,2013-06-21,10,118,213,331
21489,2013-06-21,11,123,247,370
21490,2013-06-21,12,104,331,435
21491,2013-06-21,13,158,351,509
21492,2013-06-21,14,195,283,478
21493,2013-06-21,15,143,310,453
21494,2013-06-21,16,201,512,713
21495,2013-06-21,17,239,918,1157
21496,2013-06-21,18,189,732,921
21497,2013-06-21,19,185,526,711
21498,2013-06-21,20,163,426,589
21499,2013-06-21,21,125,362,487
21500,2013-06-21,22,96,298,394
21501,2013-06-21,23,82,223,305
21502,2013-06-22,0,48,188,236
21503,2013-06-22,1,28,103,131
21504,2013-06-22,2,17,60,77
21505,2013-06-22,3,9,29,38
21506,2013-06-22,4,6,10,16
21507,2013-06-22,5,6,12,18
21508,2013-06-22,6,7,35,42
21509,2013-06-22,7,22,91,113
21510,2013-06-22,8,76,194,270
21511,2013-06-22,9,148,301,449
21512,2013-06-22,10,204,390,594
21513,2013-06-22,11,344,475,819
21514,2013-06-22,12,357,490,847
21515,2013-06-22,13,389,470,859
21516,2013-06-22,14,452,434,886
21517,2013-06-22,15,374,436,810
21518,2013-06-22,16,386,426,812
21519,2013-06-22,17,300,457,757
21520,2013-06-22,18,321,407,728
21521,2013-06-22,19,259,367,626
21522,2013-06-22,20,223,308,531
21523,2013-06-22,21,196,264,460
21524,2013-06-22,22,130,242,372
21525,2013-06-22,23,98,207,305
21526,2013-06-23,0,61,146,207
21527,2013-06-23,1,55,136,191
21528,2013-06-23,2,37,108,145
21529,2013-06-23,3,15,40,55
21530,2013-06-23,4,9,15,24
21531,2013-06-23,5,5,18,23
21532,2013-06-23,6,5,16,21
21533,2013-06-23,7,19,43,62
21534,2013-06-23,8,12,58,70
21535,2013-06-23,9,7,30,37
21536,2013-06-23,10,37,81,118
21537,2013-06-23,11,93,233,326
21538,2013-06-23,12,161,340,501
21539,2013-06-23,13,168,322,490
21540,2013-06-23,14,248,368,616
21541,2013-06-23,15,241,365,606
21542,2013-06-23,16,243,448,691
21543,2013-06-23,17,224,409,633
21544,2013-06-23,18,214,431,645
21545,2013-06-23,19,174,366,540
21546,2013-06-23,20,180,293,473
21547,2013-06-23,21,100,237,337
21548,2013-06-23,22,60,160,220
21549,2013-06-23,23,36,108,144
21550,2013-06-24,0,6,44,50
21551,2013-06-24,1,6,23,29
21552,2013-06-24,2,3,11,14
21553,2013-06-24,3,3,7,10
21554,2013-06-24,4,3,10,13
21555,2013-06-24,5,1,44,45
21556,2013-06-24,6,11,193,204
21557,2013-06-24,7,40,506,546
21558,2013-06-24,8,55,800,855
21559,2013-06-24,9,73,291,364
21560,2013-06-24,10,113,141,254
21561,2013-06-24,11,118,178,296
21562,2013-06-24,12,132,228,360
21563,2013-06-24,13,90,196,286
21564,2013-06-24,14,107,215,322
21565,2013-06-24,15,96,232,328
21566,2013-06-24,16,77,328,405
21567,2013-06-24,17,99,650,749
21568,2013-06-24,18,100,773,873
21569,2013-06-24,19,94,609,703
21570,2013-06-24,20,81,442,523
21571,2013-06-24,21,85,330,415
21572,2013-06-24,22,46,189,235
21573,2013-06-24,23,31,132,163
21574,2013-06-25,0,13,41,54
21575,2013-06-25,1,9,15,24
21576,2013-06-25,2,4,17,21
21577,2013-06-25,3,1,11,12
21578,2013-06-25,4,0,5,5
21579,2013-06-25,5,5,65,70
21580,2013-06-25,6,14,230,244
21581,2013-06-25,7,40,589,629
21582,2013-06-25,8,58,858,916
21583,2013-06-25,9,64,320,384
21584,2013-06-25,10,76,173,249
21585,2013-06-25,11,110,195,305
21586,2013-06-25,12,102,248,350
21587,2013-06-25,13,84,249,333
21588,2013-06-25,14,87,213,300
21589,2013-06-25,15,107,238,345
21590,2013-06-25,16,106,403,509
21591,2013-06-25,17,159,900,1059
21592,2013-06-25,18,110,826,936
21593,2013-06-25,19,128,641,769
21594,2013-06-25,20,100,426,526
21595,2013-06-25,21,81,386,467
21596,2013-06-25,22,78,255,333
21597,2013-06-25,23,23,106,129
21598,2013-06-26,0,6,48,54
21599,2013-06-26,1,7,26,33
21600,2013-06-26,2,3,11,14
21601,2013-06-26,3,0,4,4
21602,2013-06-26,4,1,5,6
21603,2013-06-26,5,5,57,62
21604,2013-06-26,6,23,230,253
21605,2013-06-26,7,31,609,640
21606,2013-06-26,8,52,820,872
21607,2013-06-26,9,64,366,430
21608,2013-06-26,10,62,155,217
21609,2013-06-26,11,90,188,278
21610,2013-06-26,12,99,246,345
21611,2013-06-26,13,105,229,334
21612,2013-06-26,14,76,202,278
21613,2013-06-26,15,101,236,337
21614,2013-06-26,16,95,357,452
21615,2013-06-26,17,125,838,963
21616,2013-06-26,18,130,830,960
21617,2013-06-26,19,83,542,625
21618,2013-06-26,20,56,313,369
21619,2013-06-26,21,50,362,412
21620,2013-06-26,22,36,260,296
21621,2013-06-26,23,12,146,158
21622,2013-06-27,0,18,56,74
21623,2013-06-27,1,19,26,45
21624,2013-06-27,2,1,12,13
21625,2013-06-27,3,0,6,6
21626,2013-06-27,4,1,4,5
21627,2013-06-27,5,8,53,61
21628,2013-06-27,6,9,218,227
21629,2013-06-27,7,28,583,611
21630,2013-06-27,8,47,857,904
21631,2013-06-27,9,52,364,416
21632,2013-06-27,10,83,183,266
21633,2013-06-27,11,73,218,291
21634,2013-06-27,12,100,284,384
21635,2013-06-27,13,63,252,315
21636,2013-06-27,14,76,218,294
21637,2013-06-27,15,66,154,220
21638,2013-06-27,16,64,247,311
21639,2013-06-27,17,98,829,927
21640,2013-06-27,18,118,872,990
21641,2013-06-27,19,108,646,754
21642,2013-06-27,20,112,481,593
21643,2013-06-27,21,72,368,440
21644,2013-06-27,22,48,207,255
21645,2013-06-27,23,37,178,215
21646,2013-06-28,0,32,88,120
21647,2013-06-28,1,12,33,45
21648,2013-06-28,2,5,13,18
21649,2013-06-28,3,2,8,10
21650,2013-06-28,4,0,5,5
21651,2013-06-28,5,3,50,53
21652,2013-06-28,6,7,179,186
21653,2013-06-28,7,23,514,537
21654,2013-06-28,8,55,810,865
21655,2013-06-28,9,67,357,424
21656,2013-06-28,10,76,218,294
21657,2013-06-28,11,94,233,327
21658,2013-06-28,12,109,338,447
21659,2013-06-28,13,91,323,414
21660,2013-06-28,14,137,262,399
21661,2013-06-28,15,33,102,135
21662,2013-06-28,16,68,234,302
21663,2013-06-28,17,52,279,331
21664,2013-06-28,18,15,108,123
21665,2013-06-28,19,31,246,277
21666,2013-06-28,20,42,269,311
21667,2013-06-28,21,46,215,261
21668,2013-06-28,22,24,155,179
21669,2013-06-28,23,36,148,184
21670,2013-06-29,0,35,119,154
21671,2013-06-29,1,30,97,127
21672,2013-06-29,2,34,84,118
21673,2013-06-29,3,18,34,52
21674,2013-06-29,4,4,16,20
21675,2013-06-29,5,3,9,12
21676,2013-06-29,6,15,49,64
21677,2013-06-29,7,23,99,122
21678,2013-06-29,8,57,170,227
21679,2013-06-29,9,114,293,407
21680,2013-06-29,10,201,402,603
21681,2013-06-29,11,320,527,847
21682,2013-06-29,12,321,481,802
21683,2013-06-29,13,307,469,776
21684,2013-06-29,14,335,442,777
21685,2013-06-29,15,316,452,768
21686,2013-06-29,16,298,461,759
21687,2013-06-29,17,342,478,820
21688,2013-06-29,18,283,403,686
21689,2013-06-29,19,230,390,620
21690,2013-06-29,20,256,342,598
21691,2013-06-29,21,178,299,477
21692,2013-06-29,22,131,207,338
21693,2013-06-29,23,121,205,326
21694,2013-06-30,0,50,191,241
21695,2013-06-30,1,43,126,169
21696,2013-06-30,2,27,94,121
21697,2013-06-30,3,13,51,64
21698,2013-06-30,4,1,9,10
21699,2013-06-30,5,4,12,16
21700,2013-06-30,6,13,18,31
21701,2013-06-30,7,24,57,81
21702,2013-06-30,8,43,122,165
21703,2013-06-30,9,104,224,328
21704,2013-06-30,10,101,211,312
21705,2013-06-30,11,78,190,268
21706,2013-06-30,12,198,369,567
21707,2013-06-30,13,241,421,662
21708,2013-06-30,14,313,452,765
21709,2013-06-30,15,237,374,611
21710,2013-06-30,16,217,405,622
21711,2013-06-30,17,170,344,514
21712,2013-06-30,18,130,223,353
21713,2013-06-30,19,94,204,298
21714,2013-06-30,20,120,223,343
21715,2013-06-30,21,91,184,275
21716,2013-06-30,22,67,118,185
21717,2013-06-30,23,25,60,85
21718,2013-07-01,0,8,46,54
21719,2013-07-01,1,6,21,27
21720,2013-07-01,2,0,16,16
21721,2013-07-01,3,4,9,13
21722,2013-07-01,4,2,10,12
21723,2013-07-01,5,1,46,47
21724,2013-07-01,6,12,194,206
21725,2013-07-01,7,19,548,567
21726,2013-07-01,8,43,807,850
21727,2013-07-01,9,85,274,359
21728,2013-07-01,10,37,40,77
21729,2013-07-01,11,42,81,123
21730,2013-07-01,12,65,69,134
21731,2013-07-01,13,80,157,237
21732,2013-07-01,14,133,205,338
21733,2013-07-01,15,116,218,334
21734,2013-07-01,16,159,371,530
21735,2013-07-01,17,129,902,1031
21736,2013-07-01,18,111,850,961
21737,2013-07-01,19,70,545,615
21738,2013-07-01,20,89,440,529
21739,2013-07-01,21,81,298,379
21740,2013-07-01,22,49,220,269
21741,2013-07-01,23,31,103,134
21742,2013-07-02,0,17,47,64
21743,2013-07-02,1,11,22,33
21744,2013-07-02,2,2,7,9
21745,2013-07-02,3,1,11,12
21746,2013-07-02,4,2,6,8
21747,2013-07-02,5,7,53,60
21748,2013-07-02,6,8,180,188
21749,2013-07-02,7,23,466,489
21750,2013-07-02,8,28,851,879
21751,2013-07-02,9,42,349,391
21752,2013-07-02,10,93,169,262
21753,2013-07-02,11,114,184,298
21754,2013-07-02,12,119,268,387
21755,2013-07-02,13,100,247,347
21756,2013-07-02,14,87,125,212
21757,2013-07-02,15,89,148,237
21758,2013-07-02,16,92,260,352
21759,2013-07-02,17,105,821,926
21760,2013-07-02,18,99,735,834
21761,2013-07-02,19,80,502,582
21762,2013-07-02,20,57,398,455
21763,2013-07-02,21,50,307,357
21764,2013-07-02,22,38,256,294
21765,2013-07-02,23,20,125,145
21766,2013-07-03,0,13,81,94
21767,2013-07-03,1,5,27,32
21768,2013-07-03,2,1,14,15
21769,2013-07-03,3,1,4,5
21770,2013-07-03,4,0,7,7
21771,2013-07-03,5,1,31,32
21772,2013-07-03,6,6,137,143
21773,2013-07-03,7,10,405,415
21774,2013-07-03,8,12,146,158
21775,2013-07-03,9,28,284,312
21776,2013-07-03,10,44,141,185
21777,2013-07-03,11,87,183,270
21778,2013-07-03,12,126,257,383
21779,2013-07-03,13,124,279,403
21780,2013-07-03,14,121,345,466
21781,2013-07-03,15,131,447,578
21782,2013-07-03,16,155,511,666
21783,2013-07-03,17,130,680,810
21784,2013-07-03,18,111,573,684
21785,2013-07-03,19,148,430,578
21786,2013-07-03,20,134,381,515
21787,2013-07-03,21,79,315,394
21788,2013-07-03,22,79,254,333
21789,2013-07-03,23,57,190,247
21790,2013-07-04,0,33,148,181
21791,2013-07-04,1,20,123,143
21792,2013-07-04,2,20,81,101
21793,2013-07-04,3,5,24,29
21794,2013-07-04,4,3,7,10
21795,2013-07-04,5,6,12,18
21796,2013-07-04,6,9,33,42
21797,2013-07-04,7,22,60,82
21798,2013-07-04,8,59,117,176
21799,2013-07-04,9,117,199,316
21800,2013-07-04,10,213,294,507
21801,2013-07-04,11,263,333,596
21802,2013-07-04,12,333,343,676
21803,2013-07-04,13,380,376,756
21804,2013-07-04,14,454,401,855
21805,2013-07-04,15,398,378,776
21806,2013-07-04,16,487,342,829
21807,2013-07-04,17,427,311,738
21808,2013-07-04,18,410,356,766
21809,2013-07-04,19,378,300,678
21810,2013-07-04,20,369,331,700
21811,2013-07-04,21,354,378,732
21812,2013-07-04,22,318,336,654
21813,2013-07-04,23,143,236,379
21814,2013-07-05,0,50,114,164
21815,2013-07-05,1,26,56,82
21816,2013-07-05,2,11,28,39
21817,2013-07-05,3,5,10,15
21818,2013-07-05,4,5,9,14
21819,2013-07-05,5,3,23,26
21820,2013-07-05,6,10,79,89
21821,2013-07-05,7,21,204,225
21822,2013-07-05,8,62,404,466
21823,2013-07-05,9,154,297,451
21824,2013-07-05,10,275,219,494
21825,2013-07-05,11,378,268,646
21826,2013-07-05,12,416,331,747
21827,2013-07-05,13,370,334,704
21828,2013-07-05,14,368,309,677
21829,2013-07-05,15,377,367,744
21830,2013-07-05,16,434,433,867
21831,2013-07-05,17,390,508,898
21832,2013-07-05,18,317,450,767
21833,2013-07-05,19,317,369,686
21834,2013-07-05,20,266,308,574
21835,2013-07-05,21,239,226,465
21836,2013-07-05,22,180,229,409
21837,2013-07-05,23,111,197,308
21838,2013-07-06,0,87,112,199
21839,2013-07-06,1,28,91,119
21840,2013-07-06,2,24,56,80
21841,2013-07-06,3,20,30,50
21842,2013-07-06,4,1,7,8
21843,2013-07-06,5,12,11,23
21844,2013-07-06,6,19,39,58
21845,2013-07-06,7,21,69,90
21846,2013-07-06,8,89,158,247
21847,2013-07-06,9,136,208,344
21848,2013-07-06,10,226,256,482
21849,2013-07-06,11,352,328,680
21850,2013-07-06,12,377,316,693
21851,2013-07-06,13,393,318,711
21852,2013-07-06,14,362,335,697
21853,2013-07-06,15,301,281,582
21854,2013-07-06,16,329,243,572
21855,2013-07-06,17,333,275,608
21856,2013-07-06,18,269,289,558
21857,2013-07-06,19,275,304,579
21858,2013-07-06,20,224,283,507
21859,2013-07-06,21,172,250,422
21860,2013-07-06,22,146,186,332
21861,2013-07-06,23,99,160,259
21862,2013-07-07,0,86,140,226
21863,2013-07-07,1,43,94,137
21864,2013-07-07,2,22,71,93
21865,2013-07-07,3,11,34,45
21866,2013-07-07,4,4,8,12
21867,2013-07-07,5,6,14,20
21868,2013-07-07,6,16,27,43
21869,2013-07-07,7,29,53,82
21870,2013-07-07,8,63,130,193
21871,2013-07-07,9,129,198,327
21872,2013-07-07,10,177,288,465
21873,2013-07-07,11,201,346,547
21874,2013-07-07,12,242,368,610
21875,2013-07-07,13,251,362,613
21876,2013-07-07,14,194,322,516
21877,2013-07-07,15,221,314,535
21878,2013-07-07,16,170,344,514
21879,2013-07-07,17,196,359,555
21880,2013-07-07,18,136,314,450
21881,2013-07-07,19,113,179,292
21882,2013-07-07,20,76,127,203
21883,2013-07-07,21,44,121,165
21884,2013-07-07,22,38,105,143
21885,2013-07-07,23,21,63,84
21886,2013-07-08,0,6,31,37
21887,2013-07-08,1,1,15,16
21888,2013-07-08,2,0,5,5
21889,2013-07-08,3,0,4,4
21890,2013-07-08,4,0,9,9
21891,2013-07-08,5,0,50,50
21892,2013-07-08,6,12,168,180
21893,2013-07-08,7,19,459,478
21894,2013-07-08,8,66,808,874
21895,2013-07-08,9,78,302,380
21896,2013-07-08,10,57,156,213
21897,2013-07-08,11,108,162,270
21898,2013-07-08,12,90,229,319
21899,2013-07-08,13,50,151,201
21900,2013-07-08,14,79,150,229
21901,2013-07-08,15,98,207,305
21902,2013-07-08,16,101,397,498
21903,2013-07-08,17,134,848,982
21904,2013-07-08,18,126,847,973
21905,2013-07-08,19,106,646,752
21906,2013-07-08,20,89,470,559
21907,2013-07-08,21,50,330,380
21908,2013-07-08,22,29,193,222
21909,2013-07-08,23,24,110,134
21910,2013-07-09,0,23,44,67
21911,2013-07-09,1,5,14,19
21912,2013-07-09,2,0,7,7
21913,2013-07-09,3,0,6,6
21914,2013-07-09,4,1,5,6
21915,2013-07-09,5,4,75,79
21916,2013-07-09,6,7,211,218
21917,2013-07-09,7,23,591,614
21918,2013-07-09,8,43,873,916
21919,2013-07-09,9,46,327,373
21920,2013-07-09,10,58,181,239
21921,2013-07-09,11,61,196,257
21922,2013-07-09,12,86,254,340
21923,2013-07-09,13,77,267,344
21924,2013-07-09,14,73,172,245
21925,2013-07-09,15,78,213,291
21926,2013-07-09,16,72,416,488
21927,2013-07-09,17,106,986,1092
21928,2013-07-09,18,118,906,1024
21929,2013-07-09,19,103,637,740
21930,2013-07-09,20,89,479,568
21931,2013-07-09,21,61,353,414
21932,2013-07-09,22,38,240,278
21933,2013-07-09,23,24,115,139
21934,2013-07-10,0,10,61,71
21935,2013-07-10,1,0,25,25
21936,2013-07-10,2,2,8,10
21937,2013-07-10,3,0,5,5
21938,2013-07-10,4,1,4,5
21939,2013-07-10,5,0,69,69
21940,2013-07-10,6,6,235,241
21941,2013-07-10,7,28,595,623
21942,2013-07-10,8,47,815,862
21943,2013-07-10,9,32,206,238
21944,2013-07-10,10,45,132,177
21945,2013-07-10,11,94,190,284
21946,2013-07-10,12,72,215,287
21947,2013-07-10,13,59,234,293
21948,2013-07-10,14,64,219,283
21949,2013-07-10,15,86,235,321
21950,2013-07-10,16,86,436,522
21951,2013-07-10,17,95,924,1019
21952,2013-07-10,18,164,958,1122
21953,2013-07-10,19,103,644,747
21954,2013-07-10,20,37,168,205
21955,2013-07-10,21,37,263,300
21956,2013-07-10,22,31,227,258
21957,2013-07-10,23,17,127,144
21958,2013-07-11,0,17,46,63
21959,2013-07-11,1,3,23,26
21960,2013-07-11,2,2,12,14
21961,2013-07-11,3,3,6,9
21962,2013-07-11,4,0,5,5
21963,2013-07-11,5,2,58,60
21964,2013-07-11,6,11,191,202
21965,2013-07-11,7,15,583,598
21966,2013-07-11,8,39,695,734
21967,2013-07-11,9,52,330,382
21968,2013-07-11,10,68,142,210
21969,2013-07-11,11,65,190,255
21970,2013-07-11,12,86,225,311
21971,2013-07-11,13,110,260,370
21972,2013-07-11,14,101,240,341
21973,2013-07-11,15,109,258,367
21974,2013-07-11,16,118,470,588
21975,2013-07-11,17,125,937,1062
21976,2013-07-11,18,109,929,1038
21977,2013-07-11,19,113,632,745
21978,2013-07-11,20,62,472,534
21979,2013-07-11,21,71,362,433
21980,2013-07-11,22,73,246,319
21981,2013-07-11,23,31,173,204
21982,2013-07-12,0,16,99,115
21983,2013-07-12,1,10,19,29
21984,2013-07-12,2,1,9,10
21985,2013-07-12,3,1,1,2
21986,2013-07-12,5,0,32,32
21987,2013-07-12,6,1,69,70
21988,2013-07-12,7,10,79,89
21989,2013-07-12,8,10,205,215
21990,2013-07-12,9,29,194,223
21991,2013-07-12,10,47,143,190
21992,2013-07-12,11,40,178,218
21993,2013-07-12,12,85,237,322
21994,2013-07-12,13,75,212,287
21995,2013-07-12,14,70,161,231
21996,2013-07-12,15,83,270,353
21997,2013-07-12,16,98,448,546
21998,2013-07-12,17,64,423,487
21999,2013-07-12,18,69,498,567
22000,2013-07-12,19,96,480,576
22001,2013-07-12,20,56,316,372
22002,2013-07-12,21,49,253,302
22003,2013-07-12,22,46,202,248
22004,2013-07-12,23,50,191,241
22005,2013-07-13,0,43,225,268
22006,2013-07-13,1,23,98,121
22007,2013-07-13,2,22,78,100
22008,2013-07-13,3,16,23,39
22009,2013-07-13,4,1,7,8
22010,2013-07-13,5,4,14,18
22011,2013-07-13,6,8,32,40
22012,2013-07-13,7,12,91,103
22013,2013-07-13,8,41,174,215
22014,2013-07-13,9,44,245,289
22015,2013-07-13,10,116,391,507
22016,2013-07-13,11,222,443,665
22017,2013-07-13,12,292,481,773
22018,2013-07-13,13,342,453,795
22019,2013-07-13,14,308,415,723
22020,2013-07-13,15,315,439,754
22021,2013-07-13,16,352,409,761
22022,2013-07-13,17,294,403,697
22023,2013-07-13,18,242,420,662
22024,2013-07-13,19,166,312,478
22025,2013-07-13,20,160,277,437
22026,2013-07-13,21,92,241,333
22027,2013-07-13,22,62,202,264
22028,2013-07-13,23,46,180,226
22029,2013-07-14,0,26,185,211
22030,2013-07-14,1,33,141,174
22031,2013-07-14,2,34,129,163
22032,2013-07-14,3,19,52,71
22033,2013-07-14,4,5,16,21
22034,2013-07-14,5,2,7,9
22035,2013-07-14,6,6,19,25
22036,2013-07-14,7,18,44,62
22037,2013-07-14,8,46,118,164
22038,2013-07-14,9,81,214,295
22039,2013-07-14,10,185,351,536
22040,2013-07-14,11,222,364,586
22041,2013-07-14,12,213,410,623
22042,2013-07-14,13,302,432,734
22043,2013-07-14,14,285,375,660
22044,2013-07-14,15,263,393,656
22045,2013-07-14,16,255,403,658
22046,2013-07-14,17,168,370,538
22047,2013-07-14,18,147,422,569
22048,2013-07-14,19,138,360,498
22049,2013-07-14,20,158,292,450
22050,2013-07-14,21,125,248,373
22051,2013-07-14,22,58,144,202
22052,2013-07-14,23,7,102,109
22053,2013-07-15,0,11,41,52
22054,2013-07-15,1,5,20,25
22055,2013-07-15,2,2,5,7
22056,2013-07-15,3,1,3,4
22057,2013-07-15,4,0,4,4
22058,2013-07-15,5,1,51,52
22059,2013-07-15,6,10,192,202
22060,2013-07-15,7,24,529,553
22061,2013-07-15,8,57,783,840
22062,2013-07-15,9,55,281,336
22063,2013-07-15,10,87,134,221
22064,2013-07-15,11,91,158,249
22065,2013-07-15,12,85,240,325
22066,2013-07-15,13,68,203,271
22067,2013-07-15,14,102,164,266
22068,2013-07-15,15,77,183,260
22069,2013-07-15,16,88,380,468
22070,2013-07-15,17,84,860,944
22071,2013-07-15,18,135,834,969
22072,2013-07-15,19,118,589,707
22073,2013-07-15,20,106,442,548
22074,2013-07-15,21,67,304,371
22075,2013-07-15,22,48,204,252
22076,2013-07-15,23,21,86,107
22077,2013-07-16,0,12,39,51
22078,2013-07-16,1,6,22,28
22079,2013-07-16,2,1,9,10
22080,2013-07-16,3,2,4,6
22081,2013-07-16,4,0,5,5
22082,2013-07-16,5,0,50,50
22083,2013-07-16,6,8,213,221
22084,2013-07-16,7,31,588,619
22085,2013-07-16,8,51,859,910
22086,2013-07-16,9,58,288,346
22087,2013-07-16,10,74,147,221
22088,2013-07-16,11,73,157,230
22089,2013-07-16,12,82,219,301
22090,2013-07-16,13,67,197,264
22091,2013-07-16,14,64,182,246
22092,2013-07-16,15,98,249,347
22093,2013-07-16,16,72,396,468
22094,2013-07-16,17,88,845,933
22095,2013-07-16,18,112,771,883
22096,2013-07-16,19,119,585,704
22097,2013-07-16,20,128,501,629
22098,2013-07-16,21,83,358,441
22099,2013-07-16,22,52,288,340
22100,2013-07-16,23,23,126,149
22101,2013-07-17,0,12,71,83
22102,2013-07-17,1,7,16,23
22103,2013-07-17,2,1,12,13
22104,2013-07-17,3,0,7,7
22105,2013-07-17,4,0,5,5
22106,2013-07-17,5,1,55,56
22107,2013-07-17,6,9,224,233
22108,2013-07-17,7,36,564,600
22109,2013-07-17,8,36,855,891
22110,2013-07-17,9,56,337,393
22111,2013-07-17,10,69,146,215
22112,2013-07-17,11,74,170,244
22113,2013-07-17,12,62,223,285
22114,2013-07-17,13,73,212,285
22115,2013-07-17,14,64,187,251
22116,2013-07-17,15,79,243,322
22117,2013-07-17,16,80,376,456
22118,2013-07-17,17,113,862,975
22119,2013-07-17,18,137,868,1005
22120,2013-07-17,19,139,604,743
22121,2013-07-17,20,129,500,629
22122,2013-07-17,21,78,347,425
22123,2013-07-17,22,58,259,317
22124,2013-07-17,23,28,148,176
22125,2013-07-18,0,19,73,92
22126,2013-07-18,1,7,22,29
22127,2013-07-18,2,2,16,18
22128,2013-07-18,3,3,13,16
22129,2013-07-18,4,2,9,11
22130,2013-07-18,5,2,55,57
22131,2013-07-18,6,8,198,206
22132,2013-07-18,7,19,552,571
22133,2013-07-18,8,25,774,799
22134,2013-07-18,9,24,360,384
22135,2013-07-18,10,34,160,194
22136,2013-07-18,11,69,153,222
22137,2013-07-18,12,74,223,297
22138,2013-07-18,13,85,197,282
22139,2013-07-18,14,81,159,240
22140,2013-07-18,15,78,201,279
22141,2013-07-18,16,61,353,414
22142,2013-07-18,17,75,785,860
22143,2013-07-18,18,111,788,899
22144,2013-07-18,19,98,478,576
22145,2013-07-18,20,74,361,435
22146,2013-07-18,21,82,331,413
22147,2013-07-18,22,53,289,342
22148,2013-07-18,23,35,153,188
22149,2013-07-19,0,15,75,90
22150,2013-07-19,1,16,35,51
22151,2013-07-19,2,5,24,29
22152,2013-07-19,3,4,9,13
22153,2013-07-19,4,0,10,10
22154,2013-07-19,5,4,45,49
22155,2013-07-19,6,14,152,166
22156,2013-07-19,7,29,458,487
22157,2013-07-19,8,44,701,745
22158,2013-07-19,9,48,320,368
22159,2013-07-19,10,88,174,262
22160,2013-07-19,11,98,189,287
22161,2013-07-19,12,77,254,331
22162,2013-07-19,13,94,257,351
22163,2013-07-19,14,116,214,330
22164,2013-07-19,15,87,251,338
22165,2013-07-19,16,105,408,513
22166,2013-07-19,17,129,710,839
22167,2013-07-19,18,126,613,739
22168,2013-07-19,19,111,443,554
22169,2013-07-19,20,115,393,508
22170,2013-07-19,21,81,252,333
22171,2013-07-19,22,65,270,335
22172,2013-07-19,23,41,209,250
22173,2013-07-20,0,67,171,238
22174,2013-07-20,1,39,111,150
22175,2013-07-20,2,17,71,88
22176,2013-07-20,3,10,36,46
22177,2013-07-20,4,9,13,22
22178,2013-07-20,5,10,12,22
22179,2013-07-20,6,13,26,39
22180,2013-07-20,7,12,71,83
22181,2013-07-20,8,49,194,243
22182,2013-07-20,9,111,254,365
22183,2013-07-20,10,202,334,536
22184,2013-07-20,11,190,380,570
22185,2013-07-20,12,206,383,589
22186,2013-07-20,13,255,390,645
22187,2013-07-20,14,284,396,680
22188,2013-07-20,15,326,362,688
22189,2013-07-20,16,224,342,566
22190,2013-07-20,17,269,372,641
22191,2013-07-20,18,219,343,562
22192,2013-07-20,19,156,332,488
22193,2013-07-20,20,151,277,428
22194,2013-07-20,21,128,227,355
22195,2013-07-20,22,93,221,314
22196,2013-07-20,23,87,174,261
22197,2013-07-21,0,43,173,216
22198,2013-07-21,1,42,141,183
22199,2013-07-21,2,27,97,124
22200,2013-07-21,3,24,51,75
22201,2013-07-21,4,9,12,21
22202,2013-07-21,5,4,8,12
22203,2013-07-21,6,16,26,42
22204,2013-07-21,7,26,44,70
22205,2013-07-21,8,54,131,185
22206,2013-07-21,9,108,208,316
22207,2013-07-21,10,211,386,597
22208,2013-07-21,11,219,346,565
22209,2013-07-21,12,259,400,659
22210,2013-07-21,13,281,375,656
22211,2013-07-21,14,268,363,631
22212,2013-07-21,15,271,380,651
22213,2013-07-21,16,277,386,663
22214,2013-07-21,17,216,315,531
22215,2013-07-21,18,166,353,519
22216,2013-07-21,19,187,362,549
22217,2013-07-21,20,166,262,428
22218,2013-07-21,21,121,238,359
22219,2013-07-21,22,94,173,267
22220,2013-07-21,23,42,101,143
22221,2013-07-22,0,25,43,68
22222,2013-07-22,1,2,13,15
22223,2013-07-22,2,1,4,5
22224,2013-07-22,3,0,4,4
22225,2013-07-22,4,0,5,5
22226,2013-07-22,5,2,50,52
22227,2013-07-22,6,6,201,207
22228,2013-07-22,7,43,530,573
22229,2013-07-22,8,69,720,789
22230,2013-07-22,9,54,324,378
22231,2013-07-22,10,93,160,253
22232,2013-07-22,11,109,163,272
22233,2013-07-22,12,105,240,345
22234,2013-07-22,13,123,225,348
22235,2013-07-22,14,144,187,331
22236,2013-07-22,15,93,251,344
22237,2013-07-22,16,128,440,568
22238,2013-07-22,17,117,882,999
22239,2013-07-22,18,127,882,1009
22240,2013-07-22,19,121,679,800
22241,2013-07-22,20,97,459,556
22242,2013-07-22,21,74,323,397
22243,2013-07-22,22,22,192,214
22244,2013-07-22,23,23,123,146
22245,2013-07-23,0,9,34,43
22246,2013-07-23,1,1,13,14
22247,2013-07-23,2,4,8,12
22248,2013-07-23,3,0,3,3
22249,2013-07-23,4,1,4,5
22250,2013-07-23,5,6,52,58
22251,2013-07-23,6,8,232,240
22252,2013-07-23,7,26,627,653
22253,2013-07-23,8,34,823,857
22254,2013-07-23,9,71,339,410
22255,2013-07-23,10,51,189,240
22256,2013-07-23,11,110,188,298
22257,2013-07-23,12,93,280,373
22258,2013-07-23,13,94,269,363
22259,2013-07-23,14,115,205,320
22260,2013-07-23,15,88,253,341
22261,2013-07-23,16,100,407,507
22262,2013-07-23,17,164,963,1127
22263,2013-07-23,18,110,865,975
22264,2013-07-23,19,136,648,784
22265,2013-07-23,20,130,529,659
22266,2013-07-23,21,87,375,462
22267,2013-07-23,22,50,272,322
22268,2013-07-23,23,25,142,167
22269,2013-07-24,0,18,55,73
22270,2013-07-24,1,15,20,35
22271,2013-07-24,2,9,4,13
22272,2013-07-24,3,2,4,6
22273,2013-07-24,4,1,9,10
22274,2013-07-24,5,5,58,63
22275,2013-07-24,6,13,229,242
22276,2013-07-24,7,33,646,679
22277,2013-07-24,8,59,837,896
22278,2013-07-24,9,65,371,436
22279,2013-07-24,10,83,221,304
22280,2013-07-24,11,108,214,322
22281,2013-07-24,12,103,276,379
22282,2013-07-24,13,116,274,390
22283,2013-07-24,14,103,225,328
22284,2013-07-24,15,129,270,399
22285,2013-07-24,16,115,424,539
22286,2013-07-24,17,142,985,1127
22287,2013-07-24,18,159,960,1119
22288,2013-07-24,19,168,633,801
22289,2013-07-24,20,90,505,595
22290,2013-07-24,21,99,374,473
22291,2013-07-24,22,51,302,353
22292,2013-07-24,23,21,157,178
22293,2013-07-25,0,9,71,80
22294,2013-07-25,1,4,44,48
22295,2013-07-25,2,6,10,16
22296,2013-07-25,3,1,8,9
22297,2013-07-25,4,5,6,11
22298,2013-07-25,5,3,39,42
22299,2013-07-25,6,10,191,201
22300,2013-07-25,7,43,588,631
22301,2013-07-25,8,54,897,951
22302,2013-07-25,9,63,347,410
22303,2013-07-25,10,127,185,312
22304,2013-07-25,11,134,199,333
22305,2013-07-25,12,137,280,417
22306,2013-07-25,13,125,301,426
22307,2013-07-25,14,137,249,386
22308,2013-07-25,15,136,311,447
22309,2013-07-25,16,156,471,627
22310,2013-07-25,17,194,1022,1216
22311,2013-07-25,18,160,991,1151
22312,2013-07-25,19,137,626,763
22313,2013-07-25,20,89,497,586
22314,2013-07-25,21,76,374,450
22315,2013-07-25,22,52,309,361
22316,2013-07-25,23,50,181,231
22317,2013-07-26,0,27,75,102
22318,2013-07-26,1,10,35,45
22319,2013-07-26,2,8,23,31
22320,2013-07-26,3,3,6,9
22321,2013-07-26,4,0,8,8
22322,2013-07-26,5,3,45,48
22323,2013-07-26,6,10,193,203
22324,2013-07-26,7,37,550,587
22325,2013-07-26,8,57,863,920
22326,2013-07-26,9,80,382,462
22327,2013-07-26,10,97,227,324
22328,2013-07-26,11,123,237,360
22329,2013-07-26,12,145,350,495
22330,2013-07-26,13,133,361,494
22331,2013-07-26,14,218,318,536
22332,2013-07-26,15,170,356,526
22333,2013-07-26,16,171,569,740
22334,2013-07-26,17,204,912,1116
22335,2013-07-26,18,165,770,935
22336,2013-07-26,19,169,513,682
22337,2013-07-26,20,123,396,519
22338,2013-07-26,21,100,339,439
22339,2013-07-26,22,122,279,401
22340,2013-07-26,23,68,212,280
22341,2013-07-27,0,40,177,217
22342,2013-07-27,1,23,107,130
22343,2013-07-27,2,23,71,94
22344,2013-07-27,3,16,27,43
22345,2013-07-27,4,9,14,23
22346,2013-07-27,5,8,9,17
22347,2013-07-27,6,17,42,59
22348,2013-07-27,7,21,78,99
22349,2013-07-27,8,57,187,244
22350,2013-07-27,9,103,287,390
22351,2013-07-27,10,220,351,571
22352,2013-07-27,11,256,434,690
22353,2013-07-27,12,303,429,732
22354,2013-07-27,13,313,448,761
22355,2013-07-27,14,348,405,753
22356,2013-07-27,15,301,383,684
22357,2013-07-27,16,304,373,677
22358,2013-07-27,17,104,158,262
22359,2013-07-27,18,151,242,393
22360,2013-07-27,19,181,278,459
22361,2013-07-27,20,128,220,348
22362,2013-07-27,21,110,220,330
22363,2013-07-27,22,73,186,259
22364,2013-07-27,23,64,83,147
22365,2013-07-28,0,23,100,123
22366,2013-07-28,1,30,125,155
22367,2013-07-28,2,11,77,88
22368,2013-07-28,3,5,24,29
22369,2013-07-28,4,2,10,12
22370,2013-07-28,5,4,16,20
22371,2013-07-28,6,16,16,32
22372,2013-07-28,7,20,50,70
22373,2013-07-28,8,35,110,145
22374,2013-07-28,9,98,225,323
22375,2013-07-28,10,174,339,513
22376,2013-07-28,11,233,377,610
22377,2013-07-28,12,285,427,712
22378,2013-07-28,13,332,399,731
22379,2013-07-28,14,290,397,687
22380,2013-07-28,15,280,446,726
22381,2013-07-28,16,202,389,591
22382,2013-07-28,17,183,349,532
22383,2013-07-28,18,195,357,552
22384,2013-07-28,19,146,331,477
22385,2013-07-28,20,140,283,423
22386,2013-07-28,21,69,188,257
22387,2013-07-28,22,57,148,205
22388,2013-07-28,23,31,92,123
22389,2013-07-29,0,11,33,44
22390,2013-07-29,1,5,22,27
22391,2013-07-29,2,1,9,10
22392,2013-07-29,3,0,5,5
22393,2013-07-29,4,2,4,6
22394,2013-07-29,5,2,47,49
22395,2013-07-29,6,3,209,212
22396,2013-07-29,7,23,582,605
22397,2013-07-29,8,55,806,861
22398,2013-07-29,9,68,320,388
22399,2013-07-29,10,93,161,254
22400,2013-07-29,11,131,168,299
22401,2013-07-29,12,151,311,462
22402,2013-07-29,13,145,255,400
22403,2013-07-29,14,140,184,324
22404,2013-07-29,15,132,235,367
22405,2013-07-29,16,175,408,583
22406,2013-07-29,17,172,905,1077
22407,2013-07-29,18,157,846,1003
22408,2013-07-29,19,149,659,808
22409,2013-07-29,20,106,467,573
22410,2013-07-29,21,86,335,421
22411,2013-07-29,22,67,220,287
22412,2013-07-29,23,41,136,177
22413,2013-07-30,0,16,44,60
22414,2013-07-30,1,4,12,16
22415,2013-07-30,2,6,13,19
22416,2013-07-30,3,0,5,5
22417,2013-07-30,4,0,4,4
22418,2013-07-30,5,3,50,53
22419,2013-07-30,6,14,235,249
22420,2013-07-30,7,30,658,688
22421,2013-07-30,8,45,836,881
22422,2013-07-30,9,77,330,407
22423,2013-07-30,10,135,180,315
22424,2013-07-30,11,149,240,389
22425,2013-07-30,12,150,275,425
22426,2013-07-30,13,130,272,402
22427,2013-07-30,14,127,240,367
22428,2013-07-30,15,137,289,426
22429,2013-07-30,16,160,421,581
22430,2013-07-30,17,172,956,1128
22431,2013-07-30,18,193,935,1128
22432,2013-07-30,19,134,683,817
22433,2013-07-30,20,103,494,597
22434,2013-07-30,21,77,360,437
22435,2013-07-30,22,60,243,303
22436,2013-07-30,23,33,146,179
22437,2013-07-31,0,8,58,66
22438,2013-07-31,1,7,24,31
22439,2013-07-31,2,3,12,15
22440,2013-07-31,3,0,5,5
22441,2013-07-31,4,1,5,6
22442,2013-07-31,5,2,51,53
22443,2013-07-31,6,7,235,242
22444,2013-07-31,7,31,599,630
22445,2013-07-31,8,37,857,894
22446,2013-07-31,9,91,358,449
22447,2013-07-31,10,99,156,255
22448,2013-07-31,11,103,192,295
22449,2013-07-31,12,102,278,380
22450,2013-07-31,13,120,233,353
22451,2013-07-31,14,118,208,326
22452,2013-07-31,15,110,290,400
22453,2013-07-31,16,117,432,549
22454,2013-07-31,17,152,899,1051
22455,2013-07-31,18,135,895,1030
22456,2013-07-31,19,96,574,670
22457,2013-07-31,20,42,322,364
22458,2013-07-31,21,23,218,241
22459,2013-07-31,22,40,210,250
22460,2013-07-31,23,24,122,146
22461,2013-08-01,0,8,34,42
22462,2013-08-01,1,1,15,16
22463,2013-08-01,2,2,9,11
22464,2013-08-01,3,1,3,4
22465,2013-08-01,4,0,3,3
22466,2013-08-01,5,2,31,33
22467,2013-08-01,6,9,129,138
22468,2013-08-01,7,17,399,416
22469,2013-08-01,8,31,804,835
22470,2013-08-01,9,32,297,329
22471,2013-08-01,10,42,113,155
22472,2013-08-01,11,52,151,203
22473,2013-08-01,12,69,227,296
22474,2013-08-01,13,94,233,327
22475,2013-08-01,14,94,205,299
22476,2013-08-01,15,63,236,299
22477,2013-08-01,16,105,398,503
22478,2013-08-01,17,105,819,924
22479,2013-08-01,18,92,781,873
22480,2013-08-01,19,106,583,689
22481,2013-08-01,20,85,440,525
22482,2013-08-01,21,77,279,356
22483,2013-08-01,22,53,237,290
22484,2013-08-01,23,38,150,188
22485,2013-08-02,0,13,83,96
22486,2013-08-02,1,11,41,52
22487,2013-08-02,2,1,15,16
22488,2013-08-02,3,1,4,5
22489,2013-08-02,4,0,8,8
22490,2013-08-02,5,3,59,62
22491,2013-08-02,6,7,159,166
22492,2013-08-02,7,34,458,492
22493,2013-08-02,8,64,821,885
22494,2013-08-02,9,63,345,408
22495,2013-08-02,10,91,218,309
22496,2013-08-02,11,158,254,412
22497,2013-08-02,12,185,345,530
22498,2013-08-02,13,180,325,505
22499,2013-08-02,14,200,305,505
22500,2013-08-02,15,196,356,552
22501,2013-08-02,16,214,525,739
22502,2013-08-02,17,223,832,1055
22503,2013-08-02,18,142,691,833
22504,2013-08-02,19,157,496,653
22505,2013-08-02,20,137,359,496
22506,2013-08-02,21,135,278,413
22507,2013-08-02,22,97,278,375
22508,2013-08-02,23,46,201,247
22509,2013-08-03,0,40,173,213
22510,2013-08-03,1,33,131,164
22511,2013-08-03,2,30,81,111
22512,2013-08-03,3,19,41,60
22513,2013-08-03,4,2,10,12
22514,2013-08-03,5,3,14,17
22515,2013-08-03,6,10,45,55
22516,2013-08-03,7,16,72,88
22517,2013-08-03,8,34,133,167
22518,2013-08-03,9,64,173,237
22519,2013-08-03,10,173,357,530
22520,2013-08-03,11,203,384,587
22521,2013-08-03,12,278,376,654
22522,2013-08-03,13,341,381,722
22523,2013-08-03,14,349,393,742
22524,2013-08-03,15,402,415,817
22525,2013-08-03,16,316,323,639
22526,2013-08-03,17,313,360,673
22527,2013-08-03,18,231,327,558
22528,2013-08-03,19,164,326,490
22529,2013-08-03,20,162,261,423
22530,2013-08-03,21,42,84,126
22531,2013-08-03,22,60,119,179
22532,2013-08-03,23,28,156,184
22533,2013-08-04,0,53,124,177
22534,2013-08-04,1,26,95,121
22535,2013-08-04,2,47,97,144
22536,2013-08-04,3,21,55,76
22537,2013-08-04,4,4,14,18
22538,2013-08-04,5,11,16,27
22539,2013-08-04,6,9,23,32
22540,2013-08-04,7,9,56,65
22541,2013-08-04,8,57,134,191
22542,2013-08-04,9,121,252,373
22543,2013-08-04,10,247,369,616
22544,2013-08-04,11,370,418,788
22545,2013-08-04,12,383,484,867
22546,2013-08-04,13,402,468,870
22547,2013-08-04,14,422,463,885
22548,2013-08-04,15,383,464,847
22549,2013-08-04,16,392,469,861
22550,2013-08-04,17,348,444,792
22551,2013-08-04,18,301,443,744
22552,2013-08-04,19,272,385,657
22553,2013-08-04,20,209,328,537
22554,2013-08-04,21,132,229,361
22555,2013-08-04,22,68,166,234
22556,2013-08-04,23,30,83,113
22557,2013-08-05,0,6,26,32
22558,2013-08-05,1,5,10,15
22559,2013-08-05,2,5,4,9
22560,2013-08-05,3,8,3,11
22561,2013-08-05,4,5,6,11
22562,2013-08-05,5,3,52,55
22563,2013-08-05,6,9,195,204
22564,2013-08-05,7,27,545,572
22565,2013-08-05,8,55,720,775
22566,2013-08-05,9,72,359,431
22567,2013-08-05,10,124,195,319
22568,2013-08-05,11,176,199,375
22569,2013-08-05,12,167,296,463
22570,2013-08-05,13,188,273,461
22571,2013-08-05,14,208,234,442
22572,2013-08-05,15,189,242,431
22573,2013-08-05,16,203,451,654
22574,2013-08-05,17,202,1015,1217
22575,2013-08-05,18,161,985,1146
22576,2013-08-05,19,166,675,841
22577,2013-08-05,20,158,466,624
22578,2013-08-05,21,83,296,379
22579,2013-08-05,22,91,341,432
22580,2013-08-05,23,33,121,154
22581,2013-08-06,0,16,47,63
22582,2013-08-06,1,11,14,25
22583,2013-08-06,2,3,6,9
22584,2013-08-06,3,0,5,5
22585,2013-08-06,4,1,7,8
22586,2013-08-06,5,2,52,54
22587,2013-08-06,6,9,218,227
22588,2013-08-06,7,11,367,378
22589,2013-08-06,8,36,725,761
22590,2013-08-06,9,37,264,301
22591,2013-08-06,10,69,127,196
22592,2013-08-06,11,113,144,257
22593,2013-08-06,12,97,235,332
22594,2013-08-06,13,117,258,375
22595,2013-08-06,14,110,218,328
22596,2013-08-06,15,152,272,424
22597,2013-08-06,16,148,408,556
22598,2013-08-06,17,159,843,1002
22599,2013-08-06,18,122,926,1048
22600,2013-08-06,19,110,592,702
22601,2013-08-06,20,92,399,491
22602,2013-08-06,21,57,313,370
22603,2013-08-06,22,58,272,330
22604,2013-08-06,23,17,123,140
22605,2013-08-07,0,19,46,65
22606,2013-08-07,1,6,30,36
22607,2013-08-07,2,4,5,9
22608,2013-08-07,3,1,6,7
22609,2013-08-07,4,1,8,9
22610,2013-08-07,5,1,51,52
22611,2013-08-07,6,13,208,221
22612,2013-08-07,7,16,543,559
22613,2013-08-07,8,56,895,951
22614,2013-08-07,9,67,377,444
22615,2013-08-07,10,101,170,271
22616,2013-08-07,11,121,210,331
22617,2013-08-07,12,145,236,381
22618,2013-08-07,13,166,270,436
22619,2013-08-07,14,177,209,386
22620,2013-08-07,15,179,265,444
22621,2013-08-07,16,149,487,636
22622,2013-08-07,17,207,999,1206
22623,2013-08-07,18,180,951,1131
22624,2013-08-07,19,125,660,785
22625,2013-08-07,20,77,451,528
22626,2013-08-07,21,38,335,373
22627,2013-08-07,22,50,246,296
22628,2013-08-07,23,32,130,162
22629,2013-08-08,0,10,57,67
22630,2013-08-08,1,12,18,30
22631,2013-08-08,2,7,11,18
22632,2013-08-08,3,1,10,11
22633,2013-08-08,4,0,4,4
22634,2013-08-08,5,3,53,56
22635,2013-08-08,6,5,196,201
22636,2013-08-08,7,22,564,586
22637,2013-08-08,8,37,862,899
22638,2013-08-08,9,49,377,426
22639,2013-08-08,10,101,185,286
22640,2013-08-08,11,119,188,307
22641,2013-08-08,12,102,279,381
22642,2013-08-08,13,118,281,399
22643,2013-08-08,14,111,242,353
22644,2013-08-08,15,98,273,371
22645,2013-08-08,16,147,425,572
22646,2013-08-08,17,165,808,973
22647,2013-08-08,18,143,855,998
22648,2013-08-08,19,90,598,688
22649,2013-08-08,20,73,412,485
22650,2013-08-08,21,61,284,345
22651,2013-08-08,22,48,206,254
22652,2013-08-08,23,16,141,157
22653,2013-08-09,0,13,95,108
22654,2013-08-09,1,5,43,48
22655,2013-08-09,2,7,23,30
22656,2013-08-09,3,1,8,9
22657,2013-08-09,4,0,6,6
22658,2013-08-09,5,2,49,51
22659,2013-08-09,6,9,152,161
22660,2013-08-09,7,29,469,498
22661,2013-08-09,8,47,784,831
22662,2013-08-09,9,108,402,510
22663,2013-08-09,10,132,208,340
22664,2013-08-09,11,123,232,355
22665,2013-08-09,12,150,302,452
22666,2013-08-09,13,141,330,471
22667,2013-08-09,14,205,290,495
22668,2013-08-09,15,160,322,482
22669,2013-08-09,16,186,516,702
22670,2013-08-09,17,160,757,917
22671,2013-08-09,18,156,675,831
22672,2013-08-09,19,141,490,631
22673,2013-08-09,20,154,420,574
22674,2013-08-09,21,111,304,415
22675,2013-08-09,22,58,235,293
22676,2013-08-09,23,54,197,251
22677,2013-08-10,0,31,148,179
22678,2013-08-10,1,19,115,134
22679,2013-08-10,2,15,81,96
22680,2013-08-10,3,10,32,42
22681,2013-08-10,4,4,12,16
22682,2013-08-10,5,5,10,15
22683,2013-08-10,6,6,33,39
22684,2013-08-10,7,12,80,92
22685,2013-08-10,8,48,159,207
22686,2013-08-10,9,140,308,448
22687,2013-08-10,10,192,349,541
22688,2013-08-10,11,263,400,663
22689,2013-08-10,12,287,403,690
22690,2013-08-10,13,357,429,786
22691,2013-08-10,14,443,443,886
22692,2013-08-10,15,367,392,759
22693,2013-08-10,16,368,405,773
22694,2013-08-10,17,433,409,842
22695,2013-08-10,18,302,424,726
22696,2013-08-10,19,271,384,655
22697,2013-08-10,20,232,263,495
22698,2013-08-10,21,118,218,336
22699,2013-08-10,22,126,259,385
22700,2013-08-10,23,80,162,242
22701,2013-08-11,0,45,161,206
22702,2013-08-11,1,36,139,175
22703,2013-08-11,2,10,101,111
22704,2013-08-11,3,17,50,67
22705,2013-08-11,4,4,10,14
22706,2013-08-11,5,2,14,16
22707,2013-08-11,6,7,38,45
22708,2013-08-11,7,16,52,68
22709,2013-08-11,8,70,115,185
22710,2013-08-11,9,132,219,351
22711,2013-08-11,10,250,306,556
22712,2013-08-11,11,321,387,708
22713,2013-08-11,12,323,403,726
22714,2013-08-11,13,378,387,765
22715,2013-08-11,14,400,439,839
22716,2013-08-11,15,320,395,715
22717,2013-08-11,16,371,419,790
22718,2013-08-11,17,317,430,747
22719,2013-08-11,18,262,428,690
22720,2013-08-11,19,217,383,600
22721,2013-08-11,20,144,298,442
22722,2013-08-11,21,122,217,339
22723,2013-08-11,22,67,143,210
22724,2013-08-11,23,43,75,118
22725,2013-08-12,0,21,45,66
22726,2013-08-12,1,7,21,28
22727,2013-08-12,2,2,14,16
22728,2013-08-12,3,3,7,10
22729,2013-08-12,4,1,3,4
22730,2013-08-12,5,8,55,63
22731,2013-08-12,6,9,196,205
22732,2013-08-12,7,28,512,540
22733,2013-08-12,8,56,784,840
22734,2013-08-12,9,98,316,414
22735,2013-08-12,10,138,158,296
22736,2013-08-12,11,147,185,332
22737,2013-08-12,12,163,248,411
22738,2013-08-12,13,141,257,398
22739,2013-08-12,14,178,207,385
22740,2013-08-12,15,137,254,391
22741,2013-08-12,16,164,431,595
22742,2013-08-12,17,184,960,1144
22743,2013-08-12,18,190,864,1054
22744,2013-08-12,19,165,697,862
22745,2013-08-12,20,139,479,618
22746,2013-08-12,21,98,296,394
22747,2013-08-12,22,48,225,273
22748,2013-08-12,23,28,112,140
22749,2013-08-13,0,21,40,61
22750,2013-08-13,1,11,12,23
22751,2013-08-13,2,1,11,12
22752,2013-08-13,3,4,4,8
22753,2013-08-13,4,1,7,8
22754,2013-08-13,5,3,61,64
22755,2013-08-13,6,10,156,166
22756,2013-08-13,7,12,465,477
22757,2013-08-13,8,20,482,502
22758,2013-08-13,9,49,353,402
22759,2013-08-13,10,93,171,264
22760,2013-08-13,11,91,191,282
22761,2013-08-13,12,115,251,366
22762,2013-08-13,13,105,272,377
22763,2013-08-13,14,120,213,333
22764,2013-08-13,15,138,259,397
22765,2013-08-13,16,158,422,580
22766,2013-08-13,17,148,961,1109
22767,2013-08-13,18,169,865,1034
22768,2013-08-13,19,136,649,785
22769,2013-08-13,20,62,263,325
22770,2013-08-13,21,51,261,312
22771,2013-08-13,22,41,209,250
22772,2013-08-13,23,30,135,165
22773,2013-08-14,0,11,63,74
22774,2013-08-14,1,2,21,23
22775,2013-08-14,2,1,7,8
22776,2013-08-14,3,0,4,4
22777,2013-08-14,4,2,9,11
22778,2013-08-14,5,4,45,49
22779,2013-08-14,6,12,192,204
22780,2013-08-14,7,24,610,634
22781,2013-08-14,8,47,842,889
22782,2013-08-14,9,80,397,477
22783,2013-08-14,10,99,199,298
22784,2013-08-14,11,120,216,336
22785,2013-08-14,12,123,293,416
22786,2013-08-14,13,145,298,443
22787,2013-08-14,14,112,276,388
22788,2013-08-14,15,152,310,462
22789,2013-08-14,16,166,478,644
22790,2013-08-14,17,211,1032,1243
22791,2013-08-14,18,195,1004,1199
22792,2013-08-14,19,182,701,883
22793,2013-08-14,20,114,517,631
22794,2013-08-14,21,90,375,465
22795,2013-08-14,22,70,323,393
22796,2013-08-14,23,35,182,217
22797,2013-08-15,0,10,64,74
22798,2013-08-15,1,4,25,29
22799,2013-08-15,2,2,10,12
22800,2013-08-15,3,0,4,4
22801,2013-08-15,4,1,7,8
22802,2013-08-15,5,4,52,56
22803,2013-08-15,6,11,208,219
22804,2013-08-15,7,27,596,623
22805,2013-08-15,8,64,922,986
22806,2013-08-15,9,67,371,438
22807,2013-08-15,10,121,223,344
22808,2013-08-15,11,127,249,376
22809,2013-08-15,12,160,328,488
22810,2013-08-15,13,150,320,470
22811,2013-08-15,14,193,291,484
22812,2013-08-15,15,194,347,541
22813,2013-08-15,16,191,498,689
22814,2013-08-15,17,204,975,1179
22815,2013-08-15,18,168,918,1086
22816,2013-08-15,19,173,719,892
22817,2013-08-15,20,121,522,643
22818,2013-08-15,21,90,365,455
22819,2013-08-15,22,66,235,301
22820,2013-08-15,23,43,189,232
22821,2013-08-16,0,41,70,111
22822,2013-08-16,1,6,43,49
22823,2013-08-16,2,5,14,19
22824,2013-08-16,3,0,8,8
22825,2013-08-16,4,1,8,9
22826,2013-08-16,5,2,50,52
22827,2013-08-16,6,22,163,185
22828,2013-08-16,7,30,447,477
22829,2013-08-16,8,54,880,934
22830,2013-08-16,9,74,399,473
22831,2013-08-16,10,146,241,387
22832,2013-08-16,11,205,316,521
22833,2013-08-16,12,193,398,591
22834,2013-08-16,13,242,360,602
22835,2013-08-16,14,225,314,539
22836,2013-08-16,15,271,368,639
22837,2013-08-16,16,280,541,821
22838,2013-08-16,17,240,837,1077
22839,2013-08-16,18,204,753,957
22840,2013-08-16,19,156,557,713
22841,2013-08-16,20,173,433,606
22842,2013-08-16,21,104,306,410
22843,2013-08-16,22,73,235,308
22844,2013-08-16,23,47,227,274
22845,2013-08-17,0,34,143,177
22846,2013-08-17,1,26,121,147
22847,2013-08-17,2,19,60,79
22848,2013-08-17,3,13,33,46
22849,2013-08-17,4,5,8,13
22850,2013-08-17,5,5,18,23
22851,2013-08-17,6,7,29,36
22852,2013-08-17,7,15,96,111
22853,2013-08-17,8,37,188,225
22854,2013-08-17,9,149,289,438
22855,2013-08-17,10,241,389,630
22856,2013-08-17,11,312,417,729
22857,2013-08-17,12,409,446,855
22858,2013-08-17,13,406,506,912
22859,2013-08-17,14,454,504,958
22860,2013-08-17,15,508,454,962
22861,2013-08-17,16,459,425,884
22862,2013-08-17,17,451,442,893
22863,2013-08-17,18,355,416,771
22864,2013-08-17,19,260,410,670
22865,2013-08-17,20,191,283,474
22866,2013-08-17,21,187,269,456
22867,2013-08-17,22,135,193,328
22868,2013-08-17,23,59,163,222
22869,2013-08-18,0,61,153,214
22870,2013-08-18,1,18,116,134
22871,2013-08-18,2,17,78,95
22872,2013-08-18,3,4,31,35
22873,2013-08-18,4,1,7,8
22874,2013-08-18,5,5,9,14
22875,2013-08-18,6,5,12,17
22876,2013-08-18,7,9,23,32
22877,2013-08-18,8,25,62,87
22878,2013-08-18,9,28,80,108
22879,2013-08-18,10,65,167,232
22880,2013-08-18,11,87,242,329
22881,2013-08-18,12,110,233,343
22882,2013-08-18,13,55,171,226
22883,2013-08-18,14,100,223,323
22884,2013-08-18,15,172,290,462
22885,2013-08-18,16,209,356,565
22886,2013-08-18,17,197,373,570
22887,2013-08-18,18,173,357,530
22888,2013-08-18,19,153,364,517
22889,2013-08-18,20,90,260,350
22890,2013-08-18,21,76,165,241
22891,2013-08-18,22,61,129,190
22892,2013-08-18,23,28,102,130
22893,2013-08-19,0,18,37,55
22894,2013-08-19,1,10,12,22
22895,2013-08-19,2,2,17,19
22896,2013-08-19,3,1,2,3
22897,2013-08-19,4,0,4,4
22898,2013-08-19,5,2,46,48
22899,2013-08-19,6,12,199,211
22900,2013-08-19,7,17,541,558
22901,2013-08-19,8,49,736,785
22902,2013-08-19,9,54,290,344
22903,2013-08-19,10,110,165,275
22904,2013-08-19,11,126,181,307
22905,2013-08-19,12,125,221,346
22906,2013-08-19,13,150,257,407
22907,2013-08-19,14,150,203,353
22908,2013-08-19,15,169,276,445
22909,2013-08-19,16,199,482,681
22910,2013-08-19,17,148,948,1096
22911,2013-08-19,18,155,849,1004
22912,2013-08-19,19,123,626,749
22913,2013-08-19,20,71,409,480
22914,2013-08-19,21,69,308,377
22915,2013-08-19,22,53,184,237
22916,2013-08-19,23,34,128,162
22917,2013-08-20,0,20,35,55
22918,2013-08-20,1,2,22,24
22919,2013-08-20,2,18,11,29
22920,2013-08-20,3,2,1,3
22921,2013-08-20,4,0,5,5
22922,2013-08-20,5,1,42,43
22923,2013-08-20,6,10,218,228
22924,2013-08-20,7,36,614,650
22925,2013-08-20,8,38,874,912
22926,2013-08-20,9,55,383,438
22927,2013-08-20,10,86,199,285
22928,2013-08-20,11,129,204,333
22929,2013-08-20,12,130,284,414
22930,2013-08-20,13,150,257,407
22931,2013-08-20,14,138,217,355
22932,2013-08-20,15,144,262,406
22933,2013-08-20,16,139,467,606
22934,2013-08-20,17,165,949,1114
22935,2013-08-20,18,124,989,1113
22936,2013-08-20,19,137,681,818
22937,2013-08-20,20,71,477,548
22938,2013-08-20,21,77,324,401
22939,2013-08-20,22,34,223,257
22940,2013-08-20,23,19,116,135
22941,2013-08-21,0,13,52,65
22942,2013-08-21,1,6,24,30
22943,2013-08-21,2,3,4,7
22944,2013-08-21,3,0,4,4
22945,2013-08-21,4,0,3,3
22946,2013-08-21,5,3,60,63
22947,2013-08-21,6,12,219,231
22948,2013-08-21,7,32,596,628
22949,2013-08-21,8,39,877,916
22950,2013-08-21,9,71,345,416
22951,2013-08-21,10,71,177,248
22952,2013-08-21,11,119,206,325
22953,2013-08-21,12,102,285,387
22954,2013-08-21,13,134,274,408
22955,2013-08-21,14,113,231,344
22956,2013-08-21,15,130,264,394
22957,2013-08-21,16,134,425,559
22958,2013-08-21,17,170,955,1125
22959,2013-08-21,18,178,925,1103
22960,2013-08-21,19,161,677,838
22961,2013-08-21,20,96,448,544
22962,2013-08-21,21,31,217,248
22963,2013-08-21,22,18,145,163
22964,2013-08-21,23,10,80,90
22965,2013-08-22,0,7,42,49
22966,2013-08-22,1,4,23,27
22967,2013-08-22,2,1,12,13
22968,2013-08-22,3,0,6,6
22969,2013-08-22,4,0,6,6
22970,2013-08-22,5,1,52,53
22971,2013-08-22,6,10,210,220
22972,2013-08-22,7,19,577,596
22973,2013-08-22,8,46,806,852
22974,2013-08-22,9,78,346,424
22975,2013-08-22,10,105,183,288
22976,2013-08-22,11,121,192,313
22977,2013-08-22,12,172,309,481
22978,2013-08-22,13,133,312,445
22979,2013-08-22,14,123,233,356
22980,2013-08-22,15,125,267,392
22981,2013-08-22,16,149,461,610
22982,2013-08-22,17,160,888,1048
22983,2013-08-22,18,178,927,1105
22984,2013-08-22,19,138,637,775
22985,2013-08-22,20,93,466,559
22986,2013-08-22,21,76,327,403
22987,2013-08-22,22,86,233,319
22988,2013-08-22,23,37,166,203
22989,2013-08-23,0,14,87,101
22990,2013-08-23,1,10,36,46
22991,2013-08-23,2,3,22,25
22992,2013-08-23,3,0,5,5
22993,2013-08-23,4,0,8,8
22994,2013-08-23,5,1,57,58
22995,2013-08-23,6,6,182,188
22996,2013-08-23,7,29,491,520
22997,2013-08-23,8,37,797,834
22998,2013-08-23,9,39,385,424
22999,2013-08-23,10,95,221,316
23000,2013-08-23,11,63,162,225
23001,2013-08-23,12,21,95,116
23002,2013-08-23,13,44,121,165
23003,2013-08-23,14,59,169,228
23004,2013-08-23,15,93,304,397
23005,2013-08-23,16,113,413,526
23006,2013-08-23,17,107,757,864
23007,2013-08-23,18,105,627,732
23008,2013-08-23,19,106,493,599
23009,2013-08-23,20,65,354,419
23010,2013-08-23,21,55,278,333
23011,2013-08-23,22,42,222,264
23012,2013-08-23,23,51,181,232
23013,2013-08-24,0,23,169,192
23014,2013-08-24,1,18,94,112
23015,2013-08-24,2,15,68,83
23016,2013-08-24,3,7,34,41
23017,2013-08-24,4,2,5,7
23018,2013-08-24,5,4,18,22
23019,2013-08-24,6,4,38,42
23020,2013-08-24,7,25,128,153
23021,2013-08-24,8,65,243,308
23022,2013-08-24,9,121,335,456
23023,2013-08-24,10,220,461,681
23024,2013-08-24,11,263,517,780
23025,2013-08-24,12,322,577,899
23026,2013-08-24,13,370,560,930
23027,2013-08-24,14,389,528,917
23028,2013-08-24,15,315,505,820
23029,2013-08-24,16,316,479,795
23030,2013-08-24,17,337,446,783
23031,2013-08-24,18,274,468,742
23032,2013-08-24,19,219,406,625
23033,2013-08-24,20,150,277,427
23034,2013-08-24,21,120,289,409
23035,2013-08-24,22,117,216,333
23036,2013-08-24,23,85,200,285
23037,2013-08-25,0,59,188,247
23038,2013-08-25,1,33,128,161
23039,2013-08-25,2,28,73,101
23040,2013-08-25,3,8,37,45
23041,2013-08-25,4,7,12,19
23042,2013-08-25,5,5,13,18
23043,2013-08-25,6,5,24,29
23044,2013-08-25,7,39,65,104
23045,2013-08-25,8,41,133,174
23046,2013-08-25,9,99,216,315
23047,2013-08-25,10,230,395,625
23048,2013-08-25,11,252,422,674
23049,2013-08-25,12,281,476,757
23050,2013-08-25,13,303,506,809
23051,2013-08-25,14,311,469,780
23052,2013-08-25,15,326,464,790
23053,2013-08-25,16,302,486,788
23054,2013-08-25,17,286,448,734
23055,2013-08-25,18,210,467,677
23056,2013-08-25,19,193,427,620
23057,2013-08-25,20,103,271,374
23058,2013-08-25,21,82,211,293
23059,2013-08-25,22,80,149,229
23060,2013-08-25,23,44,73,117
23061,2013-08-26,0,23,38,61
23062,2013-08-26,1,2,14,16
23063,2013-08-26,2,3,5,8
23064,2013-08-26,3,5,6,11
23065,2013-08-26,4,4,7,11
23066,2013-08-26,5,3,57,60
23067,2013-08-26,6,10,198,208
23068,2013-08-26,7,17,620,637
23069,2013-08-26,8,38,783,821
23070,2013-08-26,9,49,335,384
23071,2013-08-26,10,124,173,297
23072,2013-08-26,11,131,179,310
23073,2013-08-26,12,119,286,405
23074,2013-08-26,13,102,295,397
23075,2013-08-26,14,112,247,359
23076,2013-08-26,15,132,287,419
23077,2013-08-26,16,142,450,592
23078,2013-08-26,17,169,1005,1174
23079,2013-08-26,18,127,851,978
23080,2013-08-26,19,127,696,823
23081,2013-08-26,20,86,455,541
23082,2013-08-26,21,76,296,372
23083,2013-08-26,22,57,195,252
23084,2013-08-26,23,29,104,133
23085,2013-08-27,0,19,49,68
23086,2013-08-27,1,7,20,27
23087,2013-08-27,2,2,9,11
23088,2013-08-27,3,2,4,6
23089,2013-08-27,4,2,7,9
23090,2013-08-27,5,1,60,61
23091,2013-08-27,6,10,229,239
23092,2013-08-27,7,27,629,656
23093,2013-08-27,8,52,854,906
23094,2013-08-27,9,81,390,471
23095,2013-08-27,10,98,185,283
23096,2013-08-27,11,106,195,301
23097,2013-08-27,12,110,312,422
23098,2013-08-27,13,110,238,348
23099,2013-08-27,14,114,251,365
23100,2013-08-27,15,105,299,404
23101,2013-08-27,16,123,481,604
23102,2013-08-27,17,141,987,1128
23103,2013-08-27,18,126,994,1120
23104,2013-08-27,19,99,685,784
23105,2013-08-27,20,70,446,516
23106,2013-08-27,21,57,327,384
23107,2013-08-27,22,44,181,225
23108,2013-08-27,23,32,136,168
23109,2013-08-28,0,21,57,78
23110,2013-08-28,1,4,22,26
23111,2013-08-28,2,7,11,18
23112,2013-08-28,3,2,4,6
23113,2013-08-28,4,2,7,9
23114,2013-08-28,5,1,61,62
23115,2013-08-28,6,8,218,226
23116,2013-08-28,7,19,474,493
23117,2013-08-28,8,55,756,811
23118,2013-08-28,9,61,342,403
23119,2013-08-28,10,57,162,219
23120,2013-08-28,11,75,203,278
23121,2013-08-28,12,60,322,382
23122,2013-08-28,13,43,180,223
23123,2013-08-28,14,60,192,252
23124,2013-08-28,15,60,256,316
23125,2013-08-28,16,80,476,556
23126,2013-08-28,17,101,799,900
23127,2013-08-28,18,105,755,860
23128,2013-08-28,19,49,426,475
23129,2013-08-28,20,45,340,385
23130,2013-08-28,21,39,244,283
23131,2013-08-28,22,22,209,231
23132,2013-08-28,23,17,127,144
23133,2013-08-29,0,15,61,76
23134,2013-08-29,1,4,21,25
23135,2013-08-29,2,5,8,13
23136,2013-08-29,3,2,6,8
23137,2013-08-29,4,2,4,6
23138,2013-08-29,5,1,46,47
23139,2013-08-29,6,14,206,220
23140,2013-08-29,7,22,541,563
23141,2013-08-29,8,46,844,890
23142,2013-08-29,9,74,359,433
23143,2013-08-29,10,94,182,276
23144,2013-08-29,11,116,207,323
23145,2013-08-29,12,116,305,421
23146,2013-08-29,13,111,268,379
23147,2013-08-29,14,99,257,356
23148,2013-08-29,15,120,311,431
23149,2013-08-29,16,156,473,629
23150,2013-08-29,17,183,902,1085
23151,2013-08-29,18,131,870,1001
23152,2013-08-29,19,118,599,717
23153,2013-08-29,20,56,477,533
23154,2013-08-29,21,75,322,397
23155,2013-08-29,22,52,243,295
23156,2013-08-29,23,34,185,219
23157,2013-08-30,0,49,89,138
23158,2013-08-30,1,17,38,55
23159,2013-08-30,2,1,21,22
23160,2013-08-30,3,3,9,12
23161,2013-08-30,4,3,10,13
23162,2013-08-30,5,1,44,45
23163,2013-08-30,6,13,140,153
23164,2013-08-30,7,30,436,466
23165,2013-08-30,8,42,805,847
23166,2013-08-30,9,63,406,469
23167,2013-08-30,10,118,249,367
23168,2013-08-30,11,155,255,410
23169,2013-08-30,12,161,351,512
23170,2013-08-30,13,169,345,514
23171,2013-08-30,14,218,378,596
23172,2013-08-30,15,209,497,706
23173,2013-08-30,16,182,583,765
23174,2013-08-30,17,229,737,966
23175,2013-08-30,18,185,591,776
23176,2013-08-30,19,144,430,574
23177,2013-08-30,20,109,318,427
23178,2013-08-30,21,99,277,376
23179,2013-08-30,22,65,202,267
23180,2013-08-30,23,41,143,184
23181,2013-08-31,0,38,121,159
23182,2013-08-31,1,24,91,115
23183,2013-08-31,2,10,82,92
23184,2013-08-31,3,4,22,26
23185,2013-08-31,4,7,13,20
23186,2013-08-31,5,4,11,15
23187,2013-08-31,6,12,29,41
23188,2013-08-31,7,19,82,101
23189,2013-08-31,8,50,184,234
23190,2013-08-31,9,122,271,393
23191,2013-08-31,10,228,322,550
23192,2013-08-31,11,278,386,664
23193,2013-08-31,12,372,399,771
23194,2013-08-31,13,414,342,756
23195,2013-08-31,14,397,325,722
23196,2013-08-31,15,467,338,805
23197,2013-08-31,16,391,341,732
23198,2013-08-31,17,383,330,713
23199,2013-08-31,18,316,305,621
23200,2013-08-31,19,255,291,546
23201,2013-08-31,20,192,197,389
23202,2013-08-31,21,168,167,335
23203,2013-08-31,22,129,193,322
23204,2013-08-31,23,82,194,276
23205,2013-09-01,0,43,146,189
23206,2013-09-01,1,31,116,147
23207,2013-09-01,2,38,64,102
23208,2013-09-01,3,17,30,47
23209,2013-09-01,4,4,20,24
23210,2013-09-01,5,1,17,18
23211,2013-09-01,6,10,17,27
23212,2013-09-01,7,30,54,84
23213,2013-09-01,8,59,102,161
23214,2013-09-01,9,170,195,365
23215,2013-09-01,10,267,284,551
23216,2013-09-01,11,315,304,619
23217,2013-09-01,12,421,354,775
23218,2013-09-01,13,427,339,766
23219,2013-09-01,14,431,277,708
23220,2013-09-01,15,388,292,680
23221,2013-09-01,16,378,267,645
23222,2013-09-01,17,374,301,675
23223,2013-09-01,18,381,349,730
23224,2013-09-01,19,295,308,603
23225,2013-09-01,20,212,204,416
23226,2013-09-01,21,180,176,356
23227,2013-09-01,22,126,165,291
23228,2013-09-01,23,100,137,237
23229,2013-09-02,0,60,110,170
23230,2013-09-02,1,5,48,53
23231,2013-09-02,2,11,39,50
23232,2013-09-02,3,5,13,18
23233,2013-09-02,4,1,5,6
23234,2013-09-02,5,1,8,9
23235,2013-09-02,6,10,25,35
23236,2013-09-02,7,39,54,93
23237,2013-09-02,8,65,115,180
23238,2013-09-02,9,165,184,349
23239,2013-09-02,10,289,267,556
23240,2013-09-02,11,308,325,633
23241,2013-09-02,12,296,419,715
23242,2013-09-02,13,312,405,717
23243,2013-09-02,14,293,388,681
23244,2013-09-02,15,305,330,635
23245,2013-09-02,16,272,338,610
23246,2013-09-02,17,191,379,570
23247,2013-09-02,18,186,373,559
23248,2013-09-02,19,129,364,493
23249,2013-09-02,20,128,244,372
23250,2013-09-02,21,74,182,256
23251,2013-09-02,22,34,136,170
23252,2013-09-02,23,21,73,94
23253,2013-09-03,0,9,35,44
23254,2013-09-03,1,8,15,23
23255,2013-09-03,2,4,11,15
23256,2013-09-03,3,0,2,2
23257,2013-09-03,4,5,12,17
23258,2013-09-03,5,3,44,47
23259,2013-09-03,6,10,195,205
23260,2013-09-03,7,35,603,638
23261,2013-09-03,8,53,729,782
23262,2013-09-03,9,56,337,393
23263,2013-09-03,10,69,186,255
23264,2013-09-03,11,91,185,276
23265,2013-09-03,12,103,276,379
23266,2013-09-03,13,99,253,352
23267,2013-09-03,14,99,239,338
23268,2013-09-03,15,113,251,364
23269,2013-09-03,16,111,453,564
23270,2013-09-03,17,150,886,1036
23271,2013-09-03,18,111,1003,1114
23272,2013-09-03,19,105,649,754
23273,2013-09-03,20,52,431,483
23274,2013-09-03,21,45,327,372
23275,2013-09-03,22,35,210,245
23276,2013-09-03,23,9,103,112
23277,2013-09-04,0,24,54,78
23278,2013-09-04,1,5,21,26
23279,2013-09-04,2,0,3,3
23280,2013-09-04,3,0,3,3
23281,2013-09-04,4,1,10,11
23282,2013-09-04,5,1,70,71
23283,2013-09-04,6,16,200,216
23284,2013-09-04,7,35,712,747
23285,2013-09-04,8,41,874,915
23286,2013-09-04,9,57,378,435
23287,2013-09-04,10,107,187,294
23288,2013-09-04,11,111,215,326
23289,2013-09-04,12,87,303,390
23290,2013-09-04,13,104,281,385
23291,2013-09-04,14,110,249,359
23292,2013-09-04,15,83,307,390
23293,2013-09-04,16,119,511,630
23294,2013-09-04,17,157,1043,1200
23295,2013-09-04,18,135,964,1099
23296,2013-09-04,19,140,694,834
23297,2013-09-04,20,71,448,519
23298,2013-09-04,21,52,319,371
23299,2013-09-04,22,57,237,294
23300,2013-09-04,23,18,119,137
23301,2013-09-05,0,14,52,66
23302,2013-09-05,1,5,23,28
23303,2013-09-05,2,2,12,14
23304,2013-09-05,3,0,4,4
23305,2013-09-05,4,1,5,6
23306,2013-09-05,5,3,49,52
23307,2013-09-05,6,16,222,238
23308,2013-09-05,7,36,694,730
23309,2013-09-05,8,46,869,915
23310,2013-09-05,9,72,394,466
23311,2013-09-05,10,86,213,299
23312,2013-09-05,11,73,215,288
23313,2013-09-05,12,107,326,433
23314,2013-09-05,13,101,321,422
23315,2013-09-05,14,112,268,380
23316,2013-09-05,15,119,288,407
23317,2013-09-05,16,133,498,631
23318,2013-09-05,17,147,1020,1167
23319,2013-09-05,18,125,944,1069
23320,2013-09-05,19,129,684,813
23321,2013-09-05,20,92,504,596
23322,2013-09-05,21,76,341,417
23323,2013-09-05,22,60,241,301
23324,2013-09-05,23,19,155,174
23325,2013-09-06,0,14,100,114
23326,2013-09-06,1,2,52,54
23327,2013-09-06,2,5,21,26
23328,2013-09-06,3,0,6,6
23329,2013-09-06,4,2,5,7
23330,2013-09-06,5,5,44,49
23331,2013-09-06,6,7,198,205
23332,2013-09-06,7,23,624,647
23333,2013-09-06,8,61,923,984
23334,2013-09-06,9,60,368,428
23335,2013-09-06,10,92,223,315
23336,2013-09-06,11,112,282,394
23337,2013-09-06,12,123,372,495
23338,2013-09-06,13,155,345,500
23339,2013-09-06,14,127,333,460
23340,2013-09-06,15,143,371,514
23341,2013-09-06,16,139,537,676
23342,2013-09-06,17,194,969,1163
23343,2013-09-06,18,146,814,960
23344,2013-09-06,19,122,582,704
23345,2013-09-06,20,87,381,468
23346,2013-09-06,21,75,300,375
23347,2013-09-06,22,67,258,325
23348,2013-09-06,23,53,217,270
23349,2013-09-07,0,50,190,240
23350,2013-09-07,1,19,113,132
23351,2013-09-07,2,11,69,80
23352,2013-09-07,3,7,29,36
23353,2013-09-07,4,2,11,13
23354,2013-09-07,5,3,14,17
23355,2013-09-07,6,8,51,59
23356,2013-09-07,7,15,95,110
23357,2013-09-07,8,45,205,250
23358,2013-09-07,9,109,352,461
23359,2013-09-07,10,178,409,587
23360,2013-09-07,11,226,519,745
23361,2013-09-07,12,276,562,838
23362,2013-09-07,13,317,482,799
23363,2013-09-07,14,329,489,818
23364,2013-09-07,15,275,522,797
23365,2013-09-07,16,305,471,776
23366,2013-09-07,17,292,475,767
23367,2013-09-07,18,226,482,708
23368,2013-09-07,19,183,432,615
23369,2013-09-07,20,127,310,437
23370,2013-09-07,21,83,237,320
23371,2013-09-07,22,68,212,280
23372,2013-09-07,23,57,176,233
23373,2013-09-08,0,49,203,252
23374,2013-09-08,1,17,122,139
23375,2013-09-08,2,12,88,100
23376,2013-09-08,3,10,40,50
23377,2013-09-08,4,6,10,16
23378,2013-09-08,5,21,42,63
23379,2013-09-08,6,16,41,57
23380,2013-09-08,7,28,69,97
23381,2013-09-08,8,64,155,219
23382,2013-09-08,9,128,297,425
23383,2013-09-08,10,185,408,593
23384,2013-09-08,11,273,489,762
23385,2013-09-08,12,301,519,820
23386,2013-09-08,13,298,515,813
23387,2013-09-08,14,279,448,727
23388,2013-09-08,15,282,439,721
23389,2013-09-08,16,276,501,777
23390,2013-09-08,17,235,475,710
23391,2013-09-08,18,206,429,635
23392,2013-09-08,19,136,328,464
23393,2013-09-08,20,69,306,375
23394,2013-09-08,21,50,207,257
23395,2013-09-08,22,62,143,205
23396,2013-09-08,23,29,93,122
23397,2013-09-09,0,8,27,35
23398,2013-09-09,1,5,21,26
23399,2013-09-09,2,1,11,12
23400,2013-09-09,3,1,5,6
23401,2013-09-09,4,2,9,11
23402,2013-09-09,5,4,55,59
23403,2013-09-09,6,11,210,221
23404,2013-09-09,7,32,638,670
23405,2013-09-09,8,48,811,859
23406,2013-09-09,9,61,358,419
23407,2013-09-09,10,86,172,258
23408,2013-09-09,11,116,189,305
23409,2013-09-09,12,88,276,364
23410,2013-09-09,13,105,263,368
23411,2013-09-09,14,101,243,344
23412,2013-09-09,15,97,284,381
23413,2013-09-09,16,121,503,624
23414,2013-09-09,17,132,1024,1156
23415,2013-09-09,18,135,946,1081
23416,2013-09-09,19,68,600,668
23417,2013-09-09,20,55,373,428
23418,2013-09-09,21,50,315,365
23419,2013-09-09,22,31,213,244
23420,2013-09-09,23,23,129,152
23421,2013-09-10,0,7,35,42
23422,2013-09-10,1,3,25,28
23423,2013-09-10,2,2,7,9
23424,2013-09-10,3,0,2,2
23425,2013-09-10,4,3,11,14
23426,2013-09-10,5,3,56,59
23427,2013-09-10,6,15,238,253
23428,2013-09-10,7,52,736,788
23429,2013-09-10,8,47,869,916
23430,2013-09-10,9,57,342,399
23431,2013-09-10,10,72,152,224
23432,2013-09-10,11,111,207,318
23433,2013-09-10,12,88,314,402
23434,2013-09-10,13,75,269,344
23435,2013-09-10,14,109,191,300
23436,2013-09-10,15,90,270,360
23437,2013-09-10,16,109,461,570
23438,2013-09-10,17,144,949,1093
23439,2013-09-10,18,127,977,1104
23440,2013-09-10,19,116,663,779
23441,2013-09-10,20,84,488,572
23442,2013-09-10,21,49,338,387
23443,2013-09-10,22,53,260,313
23444,2013-09-10,23,18,135,153
23445,2013-09-11,0,13,57,70
23446,2013-09-11,1,8,24,32
23447,2013-09-11,2,7,9,16
23448,2013-09-11,3,0,5,5
23449,2013-09-11,4,1,8,9
23450,2013-09-11,5,5,65,70
23451,2013-09-11,6,11,223,234
23452,2013-09-11,7,42,644,686
23453,2013-09-11,8,47,922,969
23454,2013-09-11,9,48,356,404
23455,2013-09-11,10,60,169,229
23456,2013-09-11,11,62,191,253
23457,2013-09-11,12,69,261,330
23458,2013-09-11,13,77,239,316
23459,2013-09-11,14,59,207,266
23460,2013-09-11,15,69,263,332
23461,2013-09-11,16,110,428,538
23462,2013-09-11,17,121,957,1078
23463,2013-09-11,18,112,937,1049
23464,2013-09-11,19,114,706,820
23465,2013-09-11,20,74,484,558
23466,2013-09-11,21,61,350,411
23467,2013-09-11,22,64,251,315
23468,2013-09-11,23,37,148,185
23469,2013-09-12,0,18,60,78
23470,2013-09-12,1,7,30,37
23471,2013-09-12,2,0,9,9
23472,2013-09-12,3,0,8,8
23473,2013-09-12,4,2,13,15
23474,2013-09-12,5,7,57,64
23475,2013-09-12,6,11,232,243
23476,2013-09-12,7,30,713,743
23477,2013-09-12,8,35,896,931
23478,2013-09-12,9,48,378,426
23479,2013-09-12,10,81,219,300
23480,2013-09-12,11,89,188,277
23481,2013-09-12,12,84,237,321
23482,2013-09-12,13,84,242,326
23483,2013-09-12,14,60,192,252
23484,2013-09-12,15,100,257,357
23485,2013-09-12,16,85,369,454
23486,2013-09-12,17,37,272,309
23487,2013-09-12,18,30,269,299
23488,2013-09-12,19,36,372,408
23489,2013-09-12,20,33,355,388
23490,2013-09-12,21,28,305,333
23491,2013-09-12,22,27,218,245
23492,2013-09-12,23,14,144,158
23493,2013-09-13,0,17,74,91
23494,2013-09-13,1,6,34,40
23495,2013-09-13,2,0,23,23
23496,2013-09-13,3,1,8,9
23497,2013-09-13,4,2,9,11
23498,2013-09-13,5,5,55,60
23499,2013-09-13,6,3,203,206
23500,2013-09-13,7,24,606,630
23501,2013-09-13,8,38,878,916
23502,2013-09-13,9,56,359,415
23503,2013-09-13,10,58,214,272
23504,2013-09-13,11,110,262,372
23505,2013-09-13,12,116,336,452
23506,2013-09-13,13,125,337,462
23507,2013-09-13,14,123,345,468
23508,2013-09-13,15,120,389,509
23509,2013-09-13,16,135,601,736
23510,2013-09-13,17,159,977,1136
23511,2013-09-13,18,113,856,969
23512,2013-09-13,19,109,583,692
23513,2013-09-13,20,85,406,491
23514,2013-09-13,21,80,288,368
23515,2013-09-13,22,66,311,377
23516,2013-09-13,23,38,188,226
23517,2013-09-14,0,41,137,178
23518,2013-09-14,1,23,124,147
23519,2013-09-14,2,25,87,112
23520,2013-09-14,3,14,42,56
23521,2013-09-14,4,2,12,14
23522,2013-09-14,5,0,14,14
23523,2013-09-14,6,7,55,62
23524,2013-09-14,7,23,114,137
23525,2013-09-14,8,55,224,279
23526,2013-09-14,9,110,340,450
23527,2013-09-14,10,181,439,620
23528,2013-09-14,11,299,509,808
23529,2013-09-14,12,332,567,899
23530,2013-09-14,13,402,535,937
23531,2013-09-14,14,369,538,907
23532,2013-09-14,15,424,517,941
23533,2013-09-14,16,366,482,848
23534,2013-09-14,17,355,492,847
23535,2013-09-14,18,339,489,828
23536,2013-09-14,19,234,392,626
23537,2013-09-14,20,130,310,440
23538,2013-09-14,21,82,287,369
23539,2013-09-14,22,83,255,338
23540,2013-09-14,23,47,226,273
23541,2013-09-15,0,30,151,181
23542,2013-09-15,1,24,150,174
23543,2013-09-15,2,13,108,121
23544,2013-09-15,3,16,52,68
23545,2013-09-15,4,0,5,5
23546,2013-09-15,5,2,9,11
23547,2013-09-15,6,5,14,19
23548,2013-09-15,7,4,48,52
23549,2013-09-15,8,51,153,204
23550,2013-09-15,9,127,238,365
23551,2013-09-15,10,221,409,630
23552,2013-09-15,11,262,509,771
23553,2013-09-15,12,331,617,948
23554,2013-09-15,13,352,478,830
23555,2013-09-15,14,317,502,819
23556,2013-09-15,15,296,443,739
23557,2013-09-15,16,301,555,856
23558,2013-09-15,17,288,522,810
23559,2013-09-15,18,196,499,695
23560,2013-09-15,19,143,376,519
23561,2013-09-15,20,103,301,404
23562,2013-09-15,21,59,182,241
23563,2013-09-15,22,32,138,170
23564,2013-09-15,23,27,86,113
23565,2013-09-16,0,12,50,62
23566,2013-09-16,1,9,13,22
23567,2013-09-16,2,2,8,10
23568,2013-09-16,3,2,7,9
23569,2013-09-16,4,0,7,7
23570,2013-09-16,5,2,62,64
23571,2013-09-16,6,6,214,220
23572,2013-09-16,7,23,632,655
23573,2013-09-16,8,38,860,898
23574,2013-09-16,9,41,283,324
23575,2013-09-16,10,36,96,132
23576,2013-09-16,11,52,128,180
23577,2013-09-16,12,48,252,300
23578,2013-09-16,13,82,224,306
23579,2013-09-16,14,71,222,293
23580,2013-09-16,15,80,266,346
23581,2013-09-16,16,92,473,565
23582,2013-09-16,17,109,962,1071
23583,2013-09-16,18,106,888,994
23584,2013-09-16,19,77,573,650
23585,2013-09-16,20,74,380,454
23586,2013-09-16,21,50,287,337
23587,2013-09-16,22,48,200,248
23588,2013-09-16,23,24,97,121
23589,2013-09-17,0,7,41,48
23590,2013-09-17,1,1,17,18
23591,2013-09-17,2,0,11,11
23592,2013-09-17,3,0,5,5
23593,2013-09-17,4,1,8,9
23594,2013-09-17,5,1,63,64
23595,2013-09-17,6,10,248,258
23596,2013-09-17,7,30,737,767
23597,2013-09-17,8,39,866,905
23598,2013-09-17,9,46,365,411
23599,2013-09-17,10,79,201,280
23600,2013-09-17,11,109,209,318
23601,2013-09-17,12,87,336,423
23602,2013-09-17,13,85,298,383
23603,2013-09-17,14,109,309,418
23604,2013-09-17,15,98,334,432
23605,2013-09-17,16,125,575,700
23606,2013-09-17,17,93,1045,1138
23607,2013-09-17,18,140,1065,1205
23608,2013-09-17,19,63,641,704
23609,2013-09-17,20,48,432,480
23610,2013-09-17,21,53,394,447
23611,2013-09-17,22,20,246,266
23612,2013-09-17,23,25,121,146
23613,2013-09-18,0,8,54,62
23614,2013-09-18,1,3,24,27
23615,2013-09-18,2,0,9,9
23616,2013-09-18,3,0,3,3
23617,2013-09-18,4,2,12,14
23618,2013-09-18,5,4,58,62
23619,2013-09-18,6,4,219,223
23620,2013-09-18,7,29,726,755
23621,2013-09-18,8,36,939,975
23622,2013-09-18,9,29,413,442
23623,2013-09-18,10,59,207,266
23624,2013-09-18,11,90,240,330
23625,2013-09-18,12,112,295,407
23626,2013-09-18,13,102,304,406
23627,2013-09-18,14,115,302,417
23628,2013-09-18,15,122,315,437
23629,2013-09-18,16,112,520,632
23630,2013-09-18,17,122,1131,1253
23631,2013-09-18,18,109,990,1099
23632,2013-09-18,19,78,641,719
23633,2013-09-18,20,55,446,501
23634,2013-09-18,21,32,366,398
23635,2013-09-18,22,50,297,347
23636,2013-09-18,23,25,143,168
23637,2013-09-19,0,17,44,61
23638,2013-09-19,1,11,24,35
23639,2013-09-19,2,2,11,13
23640,2013-09-19,3,0,8,8
23641,2013-09-19,4,5,6,11
23642,2013-09-19,5,3,58,61
23643,2013-09-19,6,10,228,238
23644,2013-09-19,7,31,689,720
23645,2013-09-19,8,44,940,984
23646,2013-09-19,9,52,425,477
23647,2013-09-19,10,103,239,342
23648,2013-09-19,11,109,261,370
23649,2013-09-19,12,119,324,443
23650,2013-09-19,13,105,305,410
23651,2013-09-19,14,140,289,429
23652,2013-09-19,15,122,331,453
23653,2013-09-19,16,140,496,636
23654,2013-09-19,17,168,1069,1237
23655,2013-09-19,18,162,969,1131
23656,2013-09-19,19,95,626,721
23657,2013-09-19,20,69,443,512
23658,2013-09-19,21,60,410,470
23659,2013-09-19,22,37,322,359
23660,2013-09-19,23,33,206,239
23661,2013-09-20,0,19,97,116
23662,2013-09-20,1,5,46,51
23663,2013-09-20,2,5,18,23
23664,2013-09-20,3,3,4,7
23665,2013-09-20,4,4,14,18
23666,2013-09-20,5,2,44,46
23667,2013-09-20,6,5,201,206
23668,2013-09-20,7,22,642,664
23669,2013-09-20,8,46,893,939
23670,2013-09-20,9,63,432,495
23671,2013-09-20,10,105,223,328
23672,2013-09-20,11,126,286,412
23673,2013-09-20,12,134,364,498
23674,2013-09-20,13,141,338,479
23675,2013-09-20,14,164,343,507
23676,2013-09-20,15,208,414,622
23677,2013-09-20,16,150,581,731
23678,2013-09-20,17,173,1007,1180
23679,2013-09-20,18,148,873,1021
23680,2013-09-20,19,107,555,662
23681,2013-09-20,20,90,406,496
23682,2013-09-20,21,88,340,428
23683,2013-09-20,22,69,273,342
23684,2013-09-20,23,32,240,272
23685,2013-09-21,0,35,169,204
23686,2013-09-21,1,25,136,161
23687,2013-09-21,2,29,82,111
23688,2013-09-21,3,12,45,57
23689,2013-09-21,4,6,15,21
23690,2013-09-21,5,1,14,15
23691,2013-09-21,6,4,34,38
23692,2013-09-21,7,17,112,129
23693,2013-09-21,8,35,230,265
23694,2013-09-21,9,108,360,468
23695,2013-09-21,10,210,452,662
23696,2013-09-21,11,255,532,787
23697,2013-09-21,12,339,564,903
23698,2013-09-21,13,328,526,854
23699,2013-09-21,14,283,473,756
23700,2013-09-21,15,237,344,581
23701,2013-09-21,16,74,141,215
23702,2013-09-21,17,70,87,157
23703,2013-09-21,18,23,96,119
23704,2013-09-21,19,21,98,119
23705,2013-09-21,20,12,53,65
23706,2013-09-21,21,7,10,17
23707,2013-09-21,22,3,32,35
23708,2013-09-21,23,15,86,101
23709,2013-09-22,0,16,93,109
23710,2013-09-22,1,8,83,91
23711,2013-09-22,2,2,46,48
23712,2013-09-22,3,5,35,40
23713,2013-09-22,4,3,11,14
23714,2013-09-22,5,2,13,15
23715,2013-09-22,6,6,19,25
23716,2013-09-22,7,13,60,73
23717,2013-09-22,8,48,167,215
23718,2013-09-22,9,131,267,398
23719,2013-09-22,10,189,446,635
23720,2013-09-22,11,220,490,710
23721,2013-09-22,12,245,609,854
23722,2013-09-22,13,289,554,843
23723,2013-09-22,14,320,524,844
23724,2013-09-22,15,276,467,743
23725,2013-09-22,16,293,632,925
23726,2013-09-22,17,200,526,726
23727,2013-09-22,18,185,460,645
23728,2013-09-22,19,119,392,511
23729,2013-09-22,20,80,288,368
23730,2013-09-22,21,39,173,212
23731,2013-09-22,22,40,153,193
23732,2013-09-22,23,20,82,102
23733,2013-09-23,0,4,47,51
23734,2013-09-23,1,7,16,23
23735,2013-09-23,2,1,5,6
23736,2013-09-23,3,0,5,5
23737,2013-09-23,4,1,12,13
23738,2013-09-23,5,2,53,55
23739,2013-09-23,6,3,197,200
23740,2013-09-23,7,27,590,617
23741,2013-09-23,8,42,792,834
23742,2013-09-23,9,58,358,416
23743,2013-09-23,10,61,178,239
23744,2013-09-23,11,98,211,309
23745,2013-09-23,12,92,299,391
23746,2013-09-23,13,108,292,400
23747,2013-09-23,14,113,276,389
23748,2013-09-23,15,111,317,428
23749,2013-09-23,16,115,496,611
23750,2013-09-23,17,149,1059,1208
23751,2013-09-23,18,116,929,1045
23752,2013-09-23,19,63,625,688
23753,2013-09-23,20,46,400,446
23754,2013-09-23,21,32,287,319
23755,2013-09-23,22,16,164,180
23756,2013-09-23,23,7,100,107
23757,2013-09-24,0,6,27,33
23758,2013-09-24,1,5,19,24
23759,2013-09-24,2,1,7,8
23760,2013-09-24,3,2,1,3
23761,2013-09-24,4,0,11,11
23762,2013-09-24,5,4,53,57
23763,2013-09-24,6,10,222,232
23764,2013-09-24,7,22,705,727
23765,2013-09-24,8,34,911,945
23766,2013-09-24,9,43,394,437
23767,2013-09-24,10,62,170,232
23768,2013-09-24,11,84,250,334
23769,2013-09-24,12,58,304,362
23770,2013-09-24,13,69,265,334
23771,2013-09-24,14,86,264,350
23772,2013-09-24,15,95,297,392
23773,2013-09-24,16,113,502,615
23774,2013-09-24,17,131,1079,1210
23775,2013-09-24,18,115,1061,1176
23776,2013-09-24,19,72,699,771
23777,2013-09-24,20,47,426,473
23778,2013-09-24,21,39,330,369
23779,2013-09-24,22,29,227,256
23780,2013-09-24,23,17,121,138
23781,2013-09-25,0,7,40,47
23782,2013-09-25,1,2,21,23
23783,2013-09-25,2,3,6,9
23784,2013-09-25,4,1,12,13
23785,2013-09-25,5,1,54,55
23786,2013-09-25,6,8,217,225
23787,2013-09-25,7,35,656,691
23788,2013-09-25,8,51,944,995
23789,2013-09-25,9,38,429,467
23790,2013-09-25,10,48,257,305
23791,2013-09-25,11,62,260,322
23792,2013-09-25,12,53,324,377
23793,2013-09-25,13,85,297,382
23794,2013-09-25,14,93,253,346
23795,2013-09-25,15,104,291,395
23796,2013-09-25,16,98,527,625
23797,2013-09-25,17,131,1055,1186
23798,2013-09-25,18,113,970,1083
23799,2013-09-25,19,74,652,726
23800,2013-09-25,20,60,441,501
23801,2013-09-25,21,62,309,371
23802,2013-09-25,22,27,225,252
23803,2013-09-25,23,13,115,128
23804,2013-09-26,0,11,53,64
23805,2013-09-26,1,5,28,33
23806,2013-09-26,2,0,12,12
23807,2013-09-26,3,0,4,4
23808,2013-09-26,4,1,6,7
23809,2013-09-26,5,1,57,58
23810,2013-09-26,6,6,215,221
23811,2013-09-26,7,28,685,713
23812,2013-09-26,8,38,908,946
23813,2013-09-26,9,45,427,472
23814,2013-09-26,10,53,232,285
23815,2013-09-26,11,91,213,304
23816,2013-09-26,12,93,321,414
23817,2013-09-26,13,89,291,380
23818,2013-09-26,14,108,294,402
23819,2013-09-26,15,92,340,432
23820,2013-09-26,16,134,486,620
23821,2013-09-26,17,182,993,1175
23822,2013-09-26,18,123,1056,1179
23823,2013-09-26,19,62,642,704
23824,2013-09-26,20,48,444,492
23825,2013-09-26,21,31,344,375
23826,2013-09-26,22,37,253,290
23827,2013-09-26,23,15,191,206
23828,2013-09-27,0,15,94,109
23829,2013-09-27,1,10,56,66
23830,2013-09-27,2,7,14,21
23831,2013-09-27,3,2,6,8
23832,2013-09-27,4,1,8,9
23833,2013-09-27,5,3,52,55
23834,2013-09-27,6,4,180,184
23835,2013-09-27,7,32,568,600
23836,2013-09-27,8,45,908,953
23837,2013-09-27,9,62,424,486
23838,2013-09-27,10,57,200,257
23839,2013-09-27,11,112,262,374
23840,2013-09-27,12,106,370,476
23841,2013-09-27,13,141,358,499
23842,2013-09-27,14,158,348,506
23843,2013-09-27,15,163,353,516
23844,2013-09-27,16,139,582,721
23845,2013-09-27,17,164,951,1115
23846,2013-09-27,18,116,851,967
23847,2013-09-27,19,113,536,649
23848,2013-09-27,20,67,338,405
23849,2013-09-27,21,62,287,349
23850,2013-09-27,22,36,263,299
23851,2013-09-27,23,19,214,233
23852,2013-09-28,0,18,155,173
23853,2013-09-28,1,18,119,137
23854,2013-09-28,2,14,84,98
23855,2013-09-28,3,10,33,43
23856,2013-09-28,4,6,17,23
23857,2013-09-28,5,7,15,22
23858,2013-09-28,6,5,37,42
23859,2013-09-28,7,15,122,137
23860,2013-09-28,8,44,203,247
23861,2013-09-28,9,83,312,395
23862,2013-09-28,10,183,459,642
23863,2013-09-28,11,212,453,665
23864,2013-09-28,12,308,482,790
23865,2013-09-28,13,352,445,797
23866,2013-09-28,14,381,515,896
23867,2013-09-28,15,391,458,849
23868,2013-09-28,16,354,467,821
23869,2013-09-28,17,359,463,822
23870,2013-09-28,18,253,403,656
23871,2013-09-28,19,190,370,560
23872,2013-09-28,20,99,321,420
23873,2013-09-28,21,76,208,284
23874,2013-09-28,22,61,225,286
23875,2013-09-28,23,62,188,250
23876,2013-09-29,0,36,138,174
23877,2013-09-29,1,27,106,133
23878,2013-09-29,2,31,114,145
23879,2013-09-29,3,29,38,67
23880,2013-09-29,4,9,14,23
23881,2013-09-29,5,4,6,10
23882,2013-09-29,6,4,21,25
23883,2013-09-29,7,17,54,71
23884,2013-09-29,8,43,125,168
23885,2013-09-29,9,115,215,330
23886,2013-09-29,10,201,395,596
23887,2013-09-29,11,263,449,712
23888,2013-09-29,12,304,545,849
23889,2013-09-29,13,279,496,775
23890,2013-09-29,14,280,465,745
23891,2013-09-29,15,338,462,800
23892,2013-09-29,16,270,471,741
23893,2013-09-29,17,282,460,742
23894,2013-09-29,18,203,470,673
23895,2013-09-29,19,129,425,554
23896,2013-09-29,20,82,247,329
23897,2013-09-29,21,49,177,226
23898,2013-09-29,22,58,183,241
23899,2013-09-29,23,27,94,121
23900,2013-09-30,0,23,44,67
23901,2013-09-30,1,3,15,18
23902,2013-09-30,2,4,12,16
23903,2013-09-30,3,0,5,5
23904,2013-09-30,4,0,10,10
23905,2013-09-30,5,1,43,44
23906,2013-09-30,6,8,219,227
23907,2013-09-30,7,25,612,637
23908,2013-09-30,8,62,783,845
23909,2013-09-30,9,62,351,413
23910,2013-09-30,10,92,175,267
23911,2013-09-30,11,103,214,317
23912,2013-09-30,12,94,288,382
23913,2013-09-30,13,104,259,363
23914,2013-09-30,14,82,244,326
23915,2013-09-30,15,102,284,386
23916,2013-09-30,16,84,538,622
23917,2013-09-30,17,173,978,1151
23918,2013-09-30,18,100,989,1089
23919,2013-09-30,19,66,623,689
23920,2013-09-30,20,64,402,466
23921,2013-09-30,21,43,288,331
23922,2013-09-30,22,30,196,226
23923,2013-09-30,23,13,122,135
23924,2013-10-01,0,12,52,64
23925,2013-10-01,1,0,28,28
23926,2013-10-01,2,3,11,14
23927,2013-10-01,3,1,2,3
23928,2013-10-01,4,0,8,8
23929,2013-10-01,5,6,45,51
23930,2013-10-01,6,4,200,204
23931,2013-10-01,7,27,730,757
23932,2013-10-01,8,37,906,943
23933,2013-10-01,9,46,409,455
23934,2013-10-01,10,90,240,330
23935,2013-10-01,11,94,311,405
23936,2013-10-01,12,121,382,503
23937,2013-10-01,13,132,376,508
23938,2013-10-01,14,116,361,477
23939,2013-10-01,15,96,366,462
23940,2013-10-01,16,125,529,654
23941,2013-10-01,17,149,1025,1174
23942,2013-10-01,18,97,1062,1159
23943,2013-10-01,19,59,681,740
23944,2013-10-01,20,46,421,467
23945,2013-10-01,21,37,321,358
23946,2013-10-01,22,31,267,298
23947,2013-10-01,23,10,183,193
23948,2013-10-02,0,6,71,77
23949,2013-10-02,1,6,22,28
23950,2013-10-02,2,2,14,16
23951,2013-10-02,3,0,4,4
23952,2013-10-02,4,0,7,7
23953,2013-10-02,5,5,45,50
23954,2013-10-02,6,11,193,204
23955,2013-10-02,7,25,609,634
23956,2013-10-02,8,47,896,943
23957,2013-10-02,9,30,444,474
23958,2013-10-02,10,55,234,289
23959,2013-10-02,11,50,294,344
23960,2013-10-02,12,118,401,519
23961,2013-10-02,13,86,386,472
23962,2013-10-02,14,102,347,449
23963,2013-10-02,15,113,370,483
23964,2013-10-02,16,115,519,634
23965,2013-10-02,17,155,1080,1235
23966,2013-10-02,18,116,1016,1132
23967,2013-10-02,19,92,701,793
23968,2013-10-02,20,54,491,545
23969,2013-10-02,21,55,358,413
23970,2013-10-02,22,29,266,295
23971,2013-10-02,23,17,191,208
23972,2013-10-03,0,11,58,69
23973,2013-10-03,1,6,32,38
23974,2013-10-03,2,0,16,16
23975,2013-10-03,3,0,6,6
23976,2013-10-03,4,0,7,7
23977,2013-10-03,5,4,45,49
23978,2013-10-03,6,8,200,208
23979,2013-10-03,7,27,570,597
23980,2013-10-03,8,34,924,958
23981,2013-10-03,9,60,424,484
23982,2013-10-03,10,75,234,309
23983,2013-10-03,11,106,321,427
23984,2013-10-03,12,102,374,476
23985,2013-10-03,13,93,386,479
23986,2013-10-03,14,98,363,461
23987,2013-10-03,15,101,359,460
23988,2013-10-03,16,95,560,655
23989,2013-10-03,17,113,953,1066
23990,2013-10-03,18,93,1004,1097
23991,2013-10-03,19,49,640,689
23992,2013-10-03,20,50,453,503
23993,2013-10-03,21,60,393,453
23994,2013-10-03,22,38,283,321
23995,2013-10-03,23,25,205,230
23996,2013-10-04,0,11,118,129
23997,2013-10-04,1,3,29,32
23998,2013-10-04,2,11,29,40
23999,2013-10-04,3,3,11,14
24000,2013-10-04,4,0,6,6
24001,2013-10-04,5,0,48,48
24002,2013-10-04,6,7,165,172
24003,2013-10-04,7,10,517,527
24004,2013-10-04,8,44,887,931
24005,2013-10-04,9,66,407,473
24006,2013-10-04,10,77,217,294
24007,2013-10-04,11,118,312,430
24008,2013-10-04,12,155,398,553
24009,2013-10-04,13,152,443,595
24010,2013-10-04,14,160,397,557
24011,2013-10-04,15,167,389,556
24012,2013-10-04,16,130,561,691
24013,2013-10-04,17,151,907,1058
24014,2013-10-04,18,126,829,955
24015,2013-10-04,19,83,598,681
24016,2013-10-04,20,62,381,443
24017,2013-10-04,21,51,321,372
24018,2013-10-04,22,41,254,295
24019,2013-10-04,23,39,267,306
24020,2013-10-05,0,23,199,222
24021,2013-10-05,1,18,140,158
24022,2013-10-05,2,16,95,111
24023,2013-10-05,3,4,48,52
24024,2013-10-05,4,1,10,11
24025,2013-10-05,5,1,13,14
24026,2013-10-05,6,7,28,35
24027,2013-10-05,7,22,118,140
24028,2013-10-05,8,37,234,271
24029,2013-10-05,9,90,364,454
24030,2013-10-05,10,177,445,622
24031,2013-10-05,11,311,500,811
24032,2013-10-05,12,370,529,899
24033,2013-10-05,13,442,512,954
24034,2013-10-05,14,337,460,797
24035,2013-10-05,15,324,490,814
24036,2013-10-05,16,372,478,850
24037,2013-10-05,17,231,461,692
24038,2013-10-05,18,201,490,691
24039,2013-10-05,19,131,423,554
24040,2013-10-05,20,88,280,368
24041,2013-10-05,21,85,268,353
24042,2013-10-05,22,54,228,282
24043,2013-10-05,23,58,242,300
24044,2013-10-06,0,48,218,266
24045,2013-10-06,1,31,148,179
24046,2013-10-06,2,12,132,144
24047,2013-10-06,3,15,42,57
24048,2013-10-06,4,0,14,14
24049,2013-10-06,5,2,9,11
24050,2013-10-06,6,5,20,25
24051,2013-10-06,7,20,56,76
24052,2013-10-06,8,53,144,197
24053,2013-10-06,9,133,294,427
24054,2013-10-06,10,204,378,582
24055,2013-10-06,11,290,476,766
24056,2013-10-06,12,297,585,882
24057,2013-10-06,13,343,504,847
24058,2013-10-06,14,307,536,843
24059,2013-10-06,15,316,461,777
24060,2013-10-06,16,263,528,791
24061,2013-10-06,17,214,516,730
24062,2013-10-06,18,156,487,643
24063,2013-10-06,19,78,399,477
24064,2013-10-06,20,74,273,347
24065,2013-10-06,21,58,205,263
24066,2013-10-06,22,30,144,174
24067,2013-10-06,23,41,89,130
24068,2013-10-07,0,8,36,44
24069,2013-10-07,1,4,21,25
24070,2013-10-07,2,1,7,8
24071,2013-10-07,3,6,5,11
24072,2013-10-07,4,0,12,12
24073,2013-10-07,5,3,41,44
24074,2013-10-07,6,6,192,198
24075,2013-10-07,7,9,544,553
24076,2013-10-07,8,30,795,825
24077,2013-10-07,9,27,298,325
24078,2013-10-07,10,48,167,215
24079,2013-10-07,11,23,77,100
24080,2013-10-07,12,3,22,25
24081,2013-10-07,13,1,28,29
24082,2013-10-07,14,5,32,37
24083,2013-10-07,15,7,90,97
24084,2013-10-07,16,26,227,253
24085,2013-10-07,17,38,643,681
24086,2013-10-07,18,46,702,748
24087,2013-10-07,19,54,559,613
24088,2013-10-07,20,33,352,385
24089,2013-10-07,21,15,267,282
24090,2013-10-07,22,17,177,194
24091,2013-10-07,23,10,83,93
24092,2013-10-08,0,7,39,46
24093,2013-10-08,1,3,14,17
24094,2013-10-08,2,2,3,5
24095,2013-10-08,3,0,6,6
24096,2013-10-08,4,4,7,11
24097,2013-10-08,5,1,43,44
24098,2013-10-08,6,5,205,210
24099,2013-10-08,7,28,645,673
24100,2013-10-08,8,32,989,1021
24101,2013-10-08,9,43,396,439
24102,2013-10-08,10,64,197,261
24103,2013-10-08,11,96,246,342
24104,2013-10-08,12,81,363,444
24105,2013-10-08,13,99,357,456
24106,2013-10-08,14,148,309,457
24107,2013-10-08,15,139,374,513
24108,2013-10-08,16,116,524,640
24109,2013-10-08,17,128,953,1081
24110,2013-10-08,18,96,982,1078
24111,2013-10-08,19,59,640,699
24112,2013-10-08,20,31,505,536
24113,2013-10-08,21,40,345,385
24114,2013-10-08,22,36,288,324
24115,2013-10-08,23,20,119,139
24116,2013-10-09,0,21,56,77
24117,2013-10-09,1,10,23,33
24118,2013-10-09,2,5,8,13
24119,2013-10-09,3,2,6,8
24120,2013-10-09,4,1,10,11
24121,2013-10-09,5,1,53,54
24122,2013-10-09,6,9,205,214
24123,2013-10-09,7,29,586,615
24124,2013-10-09,8,46,901,947
24125,2013-10-09,9,58,398,456
24126,2013-10-09,10,57,205,262
24127,2013-10-09,11,64,255,319
24128,2013-10-09,12,95,295,390
24129,2013-10-09,13,87,321,408
24130,2013-10-09,14,71,263,334
24131,2013-10-09,15,66,276,342
24132,2013-10-09,16,34,338,372
24133,2013-10-09,17,36,317,353
24134,2013-10-09,18,18,288,306
24135,2013-10-09,19,11,238,249
24136,2013-10-09,20,9,159,168
24137,2013-10-09,21,11,163,174
24138,2013-10-09,22,11,144,155
24139,2013-10-09,23,4,95,99
24140,2013-10-10,0,10,38,48
24141,2013-10-10,1,0,18,18
24142,2013-10-10,2,0,8,8
24143,2013-10-10,3,0,1,1
24144,2013-10-10,4,1,5,6
24145,2013-10-10,5,1,18,19
24146,2013-10-10,6,8,76,84
24147,2013-10-10,7,0,72,72
24148,2013-10-10,8,2,76,78
24149,2013-10-10,9,1,56,57
24150,2013-10-10,10,3,41,44
24151,2013-10-10,11,2,28,30
24152,2013-10-10,12,11,75,86
24153,2013-10-10,13,15,110,125
24154,2013-10-10,14,18,126,144
24155,2013-10-10,15,21,175,196
24156,2013-10-10,16,29,155,184
24157,2013-10-10,17,18,264,282
24158,2013-10-10,18,19,266,285
24159,2013-10-10,19,5,235,240
24160,2013-10-10,20,6,167,173
24161,2013-10-10,21,5,123,128
24162,2013-10-10,22,0,98,98
24163,2013-10-10,23,5,80,85
24164,2013-10-11,0,3,49,52
24165,2013-10-11,1,1,19,20
24166,2013-10-11,2,1,12,13
24167,2013-10-11,3,1,6,7
24168,2013-10-11,4,1,6,7
24169,2013-10-11,5,2,28,30
24170,2013-10-11,6,4,88,92
24171,2013-10-11,7,3,95,98
24172,2013-10-11,8,6,160,166
24173,2013-10-11,9,9,168,177
24174,2013-10-11,10,3,78,81
24175,2013-10-11,11,12,67,79
24176,2013-10-11,12,4,55,59
24177,2013-10-11,13,3,56,59
24178,2013-10-11,14,7,69,76
24179,2013-10-11,15,9,61,70
24180,2013-10-11,16,19,92,111
24181,2013-10-11,17,11,124,135
24182,2013-10-11,18,5,157,162
24183,2013-10-11,19,6,136,142
24184,2013-10-11,20,2,29,31
24185,2013-10-11,21,3,26,29
24186,2013-10-11,22,1,34,35
24187,2013-10-11,23,1,43,44
24188,2013-10-12,0,7,53,60
24189,2013-10-12,1,3,58,61
24190,2013-10-12,2,2,29,31
24191,2013-10-12,3,1,22,23
24192,2013-10-12,4,3,6,9
24193,2013-10-12,5,0,13,13
24194,2013-10-12,6,2,14,16
24195,2013-10-12,7,6,46,52
24196,2013-10-12,8,9,98,107
24197,2013-10-12,9,25,128,153
24198,2013-10-12,10,31,177,208
24199,2013-10-12,11,63,289,352
24200,2013-10-12,12,96,334,430
24201,2013-10-12,13,103,355,458
24202,2013-10-12,14,188,343,531
24203,2013-10-12,15,190,396,586
24204,2013-10-12,16,239,371,610
24205,2013-10-12,17,125,306,431
24206,2013-10-12,18,98,306,404
24207,2013-10-12,19,37,139,176
24208,2013-10-12,20,26,137,163
24209,2013-10-12,21,26,107,133
24210,2013-10-12,22,15,75,90
24211,2013-10-12,23,4,89,93
24212,2013-10-13,0,7,60,67
24213,2013-10-13,1,21,75,96
24214,2013-10-13,2,12,80,92
24215,2013-10-13,3,11,36,47
24216,2013-10-13,4,1,9,10
24217,2013-10-13,5,3,6,9
24218,2013-10-13,6,8,16,24
24219,2013-10-13,7,8,20,28
24220,2013-10-13,8,12,68,80
24221,2013-10-13,9,39,117,156
24222,2013-10-13,10,66,225,291
24223,2013-10-13,11,82,297,379
24224,2013-10-13,12,118,351,469
24225,2013-10-13,13,149,380,529
24226,2013-10-13,14,125,310,435
24227,2013-10-13,15,175,364,539
24228,2013-10-13,16,196,419,615
24229,2013-10-13,17,137,353,490
24230,2013-10-13,18,86,331,417
24231,2013-10-13,19,81,293,374
24232,2013-10-13,20,71,203,274
24233,2013-10-13,21,37,142,179
24234,2013-10-13,22,48,148,196
24235,2013-10-13,23,29,110,139
24236,2013-10-14,0,14,78,92
24237,2013-10-14,1,2,43,45
24238,2013-10-14,2,4,30,34
24239,2013-10-14,3,0,12,12
24240,2013-10-14,4,1,6,7
24241,2013-10-14,5,1,28,29
24242,2013-10-14,6,6,84,90
24243,2013-10-14,7,18,248,266
24244,2013-10-14,8,29,479,508
24245,2013-10-14,9,47,302,349
24246,2013-10-14,10,78,286,364
24247,2013-10-14,11,170,372,542
24248,2013-10-14,12,203,403,606
24249,2013-10-14,13,237,457,694
24250,2013-10-14,14,197,412,609
24251,2013-10-14,15,176,454,630
24252,2013-10-14,16,201,537,738
24253,2013-10-14,17,155,693,848
24254,2013-10-14,18,130,675,805
24255,2013-10-14,19,45,470,515
24256,2013-10-14,20,46,327,373
24257,2013-10-14,21,37,292,329
24258,2013-10-14,22,22,180,202
24259,2013-10-14,23,10,120,130
24260,2013-10-15,0,3,51,54
24261,2013-10-15,1,5,18,23
24262,2013-10-15,2,0,2,2
24263,2013-10-15,3,0,2,2
24264,2013-10-15,4,0,17,17
24265,2013-10-15,5,3,46,49
24266,2013-10-15,6,7,178,185
24267,2013-10-15,7,14,560,574
24268,2013-10-15,8,40,913,953
24269,2013-10-15,9,34,369,403
24270,2013-10-15,10,71,221,292
24271,2013-10-15,11,85,239,324
24272,2013-10-15,12,104,355,459
24273,2013-10-15,13,88,349,437
24274,2013-10-15,14,109,332,441
24275,2013-10-15,15,83,348,431
24276,2013-10-15,16,104,521,625
24277,2013-10-15,17,87,1028,1115
24278,2013-10-15,18,74,971,1045
24279,2013-10-15,19,32,629,661
24280,2013-10-15,20,37,409,446
24281,2013-10-15,21,31,355,386
24282,2013-10-15,22,14,202,216
24283,2013-10-15,23,6,126,132
24284,2013-10-16,0,3,55,58
24285,2013-10-16,1,1,17,18
24286,2013-10-16,2,0,6,6
24287,2013-10-16,3,0,4,4
24288,2013-10-16,4,0,12,12
24289,2013-10-16,5,3,44,47
24290,2013-10-16,6,4,198,202
24291,2013-10-16,7,19,559,578
24292,2013-10-16,8,36,957,993
24293,2013-10-16,9,23,419,442
24294,2013-10-16,10,65,262,327
24295,2013-10-16,11,87,300,387
24296,2013-10-16,12,106,328,434
24297,2013-10-16,13,94,328,422
24298,2013-10-16,14,119,286,405
24299,2013-10-16,15,116,383,499
24300,2013-10-16,16,88,532,620
24301,2013-10-16,17,92,1035,1127
24302,2013-10-16,18,84,992,1076
24303,2013-10-16,19,69,620,689
24304,2013-10-16,20,43,454,497
24305,2013-10-16,21,19,330,349
24306,2013-10-16,22,24,240,264
24307,2013-10-16,23,18,153,171
24308,2013-10-17,0,3,62,65
24309,2013-10-17,1,2,25,27
24310,2013-10-17,2,1,13,14
24311,2013-10-17,3,0,8,8
24312,2013-10-17,4,0,7,7
24313,2013-10-17,5,1,45,46
24314,2013-10-17,6,1,211,212
24315,2013-10-17,7,28,618,646
24316,2013-10-17,8,28,956,984
24317,2013-10-17,9,37,471,508
24318,2013-10-17,10,49,228,277
24319,2013-10-17,11,66,229,295
24320,2013-10-17,12,77,337,414
24321,2013-10-17,13,81,294,375
24322,2013-10-17,14,97,255,352
24323,2013-10-17,15,76,290,366
24324,2013-10-17,16,114,538,652
24325,2013-10-17,17,112,1049,1161
24326,2013-10-17,18,88,951,1039
24327,2013-10-17,19,71,635,706
24328,2013-10-17,20,48,505,553
24329,2013-10-17,21,32,339,371
24330,2013-10-17,22,21,180,201
24331,2013-10-17,23,16,173,189
24332,2013-10-18,0,9,90,99
24333,2013-10-18,1,10,37,47
24334,2013-10-18,2,2,18,20
24335,2013-10-18,3,0,10,10
24336,2013-10-18,4,0,9,9
24337,2013-10-18,5,2,44,46
24338,2013-10-18,6,1,171,172
24339,2013-10-18,7,19,555,574
24340,2013-10-18,8,32,989,1021
24341,2013-10-18,9,63,439,502
24342,2013-10-18,10,111,268,379
24343,2013-10-18,11,125,267,392
24344,2013-10-18,12,160,422,582
24345,2013-10-18,13,135,334,469
24346,2013-10-18,14,153,368,521
24347,2013-10-18,15,188,395,583
24348,2013-10-18,16,189,578,767
24349,2013-10-18,17,209,967,1176
24350,2013-10-18,18,122,832,954
24351,2013-10-18,19,82,519,601
24352,2013-10-18,20,88,336,424
24353,2013-10-18,21,66,303,369
24354,2013-10-18,22,54,233,287
24355,2013-10-18,23,50,200,250
24356,2013-10-19,0,33,130,163
24357,2013-10-19,1,17,100,117
24358,2013-10-19,2,8,61,69
24359,2013-10-19,3,5,36,41
24360,2013-10-19,4,1,12,13
24361,2013-10-19,5,0,8,8
24362,2013-10-19,6,3,26,29
24363,2013-10-19,7,12,76,88
24364,2013-10-19,8,45,221,266
24365,2013-10-19,9,80,299,379
24366,2013-10-19,10,213,363,576
24367,2013-10-19,11,238,500,738
24368,2013-10-19,12,347,515,862
24369,2013-10-19,13,336,532,868
24370,2013-10-19,14,329,395,724
24371,2013-10-19,15,343,423,766
24372,2013-10-19,16,265,438,703
24373,2013-10-19,17,253,384,637
24374,2013-10-19,18,205,373,578
24375,2013-10-19,19,117,332,449
24376,2013-10-19,20,110,278,388
24377,2013-10-19,21,85,204,289
24378,2013-10-19,22,77,224,301
24379,2013-10-19,23,66,188,254
24380,2013-10-20,0,31,160,191
24381,2013-10-20,1,23,105,128
24382,2013-10-20,2,17,93,110
24383,2013-10-20,3,6,39,45
24384,2013-10-20,4,3,11,14
24385,2013-10-20,5,3,8,11
24386,2013-10-20,6,5,32,37
24387,2013-10-20,7,15,69,84
24388,2013-10-20,8,40,136,176
24389,2013-10-20,9,96,246,342
24390,2013-10-20,10,194,368,562
24391,2013-10-20,11,211,494,705
24392,2013-10-20,12,236,516,752
24393,2013-10-20,13,296,449,745
24394,2013-10-20,14,290,444,734
24395,2013-10-20,15,298,468,766
24396,2013-10-20,16,229,531,760
24397,2013-10-20,17,217,445,662
24398,2013-10-20,18,156,432,588
24399,2013-10-20,19,74,322,396
24400,2013-10-20,20,42,205,247
24401,2013-10-20,21,39,176,215
24402,2013-10-20,22,13,121,134
24403,2013-10-20,23,6,82,88
24404,2013-10-21,0,8,34,42
24405,2013-10-21,1,3,18,21
24406,2013-10-21,2,0,7,7
24407,2013-10-21,3,0,5,5
24408,2013-10-21,4,0,10,10
24409,2013-10-21,5,3,45,48
24410,2013-10-21,6,4,174,178
24411,2013-10-21,7,14,562,576
24412,2013-10-21,8,29,869,898
24413,2013-10-21,9,43,398,441
24414,2013-10-21,10,93,196,289
24415,2013-10-21,11,120,201,321
24416,2013-10-21,12,125,306,431
24417,2013-10-21,13,127,289,416
24418,2013-10-21,14,105,264,369
24419,2013-10-21,15,111,312,423
24420,2013-10-21,16,125,528,653
24421,2013-10-21,17,151,1021,1172
24422,2013-10-21,18,93,942,1035
24423,2013-10-21,19,45,546,591
24424,2013-10-21,20,35,354,389
24425,2013-10-21,21,51,282,333
24426,2013-10-21,22,26,172,198
24427,2013-10-21,23,20,90,110
24428,2013-10-22,0,9,29,38
24429,2013-10-22,1,1,12,13
24430,2013-10-22,2,1,10,11
24431,2013-10-22,3,2,3,5
24432,2013-10-22,4,1,11,12
24433,2013-10-22,5,1,66,67
24434,2013-10-22,6,7,219,226
24435,2013-10-22,7,11,704,715
24436,2013-10-22,8,28,996,1024
24437,2013-10-22,9,34,410,444
24438,2013-10-22,10,60,197,257
24439,2013-10-22,11,63,208,271
24440,2013-10-22,12,38,277,315
24441,2013-10-22,13,46,292,338
24442,2013-10-22,14,56,245,301
24443,2013-10-22,15,77,321,398
24444,2013-10-22,16,48,573,621
24445,2013-10-22,17,94,1048,1142
24446,2013-10-22,18,54,928,982
24447,2013-10-22,19,37,614,651
24448,2013-10-22,20,27,423,450
24449,2013-10-22,21,16,330,346
24450,2013-10-22,22,19,223,242
24451,2013-10-22,23,6,115,121
24452,2013-10-23,0,3,40,43
24453,2013-10-23,1,2,19,21
24454,2013-10-23,2,0,11,11
24455,2013-10-23,3,0,6,6
24456,2013-10-23,4,1,10,11
24457,2013-10-23,5,1,45,46
24458,2013-10-23,6,4,112,116
24459,2013-10-23,7,14,431,445
24460,2013-10-23,8,22,885,907
24461,2013-10-23,9,31,430,461
24462,2013-10-23,10,30,201,231
24463,2013-10-23,11,44,217,261
24464,2013-10-23,12,49,319,368
24465,2013-10-23,13,50,291,341
24466,2013-10-23,14,60,246,306
24467,2013-10-23,15,65,275,340
24468,2013-10-23,16,51,439,490
24469,2013-10-23,17,75,971,1046
24470,2013-10-23,18,48,843,891
24471,2013-10-23,19,23,541,564
24472,2013-10-23,20,13,336,349
24473,2013-10-23,21,16,298,314
24474,2013-10-23,22,5,181,186
24475,2013-10-23,23,9,121,130
24476,2013-10-24,0,4,50,54
24477,2013-10-24,1,1,25,26
24478,2013-10-24,2,1,4,5
24479,2013-10-24,3,0,4,4
24480,2013-10-24,4,1,5,6
24481,2013-10-24,5,0,40,40
24482,2013-10-24,6,2,176,178
24483,2013-10-24,7,8,578,586
24484,2013-10-24,8,19,930,949
24485,2013-10-24,9,25,398,423
24486,2013-10-24,10,40,188,228
24487,2013-10-24,11,48,199,247
24488,2013-10-24,12,35,284,319
24489,2013-10-24,13,39,237,276
24490,2013-10-24,14,50,248,298
24491,2013-10-24,15,65,308,373
24492,2013-10-24,16,34,421,455
24493,2013-10-24,17,77,909,986
24494,2013-10-24,18,57,792,849
24495,2013-10-24,19,28,478,506
24496,2013-10-24,20,24,386,410
24497,2013-10-24,21,16,246,262
24498,2013-10-24,22,12,186,198
24499,2013-10-24,23,5,140,145
24500,2013-10-25,0,2,75,77
24501,2013-10-25,1,6,26,32
24502,2013-10-25,2,1,14,15
24503,2013-10-25,3,0,4,4
24504,2013-10-25,4,0,10,10
24505,2013-10-25,5,1,50,51
24506,2013-10-25,6,1,133,134
24507,2013-10-25,7,13,430,443
24508,2013-10-25,8,15,828,843
24509,2013-10-25,9,24,404,428
24510,2013-10-25,10,47,182,229
24511,2013-10-25,11,54,220,274
24512,2013-10-25,12,55,317,372
24513,2013-10-25,13,111,341,452
24514,2013-10-25,14,81,299,380
24515,2013-10-25,15,116,386,502
24516,2013-10-25,16,134,514,648
24517,2013-10-25,17,106,835,941
24518,2013-10-25,18,53,661,714
24519,2013-10-25,19,34,401,435
24520,2013-10-25,20,16,307,323
24521,2013-10-25,21,20,193,213
24522,2013-10-25,22,15,176,191
24523,2013-10-25,23,8,147,155
24524,2013-10-26,0,13,129,142
24525,2013-10-26,1,4,104,108
24526,2013-10-26,2,0,72,72
24527,2013-10-26,3,0,21,21
24528,2013-10-26,4,2,4,6
24529,2013-10-26,5,1,15,16
24530,2013-10-26,6,0,18,18
24531,2013-10-26,7,5,76,81
24532,2013-10-26,8,31,185,216
24533,2013-10-26,9,61,278,339
24534,2013-10-26,10,118,350,468
24535,2013-10-26,11,188,418,606
24536,2013-10-26,12,205,449,654
24537,2013-10-26,13,217,474,691
24538,2013-10-26,14,237,454,691
24539,2013-10-26,15,252,459,711
24540,2013-10-26,16,238,441,679
24541,2013-10-26,17,253,415,668
24542,2013-10-26,18,111,340,451
24543,2013-10-26,19,88,300,388
24544,2013-10-26,20,64,244,308
24545,2013-10-26,21,47,186,233
24546,2013-10-26,22,21,160,181
24547,2013-10-26,23,39,118,157
24548,2013-10-27,0,16,122,138
24549,2013-10-27,1,31,104,135
24550,2013-10-27,2,22,102,124
24551,2013-10-27,3,10,49,59
24552,2013-10-27,4,3,21,24
24553,2013-10-27,5,5,12,17
24554,2013-10-27,6,8,49,57
24555,2013-10-27,7,26,76,102
24556,2013-10-27,8,72,146,218
24557,2013-10-27,9,138,268,406
24558,2013-10-27,10,166,403,569
24559,2013-10-27,11,231,388,619
24560,2013-10-27,12,199,492,691
24561,2013-10-27,13,232,467,699
24562,2013-10-27,14,279,450,729
24563,2013-10-27,15,240,426,666
24564,2013-10-27,16,235,440,675
24565,2013-10-27,17,189,392,581
24566,2013-10-27,18,98,371,469
24567,2013-10-27,19,75,238,313
24568,2013-10-27,20,34,194,228
24569,2013-10-27,21,30,157,187
24570,2013-10-27,22,17,110,127
24571,2013-10-27,23,23,59,82
24572,2013-10-28,0,17,30,47
24573,2013-10-28,1,3,18,21
24574,2013-10-28,2,0,7,7
24575,2013-10-28,3,0,5,5
24576,2013-10-28,4,0,4,4
24577,2013-10-28,5,1,44,45
24578,2013-10-28,6,6,145,151
24579,2013-10-28,7,10,493,503
24580,2013-10-28,8,31,870,901
24581,2013-10-28,9,51,376,427
24582,2013-10-28,10,83,169,252
24583,2013-10-28,11,113,209,322
24584,2013-10-28,12,102,256,358
24585,2013-10-28,13,119,242,361
24586,2013-10-28,14,107,233,340
24587,2013-10-28,15,101,295,396
24588,2013-10-28,16,106,490,596
24589,2013-10-28,17,93,1058,1151
24590,2013-10-28,18,96,934,1030
24591,2013-10-28,19,37,533,570
24592,2013-10-28,20,28,399,427
24593,2013-10-28,21,25,272,297
24594,2013-10-28,22,33,171,204
24595,2013-10-28,23,15,84,99
24596,2013-10-29,0,10,34,44
24597,2013-10-29,1,0,14,14
24598,2013-10-29,2,0,2,2
24599,2013-10-29,3,0,4,4
24600,2013-10-29,4,0,9,9
24601,2013-10-29,5,4,49,53
24602,2013-10-29,6,3,184,187
24603,2013-10-29,7,11,629,640
24604,2013-10-29,8,39,1000,1039
24605,2013-10-29,9,27,381,408
24606,2013-10-29,10,65,199,264
24607,2013-10-29,11,69,200,269
24608,2013-10-29,12,87,278,365
24609,2013-10-29,13,80,294,374
24610,2013-10-29,14,93,261,354
24611,2013-10-29,15,83,315,398
24612,2013-10-29,16,83,503,586
24613,2013-10-29,17,103,1087,1190
24614,2013-10-29,18,85,897,982
24615,2013-10-29,19,46,553,599
24616,2013-10-29,20,30,407,437
24617,2013-10-29,21,17,339,356
24618,2013-10-29,22,16,210,226
24619,2013-10-29,23,12,137,149
24620,2013-10-30,0,4,47,51
24621,2013-10-30,1,1,29,30
24622,2013-10-30,2,1,17,18
24623,2013-10-30,3,0,6,6
24624,2013-10-30,4,1,14,15
24625,2013-10-30,5,1,49,50
24626,2013-10-30,6,5,146,151
24627,2013-10-30,7,8,397,405
24628,2013-10-30,8,24,460,484
24629,2013-10-30,9,20,339,359
24630,2013-10-30,10,32,172,204
24631,2013-10-30,11,52,222,274
24632,2013-10-30,12,51,298,349
24633,2013-10-30,13,85,306,391
24634,2013-10-30,14,72,276,348
24635,2013-10-30,15,79,333,412
24636,2013-10-30,16,104,519,623
24637,2013-10-30,17,96,1018,1114
24638,2013-10-30,18,66,905,971
24639,2013-10-30,19,27,555,582
24640,2013-10-30,20,21,435,456
24641,2013-10-30,21,24,319,343
24642,2013-10-30,22,13,228,241
24643,2013-10-30,23,19,159,178
24644,2013-10-31,0,6,76,82
24645,2013-10-31,1,1,19,20
24646,2013-10-31,2,0,10,10
24647,2013-10-31,3,0,6,6
24648,2013-10-31,4,0,8,8
24649,2013-10-31,5,1,55,56
24650,2013-10-31,6,2,163,165
24651,2013-10-31,7,12,551,563
24652,2013-10-31,8,29,898,927
24653,2013-10-31,9,41,412,453
24654,2013-10-31,10,23,210,233
24655,2013-10-31,11,58,227,285
24656,2013-10-31,12,60,325,385
24657,2013-10-31,13,78,311,389
24658,2013-10-31,14,60,274,334
24659,2013-10-31,15,78,347,425
24660,2013-10-31,16,66,582,648
24661,2013-10-31,17,73,1039,1112
24662,2013-10-31,18,36,801,837
24663,2013-10-31,19,27,363,390
24664,2013-10-31,20,16,294,310
24665,2013-10-31,21,16,251,267
24666,2013-10-31,22,18,200,218
24667,2013-10-31,23,22,190,212
24668,2013-11-01,0,18,117,135
24669,2013-11-01,1,14,79,93
24670,2013-11-01,2,5,40,45
24671,2013-11-01,3,4,26,30
24672,2013-11-01,4,0,9,9
24673,2013-11-01,5,3,53,56
24674,2013-11-01,6,0,126,126
24675,2013-11-01,7,8,271,279
24676,2013-11-01,8,24,795,819
24677,2013-11-01,9,3,202,205
24678,2013-11-01,10,12,148,160
24679,2013-11-01,11,41,164,205
24680,2013-11-01,12,45,303,348
24681,2013-11-01,13,65,321,386
24682,2013-11-01,14,76,277,353
24683,2013-11-01,15,107,369,476
24684,2013-11-01,16,108,525,633
24685,2013-11-01,17,135,960,1095
24686,2013-11-01,18,79,746,825
24687,2013-11-01,19,55,498,553
24688,2013-11-01,20,37,358,395
24689,2013-11-01,21,29,321,350
24690,2013-11-01,22,24,242,266
24691,2013-11-01,23,29,175,204
24692,2013-11-02,0,31,176,207
24693,2013-11-02,1,26,104,130
24694,2013-11-02,2,17,105,122
24695,2013-11-02,3,8,42,50
24696,2013-11-02,4,4,17,21
24697,2013-11-02,5,0,14,14
24698,2013-11-02,6,1,20,21
24699,2013-11-02,7,14,82,96
24700,2013-11-02,8,30,189,219
24701,2013-11-02,9,75,279,354
24702,2013-11-02,10,179,437,616
24703,2013-11-02,11,204,514,718
24704,2013-11-02,12,266,567,833
24705,2013-11-02,13,318,518,836
24706,2013-11-02,14,346,513,859
24707,2013-11-02,15,355,530,885
24708,2013-11-02,16,312,442,754
24709,2013-11-02,17,260,443,703
24710,2013-11-02,18,147,405,552
24711,2013-11-02,19,76,308,384
24712,2013-11-02,20,55,212,267
24713,2013-11-02,21,55,221,276
24714,2013-11-02,22,46,213,259
24715,2013-11-02,23,39,155,194
24716,2013-11-03,0,23,126,149
24717,2013-11-03,1,28,236,264
24718,2013-11-03,2,7,50,57
24719,2013-11-03,3,1,23,24
24720,2013-11-03,4,0,4,4
24721,2013-11-03,5,2,10,12
24722,2013-11-03,6,9,34,43
24723,2013-11-03,7,23,72,95
24724,2013-11-03,8,54,161,215
24725,2013-11-03,9,104,283,387
24726,2013-11-03,10,167,432,599
24727,2013-11-03,11,221,420,641
24728,2013-11-03,12,263,483,746
24729,2013-11-03,13,240,465,705
24730,2013-11-03,14,234,420,654
24731,2013-11-03,15,212,468,680
24732,2013-11-03,16,185,465,650
24733,2013-11-03,17,129,384,513
24734,2013-11-03,18,78,288,366
24735,2013-11-03,19,48,246,294
24736,2013-11-03,20,34,191,225
24737,2013-11-03,21,19,118,137
24738,2013-11-03,22,20,91,111
24739,2013-11-03,23,12,65,77
24740,2013-11-04,0,7,16,23
24741,2013-11-04,1,2,10,12
24742,2013-11-04,2,3,2,5
24743,2013-11-04,3,0,4,4
24744,2013-11-04,4,1,7,8
24745,2013-11-04,5,1,47,48
24746,2013-11-04,6,6,173,179
24747,2013-11-04,7,19,585,604
24748,2013-11-04,8,23,762,785
24749,2013-11-04,9,44,318,362
24750,2013-11-04,10,50,165,215
24751,2013-11-04,11,56,191,247
24752,2013-11-04,12,62,261,323
24753,2013-11-04,13,50,204,254
24754,2013-11-04,14,45,191,236
24755,2013-11-04,15,33,263,296
24756,2013-11-04,16,26,419,445
24757,2013-11-04,17,40,807,847
24758,2013-11-04,18,24,667,691
24759,2013-11-04,19,15,484,499
24760,2013-11-04,20,14,295,309
24761,2013-11-04,21,15,203,218
24762,2013-11-04,22,9,134,143
24763,2013-11-04,23,9,91,100
24764,2013-11-05,0,5,27,32
24765,2013-11-05,1,1,10,11
24766,2013-11-05,2,1,7,8
24767,2013-11-05,3,0,5,5
24768,2013-11-05,4,1,8,9
24769,2013-11-05,5,0,56,56
24770,2013-11-05,6,5,203,208
24771,2013-11-05,7,19,683,702
24772,2013-11-05,8,39,909,948
24773,2013-11-05,9,20,374,394
24774,2013-11-05,10,36,176,212
24775,2013-11-05,11,68,208,276
24776,2013-11-05,12,47,291,338
24777,2013-11-05,13,67,295,362
24778,2013-11-05,14,67,253,320
24779,2013-11-05,15,41,285,326
24780,2013-11-05,16,61,526,587
24781,2013-11-05,17,70,912,982
24782,2013-11-05,18,34,805,839
24783,2013-11-05,19,19,525,544
24784,2013-11-05,20,11,350,361
24785,2013-11-05,21,18,268,286
24786,2013-11-05,22,26,204,230
24787,2013-11-05,23,13,101,114
24788,2013-11-06,0,5,46,51
24789,2013-11-06,1,1,14,15
24790,2013-11-06,2,6,7,13
24791,2013-11-06,3,3,4,7
24792,2013-11-06,4,0,8,8
24793,2013-11-06,5,4,51,55
24794,2013-11-06,6,3,210,213
24795,2013-11-06,7,15,680,695
24796,2013-11-06,8,33,951,984
24797,2013-11-06,9,27,381,408
24798,2013-11-06,10,42,197,239
24799,2013-11-06,11,50,231,281
24800,2013-11-06,12,65,316,381
24801,2013-11-06,13,68,304,372
24802,2013-11-06,14,79,237,316
24803,2013-11-06,15,75,314,389
24804,2013-11-06,16,79,506,585
24805,2013-11-06,17,75,992,1067
24806,2013-11-06,18,36,842,878
24807,2013-11-06,19,48,604,652
24808,2013-11-06,20,31,424,455
24809,2013-11-06,21,17,309,326
24810,2013-11-06,22,15,216,231
24811,2013-11-06,23,20,138,158
24812,2013-11-07,0,9,52,61
24813,2013-11-07,1,3,19,22
24814,2013-11-07,2,8,12,20
24815,2013-11-07,3,0,3,3
24816,2013-11-07,4,0,8,8
24817,2013-11-07,5,0,56,56
24818,2013-11-07,6,6,225,231
24819,2013-11-07,7,22,747,769
24820,2013-11-07,8,44,1026,1070
24821,2013-11-07,9,17,434,451
24822,2013-11-07,10,27,218,245
24823,2013-11-07,11,25,148,173
24824,2013-11-07,12,18,157,175
24825,2013-11-07,13,28,217,245
24826,2013-11-07,14,38,245,283
24827,2013-11-07,15,51,300,351
24828,2013-11-07,16,57,464,521
24829,2013-11-07,17,35,843,878
24830,2013-11-07,18,31,781,812
24831,2013-11-07,19,23,500,523
24832,2013-11-07,20,15,386,401
24833,2013-11-07,21,17,295,312
24834,2013-11-07,22,8,222,230
24835,2013-11-07,23,3,130,133
24836,2013-11-08,0,5,66,71
24837,2013-11-08,1,11,32,43
24838,2013-11-08,2,1,13,14
24839,2013-11-08,3,12,2,14
24840,2013-11-08,4,6,8,14
24841,2013-11-08,5,1,49,50
24842,2013-11-08,6,1,140,141
24843,2013-11-08,7,17,514,531
24844,2013-11-08,8,27,869,896
24845,2013-11-08,9,27,384,411
24846,2013-11-08,10,52,208,260
24847,2013-11-08,11,54,263,317
24848,2013-11-08,12,66,283,349
24849,2013-11-08,13,75,312,387
24850,2013-11-08,14,69,259,328
24851,2013-11-08,15,68,332,400
24852,2013-11-08,16,62,459,521
24853,2013-11-08,17,61,793,854
24854,2013-11-08,18,37,641,678
24855,2013-11-08,19,18,376,394
24856,2013-11-08,20,17,284,301
24857,2013-11-08,21,10,192,202
24858,2013-11-08,22,19,174,193
24859,2013-11-08,23,11,128,139
24860,2013-11-09,0,12,110,122
24861,2013-11-09,1,5,79,84
24862,2013-11-09,2,6,56,62
24863,2013-11-09,3,3,18,21
24864,2013-11-09,4,1,7,8
24865,2013-11-09,5,5,7,12
24866,2013-11-09,6,0,27,27
24867,2013-11-09,7,12,80,92
24868,2013-11-09,8,41,189,230
24869,2013-11-09,9,86,261,347
24870,2013-11-09,10,123,332,455
24871,2013-11-09,11,178,442,620
24872,2013-11-09,12,245,466,711
24873,2013-11-09,13,258,412,670
24874,2013-11-09,14,252,435,687
24875,2013-11-09,15,256,444,700
24876,2013-11-09,16,268,435,703
24877,2013-11-09,17,179,333,512
24878,2013-11-09,18,60,274,334
24879,2013-11-09,19,53,257,310
24880,2013-11-09,20,30,197,227
24881,2013-11-09,21,48,176,224
24882,2013-11-09,22,38,148,186
24883,2013-11-09,23,32,163,195
24884,2013-11-10,0,17,143,160
24885,2013-11-10,1,9,115,124
24886,2013-11-10,2,13,77,90
24887,2013-11-10,3,3,22,25
24888,2013-11-10,4,1,6,7
24889,2013-11-10,5,1,6,7
24890,2013-11-10,6,2,25,27
24891,2013-11-10,7,24,69,93
24892,2013-11-10,8,35,125,160
24893,2013-11-10,9,93,240,333
24894,2013-11-10,10,143,347,490
24895,2013-11-10,11,196,404,600
24896,2013-11-10,12,249,511,760
24897,2013-11-10,13,276,489,765
24898,2013-11-10,14,257,444,701
24899,2013-11-10,15,248,419,667
24900,2013-11-10,16,201,396,597
24901,2013-11-10,17,108,316,424
24902,2013-11-10,18,67,241,308
24903,2013-11-10,19,41,220,261
24904,2013-11-10,20,33,154,187
24905,2013-11-10,21,20,144,164
24906,2013-11-10,22,17,129,146
24907,2013-11-10,23,12,68,80
24908,2013-11-11,0,7,42,49
24909,2013-11-11,1,6,15,21
24910,2013-11-11,2,0,10,10
24911,2013-11-11,3,0,7,7
24912,2013-11-11,4,0,6,6
24913,2013-11-11,5,1,17,18
24914,2013-11-11,6,3,84,87
24915,2013-11-11,7,9,287,296
24916,2013-11-11,8,40,604,644
24917,2013-11-11,9,60,391,451
24918,2013-11-11,10,75,308,383
24919,2013-11-11,11,101,315,416
24920,2013-11-11,12,121,323,444
24921,2013-11-11,13,108,350,458
24922,2013-11-11,14,96,314,410
24923,2013-11-11,15,98,338,436
24924,2013-11-11,16,69,396,465
24925,2013-11-11,17,57,623,680
24926,2013-11-11,18,35,611,646
24927,2013-11-11,19,21,417,438
24928,2013-11-11,20,21,299,320
24929,2013-11-11,21,20,226,246
24930,2013-11-11,22,17,162,179
24931,2013-11-11,23,7,71,78
24932,2013-11-12,0,4,33,37
24933,2013-11-12,1,3,16,19
24934,2013-11-12,2,1,4,5
24935,2013-11-12,3,3,1,4
24936,2013-11-12,4,0,7,7
24937,2013-11-12,5,0,58,58
24938,2013-11-12,6,2,177,179
24939,2013-11-12,7,11,559,570
24940,2013-11-12,8,22,865,887
24941,2013-11-12,9,11,336,347
24942,2013-11-12,10,8,125,133
24943,2013-11-12,11,14,133,147
24944,2013-11-12,12,11,196,207
24945,2013-11-12,13,10,177,187
24946,2013-11-12,14,17,149,166
24947,2013-11-12,15,22,195,217
24948,2013-11-12,16,18,361,379
24949,2013-11-12,17,19,697,716
24950,2013-11-12,18,15,620,635
24951,2013-11-12,19,13,418,431
24952,2013-11-12,20,12,275,287
24953,2013-11-12,21,17,251,268
24954,2013-11-12,22,24,128,152
24955,2013-11-12,23,5,69,74
24956,2013-11-13,0,3,29,32
24957,2013-11-13,1,2,12,14
24958,2013-11-13,2,1,6,7
24959,2013-11-13,4,0,11,11
24960,2013-11-13,5,1,48,49
24961,2013-11-13,6,3,158,161
24962,2013-11-13,7,10,526,536
24963,2013-11-13,8,29,941,970
24964,2013-11-13,9,23,366,389
24965,2013-11-13,10,17,200,217
24966,2013-11-13,11,16,146,162
24967,2013-11-13,12,16,231,247
24968,2013-11-13,13,22,212,234
24969,2013-11-13,14,17,173,190
24970,2013-11-13,15,12,193,205
24971,2013-11-13,16,20,353,373
24972,2013-11-13,17,16,702,718
24973,2013-11-13,18,13,695,708
24974,2013-11-13,19,22,429,451
24975,2013-11-13,20,8,298,306
24976,2013-11-13,21,11,249,260
24977,2013-11-13,22,8,142,150
24978,2013-11-13,23,10,66,76
24979,2013-11-14,0,7,44,51
24980,2013-11-14,1,1,11,12
24981,2013-11-14,2,2,7,9
24982,2013-11-14,3,0,1,1
24983,2013-11-14,4,0,8,8
24984,2013-11-14,5,0,41,41
24985,2013-11-14,6,3,149,152
24986,2013-11-14,7,9,522,531
24987,2013-11-14,8,19,943,962
24988,2013-11-14,9,23,395,418
24989,2013-11-14,10,22,176,198
24990,2013-11-14,11,27,189,216
24991,2013-11-14,12,30,281,311
24992,2013-11-14,13,37,272,309
24993,2013-11-14,14,30,222,252
24994,2013-11-14,15,37,257,294
24995,2013-11-14,16,28,417,445
24996,2013-11-14,17,32,764,796
24997,2013-11-14,18,26,736,762
24998,2013-11-14,19,12,483,495
24999,2013-11-14,20,9,379,388
25000,2013-11-14,21,12,278,290
25001,2013-11-14,22,7,199,206
25002,2013-11-14,23,5,121,126
25003,2013-11-15,0,3,67,70
25004,2013-11-15,1,2,31,33
25005,2013-11-15,2,1,21,22
25006,2013-11-15,3,0,7,7
25007,2013-11-15,4,0,6,6
25008,2013-11-15,5,0,51,51
25009,2013-11-15,6,1,130,131
25010,2013-11-15,7,6,516,522
25011,2013-11-15,8,24,860,884
25012,2013-11-15,9,30,388,418
25013,2013-11-15,10,52,214,266
25014,2013-11-15,11,54,238,292
25015,2013-11-15,12,77,307,384
25016,2013-11-15,13,85,311,396
25017,2013-11-15,14,65,295,360
25018,2013-11-15,15,112,334,446
25019,2013-11-15,16,106,480,586
25020,2013-11-15,17,67,814,881
25021,2013-11-15,18,35,630,665
25022,2013-11-15,19,28,438,466
25023,2013-11-15,20,12,324,336
25024,2013-11-15,21,11,224,235
25025,2013-11-15,22,9,131,140
25026,2013-11-15,23,2,72,74
25027,2013-11-16,0,3,34,37
25028,2013-11-16,1,0,42,42
25029,2013-11-16,2,1,33,34
25030,2013-11-16,3,0,13,13
25031,2013-11-16,4,0,5,5
25032,2013-11-16,5,1,6,7
25033,2013-11-16,6,4,15,19
25034,2013-11-16,7,9,59,68
25035,2013-11-16,8,22,144,166
25036,2013-11-16,9,48,264,312
25037,2013-11-16,10,89,313,402
25038,2013-11-16,11,102,425,527
25039,2013-11-16,12,146,442,588
25040,2013-11-16,13,162,471,633
25041,2013-11-16,14,213,436,649
25042,2013-11-16,15,205,439,644
25043,2013-11-16,16,172,453,625
25044,2013-11-16,17,117,352,469
25045,2013-11-16,18,78,314,392
25046,2013-11-16,19,45,247,292
25047,2013-11-16,20,35,206,241
25048,2013-11-16,21,24,197,221
25049,2013-11-16,22,29,193,222
25050,2013-11-16,23,24,172,196
25051,2013-11-17,0,17,140,157
25052,2013-11-17,1,21,123,144
25053,2013-11-17,2,25,101,126
25054,2013-11-17,3,12,38,50
25055,2013-11-17,4,3,7,10
25056,2013-11-17,5,1,6,7
25057,2013-11-17,6,4,19,23
25058,2013-11-17,7,12,46,58
25059,2013-11-17,8,24,130,154
25060,2013-11-17,9,52,222,274
25061,2013-11-17,10,85,346,431
25062,2013-11-17,11,175,439,614
25063,2013-11-17,12,136,504,640
25064,2013-11-17,13,142,468,610
25065,2013-11-17,14,182,431,613
25066,2013-11-17,15,169,464,633
25067,2013-11-17,16,123,481,604
25068,2013-11-17,17,93,412,505
25069,2013-11-17,18,60,314,374
25070,2013-11-17,19,36,252,288
25071,2013-11-17,20,28,204,232
25072,2013-11-17,21,17,162,179
25073,2013-11-17,22,13,118,131
25074,2013-11-17,23,16,71,87
25075,2013-11-18,0,7,40,47
25076,2013-11-18,1,3,10,13
25077,2013-11-18,2,0,7,7
25078,2013-11-18,3,3,1,4
25079,2013-11-18,4,0,6,6
25080,2013-11-18,5,0,37,37
25081,2013-11-18,6,5,173,178
25082,2013-11-18,7,4,573,577
25083,2013-11-18,8,40,979,1019
25084,2013-11-18,9,36,400,436
25085,2013-11-18,10,63,198,261
25086,2013-11-18,11,57,227,284
25087,2013-11-18,12,47,305,352
25088,2013-11-18,13,50,289,339
25089,2013-11-18,14,71,233,304
25090,2013-11-18,15,56,331,387
25091,2013-11-18,16,53,463,516
25092,2013-11-18,17,58,924,982
25093,2013-11-18,18,58,873,931
25094,2013-11-18,19,29,570,599
25095,2013-11-18,20,28,361,389
25096,2013-11-18,21,13,270,283
25097,2013-11-18,22,11,171,182
25098,2013-11-18,23,15,105,120
25099,2013-11-19,0,3,33,36
25100,2013-11-19,1,1,19,20
25101,2013-11-19,2,2,6,8
25102,2013-11-19,3,1,4,5
25103,2013-11-19,4,0,9,9
25104,2013-11-19,5,1,47,48
25105,2013-11-19,6,5,182,187
25106,2013-11-19,7,9,575,584
25107,2013-11-19,8,28,1009,1037
25108,2013-11-19,9,20,421,441
25109,2013-11-19,10,26,185,211
25110,2013-11-19,11,35,196,231
25111,2013-11-19,12,33,249,282
25112,2013-11-19,13,37,262,299
25113,2013-11-19,14,37,206,243
25114,2013-11-19,15,42,253,295
25115,2013-11-19,16,31,431,462
25116,2013-11-19,17,34,796,830
25117,2013-11-19,18,20,726,746
25118,2013-11-19,19,17,526,543
25119,2013-11-19,20,17,328,345
25120,2013-11-19,21,8,296,304
25121,2013-11-19,22,15,171,186
25122,2013-11-19,23,4,89,93
25123,2013-11-20,0,2,43,45
25124,2013-11-20,1,2,11,13
25125,2013-11-20,2,1,8,9
25126,2013-11-20,3,1,1,2
25127,2013-11-20,4,0,10,10
25128,2013-11-20,5,0,51,51
25129,2013-11-20,6,1,181,182
25130,2013-11-20,7,10,531,541
25131,2013-11-20,8,22,932,954
25132,2013-11-20,9,20,398,418
25133,2013-11-20,10,26,192,218
25134,2013-11-20,11,38,207,245
25135,2013-11-20,12,38,260,298
25136,2013-11-20,13,40,246,286
25137,2013-11-20,14,53,233,286
25138,2013-11-20,15,33,268,301
25139,2013-11-20,16,41,406,447
25140,2013-11-20,17,39,782,821
25141,2013-11-20,18,30,713,743
25142,2013-11-20,19,15,488,503
25143,2013-11-20,20,16,346,362
25144,2013-11-20,21,10,261,271
25145,2013-11-20,22,8,203,211
25146,2013-11-20,23,6,117,123
25147,2013-11-21,0,1,42,43
25148,2013-11-21,1,3,12,15
25149,2013-11-21,2,1,13,14
25150,2013-11-21,3,0,2,2
25151,2013-11-21,4,0,9,9
25152,2013-11-21,5,0,51,51
25153,2013-11-21,6,1,166,167
25154,2013-11-21,7,13,511,524
25155,2013-11-21,8,19,926,945
25156,2013-11-21,9,14,389,403
25157,2013-11-21,10,30,212,242
25158,2013-11-21,11,27,219,246
25159,2013-11-21,12,38,264,302
25160,2013-11-21,13,44,264,308
25161,2013-11-21,14,36,213,249
25162,2013-11-21,15,42,303,345
25163,2013-11-21,16,41,413,454
25164,2013-11-21,17,30,775,805
25165,2013-11-21,18,37,745,782
25166,2013-11-21,19,20,504,524
25167,2013-11-21,20,22,389,411
25168,2013-11-21,21,17,291,308
25169,2013-11-21,22,16,196,212
25170,2013-11-21,23,19,141,160
25171,2013-11-22,0,7,81,88
25172,2013-11-22,1,11,38,49
25173,2013-11-22,2,1,14,15
25174,2013-11-22,3,3,4,7
25175,2013-11-22,4,0,8,8
25176,2013-11-22,5,1,45,46
25177,2013-11-22,6,2,159,161
25178,2013-11-22,7,10,447,457
25179,2013-11-22,8,19,972,991
25180,2013-11-22,9,32,418,450
25181,2013-11-22,10,41,236,277
25182,2013-11-22,11,50,246,296
25183,2013-11-22,12,65,329,394
25184,2013-11-22,13,76,300,376
25185,2013-11-22,14,70,299,369
25186,2013-11-22,15,75,336,411
25187,2013-11-22,16,62,467,529
25188,2013-11-22,17,41,828,869
25189,2013-11-22,18,38,694,732
25190,2013-11-22,19,37,511,548
25191,2013-11-22,20,17,284,301
25192,2013-11-22,21,25,248,273
25193,2013-11-22,22,9,269,278
25194,2013-11-22,23,27,194,221
25195,2013-11-23,0,14,149,163
25196,2013-11-23,1,7,103,110
25197,2013-11-23,2,7,80,87
25198,2013-11-23,3,4,40,44
25199,2013-11-23,4,1,8,9
25200,2013-11-23,5,1,10,11
25201,2013-11-23,6,5,19,24
25202,2013-11-23,7,11,77,88
25203,2013-11-23,8,23,125,148
25204,2013-11-23,9,54,264,318
25205,2013-11-23,10,91,332,423
25206,2013-11-23,11,149,424,573
25207,2013-11-23,12,147,431,578
25208,2013-11-23,13,159,431,590
25209,2013-11-23,14,147,410,557
25210,2013-11-23,15,153,405,558
25211,2013-11-23,16,112,314,426
25212,2013-11-23,17,66,280,346
25213,2013-11-23,18,36,259,295
25214,2013-11-23,19,26,225,251
25215,2013-11-23,20,21,150,171
25216,2013-11-23,21,20,139,159
25217,2013-11-23,22,9,99,108
25218,2013-11-23,23,4,93,97
25219,2013-11-24,0,3,85,88
25220,2013-11-24,1,6,61,67
25221,2013-11-24,2,5,55,60
25222,2013-11-24,3,0,18,18
25223,2013-11-24,4,3,8,11
25224,2013-11-24,5,0,5,5
25225,2013-11-24,6,3,8,11
25226,2013-11-24,7,6,26,32
25227,2013-11-24,8,6,62,68
25228,2013-11-24,9,16,123,139
25229,2013-11-24,10,36,167,203
25230,2013-11-24,11,49,256,305
25231,2013-11-24,12,34,254,288
25232,2013-11-24,13,50,255,305
25233,2013-11-24,14,29,199,228
25234,2013-11-24,15,31,213,244
25235,2013-11-24,16,31,247,278
25236,2013-11-24,17,19,211,230
25237,2013-11-24,18,9,156,165
25238,2013-11-24,19,10,117,127
25239,2013-11-24,20,13,95,108
25240,2013-11-24,21,9,76,85
25241,2013-11-24,22,0,73,73
25242,2013-11-24,23,2,53,55
25243,2013-11-25,0,2,22,24
25244,2013-11-25,1,0,4,4
25245,2013-11-25,2,1,1,2
25246,2013-11-25,3,0,5,5
25247,2013-11-25,4,1,5,6
25248,2013-11-25,5,0,28,28
25249,2013-11-25,6,0,120,120
25250,2013-11-25,7,6,394,400
25251,2013-11-25,8,9,730,739
25252,2013-11-25,9,15,330,345
25253,2013-11-25,10,21,141,162
25254,2013-11-25,11,38,162,200
25255,2013-11-25,12,26,203,229
25256,2013-11-25,13,27,162,189
25257,2013-11-25,14,27,174,201
25258,2013-11-25,15,39,184,223
25259,2013-11-25,16,27,351,378
25260,2013-11-25,17,36,570,606
25261,2013-11-25,18,11,496,507
25262,2013-11-25,19,8,354,362
25263,2013-11-25,20,7,203,210
25264,2013-11-25,21,4,160,164
25265,2013-11-25,22,2,87,89
25266,2013-11-25,23,3,64,67
25267,2013-11-26,0,0,27,27
25268,2013-11-26,1,0,9,9
25269,2013-11-26,2,0,8,8
25270,2013-11-26,3,0,2,2
25271,2013-11-26,4,1,5,6
25272,2013-11-26,5,0,31,31
25273,2013-11-26,6,6,137,143
25274,2013-11-26,7,4,379,383
25275,2013-11-26,8,7,348,355
25276,2013-11-26,9,3,114,117
25277,2013-11-26,10,4,42,46
25278,2013-11-26,11,2,43,45
25279,2013-11-26,12,7,48,55
25280,2013-11-26,13,3,48,51
25281,2013-11-26,14,1,46,47
25282,2013-11-26,15,2,42,44
25283,2013-11-26,16,2,87,89
25284,2013-11-26,17,4,121,125
25285,2013-11-26,18,3,135,138
25286,2013-11-26,19,0,61,61
25287,2013-11-26,20,1,32,33
25288,2013-11-26,21,1,26,27
25289,2013-11-26,22,0,21,21
25290,2013-11-26,23,0,10,10
25291,2013-11-27,0,0,6,6
25292,2013-11-27,1,0,2,2
25293,2013-11-27,2,0,2,2
25294,2013-11-27,3,1,1,2
25295,2013-11-27,4,0,8,8
25296,2013-11-27,5,0,17,17
25297,2013-11-27,6,0,34,34
25298,2013-11-27,7,0,106,106
25299,2013-11-27,8,6,339,345
25300,2013-11-27,9,6,255,261
25301,2013-11-27,10,4,77,81
25302,2013-11-27,11,4,77,81
25303,2013-11-27,12,1,73,74
25304,2013-11-27,13,4,85,89
25305,2013-11-27,14,2,102,104
25306,2013-11-27,15,1,182,183
25307,2013-11-27,16,0,166,166
25308,2013-11-27,17,3,182,185
25309,2013-11-27,18,2,159,161
25310,2013-11-27,19,2,106,108
25311,2013-11-27,20,0,80,80
25312,2013-11-27,21,2,64,66
25313,2013-11-27,22,2,39,41
25314,2013-11-27,23,4,34,38
25315,2013-11-28,0,2,15,17
25316,2013-11-28,1,1,18,19
25317,2013-11-28,2,3,16,19
25318,2013-11-28,3,0,12,12
25319,2013-11-28,4,0,8,8
25320,2013-11-28,5,0,5,5
25321,2013-11-28,6,1,23,24
25322,2013-11-28,7,0,27,27
25323,2013-11-28,8,9,65,74
25324,2013-11-28,9,10,78,88
25325,2013-11-28,10,19,110,129
25326,2013-11-28,11,35,100,135
25327,2013-11-28,12,44,98,142
25328,2013-11-28,13,42,99,141
25329,2013-11-28,14,62,102,164
25330,2013-11-28,15,50,97,147
25331,2013-11-28,16,37,70,107
25332,2013-11-28,17,23,38,61
25333,2013-11-28,18,7,29,36
25334,2013-11-28,19,13,20,33
25335,2013-11-28,20,13,38,51
25336,2013-11-28,21,6,35,41
25337,2013-11-28,22,3,41,44
25338,2013-11-28,23,8,42,50
25339,2013-11-29,0,1,16,17
25340,2013-11-29,1,0,12,12
25341,2013-11-29,2,0,5,5
25342,2013-11-29,3,1,5,6
25343,2013-11-29,4,1,1,2
25344,2013-11-29,5,1,7,8
25345,2013-11-29,6,4,27,31
25346,2013-11-29,7,4,59,63
25347,2013-11-29,8,15,119,134
25348,2013-11-29,9,16,106,122
25349,2013-11-29,10,35,100,135
25350,2013-11-29,11,66,128,194
25351,2013-11-29,12,83,161,244
25352,2013-11-29,13,105,176,281
25353,2013-11-29,14,112,192,304
25354,2013-11-29,15,91,196,287
25355,2013-11-29,16,84,222,306
25356,2013-11-29,17,34,186,220
25357,2013-11-29,18,13,113,126
25358,2013-11-29,19,13,108,121
25359,2013-11-29,20,9,84,93
25360,2013-11-29,21,12,64,76
25361,2013-11-29,22,19,58,77
25362,2013-11-29,23,3,51,54
25363,2013-11-30,0,4,25,29
25364,2013-11-30,1,1,24,25
25365,2013-11-30,2,4,22,26
25366,2013-11-30,3,3,8,11
25367,2013-11-30,4,1,4,5
25368,2013-11-30,5,1,2,3
25369,2013-11-30,6,1,13,14
25370,2013-11-30,7,3,17,20
25371,2013-11-30,8,14,52,66
25372,2013-11-30,9,27,90,117
25373,2013-11-30,10,50,124,174
25374,2013-11-30,11,71,176,247
25375,2013-11-30,12,68,174,242
25376,2013-11-30,13,93,190,283
25377,2013-11-30,14,101,190,291
25378,2013-11-30,15,102,209,311
25379,2013-11-30,16,86,189,275
25380,2013-11-30,17,55,147,202
25381,2013-11-30,18,37,109,146
25382,2013-11-30,19,15,105,120
25383,2013-11-30,20,24,100,124
25384,2013-11-30,21,11,84,95
25385,2013-11-30,22,7,97,104
25386,2013-11-30,23,5,67,72
25387,2013-12-01,0,1,52,53
25388,2013-12-01,1,2,43,45
25389,2013-12-01,2,3,25,28
25390,2013-12-01,3,3,15,18
25391,2013-12-01,4,1,7,8
25392,2013-12-01,5,0,5,5
25393,2013-12-01,6,0,15,15
25394,2013-12-01,7,1,28,29
25395,2013-12-01,8,4,68,72
25396,2013-12-01,9,19,126,145
25397,2013-12-01,10,28,182,210
25398,2013-12-01,11,54,216,270
25399,2013-12-01,12,80,260,340
25400,2013-12-01,13,93,242,335
25401,2013-12-01,14,88,302,390
25402,2013-12-01,15,89,256,345
25403,2013-12-01,16,52,288,340
25404,2013-12-01,17,40,235,275
25405,2013-12-01,18,44,175,219
25406,2013-12-01,19,27,142,169
25407,2013-12-01,20,6,103,109
25408,2013-12-01,21,17,89,106
25409,2013-12-01,22,1,76,77
25410,2013-12-01,23,8,57,65
25411,2013-12-02,0,1,26,27
25412,2013-12-02,1,1,15,16
25413,2013-12-02,2,3,8,11
25414,2013-12-02,3,2,3,5
25415,2013-12-02,4,1,10,11
25416,2013-12-02,5,0,42,42
25417,2013-12-02,6,2,158,160
25418,2013-12-02,7,4,480,484
25419,2013-12-02,8,15,844,859
25420,2013-12-02,9,14,317,331
25421,2013-12-02,10,12,153,165
25422,2013-12-02,11,25,145,170
25423,2013-12-02,12,18,230,248
25424,2013-12-02,13,25,206,231
25425,2013-12-02,14,27,179,206
25426,2013-12-02,15,30,216,246
25427,2013-12-02,16,26,379,405
25428,2013-12-02,17,24,748,772
25429,2013-12-02,18,17,627,644
25430,2013-12-02,19,9,482,491
25431,2013-12-02,20,7,315,322
25432,2013-12-02,21,12,224,236
25433,2013-12-02,22,7,120,127
25434,2013-12-02,23,2,103,105
25435,2013-12-03,0,3,36,39
25436,2013-12-03,1,2,11,13
25437,2013-12-03,2,0,6,6
25438,2013-12-03,3,0,1,1
25439,2013-12-03,4,0,9,9
25440,2013-12-03,5,1,45,46
25441,2013-12-03,6,4,174,178
25442,2013-12-03,7,8,560,568
25443,2013-12-03,8,15,942,957
25444,2013-12-03,9,16,443,459
25445,2013-12-03,10,19,187,206
25446,2013-12-03,11,29,205,234
25447,2013-12-03,12,41,270,311
25448,2013-12-03,13,40,250,290
25449,2013-12-03,14,30,209,239
25450,2013-12-03,15,37,275,312
25451,2013-12-03,16,42,449,491
25452,2013-12-03,17,39,832,871
25453,2013-12-03,18,21,743,764
25454,2013-12-03,19,24,483,507
25455,2013-12-03,20,19,346,365
25456,2013-12-03,21,8,281,289
25457,2013-12-03,22,12,170,182
25458,2013-12-03,23,6,105,111
25459,2013-12-04,0,0,43,43
25460,2013-12-04,1,4,12,16
25461,2013-12-04,2,0,17,17
25462,2013-12-04,4,0,13,13
25463,2013-12-04,5,1,49,50
25464,2013-12-04,6,0,185,185
25465,2013-12-04,7,12,556,568
25466,2013-12-04,8,28,984,1012
25467,2013-12-04,9,9,371,380
25468,2013-12-04,10,27,205,232
25469,2013-12-04,11,47,198,245
25470,2013-12-04,12,28,255,283
25471,2013-12-04,13,34,286,320
25472,2013-12-04,14,43,227,270
25473,2013-12-04,15,34,253,287
25474,2013-12-04,16,48,427,475
25475,2013-12-04,17,23,783,806
25476,2013-12-04,18,31,781,812
25477,2013-12-04,19,15,512,527
25478,2013-12-04,20,21,352,373
25479,2013-12-04,21,21,300,321
25480,2013-12-04,22,10,203,213
25481,2013-12-04,23,1,102,103
25482,2013-12-05,0,2,63,65
25483,2013-12-05,1,0,17,17
25484,2013-12-05,2,0,9,9
25485,2013-12-05,3,0,6,6
25486,2013-12-05,4,0,10,10
25487,2013-12-05,5,0,45,45
25488,2013-12-05,6,7,210,217
25489,2013-12-05,7,17,566,583
25490,2013-12-05,8,27,922,949
25491,2013-12-05,9,30,435,465
25492,2013-12-05,10,31,210,241
25493,2013-12-05,11,33,207,240
25494,2013-12-05,12,51,293,344
25495,2013-12-05,13,62,344,406
25496,2013-12-05,14,47,264,311
25497,2013-12-05,15,41,331,372
25498,2013-12-05,16,54,477,531
25499,2013-12-05,17,45,823,868
25500,2013-12-05,18,26,775,801
25501,2013-12-05,19,33,528,561
25502,2013-12-05,20,32,391,423
25503,2013-12-05,21,27,255,282
25504,2013-12-05,22,12,218,230
25505,2013-12-05,23,5,160,165
25506,2013-12-06,0,10,89,99
25507,2013-12-06,1,0,36,36
25508,2013-12-06,2,1,16,17
25509,2013-12-06,3,0,7,7
25510,2013-12-06,4,0,7,7
25511,2013-12-06,5,0,49,49
25512,2013-12-06,6,2,115,117
25513,2013-12-06,7,5,246,251
25514,2013-12-06,8,13,520,533
25515,2013-12-06,9,9,240,249
25516,2013-12-06,10,20,140,160
25517,2013-12-06,11,18,76,94
25518,2013-12-06,12,15,84,99
25519,2013-12-06,13,8,134,142
25520,2013-12-06,14,4,78,82
25521,2013-12-06,15,4,67,71
25522,2013-12-06,16,3,120,123
25523,2013-12-06,17,6,198,204
25524,2013-12-06,18,1,176,177
25525,2013-12-06,19,3,146,149
25526,2013-12-06,20,4,111,115
25527,2013-12-06,21,5,70,75
25528,2013-12-06,22,14,30,44
25529,2013-12-06,23,0,44,44
25530,2013-12-07,0,0,29,29
25531,2013-12-07,1,1,18,19
25532,2013-12-07,2,2,47,49
25533,2013-12-07,3,1,23,24
25534,2013-12-07,4,0,8,8
25535,2013-12-07,5,1,5,6
25536,2013-12-07,6,6,18,24
25537,2013-12-07,7,6,62,68
25538,2013-12-07,8,11,130,141
25539,2013-12-07,9,30,214,244
25540,2013-12-07,10,44,301,345
25541,2013-12-07,11,64,364,428
25542,2013-12-07,12,63,370,433
25543,2013-12-07,13,72,387,459
25544,2013-12-07,14,62,352,414
25545,2013-12-07,15,75,360,435
25546,2013-12-07,16,39,325,364
25547,2013-12-07,17,34,259,293
25548,2013-12-07,18,26,237,263
25549,2013-12-07,19,21,230,251
25550,2013-12-07,20,6,167,173
25551,2013-12-07,21,14,133,147
25552,2013-12-07,22,10,131,141
25553,2013-12-07,23,5,113,118
25554,2013-12-08,0,8,131,139
25555,2013-12-08,1,9,78,87
25556,2013-12-08,2,1,62,63
25557,2013-12-08,3,3,23,26
25558,2013-12-08,4,0,6,6
25559,2013-12-08,5,1,8,9
25560,2013-12-08,6,1,9,10
25561,2013-12-08,7,4,32,36
25562,2013-12-08,8,3,85,88
25563,2013-12-08,9,12,87,99
25564,2013-12-08,10,12,117,129
25565,2013-12-08,11,5,121,126
25566,2013-12-08,12,7,111,118
25567,2013-12-08,13,2,75,77
25568,2013-12-08,14,2,48,50
25569,2013-12-08,15,4,58,62
25570,2013-12-08,16,4,37,41
25571,2013-12-08,17,1,42,43
25572,2013-12-08,18,3,39,42
25573,2013-12-08,19,3,25,28
25574,2013-12-08,20,2,26,28
25575,2013-12-08,21,1,21,22
25576,2013-12-08,22,0,10,10
25577,2013-12-08,23,0,18,18
25578,2013-12-09,0,0,3,3
25579,2013-12-09,1,0,1,1
25580,2013-12-09,2,0,4,4
25581,2013-12-09,3,0,2,2
25582,2013-12-09,4,2,3,5
25583,2013-12-09,5,1,18,19
25584,2013-12-09,6,1,37,38
25585,2013-12-09,7,0,67,67
25586,2013-12-09,8,2,149,151
25587,2013-12-09,9,4,199,203
25588,2013-12-09,10,2,177,179
25589,2013-12-09,11,1,112,113
25590,2013-12-09,12,0,103,103
25591,2013-12-09,13,2,129,131
25592,2013-12-09,14,7,106,113
25593,2013-12-09,15,6,150,156
25594,2013-12-09,16,9,237,246
25595,2013-12-09,17,11,483,494
25596,2013-12-09,18,7,477,484
25597,2013-12-09,19,5,323,328
25598,2013-12-09,20,2,237,239
25599,2013-12-09,21,2,170,172
25600,2013-12-09,22,1,122,123
25601,2013-12-09,23,2,70,72
25602,2013-12-10,0,2,31,33
25603,2013-12-10,1,0,11,11
25604,2013-12-10,2,1,0,1
25605,2013-12-10,3,0,2,2
25606,2013-12-10,4,0,7,7
25607,2013-12-10,5,1,27,28
25608,2013-12-10,6,0,61,61
25609,2013-12-10,7,3,58,61
25610,2013-12-10,8,1,91,92
25611,2013-12-10,9,1,51,52
25612,2013-12-10,10,5,49,54
25613,2013-12-10,11,1,54,55
25614,2013-12-10,12,4,103,107
25615,2013-12-10,13,3,113,116
25616,2013-12-10,14,5,145,150
25617,2013-12-10,15,14,187,201
25618,2013-12-10,16,15,232,247
25619,2013-12-10,17,14,325,339
25620,2013-12-10,18,8,338,346
25621,2013-12-10,19,8,214,222
25622,2013-12-10,20,6,174,180
25623,2013-12-10,21,4,140,144
25624,2013-12-10,22,1,126,127
25625,2013-12-10,23,2,58,60
25626,2013-12-11,0,0,35,35
25627,2013-12-11,1,1,13,14
25628,2013-12-11,2,0,5,5
25629,2013-12-11,3,0,2,2
25630,2013-12-11,4,0,4,4
25631,2013-12-11,5,1,35,36
25632,2013-12-11,6,2,115,117
25633,2013-12-11,7,5,350,355
25634,2013-12-11,8,15,721,736
25635,2013-12-11,9,6,355,361
25636,2013-12-11,10,16,131,147
25637,2013-12-11,11,21,166,187
25638,2013-12-11,12,19,194,213
25639,2013-12-11,13,14,167,181
25640,2013-12-11,14,14,159,173
25641,2013-12-11,15,13,201,214
25642,2013-12-11,16,26,325,351
25643,2013-12-11,17,12,610,622
25644,2013-12-11,18,14,558,572
25645,2013-12-11,19,12,378,390
25646,2013-12-11,20,13,286,299
25647,2013-12-11,21,9,218,227
25648,2013-12-11,22,4,138,142
25649,2013-12-11,23,7,80,87
25650,2013-12-12,0,1,41,42
25651,2013-12-12,1,2,15,17
25652,2013-12-12,2,0,7,7
25653,2013-12-12,3,2,4,6
25654,2013-12-12,4,0,3,3
25655,2013-12-12,5,1,40,41
25656,2013-12-12,6,1,132,133
25657,2013-12-12,7,3,367,370
25658,2013-12-12,8,13,691,704
25659,2013-12-12,9,14,348,362
25660,2013-12-12,10,11,167,178
25661,2013-12-12,11,9,145,154
25662,2013-12-12,12,8,159,167
25663,2013-12-12,13,9,177,186
25664,2013-12-12,14,10,145,155
25665,2013-12-12,15,13,209,222
25666,2013-12-12,16,10,314,324
25667,2013-12-12,17,9,539,548
25668,2013-12-12,18,10,470,480
25669,2013-12-12,19,8,328,336
25670,2013-12-12,20,10,243,253
25671,2013-12-12,21,6,181,187
25672,2013-12-12,22,6,134,140
25673,2013-12-12,23,2,67,69
25674,2013-12-13,0,0,53,53
25675,2013-12-13,1,2,26,28
25676,2013-12-13,2,1,10,11
25677,2013-12-13,3,0,5,5
25678,2013-12-13,4,0,4,4
25679,2013-12-13,5,2,47,49
25680,2013-12-13,6,0,114,114
25681,2013-12-13,7,3,330,333
25682,2013-12-13,8,6,694,700
25683,2013-12-13,9,7,392,399
25684,2013-12-13,10,14,182,196
25685,2013-12-13,11,16,185,201
25686,2013-12-13,12,19,225,244
25687,2013-12-13,13,24,217,241
25688,2013-12-13,14,19,221,240
25689,2013-12-13,15,28,243,271
25690,2013-12-13,16,32,371,403
25691,2013-12-13,17,21,562,583
25692,2013-12-13,18,13,498,511
25693,2013-12-13,19,12,315,327
25694,2013-12-13,20,7,222,229
25695,2013-12-13,21,9,205,214
25696,2013-12-13,22,6,155,161
25697,2013-12-13,23,5,102,107
25698,2013-12-14,0,12,100,112
25699,2013-12-14,1,3,83,86
25700,2013-12-14,2,4,46,50
25701,2013-12-14,3,2,26,28
25702,2013-12-14,4,1,3,4
25703,2013-12-14,5,1,10,11
25704,2013-12-14,6,1,13,14
25705,2013-12-14,7,2,50,52
25706,2013-12-14,8,12,128,140
25707,2013-12-14,9,11,176,187
25708,2013-12-14,10,24,238,262
25709,2013-12-14,11,38,277,315
25710,2013-12-14,12,36,315,351
25711,2013-12-14,13,45,301,346
25712,2013-12-14,14,19,240,259
25713,2013-12-14,15,18,170,188
25714,2013-12-14,16,7,59,66
25715,2013-12-14,17,4,48,52
25716,2013-12-14,18,3,47,50
25717,2013-12-14,19,4,52,56
25718,2013-12-14,20,4,30,34
25719,2013-12-14,21,1,28,29
25720,2013-12-14,22,1,46,47
25721,2013-12-14,23,0,55,55
25722,2013-12-15,0,1,63,64
25723,2013-12-15,1,2,47,49
25724,2013-12-15,2,2,66,68
25725,2013-12-15,3,2,24,26
25726,2013-12-15,4,2,7,9
25727,2013-12-15,5,1,3,4
25728,2013-12-15,6,0,11,11
25729,2013-12-15,7,3,34,37
25730,2013-12-15,8,7,75,82
25731,2013-12-15,9,14,162,176
25732,2013-12-15,10,44,240,284
25733,2013-12-15,11,53,298,351
25734,2013-12-15,12,59,390,449
25735,2013-12-15,13,62,377,439
25736,2013-12-15,14,81,339,420
25737,2013-12-15,15,57,351,408
25738,2013-12-15,16,52,347,399
25739,2013-12-15,17,45,239,284
25740,2013-12-15,18,14,192,206
25741,2013-12-15,19,11,156,167
25742,2013-12-15,20,15,112,127
25743,2013-12-15,21,6,104,110
25744,2013-12-15,22,5,77,82
25745,2013-12-15,23,1,48,49
25746,2013-12-16,0,2,38,40
25747,2013-12-16,1,4,9,13
25748,2013-12-16,2,1,3,4
25749,2013-12-16,3,0,2,2
25750,2013-12-16,4,2,6,8
25751,2013-12-16,5,1,36,37
25752,2013-12-16,6,1,150,151
25753,2013-12-16,7,5,404,409
25754,2013-12-16,8,8,761,769
25755,2013-12-16,9,7,378,385
25756,2013-12-16,10,11,138,149
25757,2013-12-16,11,19,138,157
25758,2013-12-16,12,28,204,232
25759,2013-12-16,13,34,214,248
25760,2013-12-16,14,10,172,182
25761,2013-12-16,15,20,218,238
25762,2013-12-16,16,20,305,325
25763,2013-12-16,17,10,621,631
25764,2013-12-16,18,12,531,543
25765,2013-12-16,19,19,417,436
25766,2013-12-16,20,5,244,249
25767,2013-12-16,21,11,196,207
25768,2013-12-16,22,6,115,121
25769,2013-12-16,23,3,73,76
25770,2013-12-17,0,1,29,30
25771,2013-12-17,1,0,17,17
25772,2013-12-17,2,0,3,3
25773,2013-12-17,3,2,3,5
25774,2013-12-17,4,0,6,6
25775,2013-12-17,5,0,47,47
25776,2013-12-17,6,1,162,163
25777,2013-12-17,7,4,424,428
25778,2013-12-17,8,6,840,846
25779,2013-12-17,9,6,394,400
25780,2013-12-17,10,13,179,192
25781,2013-12-17,11,14,189,203
25782,2013-12-17,12,16,193,209
25783,2013-12-17,13,26,215,241
25784,2013-12-17,14,12,171,183
25785,2013-12-17,15,16,229,245
25786,2013-12-17,16,17,325,342
25787,2013-12-17,17,13,403,416
25788,2013-12-17,18,16,387,403
25789,2013-12-17,19,17,292,309
25790,2013-12-17,20,4,248,252
25791,2013-12-17,21,9,183,192
25792,2013-12-17,22,3,124,127
25793,2013-12-17,23,6,85,91
25794,2013-12-18,0,2,31,33
25795,2013-12-18,1,1,14,15
25796,2013-12-18,2,0,7,7
25797,2013-12-18,3,0,3,3
25798,2013-12-18,4,0,5,5
25799,2013-12-18,5,1,38,39
25800,2013-12-18,6,0,136,136
25801,2013-12-18,7,4,430,434
25802,2013-12-18,8,12,763,775
25803,2013-12-18,9,13,344,357
25804,2013-12-18,10,22,139,161
25805,2013-12-18,11,26,155,181
25806,2013-12-18,12,20,194,214
25807,2013-12-18,13,39,205,244
25808,2013-12-18,14,15,182,197
25809,2013-12-18,15,34,211,245
25810,2013-12-18,16,35,343,378
25811,2013-12-18,17,27,633,660
25812,2013-12-18,18,11,553,564
25813,2013-12-18,19,6,379,385
25814,2013-12-18,20,5,292,297
25815,2013-12-18,21,7,204,211
25816,2013-12-18,22,5,131,136
25817,2013-12-18,23,7,88,95
25818,2013-12-19,0,1,28,29
25819,2013-12-19,1,2,14,16
25820,2013-12-19,2,0,10,10
25821,2013-12-19,3,0,3,3
25822,2013-12-19,4,0,6,6
25823,2013-12-19,5,0,42,42
25824,2013-12-19,6,2,134,136
25825,2013-12-19,7,2,390,392
25826,2013-12-19,8,10,759,769
25827,2013-12-19,9,20,376,396
25828,2013-12-19,10,19,158,177
25829,2013-12-19,11,28,185,213
25830,2013-12-19,12,52,262,314
25831,2013-12-19,13,35,245,280
25832,2013-12-19,14,58,224,282
25833,2013-12-19,15,50,311,361
25834,2013-12-19,16,51,386,437
25835,2013-12-19,17,67,688,755
25836,2013-12-19,18,10,697,707
25837,2013-12-19,19,26,439,465
25838,2013-12-19,20,14,291,305
25839,2013-12-19,21,13,228,241
25840,2013-12-19,22,10,175,185
25841,2013-12-19,23,11,121,132
25842,2013-12-20,0,8,74,82
25843,2013-12-20,1,6,39,45
25844,2013-12-20,2,7,14,21
25845,2013-12-20,3,0,6,6
25846,2013-12-20,4,1,5,6
25847,2013-12-20,5,1,47,48
25848,2013-12-20,6,2,127,129
25849,2013-12-20,7,2,387,389
25850,2013-12-20,8,20,680,700
25851,2013-12-20,9,23,458,481
25852,2013-12-20,10,34,188,222
25853,2013-12-20,11,36,230,266
25854,2013-12-20,12,53,298,351
25855,2013-12-20,13,43,286,329
25856,2013-12-20,14,60,254,314
25857,2013-12-20,15,66,307,373
25858,2013-12-20,16,54,419,473
25859,2013-12-20,17,51,605,656
25860,2013-12-20,18,19,474,493
25861,2013-12-20,19,18,339,357
25862,2013-12-20,20,28,226,254
25863,2013-12-20,21,22,181,203
25864,2013-12-20,22,18,162,180
25865,2013-12-20,23,8,125,133
25866,2013-12-21,0,11,102,113
25867,2013-12-21,1,4,67,71
25868,2013-12-21,2,8,63,71
25869,2013-12-21,3,3,19,22
25870,2013-12-21,4,2,2,4
25871,2013-12-21,5,1,3,4
25872,2013-12-21,6,3,18,21
25873,2013-12-21,7,7,48,55
25874,2013-12-21,8,21,102,123
25875,2013-12-21,9,55,185,240
25876,2013-12-21,10,73,262,335
25877,2013-12-21,11,112,344,456
25878,2013-12-21,12,142,350,492
25879,2013-12-21,13,178,408,586
25880,2013-12-21,14,220,455,675
25881,2013-12-21,15,238,450,688
25882,2013-12-21,16,241,397,638
25883,2013-12-21,17,177,318,495
25884,2013-12-21,18,103,260,363
25885,2013-12-21,19,65,201,266
25886,2013-12-21,20,61,145,206
25887,2013-12-21,21,49,151,200
25888,2013-12-21,22,37,137,174
25889,2013-12-21,23,27,105,132
25890,2013-12-22,0,38,75,113
25891,2013-12-22,1,16,68,84
25892,2013-12-22,2,1,41,42
25893,2013-12-22,3,7,15,22
25894,2013-12-22,4,5,3,8
25895,2013-12-22,5,1,3,4
25896,2013-12-22,6,0,11,11
25897,2013-12-22,7,3,31,34
25898,2013-12-22,8,6,45,51
25899,2013-12-22,9,8,39,47
25900,2013-12-22,10,22,74,96
25901,2013-12-22,11,23,100,123
25902,2013-12-22,12,45,158,203
25903,2013-12-22,13,57,179,236
25904,2013-12-22,14,76,203,279
25905,2013-12-22,15,77,193,270
25906,2013-12-22,16,90,233,323
25907,2013-12-22,17,59,185,244
25908,2013-12-22,18,36,115,151
25909,2013-12-22,19,20,123,143
25910,2013-12-22,20,17,101,118
25911,2013-12-22,21,28,85,113
25912,2013-12-22,22,14,44,58
25913,2013-12-22,23,11,46,57
25914,2013-12-23,0,4,13,17
25915,2013-12-23,1,2,7,9
25916,2013-12-23,2,0,1,1
25917,2013-12-23,3,0,2,2
25918,2013-12-23,4,0,2,2
25919,2013-12-23,5,0,10,10
25920,2013-12-23,6,1,27,28
25921,2013-12-23,7,3,83,86
25922,2013-12-23,8,8,109,117
25923,2013-12-23,9,15,78,93
25924,2013-12-23,10,8,28,36
25925,2013-12-23,11,16,40,56
25926,2013-12-23,12,14,58,72
25927,2013-12-23,13,8,86,94
25928,2013-12-23,14,9,129,138
25929,2013-12-23,15,21,132,153
25930,2013-12-23,16,9,172,181
25931,2013-12-23,17,15,251,266
25932,2013-12-23,18,5,204,209
25933,2013-12-23,19,11,147,158
25934,2013-12-23,20,4,104,108
25935,2013-12-23,21,0,69,69
25936,2013-12-23,22,4,48,52
25937,2013-12-23,23,2,42,44
25938,2013-12-24,0,1,25,26
25939,2013-12-24,1,0,5,5
25940,2013-12-24,2,0,2,2
25941,2013-12-24,3,0,3,3
25942,2013-12-24,4,0,7,7
25943,2013-12-24,5,0,19,19
25944,2013-12-24,6,2,55,57
25945,2013-12-24,7,2,105,107
25946,2013-12-24,8,5,203,208
25947,2013-12-24,9,7,150,157
25948,2013-12-24,10,34,100,134
25949,2013-12-24,11,38,156,194
25950,2013-12-24,12,50,168,218
25951,2013-12-24,13,43,227,270
25952,2013-12-24,14,23,206,229
25953,2013-12-24,15,22,180,202
25954,2013-12-24,16,11,144,155
25955,2013-12-24,17,13,110,123
25956,2013-12-24,18,10,63,73
25957,2013-12-24,19,4,44,48
25958,2013-12-24,20,2,31,33
25959,2013-12-24,21,3,27,30
25960,2013-12-24,22,5,15,20
25961,2013-12-24,23,1,24,25
25962,2013-12-25,0,0,6,6
25963,2013-12-25,1,1,11,12
25964,2013-12-25,2,0,1,1
25965,2013-12-25,3,0,2,2
25966,2013-12-25,5,1,3,4
25967,2013-12-25,6,1,4,5
25968,2013-12-25,7,0,6,6
25969,2013-12-25,8,3,19,22
25970,2013-12-25,9,18,24,42
25971,2013-12-25,10,16,34,50
25972,2013-12-25,11,37,51,88
25973,2013-12-25,12,54,62,116
25974,2013-12-25,13,61,61,122
25975,2013-12-25,14,49,51,100
25976,2013-12-25,15,36,55,91
25977,2013-12-25,16,37,53,90
25978,2013-12-25,17,11,43,54
25979,2013-12-25,18,9,35,44
25980,2013-12-25,19,7,37,44
25981,2013-12-25,20,6,26,32
25982,2013-12-25,21,5,26,31
25983,2013-12-25,22,2,22,24
25984,2013-12-25,23,0,15,15
25985,2013-12-26,0,0,9,9
25986,2013-12-26,1,0,2,2
25987,2013-12-26,2,0,1,1
25988,2013-12-26,4,0,2,2
25989,2013-12-26,5,0,13,13
25990,2013-12-26,6,0,28,28
25991,2013-12-26,7,1,85,86
25992,2013-12-26,8,1,157,158
25993,2013-12-26,9,6,141,147
25994,2013-12-26,10,16,75,91
25995,2013-12-26,11,33,94,127
25996,2013-12-26,12,54,133,187
25997,2013-12-26,13,55,130,185
25998,2013-12-26,14,48,110,158
25999,2013-12-26,15,66,152,218
26000,2013-12-26,16,64,177,241
26001,2013-12-26,17,40,230,270
26002,2013-12-26,18,12,159,171
26003,2013-12-26,19,10,112,122
26004,2013-12-26,20,7,80,87
26005,2013-12-26,21,2,50,52
26006,2013-12-26,22,6,46,52
26007,2013-12-26,23,4,35,39
26008,2013-12-27,0,0,19,19
26009,2013-12-27,1,2,8,10
26010,2013-12-27,2,1,6,7
26011,2013-12-27,4,0,1,1
26012,2013-12-27,5,1,22,23
26013,2013-12-27,6,1,46,47
26014,2013-12-27,7,2,126,128
26015,2013-12-27,8,14,224,238
26016,2013-12-27,9,22,181,203
26017,2013-12-27,10,70,107,177
26018,2013-12-27,11,98,133,231
26019,2013-12-27,12,59,154,213
26020,2013-12-27,13,91,178,269
26021,2013-12-27,14,77,200,277
26022,2013-12-27,15,87,181,268
26023,2013-12-27,16,91,248,339
26024,2013-12-27,17,66,301,367
26025,2013-12-27,18,33,201,234
26026,2013-12-27,19,26,139,165
26027,2013-12-27,20,20,112,132
26028,2013-12-27,21,17,66,83
26029,2013-12-27,22,19,73,92
26030,2013-12-27,23,3,58,61
26031,2013-12-28,0,1,47,48
26032,2013-12-28,1,5,34,39
26033,2013-12-28,2,1,20,21
26034,2013-12-28,3,2,4,6
26035,2013-12-28,4,0,5,5
26036,2013-12-28,5,0,5,5
26037,2013-12-28,6,1,10,11
26038,2013-12-28,7,4,27,31
26039,2013-12-28,8,8,49,57
26040,2013-12-28,9,48,86,134
26041,2013-12-28,10,109,133,242
26042,2013-12-28,11,158,155,313
26043,2013-12-28,12,219,194,413
26044,2013-12-28,13,217,219,436
26045,2013-12-28,14,287,257,544
26046,2013-12-28,15,261,222,483
26047,2013-12-28,16,240,233,473
26048,2013-12-28,17,151,190,341
26049,2013-12-28,18,86,151,237
26050,2013-12-28,19,52,107,159
26051,2013-12-28,20,27,88,115
26052,2013-12-28,21,35,115,150
26053,2013-12-28,22,19,70,89
26054,2013-12-28,23,4,64,68
26055,2013-12-29,0,9,46,55
26056,2013-12-29,1,15,46,61
26057,2013-12-29,2,1,26,27
26058,2013-12-29,3,1,17,18
26059,2013-12-29,4,1,3,4
26060,2013-12-29,5,0,1,1
26061,2013-12-29,6,1,1,2
26062,2013-12-29,7,2,10,12
26063,2013-12-29,8,0,11,11
26064,2013-12-29,9,2,16,18
26065,2013-12-29,10,5,19,24
26066,2013-12-29,11,1,20,21
26067,2013-12-29,12,1,17,18
26068,2013-12-29,13,12,34,46
26069,2013-12-29,14,24,76,100
26070,2013-12-29,15,20,112,132
26071,2013-12-29,16,37,145,182
26072,2013-12-29,17,22,133,155
26073,2013-12-29,18,35,116,151
26074,2013-12-29,19,20,83,103
26075,2013-12-29,20,18,60,78
26076,2013-12-29,21,31,67,98
26077,2013-12-29,22,18,63,81
26078,2013-12-29,23,11,32,43
26079,2013-12-30,0,12,19,31
26080,2013-12-30,1,2,11,13
26081,2013-12-30,2,0,5,5
26082,2013-12-30,3,0,3,3
26083,2013-12-30,4,1,4,5
26084,2013-12-30,5,0,27,27
26085,2013-12-30,6,0,90,90
26086,2013-12-30,7,3,229,232
26087,2013-12-30,8,16,397,413
26088,2013-12-30,9,46,259,305
26089,2013-12-30,10,51,140,191
26090,2013-12-30,11,58,160,218
26091,2013-12-30,12,67,166,233
26092,2013-12-30,13,71,186,257
26093,2013-12-30,14,78,170,248
26094,2013-12-30,15,75,210,285
26095,2013-12-30,16,73,267,340
26096,2013-12-30,17,45,426,471
26097,2013-12-30,18,22,343,365
26098,2013-12-30,19,13,233,246
26099,2013-12-30,20,15,122,137
26100,2013-12-30,21,17,86,103
26101,2013-12-30,22,5,73,78
26102,2013-12-30,23,4,55,59
26103,2013-12-31,0,0,25,25
26104,2013-12-31,1,0,14,14
26105,2013-12-31,2,2,6,8
26106,2013-12-31,3,0,1,1
26107,2013-12-31,4,1,6,7
26108,2013-12-31,5,1,17,18
26109,2013-12-31,6,0,64,64
26110,2013-12-31,7,2,183,185
26111,2013-12-31,8,15,396,411
26112,2013-12-31,9,28,255,283
26113,2013-12-31,10,38,151,189
26114,2013-12-31,11,72,164,236
26115,2013-12-31,12,53,230,283
26116,2013-12-31,13,48,264,312
26117,2013-12-31,14,58,295,353
26118,2013-12-31,15,73,364,437
26119,2013-12-31,16,61,310,371
26120,2013-12-31,17,22,230,252
26121,2013-12-31,18,15,181,196
26122,2013-12-31,19,7,143,150
26123,2013-12-31,20,13,87,100
26124,2013-12-31,21,11,87,98
26125,2013-12-31,22,4,68,72
26126,2013-12-31,23,6,54,60
26127,2014-01-01,0,4,63,67
26128,2014-01-01,1,5,99,104
26129,2014-01-01,2,24,97,121
26130,2014-01-01,3,13,51,64
26131,2014-01-01,4,0,10,10
26132,2014-01-01,5,0,11,11
26133,2014-01-01,6,0,10,10
26134,2014-01-01,7,0,10,10
26135,2014-01-01,8,1,25,26
26136,2014-01-01,9,12,55,67
26137,2014-01-01,10,20,72,92
26138,2014-01-01,11,37,142,179
26139,2014-01-01,12,67,193,260
26140,2014-01-01,13,94,188,282
26141,2014-01-01,14,120,215,335
26142,2014-01-01,15,107,187,294
26143,2014-01-01,16,81,200,281
26144,2014-01-01,17,53,155,208
26145,2014-01-01,18,17,130,147
26146,2014-01-01,19,23,116,139
26147,2014-01-01,20,22,83,105
26148,2014-01-01,21,6,85,91
26149,2014-01-01,22,16,51,67
26150,2014-01-01,23,7,33,40
26151,2014-01-02,0,2,14,16
26152,2014-01-02,1,0,2,2
26153,2014-01-02,2,0,1,1
26154,2014-01-02,4,0,1,1
26155,2014-01-02,5,3,21,24
26156,2014-01-02,6,1,108,109
26157,2014-01-02,7,5,267,272
26158,2014-01-02,8,10,585,595
26159,2014-01-02,9,15,324,339
26160,2014-01-02,10,19,115,134
26161,2014-01-02,11,19,130,149
26162,2014-01-02,12,28,170,198
26163,2014-01-02,13,43,180,223
26164,2014-01-02,14,45,176,221
26165,2014-01-02,15,40,196,236
26166,2014-01-02,16,17,190,207
26167,2014-01-02,17,21,234,255
26168,2014-01-02,18,10,160,170
26169,2014-01-02,19,7,65,72
26170,2014-01-02,20,0,42,42
26171,2014-01-02,21,2,21,23
26172,2014-01-02,22,1,14,15
26173,2014-01-02,23,0,12,12
26174,2014-01-03,0,1,6,7
26175,2014-01-03,1,3,6,9
26176,2014-01-03,2,0,3,3
26177,2014-01-03,4,0,2,2
26178,2014-01-03,5,0,11,11
26179,2014-01-03,6,1,17,18
26180,2014-01-03,7,0,51,51
26181,2014-01-03,8,2,130,132
26182,2014-01-03,9,2,99,101
26183,2014-01-03,10,14,45,59
26184,2014-01-03,11,4,49,53
26185,2014-01-03,12,0,71,71
26186,2014-01-03,13,6,71,77
26187,2014-01-03,14,9,70,79
26188,2014-01-03,15,11,96,107
26189,2014-01-03,16,8,111,119
26190,2014-01-03,17,7,215,222
26191,2014-01-03,18,2,192,194
26192,2014-01-03,19,5,98,103
26193,2014-01-03,20,0,67,67
26194,2014-01-03,21,0,53,53
26195,2014-01-03,22,0,40,40
26196,2014-01-03,23,0,30,30
26197,2014-01-04,0,1,20,21
26198,2014-01-04,1,0,16,16
26199,2014-01-04,2,0,13,13
26200,2014-01-04,3,2,6,8
26201,2014-01-04,4,0,1,1
26202,2014-01-04,5,0,6,6
26203,2014-01-04,6,0,4,4
26204,2014-01-04,7,1,21,22
26205,2014-01-04,8,1,52,53
26206,2014-01-04,9,4,91,95
26207,2014-01-04,10,11,117,128
26208,2014-01-04,11,12,167,179
26209,2014-01-04,12,15,177,192
26210,2014-01-04,13,12,155,167
26211,2014-01-04,14,21,164,185
26212,2014-01-04,15,23,192,215
26213,2014-01-04,16,6,194,200
26214,2014-01-04,17,14,137,151
26215,2014-01-04,18,7,142,149
26216,2014-01-04,19,4,127,131
26217,2014-01-04,20,6,89,95
26218,2014-01-04,21,3,73,76
26219,2014-01-04,22,9,61,70
26220,2014-01-04,23,6,59,65
26221,2014-01-05,0,5,59,64
26222,2014-01-05,1,1,44,45
26223,2014-01-05,2,1,34,35
26224,2014-01-05,3,0,19,19
26225,2014-01-05,4,0,4,4
26226,2014-01-05,5,0,3,3
26227,2014-01-05,6,0,2,2
26228,2014-01-05,7,3,14,17
26229,2014-01-05,8,0,21,21
26230,2014-01-05,9,0,43,43
26231,2014-01-05,10,1,84,85
26232,2014-01-05,11,6,120,126
26233,2014-01-05,12,11,145,156
26234,2014-01-05,13,13,175,188
26235,2014-01-05,14,13,161,174
26236,2014-01-05,15,28,163,191
26237,2014-01-05,16,20,214,234
26238,2014-01-05,17,16,193,209
26239,2014-01-05,18,8,99,107
26240,2014-01-05,19,3,101,104
26241,2014-01-05,20,0,112,112
26242,2014-01-05,21,2,53,55
26243,2014-01-05,22,2,31,33
26244,2014-01-05,23,2,31,33
26245,2014-01-06,0,0,15,15
26246,2014-01-06,1,0,4,4
26247,2014-01-06,2,0,2,2
26248,2014-01-06,3,0,2,2
26249,2014-01-06,4,0,2,2
26250,2014-01-06,5,0,15,15
26251,2014-01-06,6,0,81,81
26252,2014-01-06,7,3,167,170
26253,2014-01-06,8,5,594,599
26254,2014-01-06,9,6,235,241
26255,2014-01-06,10,7,104,111
26256,2014-01-06,11,10,103,113
26257,2014-01-06,12,14,143,157
26258,2014-01-06,13,7,147,154
26259,2014-01-06,14,11,115,126
26260,2014-01-06,15,10,171,181
26261,2014-01-06,16,9,244,253
26262,2014-01-06,17,13,466,479
26263,2014-01-06,18,10,359,369
26264,2014-01-06,19,4,207,211
26265,2014-01-06,20,8,88,96
26266,2014-01-06,21,4,75,79
26267,2014-01-06,22,1,26,27
26268,2014-01-06,23,1,18,19
26269,2014-01-07,0,0,18,18
26270,2014-01-07,1,0,4,4
26271,2014-01-07,2,0,1,1
26272,2014-01-07,3,0,1,1
26273,2014-01-07,4,0,2,2
26274,2014-01-07,5,0,23,23
26275,2014-01-07,6,0,49,49
26276,2014-01-07,7,4,143,147
26277,2014-01-07,8,4,303,307
26278,2014-01-07,9,2,205,207
26279,2014-01-07,10,3,65,68
26280,2014-01-07,11,3,46,49
26281,2014-01-07,12,0,76,76
26282,2014-01-07,13,1,67,68
26283,2014-01-07,14,2,69,71
26284,2014-01-07,15,4,71,75
26285,2014-01-07,16,0,136,136
26286,2014-01-07,17,1,274,275
26287,2014-01-07,18,2,274,276
26288,2014-01-07,19,1,172,173
26289,2014-01-07,20,0,93,93
26290,2014-01-07,21,1,68,69
26291,2014-01-07,22,1,56,57
26292,2014-01-07,23,0,37,37
26293,2014-01-08,0,0,8,8
26294,2014-01-08,1,0,1,1
26295,2014-01-08,2,0,1,1
26296,2014-01-08,3,0,1,1
26297,2014-01-08,4,0,3,3
26298,2014-01-08,5,0,23,23
26299,2014-01-08,6,1,91,92
26300,2014-01-08,7,2,208,210
26301,2014-01-08,8,4,537,541
26302,2014-01-08,9,2,295,297
26303,2014-01-08,10,4,83,87
26304,2014-01-08,11,7,107,114
26305,2014-01-08,12,8,127,135
26306,2014-01-08,13,4,125,129
26307,2014-01-08,14,8,129,137
26308,2014-01-08,15,4,143,147
26309,2014-01-08,16,10,224,234
26310,2014-01-08,17,6,493,499
26311,2014-01-08,18,8,432,440
26312,2014-01-08,19,4,324,328
26313,2014-01-08,20,1,171,172
26314,2014-01-08,21,0,120,120
26315,2014-01-08,22,1,77,78
26316,2014-01-08,23,1,57,58
26317,2014-01-09,0,1,11,12
26318,2014-01-09,1,1,4,5
26319,2014-01-09,2,1,1,2
26320,2014-01-09,3,0,3,3
26321,2014-01-09,4,0,2,2
26322,2014-01-09,5,0,35,35
26323,2014-01-09,6,2,128,130
26324,2014-01-09,7,2,324,326
26325,2014-01-09,8,5,738,743
26326,2014-01-09,9,3,343,346
26327,2014-01-09,10,17,133,150
26328,2014-01-09,11,19,115,134
26329,2014-01-09,12,34,187,221
26330,2014-01-09,13,28,188,216
26331,2014-01-09,14,11,155,166
26332,2014-01-09,15,21,195,216
26333,2014-01-09,16,16,269,285
26334,2014-01-09,17,8,533,541
26335,2014-01-09,18,8,468,476
26336,2014-01-09,19,3,343,346
26337,2014-01-09,20,2,247,249
26338,2014-01-09,21,4,162,166
26339,2014-01-09,22,2,109,111
26340,2014-01-09,23,2,65,67
26341,2014-01-10,0,2,40,42
26342,2014-01-10,1,0,9,9
26343,2014-01-10,2,0,7,7
26344,2014-01-10,3,0,3,3
26345,2014-01-10,4,0,3,3
26346,2014-01-10,5,0,20,20
26347,2014-01-10,6,0,39,39
26348,2014-01-10,7,1,76,77
26349,2014-01-10,8,0,131,131
26350,2014-01-10,9,2,95,97
26351,2014-01-10,10,0,35,35
26352,2014-01-10,11,5,65,70
26353,2014-01-10,12,3,123,126
26354,2014-01-10,13,8,78,86
26355,2014-01-10,14,6,54,60
26356,2014-01-10,15,14,98,112
26357,2014-01-10,16,5,102,107
26358,2014-01-10,17,9,206,215
26359,2014-01-10,18,7,179,186
26360,2014-01-10,19,3,85,88
26361,2014-01-10,20,6,114,120
26362,2014-01-10,21,1,75,76
26363,2014-01-10,22,2,70,72
26364,2014-01-10,23,7,55,62
26365,2014-01-11,0,2,62,64
26366,2014-01-11,1,6,47,53
26367,2014-01-11,2,1,29,30
26368,2014-01-11,3,0,16,16
26369,2014-01-11,4,0,6,6
26370,2014-01-11,5,0,5,5
26371,2014-01-11,6,0,3,3
26372,2014-01-11,7,0,22,22
26373,2014-01-11,8,3,57,60
26374,2014-01-11,9,2,110,112
26375,2014-01-11,10,0,62,62
26376,2014-01-11,11,1,73,74
26377,2014-01-11,12,1,85,86
26378,2014-01-11,13,0,94,94
26379,2014-01-11,14,6,119,125
26380,2014-01-11,15,4,114,118
26381,2014-01-11,16,2,84,86
26382,2014-01-11,17,1,113,114
26383,2014-01-11,18,8,148,156
26384,2014-01-11,19,20,172,192
26385,2014-01-11,20,23,119,142
26386,2014-01-11,21,7,114,121
26387,2014-01-11,22,5,96,101
26388,2014-01-11,23,5,108,113
26389,2014-01-12,0,3,102,105
26390,2014-01-12,1,4,85,89
26391,2014-01-12,2,3,65,68
26392,2014-01-12,3,0,29,29
26393,2014-01-12,4,0,8,8
26394,2014-01-12,5,1,3,4
26395,2014-01-12,6,4,7,11
26396,2014-01-12,7,7,28,35
26397,2014-01-12,8,27,80,107
26398,2014-01-12,9,21,163,184
26399,2014-01-12,10,67,247,314
26400,2014-01-12,11,66,322,388
26401,2014-01-12,12,110,392,502
26402,2014-01-12,13,135,411,546
26403,2014-01-12,14,137,389,526
26404,2014-01-12,15,110,424,534
26405,2014-01-12,16,90,447,537
26406,2014-01-12,17,71,314,385
26407,2014-01-12,18,44,277,321
26408,2014-01-12,19,34,197,231
26409,2014-01-12,20,34,183,217
26410,2014-01-12,21,14,117,131
26411,2014-01-12,22,11,73,84
26412,2014-01-12,23,6,50,56
26413,2014-01-13,0,3,14,17
26414,2014-01-13,1,2,6,8
26415,2014-01-13,2,4,5,9
26416,2014-01-13,3,0,1,1
26417,2014-01-13,4,0,4,4
26418,2014-01-13,5,0,36,36
26419,2014-01-13,6,2,137,139
26420,2014-01-13,7,27,410,437
26421,2014-01-13,8,20,799,819
26422,2014-01-13,9,32,355,387
26423,2014-01-13,10,44,130,174
26424,2014-01-13,11,43,174,217
26425,2014-01-13,12,65,267,332
26426,2014-01-13,13,67,265,332
26427,2014-01-13,14,63,198,261
26428,2014-01-13,15,88,217,305
26429,2014-01-13,16,65,401,466
26430,2014-01-13,17,67,783,850
26431,2014-01-13,18,21,686,707
26432,2014-01-13,19,39,488,527
26433,2014-01-13,20,26,319,345
26434,2014-01-13,21,28,228,256
26435,2014-01-13,22,18,142,160
26436,2014-01-13,23,8,64,72
26437,2014-01-14,0,8,24,32
26438,2014-01-14,1,2,9,11
26439,2014-01-14,2,0,2,2
26440,2014-01-14,3,1,1,2
26441,2014-01-14,4,0,3,3
26442,2014-01-14,5,1,44,45
26443,2014-01-14,6,3,137,140
26444,2014-01-14,7,11,293,304
26445,2014-01-14,8,33,736,769
26446,2014-01-14,9,36,311,347
26447,2014-01-14,10,17,91,108
26448,2014-01-14,11,5,56,61
26449,2014-01-14,12,4,44,48
26450,2014-01-14,13,5,39,44
26451,2014-01-14,14,10,70,80
26452,2014-01-14,15,21,154,175
26453,2014-01-14,16,31,286,317
26454,2014-01-14,17,35,603,638
26455,2014-01-14,18,28,649,677
26456,2014-01-14,19,41,407,448
26457,2014-01-14,20,18,299,317
26458,2014-01-14,21,18,218,236
26459,2014-01-14,22,14,164,178
26460,2014-01-14,23,3,74,77
26461,2014-01-15,0,4,30,34
26462,2014-01-15,1,2,11,13
26463,2014-01-15,2,2,8,10
26464,2014-01-15,4,0,2,2
26465,2014-01-15,5,1,37,38
26466,2014-01-15,6,2,136,138
26467,2014-01-15,7,16,417,433
26468,2014-01-15,8,18,804,822
26469,2014-01-15,9,29,357,386
26470,2014-01-15,10,21,151,172
26471,2014-01-15,11,31,175,206
26472,2014-01-15,12,48,224,272
26473,2014-01-15,13,45,197,242
26474,2014-01-15,14,50,194,244
26475,2014-01-15,15,50,241,291
26476,2014-01-15,16,36,393,429
26477,2014-01-15,17,59,735,794
26478,2014-01-15,18,35,681,716
26479,2014-01-15,19,20,427,447
26480,2014-01-15,20,19,292,311
26481,2014-01-15,21,10,204,214
26482,2014-01-15,22,10,154,164
26483,2014-01-15,23,8,73,81
26484,2014-01-16,0,3,37,40
26485,2014-01-16,1,2,6,8
26486,2014-01-16,2,0,5,5
26487,2014-01-16,3,0,3,3
26488,2014-01-16,4,2,4,6
26489,2014-01-16,5,2,42,44
26490,2014-01-16,6,2,143,145
26491,2014-01-16,7,6,406,412
26492,2014-01-16,8,23,831,854
26493,2014-01-16,9,25,374,399
26494,2014-01-16,10,19,143,162
26495,2014-01-16,11,41,145,186
26496,2014-01-16,12,32,198,230
26497,2014-01-16,13,45,195,240
26498,2014-01-16,14,41,152,193
26499,2014-01-16,15,31,210,241
26500,2014-01-16,16,28,349,377
26501,2014-01-16,17,20,636,656
26502,2014-01-16,18,26,648,674
26503,2014-01-16,19,16,399,415
26504,2014-01-16,20,5,276,281
26505,2014-01-16,21,7,195,202
26506,2014-01-16,22,3,142,145
26507,2014-01-16,23,6,92,98
26508,2014-01-17,0,6,45,51
26509,2014-01-17,1,1,13,14
26510,2014-01-17,2,2,10,12
26511,2014-01-17,3,0,2,2
26512,2014-01-17,4,0,3,3
26513,2014-01-17,5,1,35,36
26514,2014-01-17,6,1,118,119
26515,2014-01-17,7,2,347,349
26516,2014-01-17,8,10,771,781
26517,2014-01-17,9,10,396,406
26518,2014-01-17,10,27,172,199
26519,2014-01-17,11,24,190,214
26520,2014-01-17,12,41,255,296
26521,2014-01-17,13,54,260,314
26522,2014-01-17,14,64,242,306
26523,2014-01-17,15,63,265,328
26524,2014-01-17,16,78,384,462
26525,2014-01-17,17,52,632,684
26526,2014-01-17,18,29,530,559
26527,2014-01-17,19,21,347,368
26528,2014-01-17,20,13,212,225
26529,2014-01-17,21,16,155,171
26530,2014-01-17,22,12,120,132
26531,2014-01-17,23,5,101,106
26532,2014-01-18,0,7,87,94
26533,2014-01-18,1,5,74,79
26534,2014-01-18,2,4,32,36
26535,2014-01-18,3,1,21,22
26536,2014-01-18,4,0,8,8
26537,2014-01-18,5,0,5,5
26538,2014-01-18,6,0,16,16
26539,2014-01-18,7,3,42,45
26540,2014-01-18,8,7,85,92
26541,2014-01-18,9,27,152,179
26542,2014-01-18,10,46,211,257
26543,2014-01-18,11,36,263,299
26544,2014-01-18,12,49,237,286
26545,2014-01-18,13,36,237,273
26546,2014-01-18,14,48,193,241
26547,2014-01-18,15,53,216,269
26548,2014-01-18,16,31,219,250
26549,2014-01-18,17,28,181,209
26550,2014-01-18,18,7,143,150
26551,2014-01-18,19,7,135,142
26552,2014-01-18,20,4,122,126
26553,2014-01-18,21,6,87,93
26554,2014-01-18,22,2,58,60
26555,2014-01-18,23,3,65,68
26556,2014-01-19,0,3,60,63
26557,2014-01-19,1,0,50,50
26558,2014-01-19,2,3,44,47
26559,2014-01-19,3,0,18,18
26560,2014-01-19,4,0,3,3
26561,2014-01-19,5,2,1,3
26562,2014-01-19,6,1,6,7
26563,2014-01-19,7,2,19,21
26564,2014-01-19,8,2,55,57
26565,2014-01-19,9,20,93,113
26566,2014-01-19,10,35,190,225
26567,2014-01-19,11,64,262,326
26568,2014-01-19,12,99,315,414
26569,2014-01-19,13,83,308,391
26570,2014-01-19,14,79,350,429
26571,2014-01-19,15,109,281,390
26572,2014-01-19,16,73,264,337
26573,2014-01-19,17,61,249,310
26574,2014-01-19,18,23,236,259
26575,2014-01-19,19,11,145,156
26576,2014-01-19,20,10,126,136
26577,2014-01-19,21,12,116,128
26578,2014-01-19,22,17,125,142
26579,2014-01-19,23,11,63,74
26580,2014-01-20,0,5,43,48
26581,2014-01-20,1,4,28,32
26582,2014-01-20,2,1,14,15
26583,2014-01-20,3,0,7,7
26584,2014-01-20,4,0,3,3
26585,2014-01-20,5,0,7,7
26586,2014-01-20,6,2,40,42
26587,2014-01-20,7,2,72,74
26588,2014-01-20,8,8,137,145
26589,2014-01-20,9,6,165,171
26590,2014-01-20,10,54,190,244
26591,2014-01-20,11,67,281,348
26592,2014-01-20,12,118,357,475
26593,2014-01-20,13,100,441,541
26594,2014-01-20,14,113,369,482
26595,2014-01-20,15,154,402,556
26596,2014-01-20,16,119,422,541
26597,2014-01-20,17,58,408,466
26598,2014-01-20,18,32,323,355
26599,2014-01-20,19,18,230,248
26600,2014-01-20,20,5,190,195
26601,2014-01-20,21,4,148,152
26602,2014-01-20,22,6,97,103
26603,2014-01-20,23,4,62,66
26604,2014-01-21,0,4,24,28
26605,2014-01-21,1,2,8,10
26606,2014-01-21,3,0,1,1
26607,2014-01-21,4,0,5,5
26608,2014-01-21,5,1,38,39
26609,2014-01-21,6,1,89,90
26610,2014-01-21,7,2,185,187
26611,2014-01-21,8,6,369,375
26612,2014-01-21,9,5,258,263
26613,2014-01-21,10,7,157,164
26614,2014-01-21,11,6,105,111
26615,2014-01-21,12,3,65,68
26616,2014-01-21,13,0,60,60
26617,2014-01-21,14,0,43,43
26618,2014-01-21,15,2,52,54
26619,2014-01-21,16,1,48,49
26620,2014-01-21,17,0,51,51
26621,2014-01-21,18,2,48,50
26622,2014-01-21,19,0,21,21
26623,2014-01-21,20,0,32,32
26624,2014-01-21,21,0,16,16
26625,2014-01-21,22,1,14,15
26626,2014-01-21,23,2,13,15
26627,2014-01-22,0,0,7,7
26628,2014-01-22,1,1,4,5
26629,2014-01-22,2,0,3,3
26630,2014-01-22,3,1,0,1
26631,2014-01-22,5,0,7,7
26632,2014-01-22,6,0,19,19
26633,2014-01-22,7,0,27,27
26634,2014-01-22,8,0,94,94
26635,2014-01-22,9,1,120,121
26636,2014-01-22,10,1,83,84
26637,2014-01-22,11,0,44,44
26638,2014-01-22,12,0,46,46
26639,2014-01-22,13,0,56,56
26640,2014-01-22,14,0,45,45
26641,2014-01-22,15,1,56,57
26642,2014-01-22,16,1,98,99
26643,2014-01-22,17,1,190,191
26644,2014-01-22,18,2,164,166
26645,2014-01-22,19,2,137,139
26646,2014-01-22,20,0,89,89
26647,2014-01-22,21,0,65,65
26648,2014-01-22,22,0,36,36
26649,2014-01-22,23,2,23,25
26650,2014-01-23,0,0,9,9
26651,2014-01-23,1,0,1,1
26652,2014-01-23,2,0,1,1
26653,2014-01-23,3,0,1,1
26654,2014-01-23,4,0,1,1
26655,2014-01-23,5,0,19,19
26656,2014-01-23,6,0,50,50
26657,2014-01-23,7,0,146,146
26658,2014-01-23,8,2,341,343
26659,2014-01-23,9,3,181,184
26660,2014-01-23,10,1,75,76
26661,2014-01-23,11,2,82,84
26662,2014-01-23,12,6,87,93
26663,2014-01-23,13,4,91,95
26664,2014-01-23,14,4,97,101
26665,2014-01-23,15,2,94,96
26666,2014-01-23,16,2,115,117
26667,2014-01-23,17,5,302,307
26668,2014-01-23,18,1,259,260
26669,2014-01-23,19,1,163,164
26670,2014-01-23,20,1,119,120
26671,2014-01-23,21,0,79,79
26672,2014-01-23,22,0,53,53
26673,2014-01-23,23,0,26,26
26674,2014-01-24,0,1,13,14
26675,2014-01-24,1,0,3,3
26676,2014-01-24,2,0,5,5
26677,2014-01-24,3,0,2,2
26678,2014-01-24,4,0,1,1
26679,2014-01-24,5,0,21,21
26680,2014-01-24,6,0,60,60
26681,2014-01-24,7,2,139,141
26682,2014-01-24,8,4,327,331
26683,2014-01-24,9,5,201,206
26684,2014-01-24,10,2,94,96
26685,2014-01-24,11,2,102,104
26686,2014-01-24,12,1,105,106
26687,2014-01-24,13,2,111,113
26688,2014-01-24,14,7,107,114
26689,2014-01-24,15,1,130,131
26690,2014-01-24,16,0,161,161
26691,2014-01-24,17,5,326,331
26692,2014-01-24,18,2,246,248
26693,2014-01-24,19,3,161,164
26694,2014-01-24,20,1,98,99
26695,2014-01-24,21,1,78,79
26696,2014-01-24,22,0,54,54
26697,2014-01-24,23,1,38,39
26698,2014-01-25,0,0,34,34
26699,2014-01-25,1,1,39,40
26700,2014-01-25,2,2,27,29
26701,2014-01-25,3,0,7,7
26702,2014-01-25,4,0,2,2
26703,2014-01-25,5,0,3,3
26704,2014-01-25,6,0,11,11
26705,2014-01-25,7,0,24,24
26706,2014-01-25,8,0,75,75
26707,2014-01-25,9,0,76,76
26708,2014-01-25,10,0,141,141
26709,2014-01-25,11,4,168,172
26710,2014-01-25,12,5,156,161
26711,2014-01-25,13,3,179,182
26712,2014-01-25,14,13,156,169
26713,2014-01-25,15,8,174,182
26714,2014-01-25,16,22,168,190
26715,2014-01-25,17,13,173,186
26716,2014-01-25,18,7,132,139
26717,2014-01-25,19,4,127,131
26718,2014-01-25,20,3,86,89
26719,2014-01-25,21,4,68,72
26720,2014-01-25,22,2,73,75
26721,2014-01-25,23,2,67,69
26722,2014-01-26,0,1,64,65
26723,2014-01-26,1,1,42,43
26724,2014-01-26,2,0,32,32
26725,2014-01-26,3,0,17,17
26726,2014-01-26,4,0,3,3
26727,2014-01-26,5,0,2,2
26728,2014-01-26,6,0,4,4
26729,2014-01-26,7,1,18,19
26730,2014-01-26,8,1,48,49
26731,2014-01-26,9,3,97,100
26732,2014-01-26,10,8,148,156
26733,2014-01-26,11,21,218,239
26734,2014-01-26,12,14,219,233
26735,2014-01-26,13,13,236,249
26736,2014-01-26,14,17,193,210
26737,2014-01-26,15,14,201,215
26738,2014-01-26,16,21,202,223
26739,2014-01-26,17,6,203,209
26740,2014-01-26,18,6,136,142
26741,2014-01-26,19,0,113,113
26742,2014-01-26,20,0,77,77
26743,2014-01-26,21,3,71,74
26744,2014-01-26,22,0,46,46
26745,2014-01-26,23,0,34,34
26746,2014-01-27,0,0,17,17
26747,2014-01-27,1,0,3,3
26748,2014-01-27,2,0,3,3
26749,2014-01-27,3,0,3,3
26750,2014-01-27,4,0,5,5
26751,2014-01-27,5,1,29,30
26752,2014-01-27,6,0,126,126
26753,2014-01-27,7,4,334,338
26754,2014-01-27,8,3,707,710
26755,2014-01-27,9,8,373,381
26756,2014-01-27,10,12,127,139
26757,2014-01-27,11,3,126,129
26758,2014-01-27,12,6,185,191
26759,2014-01-27,13,4,164,168
26760,2014-01-27,14,5,158,163
26761,2014-01-27,15,3,164,167
26762,2014-01-27,16,2,248,250
26763,2014-01-27,17,8,512,520
26764,2014-01-27,18,6,424,430
26765,2014-01-27,19,2,264,266
26766,2014-01-27,20,1,213,214
26767,2014-01-27,21,0,117,117
26768,2014-01-27,22,1,72,73
26769,2014-01-27,23,0,40,40
26770,2014-01-28,0,0,11,11
26771,2014-01-28,1,0,9,9
26772,2014-01-28,2,0,1,1
26773,2014-01-28,4,0,4,4
26774,2014-01-28,5,0,27,27
26775,2014-01-28,6,1,91,92
26776,2014-01-28,7,1,222,223
26777,2014-01-28,8,2,495,497
26778,2014-01-28,9,4,227,231
26779,2014-01-28,10,5,81,86
26780,2014-01-28,11,4,71,75
26781,2014-01-28,12,0,110,110
26782,2014-01-28,13,2,104,106
26783,2014-01-28,14,5,88,93
26784,2014-01-28,15,2,115,117
26785,2014-01-28,16,3,174,177
26786,2014-01-28,17,4,358,362
26787,2014-01-28,18,2,345,347
26788,2014-01-28,19,1,214,215
26789,2014-01-28,20,2,155,157
26790,2014-01-28,21,0,102,102
26791,2014-01-28,22,1,54,55
26792,2014-01-28,23,0,32,32
26793,2014-01-29,0,0,15,15
26794,2014-01-29,1,0,2,2
26795,2014-01-29,4,0,2,2
26796,2014-01-29,5,0,18,18
26797,2014-01-29,6,0,58,58
26798,2014-01-29,7,0,145,145
26799,2014-01-29,8,5,368,373
26800,2014-01-29,9,2,228,230
26801,2014-01-29,10,2,98,100
26802,2014-01-29,11,2,93,95
26803,2014-01-29,12,3,102,105
26804,2014-01-29,13,5,102,107
26805,2014-01-29,14,6,92,98
26806,2014-01-29,15,8,119,127
26807,2014-01-29,16,6,187,193
26808,2014-01-29,17,3,395,398
26809,2014-01-29,18,5,397,402
26810,2014-01-29,19,5,239,244
26811,2014-01-29,20,3,172,175
26812,2014-01-29,21,2,119,121
26813,2014-01-29,22,1,104,105
26814,2014-01-29,23,0,47,47
26815,2014-01-30,0,1,21,22
26816,2014-01-30,1,0,13,13
26817,2014-01-30,2,0,4,4
26818,2014-01-30,4,0,3,3
26819,2014-01-30,5,0,30,30
26820,2014-01-30,6,0,103,103
26821,2014-01-30,7,2,254,256
26822,2014-01-30,8,2,581,583
26823,2014-01-30,9,2,280,282
26824,2014-01-30,10,2,124,126
26825,2014-01-30,11,4,126,130
26826,2014-01-30,12,7,151,158
26827,2014-01-30,13,5,125,130
26828,2014-01-30,14,7,132,139
26829,2014-01-30,15,7,171,178
26830,2014-01-30,16,7,240,247
26831,2014-01-30,17,9,495,504
26832,2014-01-30,18,4,468,472
26833,2014-01-30,19,3,291,294
26834,2014-01-30,20,3,176,179
26835,2014-01-30,21,3,159,162
26836,2014-01-30,22,0,105,105
26837,2014-01-30,23,0,58,58
26838,2014-01-31,0,0,28,28
26839,2014-01-31,1,1,13,14
26840,2014-01-31,2,1,4,5
26841,2014-01-31,3,0,10,10
26842,2014-01-31,4,0,1,1
26843,2014-01-31,5,0,30,30
26844,2014-01-31,6,1,115,116
26845,2014-01-31,7,2,319,321
26846,2014-01-31,8,3,660,663
26847,2014-01-31,9,2,329,331
26848,2014-01-31,10,9,139,148
26849,2014-01-31,11,19,173,192
26850,2014-01-31,12,24,229,253
26851,2014-01-31,13,19,230,249
26852,2014-01-31,14,41,209,250
26853,2014-01-31,15,31,244,275
26854,2014-01-31,16,29,334,363
26855,2014-01-31,17,25,640,665
26856,2014-01-31,18,5,488,493
26857,2014-01-31,19,12,346,358
26858,2014-01-31,20,4,242,246
26859,2014-01-31,21,4,145,149
26860,2014-01-31,22,4,167,171
26861,2014-01-31,23,3,90,93
26862,2014-02-01,0,0,83,83
26863,2014-02-01,1,4,59,63
26864,2014-02-01,2,4,46,50
26865,2014-02-01,3,4,16,20
26866,2014-02-01,4,0,5,5
26867,2014-02-01,5,0,4,4
26868,2014-02-01,6,1,12,13
26869,2014-02-01,7,0,39,39
26870,2014-02-01,8,0,124,124
26871,2014-02-01,9,10,208,218
26872,2014-02-01,10,36,258,294
26873,2014-02-01,11,60,310,370
26874,2014-02-01,12,71,372,443
26875,2014-02-01,13,88,389,477
26876,2014-02-01,14,91,425,516
26877,2014-02-01,15,115,449,564
26878,2014-02-01,16,106,409,515
26879,2014-02-01,17,83,330,413
26880,2014-02-01,18,46,264,310
26881,2014-02-01,19,12,225,237
26882,2014-02-01,20,7,157,164
26883,2014-02-01,21,14,168,182
26884,2014-02-01,22,10,133,143
26885,2014-02-01,23,5,90,95
26886,2014-02-02,0,6,92,98
26887,2014-02-02,1,6,74,80
26888,2014-02-02,2,1,65,66
26889,2014-02-02,3,1,12,13
26890,2014-02-02,4,3,4,7
26891,2014-02-02,5,1,5,6
26892,2014-02-02,6,2,13,15
26893,2014-02-02,7,3,35,38
26894,2014-02-02,8,12,99,111
26895,2014-02-02,9,15,179,194
26896,2014-02-02,10,57,239,296
26897,2014-02-02,11,53,353,406
26898,2014-02-02,12,87,411,498
26899,2014-02-02,13,101,379,480
26900,2014-02-02,14,128,375,503
26901,2014-02-02,15,127,424,551
26902,2014-02-02,16,92,410,502
26903,2014-02-02,17,64,445,509
26904,2014-02-02,18,29,286,315
26905,2014-02-02,19,11,117,128
26906,2014-02-02,20,6,100,106
26907,2014-02-02,21,9,119,128
26908,2014-02-02,22,12,242,254
26909,2014-02-02,23,10,107,117
26910,2014-02-03,0,1,10,11
26911,2014-02-03,1,0,7,7
26912,2014-02-03,2,0,3,3
26913,2014-02-03,3,0,1,1
26914,2014-02-03,5,0,8,8
26915,2014-02-03,6,0,23,23
26916,2014-02-03,7,0,57,57
26917,2014-02-03,8,1,86,87
26918,2014-02-03,9,0,62,62
26919,2014-02-03,10,1,26,27
26920,2014-02-03,11,1,32,33
26921,2014-02-03,12,0,44,44
26922,2014-02-03,13,0,39,39
26923,2014-02-03,14,2,57,59
26924,2014-02-03,15,2,110,112
26925,2014-02-03,16,9,189,198
26926,2014-02-03,17,12,437,449
26927,2014-02-03,18,9,401,410
26928,2014-02-03,19,9,297,306
26929,2014-02-03,20,7,217,224
26930,2014-02-03,21,2,169,171
26931,2014-02-03,22,1,86,87
26932,2014-02-03,23,4,40,44
26933,2014-02-04,0,0,14,14
26934,2014-02-04,1,0,11,11
26935,2014-02-04,2,0,6,6
26936,2014-02-04,4,0,1,1
26937,2014-02-04,5,0,30,30
26938,2014-02-04,6,1,147,148
26939,2014-02-04,7,5,378,383
26940,2014-02-04,8,7,778,785
26941,2014-02-04,9,8,328,336
26942,2014-02-04,10,9,159,168
26943,2014-02-04,11,12,151,163
26944,2014-02-04,12,10,206,216
26945,2014-02-04,13,6,190,196
26946,2014-02-04,14,9,124,133
26947,2014-02-04,15,5,188,193
26948,2014-02-04,16,11,280,291
26949,2014-02-04,17,14,616,630
26950,2014-02-04,18,14,557,571
26951,2014-02-04,19,6,367,373
26952,2014-02-04,20,7,254,261
26953,2014-02-04,21,4,156,160
26954,2014-02-04,22,1,76,77
26955,2014-02-04,23,1,29,30
26956,2014-02-05,0,0,11,11
26957,2014-02-05,1,0,4,4
26958,2014-02-05,4,0,3,3
26959,2014-02-05,5,0,17,17
26960,2014-02-05,6,0,58,58
26961,2014-02-05,7,0,115,115
26962,2014-02-05,8,2,201,203
26963,2014-02-05,9,6,180,186
26964,2014-02-05,10,1,78,79
26965,2014-02-05,11,7,87,94
26966,2014-02-05,12,5,118,123
26967,2014-02-05,13,11,123,134
26968,2014-02-05,14,9,143,152
26969,2014-02-05,15,12,138,150
26970,2014-02-05,16,9,255,264
26971,2014-02-05,17,18,591,609
26972,2014-02-05,18,15,531,546
26973,2014-02-05,19,13,385,398
26974,2014-02-05,20,6,239,245
26975,2014-02-05,21,1,176,177
26976,2014-02-05,22,1,115,116
26977,2014-02-05,23,0,62,62
26978,2014-02-06,0,0,22,22
26979,2014-02-06,1,0,19,19
26980,2014-02-06,2,0,3,3
26981,2014-02-06,4,0,4,4
26982,2014-02-06,5,1,23,24
26983,2014-02-06,6,1,126,127
26984,2014-02-06,7,0,324,324
26985,2014-02-06,8,8,733,741
26986,2014-02-06,9,14,317,331
26987,2014-02-06,10,10,133,143
26988,2014-02-06,11,11,149,160
26989,2014-02-06,12,10,171,181
26990,2014-02-06,13,10,187,197
26991,2014-02-06,14,20,136,156
26992,2014-02-06,15,15,189,204
26993,2014-02-06,16,5,264,269
26994,2014-02-06,17,10,578,588
26995,2014-02-06,18,9,551,560
26996,2014-02-06,19,7,400,407
26997,2014-02-06,20,7,272,279
26998,2014-02-06,21,8,208,216
26999,2014-02-06,22,4,131,135
27000,2014-02-06,23,0,86,86
27001,2014-02-07,0,2,32,34
27002,2014-02-07,1,0,17,17
27003,2014-02-07,2,0,8,8
27004,2014-02-07,3,0,3,3
27005,2014-02-07,4,0,3,3
27006,2014-02-07,5,0,40,40
27007,2014-02-07,6,0,116,116
27008,2014-02-07,7,0,331,331
27009,2014-02-07,8,6,673,679
27010,2014-02-07,9,10,365,375
27011,2014-02-07,10,11,145,156
27012,2014-02-07,11,26,165,191
27013,2014-02-07,12,19,202,221
27014,2014-02-07,13,13,206,219
27015,2014-02-07,14,22,211,233
27016,2014-02-07,15,29,273,302
27017,2014-02-07,16,8,331,339
27018,2014-02-07,17,21,607,628
27019,2014-02-07,18,11,520,531
27020,2014-02-07,19,15,354,369
27021,2014-02-07,20,8,190,198
27022,2014-02-07,21,1,143,144
27023,2014-02-07,22,10,123,133
27024,2014-02-07,23,8,116,124
27025,2014-02-08,0,0,74,74
27026,2014-02-08,1,2,58,60
27027,2014-02-08,2,1,38,39
27028,2014-02-08,3,0,17,17
27029,2014-02-08,4,1,5,6
27030,2014-02-08,5,0,10,10
27031,2014-02-08,6,0,11,11
27032,2014-02-08,7,1,47,48
27033,2014-02-08,8,7,115,122
27034,2014-02-08,9,19,168,187
27035,2014-02-08,10,25,229,254
27036,2014-02-08,11,38,300,338
27037,2014-02-08,12,36,309,345
27038,2014-02-08,13,63,310,373
27039,2014-02-08,14,45,270,315
27040,2014-02-08,15,37,306,343
27041,2014-02-08,16,45,269,314
27042,2014-02-08,17,33,290,323
27043,2014-02-08,18,16,213,229
27044,2014-02-08,19,9,179,188
27045,2014-02-08,20,6,140,146
27046,2014-02-08,21,2,117,119
27047,2014-02-08,22,3,94,97
27048,2014-02-08,23,1,78,79
27049,2014-02-09,0,3,71,74
27050,2014-02-09,1,4,61,65
27051,2014-02-09,2,5,65,70
27052,2014-02-09,3,2,12,14
27053,2014-02-09,4,1,6,7
27054,2014-02-09,5,0,1,1
27055,2014-02-09,6,0,11,11
27056,2014-02-09,7,1,31,32
27057,2014-02-09,8,3,65,68
27058,2014-02-09,9,9,116,125
27059,2014-02-09,10,20,182,202
27060,2014-02-09,11,30,255,285
27061,2014-02-09,12,34,311,345
27062,2014-02-09,13,16,316,332
27063,2014-02-09,14,18,292,310
27064,2014-02-09,15,15,273,288
27065,2014-02-09,16,5,171,176
27066,2014-02-09,17,10,149,159
27067,2014-02-09,18,8,132,140
27068,2014-02-09,19,8,117,125
27069,2014-02-09,20,15,101,116
27070,2014-02-09,21,5,71,76
27071,2014-02-09,22,0,69,69
27072,2014-02-09,23,0,30,30
27073,2014-02-10,0,1,20,21
27074,2014-02-10,1,0,3,3
27075,2014-02-10,2,0,5,5
27076,2014-02-10,3,0,4,4
27077,2014-02-10,4,0,3,3
27078,2014-02-10,5,0,42,42
27079,2014-02-10,6,0,125,125
27080,2014-02-10,7,1,298,299
27081,2014-02-10,8,7,635,642
27082,2014-02-10,9,6,314,320
27083,2014-02-10,10,8,118,126
27084,2014-02-10,11,13,126,139
27085,2014-02-10,12,14,167,181
27086,2014-02-10,13,9,150,159
27087,2014-02-10,14,10,119,129
27088,2014-02-10,15,9,155,164
27089,2014-02-10,16,16,251,267
27090,2014-02-10,17,14,519,533
27091,2014-02-10,18,7,484,491
27092,2014-02-10,19,3,276,279
27093,2014-02-10,20,3,216,219
27094,2014-02-10,21,5,147,152
27095,2014-02-10,22,1,78,79
27096,2014-02-10,23,0,49,49
27097,2014-02-11,0,0,12,12
27098,2014-02-11,1,0,10,10
27099,2014-02-11,2,1,4,5
27100,2014-02-11,3,0,1,1
27101,2014-02-11,4,0,2,2
27102,2014-02-11,5,0,33,33
27103,2014-02-11,6,0,123,123
27104,2014-02-11,7,3,346,349
27105,2014-02-11,8,9,647,656
27106,2014-02-11,9,6,311,317
27107,2014-02-11,10,10,120,130
27108,2014-02-11,11,27,141,168
27109,2014-02-11,12,9,152,161
27110,2014-02-11,13,16,161,177
27111,2014-02-11,14,13,115,128
27112,2014-02-11,15,9,164,173
27113,2014-02-11,16,10,277,287
27114,2014-02-11,17,31,531,562
27115,2014-02-11,18,11,559,570
27116,2014-02-11,19,9,349,358
27117,2014-02-11,20,10,193,203
27118,2014-02-11,21,4,168,172
27119,2014-02-11,22,2,101,103
27120,2014-02-11,23,1,46,47
27121,2014-02-12,0,0,13,13
27122,2014-02-12,1,0,5,5
27123,2014-02-12,2,0,3,3
27124,2014-02-12,3,0,1,1
27125,2014-02-12,4,0,5,5
27126,2014-02-12,5,0,29,29
27127,2014-02-12,6,0,116,116
27128,2014-02-12,7,1,306,307
27129,2014-02-12,8,10,576,586
27130,2014-02-12,9,3,310,313
27131,2014-02-12,10,2,125,127
27132,2014-02-12,11,7,130,137
27133,2014-02-12,12,8,156,164
27134,2014-02-12,13,4,132,136
27135,2014-02-12,14,7,137,144
27136,2014-02-12,15,8,146,154
27137,2014-02-12,16,9,236,245
27138,2014-02-12,17,9,467,476
27139,2014-02-12,18,6,446,452
27140,2014-02-12,19,1,305,306
27141,2014-02-12,20,4,112,116
27142,2014-02-12,21,0,60,60
27143,2014-02-12,22,1,26,27
27144,2014-02-12,23,4,19,23
27145,2014-02-13,0,2,22,24
27146,2014-02-13,1,1,15,16
27147,2014-02-13,2,0,7,7
27148,2014-02-13,3,0,2,2
27149,2014-02-13,5,0,2,2
27150,2014-02-13,6,0,1,1
27151,2014-02-14,10,0,3,3
27152,2014-02-14,11,5,95,100
27153,2014-02-14,12,1,99,100
27154,2014-02-14,13,6,120,126
27155,2014-02-14,14,11,113,124
27156,2014-02-14,15,12,171,183
27157,2014-02-14,16,12,207,219
27158,2014-02-14,17,14,322,336
27159,2014-02-14,18,5,267,272
27160,2014-02-14,19,2,158,160
27161,2014-02-14,20,1,95,96
27162,2014-02-14,21,3,67,70
27163,2014-02-14,22,1,71,72
27164,2014-02-14,23,0,50,50
27165,2014-02-15,0,0,41,41
27166,2014-02-15,1,2,29,31
27167,2014-02-15,2,0,30,30
27168,2014-02-15,3,1,14,15
27169,2014-02-15,4,0,11,11
27170,2014-02-15,5,1,7,8
27171,2014-02-15,6,0,10,10
27172,2014-02-15,7,1,27,28
27173,2014-02-15,8,1,41,42
27174,2014-02-15,9,2,45,47
27175,2014-02-15,10,2,76,78
27176,2014-02-15,11,10,91,101
27177,2014-02-15,12,16,104,120
27178,2014-02-15,13,14,116,130
27179,2014-02-15,14,16,132,148
27180,2014-02-15,15,27,123,150
27181,2014-02-15,16,13,135,148
27182,2014-02-15,17,17,155,172
27183,2014-02-15,18,8,133,141
27184,2014-02-15,19,5,90,95
27185,2014-02-15,20,0,58,58
27186,2014-02-15,21,2,59,61
27187,2014-02-15,22,1,36,37
27188,2014-02-15,23,0,46,46
27189,2014-02-16,0,0,42,42
27190,2014-02-16,1,0,44,44
27191,2014-02-16,2,1,31,32
27192,2014-02-16,3,0,13,13
27193,2014-02-16,4,0,5,5
27194,2014-02-16,5,1,5,6
27195,2014-02-16,6,0,8,8
27196,2014-02-16,7,3,21,24
27197,2014-02-16,8,4,44,48
27198,2014-02-16,9,16,86,102
27199,2014-02-16,10,24,143,167
27200,2014-02-16,11,17,185,202
27201,2014-02-16,12,64,234,298
27202,2014-02-16,13,40,203,243
27203,2014-02-16,14,39,194,233
27204,2014-02-16,15,40,204,244
27205,2014-02-16,16,51,230,281
27206,2014-02-16,17,30,199,229
27207,2014-02-16,18,14,176,190
27208,2014-02-16,19,16,110,126
27209,2014-02-16,20,9,103,112
27210,2014-02-16,21,9,72,81
27211,2014-02-16,22,5,53,58
27212,2014-02-16,23,1,48,49
27213,2014-02-17,0,0,23,23
27214,2014-02-17,1,0,24,24
27215,2014-02-17,2,1,8,9
27216,2014-02-17,3,0,10,10
27217,2014-02-17,4,0,2,2
27218,2014-02-17,5,1,8,9
27219,2014-02-17,6,0,32,32
27220,2014-02-17,7,2,62,64
27221,2014-02-17,8,8,160,168
27222,2014-02-17,9,27,150,177
27223,2014-02-17,10,25,144,169
27224,2014-02-17,11,31,198,229
27225,2014-02-17,12,44,220,264
27226,2014-02-17,13,28,244,272
27227,2014-02-17,14,26,227,253
27228,2014-02-17,15,31,244,275
27229,2014-02-17,16,28,243,271
27230,2014-02-17,17,41,250,291
27231,2014-02-17,18,16,272,288
27232,2014-02-17,19,6,164,170
27233,2014-02-17,20,7,115,122
27234,2014-02-17,21,2,87,89
27235,2014-02-17,22,2,51,53
27236,2014-02-17,23,4,43,47
27237,2014-02-18,0,0,19,19
27238,2014-02-18,1,0,4,4
27239,2014-02-18,2,0,1,1
27240,2014-02-18,3,0,1,1
27241,2014-02-18,4,0,1,1
27242,2014-02-18,5,1,23,24
27243,2014-02-18,6,0,86,86
27244,2014-02-18,7,3,217,220
27245,2014-02-18,8,5,517,522
27246,2014-02-18,9,13,250,263
27247,2014-02-18,10,12,126,138
27248,2014-02-18,11,16,144,160
27249,2014-02-18,12,23,179,202
27250,2014-02-18,13,14,208,222
27251,2014-02-18,14,27,185,212
27252,2014-02-18,15,23,212,235
27253,2014-02-18,16,33,335,368
27254,2014-02-18,17,48,668,716
27255,2014-02-18,18,22,619,641
27256,2014-02-18,19,4,384,388
27257,2014-02-18,20,10,268,278
27258,2014-02-18,21,8,199,207
27259,2014-02-18,22,6,114,120
27260,2014-02-18,23,1,57,58
27261,2014-02-19,0,0,23,23
27262,2014-02-19,1,0,17,17
27263,2014-02-19,2,0,4,4
27264,2014-02-19,3,0,1,1
27265,2014-02-19,4,0,4,4
27266,2014-02-19,5,1,31,32
27267,2014-02-19,6,2,143,145
27268,2014-02-19,7,3,377,380
27269,2014-02-19,8,9,661,670
27270,2014-02-19,9,5,109,114
27271,2014-02-19,10,6,55,61
27272,2014-02-19,11,11,116,127
27273,2014-02-19,12,17,220,237
27274,2014-02-19,13,24,191,215
27275,2014-02-19,14,18,226,244
27276,2014-02-19,15,21,223,244
27277,2014-02-19,16,30,334,364
27278,2014-02-19,17,28,768,796
27279,2014-02-19,18,24,620,644
27280,2014-02-19,19,12,453,465
27281,2014-02-19,20,8,353,361
27282,2014-02-19,21,12,224,236
27283,2014-02-19,22,9,148,157
27284,2014-02-19,23,4,77,81
27285,2014-02-20,0,1,34,35
27286,2014-02-20,1,0,13,13
27287,2014-02-20,2,0,7,7
27288,2014-02-20,3,0,1,1
27289,2014-02-20,4,0,1,1
27290,2014-02-20,5,0,52,52
27291,2014-02-20,6,1,150,151
27292,2014-02-20,7,4,429,433
27293,2014-02-20,8,12,825,837
27294,2014-02-20,9,19,361,380
27295,2014-02-20,10,34,159,193
27296,2014-02-20,11,37,184,221
27297,2014-02-20,12,30,211,241
27298,2014-02-20,13,22,202,224
27299,2014-02-20,14,37,173,210
27300,2014-02-20,15,52,244,296
27301,2014-02-20,16,44,345,389
27302,2014-02-20,17,45,772,817
27303,2014-02-20,18,22,674,696
27304,2014-02-20,19,19,457,476
27305,2014-02-20,20,11,325,336
27306,2014-02-20,21,7,246,253
27307,2014-02-20,22,6,179,185
27308,2014-02-20,23,26,104,130
27309,2014-02-21,0,5,39,44
27310,2014-02-21,1,0,18,18
27311,2014-02-21,2,1,11,12
27312,2014-02-21,3,1,4,5
27313,2014-02-21,4,0,8,8
27314,2014-02-21,5,0,49,49
27315,2014-02-21,6,10,133,143
27316,2014-02-21,7,4,410,414
27317,2014-02-21,8,18,838,856
27318,2014-02-21,9,22,384,406
27319,2014-02-21,10,25,168,193
27320,2014-02-21,11,24,182,206
27321,2014-02-21,12,18,129,147
27322,2014-02-21,13,16,80,96
27323,2014-02-21,14,11,113,124
27324,2014-02-21,15,20,189,209
27325,2014-02-21,16,28,311,339
27326,2014-02-21,17,43,704,747
27327,2014-02-21,18,32,550,582
27328,2014-02-21,19,15,407,422
27329,2014-02-21,20,20,238,258
27330,2014-02-21,21,15,195,210
27331,2014-02-21,22,6,145,151
27332,2014-02-21,23,12,131,143
27333,2014-02-22,0,7,78,85
27334,2014-02-22,1,5,73,78
27335,2014-02-22,2,3,54,57
27336,2014-02-22,3,3,20,23
27337,2014-02-22,4,0,5,5
27338,2014-02-22,5,3,8,11
27339,2014-02-22,6,2,16,18
27340,2014-02-22,7,9,57,66
27341,2014-02-22,8,22,161,183
27342,2014-02-22,9,35,229,264
27343,2014-02-22,10,94,300,394
27344,2014-02-22,11,139,404,543
27345,2014-02-22,12,279,519,798
27346,2014-02-22,13,297,530,827
27347,2014-02-22,14,414,563,977
27348,2014-02-22,15,279,571,850
27349,2014-02-22,16,142,526,668
27350,2014-02-22,17,105,448,553
27351,2014-02-22,18,48,405,453
27352,2014-02-22,19,23,269,292
27353,2014-02-22,20,18,218,236
27354,2014-02-22,21,12,152,164
27355,2014-02-22,22,6,136,142
27356,2014-02-22,23,8,121,129
27357,2014-02-23,0,5,129,134
27358,2014-02-23,1,0,76,76
27359,2014-02-23,2,1,79,80
27360,2014-02-23,3,4,34,38
27361,2014-02-23,4,1,6,7
27362,2014-02-23,5,0,10,10
27363,2014-02-23,6,1,9,10
27364,2014-02-23,7,3,57,60
27365,2014-02-23,8,10,115,125
27366,2014-02-23,9,21,175,196
27367,2014-02-23,10,29,298,327
27368,2014-02-23,11,27,326,353
27369,2014-02-23,12,40,420,460
27370,2014-02-23,13,17,501,518
27371,2014-02-23,14,85,542,627
27372,2014-02-23,15,173,526,699
27373,2014-02-23,16,192,519,711
27374,2014-02-23,17,116,438,554
27375,2014-02-23,18,58,329,387
27376,2014-02-23,19,27,237,264
27377,2014-02-23,20,12,149,161
27378,2014-02-23,21,11,118,129
27379,2014-02-23,22,4,74,78
27380,2014-02-23,23,4,57,61
27381,2014-02-24,0,1,22,23
27382,2014-02-24,1,1,7,8
27383,2014-02-24,2,0,4,4
27384,2014-02-24,3,1,4,5
27385,2014-02-24,4,0,3,3
27386,2014-02-24,5,0,37,37
27387,2014-02-24,6,7,146,153
27388,2014-02-24,7,6,412,418
27389,2014-02-24,8,4,736,740
27390,2014-02-24,9,10,314,324
27391,2014-02-24,10,21,149,170
27392,2014-02-24,11,25,149,174
27393,2014-02-24,12,33,170,203
27394,2014-02-24,13,18,185,203
27395,2014-02-24,14,37,128,165
27396,2014-02-24,15,25,187,212
27397,2014-02-24,16,32,323,355
27398,2014-02-24,17,27,615,642
27399,2014-02-24,18,11,560,571
27400,2014-02-24,19,13,357,370
27401,2014-02-24,20,6,254,260
27402,2014-02-24,21,10,158,168
27403,2014-02-24,22,5,116,121
27404,2014-02-24,23,2,65,67
27405,2014-02-25,0,1,16,17
27406,2014-02-25,1,0,6,6
27407,2014-02-25,2,1,4,5
27408,2014-02-25,3,0,2,2
27409,2014-02-25,4,0,5,5
27410,2014-02-25,5,0,33,33
27411,2014-02-25,6,2,168,170
27412,2014-02-25,7,6,396,402
27413,2014-02-25,8,15,698,713
27414,2014-02-25,9,6,214,220
27415,2014-02-25,10,0,57,57
27416,2014-02-25,11,6,40,46
27417,2014-02-25,12,5,57,62
27418,2014-02-25,13,13,90,103
27419,2014-02-25,14,10,88,98
27420,2014-02-25,15,11,174,185
27421,2014-02-25,16,19,250,269
27422,2014-02-25,17,21,575,596
27423,2014-02-25,18,19,541,560
27424,2014-02-25,19,9,389,398
27425,2014-02-25,20,2,243,245
27426,2014-02-25,21,6,207,213
27427,2014-02-25,22,4,103,107
27428,2014-02-25,23,1,48,49
27429,2014-02-26,0,1,23,24
27430,2014-02-26,1,0,6,6
27431,2014-02-26,2,0,3,3
27432,2014-02-26,3,1,2,3
27433,2014-02-26,4,0,8,8
27434,2014-02-26,5,0,42,42
27435,2014-02-26,6,1,90,91
27436,2014-02-26,7,4,166,170
27437,2014-02-26,8,1,270,271
27438,2014-02-26,9,2,149,151
27439,2014-02-26,10,2,71,73
27440,2014-02-26,11,4,97,101
27441,2014-02-26,12,10,140,150
27442,2014-02-26,13,14,156,170
27443,2014-02-26,14,6,150,156
27444,2014-02-26,15,17,156,173
27445,2014-02-26,16,9,277,286
27446,2014-02-26,17,15,578,593
27447,2014-02-26,18,7,514,521
27448,2014-02-26,19,3,366,369
27449,2014-02-26,20,2,227,229
27450,2014-02-26,21,0,163,163
27451,2014-02-26,22,3,110,113
27452,2014-02-26,23,0,55,55
27453,2014-02-27,0,1,28,29
27454,2014-02-27,1,0,7,7
27455,2014-02-27,2,0,4,4
27456,2014-02-27,3,0,3,3
27457,2014-02-27,4,0,5,5
27458,2014-02-27,5,0,31,31
27459,2014-02-27,6,2,114,116
27460,2014-02-27,7,5,353,358
27461,2014-02-27,8,6,696,702
27462,2014-02-27,9,4,343,347
27463,2014-02-27,10,6,162,168
27464,2014-02-27,11,17,163,180
27465,2014-02-27,12,10,178,188
27466,2014-02-27,13,18,173,191
27467,2014-02-27,14,14,164,178
27468,2014-02-27,15,10,193,203
27469,2014-02-27,16,6,274,280
27470,2014-02-27,17,27,541,568
27471,2014-02-27,18,15,470,485
27472,2014-02-27,19,8,325,333
27473,2014-02-27,20,7,224,231
27474,2014-02-27,21,3,142,145
27475,2014-02-27,22,0,86,86
27476,2014-02-27,23,0,44,44
27477,2014-02-28,0,0,17,17
27478,2014-02-28,1,1,14,15
27479,2014-02-28,2,0,6,6
27480,2014-02-28,3,0,2,2
27481,2014-02-28,4,0,3,3
27482,2014-02-28,5,1,27,28
27483,2014-02-28,6,2,84,86
27484,2014-02-28,7,2,241,243
27485,2014-02-28,8,14,520,534
27486,2014-02-28,9,9,294,303
27487,2014-02-28,10,6,141,147
27488,2014-02-28,11,21,140,161
27489,2014-02-28,12,10,168,178
27490,2014-02-28,13,16,186,202
27491,2014-02-28,14,17,151,168
27492,2014-02-28,15,19,165,184
27493,2014-02-28,16,28,262,290
27494,2014-02-28,17,11,493,504
27495,2014-02-28,18,4,379,383
27496,2014-02-28,19,6,242,248
27497,2014-02-28,20,1,145,146
27498,2014-02-28,21,1,93,94
27499,2014-02-28,22,2,89,91
27500,2014-02-28,23,2,58,60
27501,2014-03-01,0,2,59,61
27502,2014-03-01,1,0,45,45
27503,2014-03-01,2,0,26,26
27504,2014-03-01,3,1,7,8
27505,2014-03-01,4,0,4,4
27506,2014-03-01,5,0,2,2
27507,2014-03-01,6,0,19,19
27508,2014-03-01,7,2,44,46
27509,2014-03-01,8,5,99,104
27510,2014-03-01,9,28,159,187
27511,2014-03-01,10,44,212,256
27512,2014-03-01,11,49,276,325
27513,2014-03-01,12,69,287,356
27514,2014-03-01,13,60,304,364
27515,2014-03-01,14,107,293,400
27516,2014-03-01,15,105,305,410
27517,2014-03-01,16,106,322,428
27518,2014-03-01,17,99,288,387
27519,2014-03-01,18,64,265,329
27520,2014-03-01,19,31,219,250
27521,2014-03-01,20,16,174,190
27522,2014-03-01,21,9,134,143
27523,2014-03-01,22,3,103,106
27524,2014-03-01,23,6,108,114
27525,2014-03-02,0,3,94,97
27526,2014-03-02,1,0,72,72
27527,2014-03-02,2,6,46,52
27528,2014-03-02,3,8,29,37
27529,2014-03-02,4,0,11,11
27530,2014-03-02,5,0,7,7
27531,2014-03-02,6,2,9,11
27532,2014-03-02,7,3,25,28
27533,2014-03-02,8,18,74,92
27534,2014-03-02,9,25,159,184
27535,2014-03-02,10,54,266,320
27536,2014-03-02,11,59,365,424
27537,2014-03-02,12,99,426,525
27538,2014-03-02,13,92,368,460
27539,2014-03-02,14,91,356,447
27540,2014-03-02,15,32,133,165
27541,2014-03-02,16,13,88,101
27542,2014-03-02,17,21,98,119
27543,2014-03-02,18,3,90,93
27544,2014-03-02,19,5,76,81
27545,2014-03-02,20,4,75,79
27546,2014-03-02,21,2,38,40
27547,2014-03-02,22,0,38,38
27548,2014-03-02,23,0,10,10
27549,2014-03-03,0,0,16,16
27550,2014-03-03,1,0,8,8
27551,2014-03-03,2,0,5,5
27552,2014-03-03,4,0,2,2
27553,2014-03-03,5,0,8,8
27554,2014-03-03,6,0,4,4
27555,2014-03-03,7,3,10,13
27556,2014-03-03,8,1,8,9
27557,2014-03-03,9,1,9,10
27558,2014-03-03,10,0,11,11
27559,2014-03-03,11,1,15,16
27560,2014-03-03,12,0,11,11
27561,2014-03-03,13,0,11,11
27562,2014-03-03,14,0,20,20
27563,2014-03-03,15,0,33,33
27564,2014-03-03,16,3,34,37
27565,2014-03-03,17,0,46,46
27566,2014-03-03,18,1,44,45
27567,2014-03-03,19,0,44,44
27568,2014-03-03,20,2,18,20
27569,2014-03-03,21,1,19,20
27570,2014-03-03,22,2,15,17
27571,2014-03-03,23,1,11,12
27572,2014-03-04,0,2,8,10
27573,2014-03-04,1,0,2,2
27574,2014-03-04,2,0,1,1
27575,2014-03-04,3,0,1,1
27576,2014-03-04,4,1,2,3
27577,2014-03-04,5,0,17,17
27578,2014-03-04,6,1,31,32
27579,2014-03-04,7,3,54,57
27580,2014-03-04,8,1,148,149
27581,2014-03-04,9,5,114,119
27582,2014-03-04,10,3,113,116
27583,2014-03-04,11,1,58,59
27584,2014-03-04,12,4,80,84
27585,2014-03-04,13,0,91,91
27586,2014-03-04,14,4,66,70
27587,2014-03-04,15,5,93,98
27588,2014-03-04,16,2,143,145
27589,2014-03-04,17,3,274,277
27590,2014-03-04,18,9,276,285
27591,2014-03-04,19,4,227,231
27592,2014-03-04,20,7,154,161
27593,2014-03-04,21,2,122,124
27594,2014-03-04,22,5,75,80
27595,2014-03-04,23,0,32,32
27596,2014-03-05,0,0,15,15
27597,2014-03-05,1,0,4,4
27598,2014-03-05,2,0,2,2
27599,2014-03-05,3,0,3,3
27600,2014-03-05,4,0,5,5
27601,2014-03-05,5,0,26,26
27602,2014-03-05,6,1,94,95
27603,2014-03-05,7,5,251,256
27604,2014-03-05,8,10,509,519
27605,2014-03-05,9,7,261,268
27606,2014-03-05,10,14,101,115
27607,2014-03-05,11,11,127,138
27608,2014-03-05,12,16,152,168
27609,2014-03-05,13,17,165,182
27610,2014-03-05,14,16,134,150
27611,2014-03-05,15,29,165,194
27612,2014-03-05,16,35,289,324
27613,2014-03-05,17,29,547,576
27614,2014-03-05,18,6,509,515
27615,2014-03-05,19,18,326,344
27616,2014-03-05,20,11,256,267
27617,2014-03-05,21,6,169,175
27618,2014-03-05,22,0,111,111
27619,2014-03-05,23,6,54,60
27620,2014-03-06,0,6,25,31
27621,2014-03-06,1,6,6,12
27622,2014-03-06,2,0,1,1
27623,2014-03-06,4,0,2,2
27624,2014-03-06,5,0,31,31
27625,2014-03-06,6,1,110,111
27626,2014-03-06,7,6,324,330
27627,2014-03-06,8,12,669,681
27628,2014-03-06,9,4,307,311
27629,2014-03-06,10,16,120,136
27630,2014-03-06,11,22,128,150
27631,2014-03-06,12,28,184,212
27632,2014-03-06,13,18,156,174
27633,2014-03-06,14,21,117,138
27634,2014-03-06,15,19,181,200
27635,2014-03-06,16,10,239,249
27636,2014-03-06,17,24,592,616
27637,2014-03-06,18,18,559,577
27638,2014-03-06,19,3,291,294
27639,2014-03-06,20,5,235,240
27640,2014-03-06,21,2,171,173
27641,2014-03-06,22,14,75,89
27642,2014-03-06,23,5,69,74
27643,2014-03-07,0,0,33,33
27644,2014-03-07,1,0,16,16
27645,2014-03-07,2,11,6,17
27646,2014-03-07,3,1,2,3
27647,2014-03-07,4,0,7,7
27648,2014-03-07,5,0,33,33
27649,2014-03-07,6,0,104,104
27650,2014-03-07,7,5,311,316
27651,2014-03-07,8,6,626,632
27652,2014-03-07,9,5,302,307
27653,2014-03-07,10,12,146,158
27654,2014-03-07,11,21,163,184
27655,2014-03-07,12,19,206,225
27656,2014-03-07,13,17,217,234
27657,2014-03-07,14,21,210,231
27658,2014-03-07,15,29,231,260
27659,2014-03-07,16,27,325,352
27660,2014-03-07,17,21,552,573
27661,2014-03-07,18,15,465,480
27662,2014-03-07,19,9,297,306
27663,2014-03-07,20,10,220,230
27664,2014-03-07,21,12,143,155
27665,2014-03-07,22,9,94,103
27666,2014-03-07,23,6,99,105
27667,2014-03-08,0,2,70,72
27668,2014-03-08,1,2,51,53
27669,2014-03-08,2,4,28,32
27670,2014-03-08,3,2,18,20
27671,2014-03-08,4,1,5,6
27672,2014-03-08,5,0,6,6
27673,2014-03-08,6,1,14,15
27674,2014-03-08,7,1,48,49
27675,2014-03-08,8,12,166,178
27676,2014-03-08,9,38,237,275
27677,2014-03-08,10,89,309,398
27678,2014-03-08,11,175,403,578
27679,2014-03-08,12,236,458,694
27680,2014-03-08,13,335,461,796
27681,2014-03-08,14,375,543,918
27682,2014-03-08,15,406,552,958
27683,2014-03-08,16,410,514,924
27684,2014-03-08,17,301,449,750
27685,2014-03-08,18,180,390,570
27686,2014-03-08,19,84,263,347
27687,2014-03-08,20,46,168,214
27688,2014-03-08,21,41,173,214
27689,2014-03-08,22,41,150,191
27690,2014-03-08,23,27,130,157
27691,2014-03-09,0,17,115,132
27692,2014-03-09,1,4,76,80
27693,2014-03-09,3,6,70,76
27694,2014-03-09,4,6,33,39
27695,2014-03-09,5,2,5,7
27696,2014-03-09,6,0,9,9
27697,2014-03-09,7,2,35,37
27698,2014-03-09,8,15,87,102
27699,2014-03-09,9,21,126,147
27700,2014-03-09,10,101,247,348
27701,2014-03-09,11,96,324,420
27702,2014-03-09,12,130,382,512
27703,2014-03-09,13,180,429,609
27704,2014-03-09,14,163,382,545
27705,2014-03-09,15,185,426,611
27706,2014-03-09,16,195,399,594
27707,2014-03-09,17,184,370,554
27708,2014-03-09,18,89,307,396
27709,2014-03-09,19,37,216,253
27710,2014-03-09,20,22,141,163
27711,2014-03-09,21,12,104,116
27712,2014-03-09,22,13,85,98
27713,2014-03-09,23,8,60,68
27714,2014-03-10,0,6,24,30
27715,2014-03-10,1,4,8,12
27716,2014-03-10,2,0,6,6
27717,2014-03-10,3,0,5,5
27718,2014-03-10,4,0,11,11
27719,2014-03-10,5,0,33,33
27720,2014-03-10,6,3,144,147
27721,2014-03-10,7,6,344,350
27722,2014-03-10,8,23,746,769
27723,2014-03-10,9,35,379,414
27724,2014-03-10,10,36,135,171
27725,2014-03-10,11,46,136,182
27726,2014-03-10,12,48,187,235
27727,2014-03-10,13,47,197,244
27728,2014-03-10,14,58,161,219
27729,2014-03-10,15,110,215,325
27730,2014-03-10,16,98,387,485
27731,2014-03-10,17,110,776,886
27732,2014-03-10,18,76,794,870
27733,2014-03-10,19,55,526,581
27734,2014-03-10,20,19,297,316
27735,2014-03-10,21,28,232,260
27736,2014-03-10,22,17,124,141
27737,2014-03-10,23,19,74,93
27738,2014-03-11,0,6,28,34
27739,2014-03-11,1,0,3,3
27740,2014-03-11,2,0,6,6
27741,2014-03-11,3,0,3,3
27742,2014-03-11,4,0,10,10
27743,2014-03-11,5,0,34,34
27744,2014-03-11,6,1,179,180
27745,2014-03-11,7,16,468,484
27746,2014-03-11,8,20,933,953
27747,2014-03-11,9,33,419,452
27748,2014-03-11,10,30,157,187
27749,2014-03-11,11,74,161,235
27750,2014-03-11,12,85,221,306
27751,2014-03-11,13,120,245,365
27752,2014-03-11,14,109,158,267
27753,2014-03-11,15,123,270,393
27754,2014-03-11,16,149,396,545
27755,2014-03-11,17,151,893,1044
27756,2014-03-11,18,152,905,1057
27757,2014-03-11,19,90,617,707
27758,2014-03-11,20,61,378,439
27759,2014-03-11,21,33,289,322
27760,2014-03-11,22,35,179,214
27761,2014-03-11,23,18,102,120
27762,2014-03-12,0,2,32,34
27763,2014-03-12,1,6,15,21
27764,2014-03-12,2,2,11,13
27765,2014-03-12,3,0,3,3
27766,2014-03-12,4,0,8,8
27767,2014-03-12,5,0,48,48
27768,2014-03-12,6,4,188,192
27769,2014-03-12,7,8,463,471
27770,2014-03-12,8,19,937,956
27771,2014-03-12,9,44,372,416
27772,2014-03-12,10,53,141,194
27773,2014-03-12,11,71,198,269
27774,2014-03-12,12,51,243,294
27775,2014-03-12,13,75,228,303
27776,2014-03-12,14,60,162,222
27777,2014-03-12,15,49,156,205
27778,2014-03-12,16,97,361,458
27779,2014-03-12,17,84,755,839
27780,2014-03-12,18,30,442,472
27781,2014-03-12,19,27,269,296
27782,2014-03-12,20,6,202,208
27783,2014-03-12,21,11,142,153
27784,2014-03-12,22,0,105,105
27785,2014-03-12,23,3,46,49
27786,2014-03-13,0,1,10,11
27787,2014-03-13,1,1,5,6
27788,2014-03-13,2,1,2,3
27789,2014-03-13,3,1,0,1
27790,2014-03-13,4,0,2,2
27791,2014-03-13,5,0,31,31
27792,2014-03-13,6,0,84,84
27793,2014-03-13,7,4,243,247
27794,2014-03-13,8,10,518,528
27795,2014-03-13,9,8,285,293
27796,2014-03-13,10,15,87,102
27797,2014-03-13,11,13,104,117
27798,2014-03-13,12,14,117,131
27799,2014-03-13,13,18,122,140
27800,2014-03-13,14,15,132,147
27801,2014-03-13,15,24,136,160
27802,2014-03-13,16,15,203,218
27803,2014-03-13,17,20,435,455
27804,2014-03-13,18,23,471,494
27805,2014-03-13,19,5,267,272
27806,2014-03-13,20,7,195,202
27807,2014-03-13,21,5,157,162
27808,2014-03-13,22,8,103,111
27809,2014-03-13,23,4,63,67
27810,2014-03-14,0,1,31,32
27811,2014-03-14,1,0,13,13
27812,2014-03-14,2,0,7,7
27813,2014-03-14,3,0,1,1
27814,2014-03-14,4,0,4,4
27815,2014-03-14,5,0,38,38
27816,2014-03-14,6,1,103,104
27817,2014-03-14,7,5,273,278
27818,2014-03-14,8,14,694,708
27819,2014-03-14,9,18,358,376
27820,2014-03-14,10,25,152,177
27821,2014-03-14,11,49,157,206
27822,2014-03-14,12,69,223,292
27823,2014-03-14,13,102,241,343
27824,2014-03-14,14,146,214,360
27825,2014-03-14,15,122,312,434
27826,2014-03-14,16,144,402,546
27827,2014-03-14,17,131,732,863
27828,2014-03-14,18,83,688,771
27829,2014-03-14,19,54,443,497
27830,2014-03-14,20,54,256,310
27831,2014-03-14,21,69,202,271
27832,2014-03-14,22,23,164,187
27833,2014-03-14,23,9,122,131
27834,2014-03-15,0,12,112,124
27835,2014-03-15,1,6,77,83
27836,2014-03-15,2,2,40,42
27837,2014-03-15,3,1,16,17
27838,2014-03-15,4,4,13,17
27839,2014-03-15,5,2,16,18
27840,2014-03-15,6,13,116,129
27841,2014-03-15,7,28,104,132
27842,2014-03-15,8,76,189,265
27843,2014-03-15,9,110,342,452
27844,2014-03-15,10,160,402,562
27845,2014-03-15,11,265,437,702
27846,2014-03-15,12,326,525,851
27847,2014-03-15,13,412,568,980
27848,2014-03-15,14,382,563,945
27849,2014-03-15,15,449,531,980
27850,2014-03-15,16,433,532,965
27851,2014-03-15,17,401,489,890
27852,2014-03-15,18,296,442,738
27853,2014-03-15,19,153,335,488
27854,2014-03-15,20,88,222,310
27855,2014-03-15,21,64,201,265
27856,2014-03-15,22,35,161,196
27857,2014-03-15,23,35,156,191
27858,2014-03-16,0,20,104,124
27859,2014-03-16,1,7,101,108
27860,2014-03-16,2,11,70,81
27861,2014-03-16,3,14,19,33
27862,2014-03-16,4,0,4,4
27863,2014-03-16,5,0,5,5
27864,2014-03-16,6,1,8,9
27865,2014-03-16,7,15,24,39
27866,2014-03-16,8,21,70,91
27867,2014-03-16,9,52,195,247
27868,2014-03-16,10,103,258,361
27869,2014-03-16,11,128,340,468
27870,2014-03-16,12,184,359,543
27871,2014-03-16,13,188,385,573
27872,2014-03-16,14,140,355,495
27873,2014-03-16,15,134,314,448
27874,2014-03-16,16,85,294,379
27875,2014-03-16,17,90,236,326
27876,2014-03-16,18,41,206,247
27877,2014-03-16,19,17,93,110
27878,2014-03-16,20,7,52,59
27879,2014-03-16,21,4,32,36
27880,2014-03-16,22,0,15,15
27881,2014-03-16,23,0,12,12
27882,2014-03-17,0,1,4,5
27883,2014-03-17,1,0,4,4
27884,2014-03-17,2,0,1,1
27885,2014-03-17,3,0,3,3
27886,2014-03-17,4,0,1,1
27887,2014-03-17,5,0,3,3
27888,2014-03-17,6,0,4,4
27889,2014-03-17,7,0,7,7
27890,2014-03-17,8,0,20,20
27891,2014-03-17,9,2,28,30
27892,2014-03-17,10,7,24,31
27893,2014-03-17,11,3,38,41
27894,2014-03-17,12,4,33,37
27895,2014-03-17,13,3,59,62
27896,2014-03-17,14,9,71,80
27897,2014-03-17,15,5,79,84
27898,2014-03-17,16,7,102,109
27899,2014-03-17,17,4,139,143
27900,2014-03-17,18,5,161,166
27901,2014-03-17,19,4,172,176
27902,2014-03-17,20,3,99,102
27903,2014-03-17,21,2,75,77
27904,2014-03-17,22,1,52,53
27905,2014-03-17,23,1,39,40
27906,2014-03-18,0,1,16,17
27907,2014-03-18,1,0,8,8
27908,2014-03-18,2,0,4,4
27909,2014-03-18,4,0,2,2
27910,2014-03-18,5,0,19,19
27911,2014-03-18,6,0,100,100
27912,2014-03-18,7,3,229,232
27913,2014-03-18,8,3,500,503
27914,2014-03-18,9,2,285,287
27915,2014-03-18,10,10,117,127
27916,2014-03-18,11,7,79,86
27917,2014-03-18,12,20,137,157
27918,2014-03-18,13,20,129,149
27919,2014-03-18,14,24,142,166
27920,2014-03-18,15,28,182,210
27921,2014-03-18,16,27,255,282
27922,2014-03-18,17,25,597,622
27923,2014-03-18,18,19,592,611
27924,2014-03-18,19,14,401,415
27925,2014-03-18,20,5,283,288
27926,2014-03-18,21,8,190,198
27927,2014-03-18,22,3,120,123
27928,2014-03-18,23,0,52,52
27929,2014-03-19,0,0,19,19
27930,2014-03-19,1,0,13,13
27931,2014-03-19,2,0,3,3
27932,2014-03-19,3,0,2,2
27933,2014-03-19,4,0,4,4
27934,2014-03-19,5,0,27,27
27935,2014-03-19,6,0,136,136
27936,2014-03-19,7,2,380,382
27937,2014-03-19,8,4,783,787
27938,2014-03-19,9,12,359,371
27939,2014-03-19,10,10,144,154
27940,2014-03-19,11,8,89,97
27941,2014-03-19,12,8,77,85
27942,2014-03-19,13,8,108,116
27943,2014-03-19,14,20,85,105
27944,2014-03-19,15,6,84,90
27945,2014-03-19,16,6,123,129
27946,2014-03-19,17,8,179,187
27947,2014-03-19,18,4,198,202
27948,2014-03-19,19,3,292,295
27949,2014-03-19,20,0,217,217
27950,2014-03-19,21,6,150,156
27951,2014-03-19,22,1,115,116
27952,2014-03-19,23,6,55,61
27953,2014-03-20,0,4,27,31
27954,2014-03-20,1,0,8,8
27955,2014-03-20,2,1,7,8
27956,2014-03-20,3,0,4,4
27957,2014-03-20,4,1,5,6
27958,2014-03-20,5,0,30,30
27959,2014-03-20,6,2,137,139
27960,2014-03-20,7,3,403,406
27961,2014-03-20,8,15,817,832
27962,2014-03-20,9,15,413,428
27963,2014-03-20,10,22,185,207
27964,2014-03-20,11,41,177,218
27965,2014-03-20,12,84,242,326
27966,2014-03-20,13,86,257,343
27967,2014-03-20,14,74,231,305
27968,2014-03-20,15,91,259,350
27969,2014-03-20,16,83,420,503
27970,2014-03-20,17,84,829,913
27971,2014-03-20,18,62,807,869
27972,2014-03-20,19,50,523,573
27973,2014-03-20,20,21,368,389
27974,2014-03-20,21,22,265,287
27975,2014-03-20,22,21,193,214
27976,2014-03-20,23,15,110,125
27977,2014-03-21,0,8,58,66
27978,2014-03-21,1,2,24,26
27979,2014-03-21,2,2,9,11
27980,2014-03-21,3,0,7,7
27981,2014-03-21,4,0,8,8
27982,2014-03-21,5,1,36,37
27983,2014-03-21,6,1,127,128
27984,2014-03-21,7,9,409,418
27985,2014-03-21,8,15,858,873
27986,2014-03-21,9,28,371,399
27987,2014-03-21,10,49,222,271
27988,2014-03-21,11,64,203,267
27989,2014-03-21,12,68,266,334
27990,2014-03-21,13,104,258,362
27991,2014-03-21,14,114,217,331
27992,2014-03-21,15,75,282,357
27993,2014-03-21,16,114,457,571
27994,2014-03-21,17,117,825,942
27995,2014-03-21,18,84,718,802
27996,2014-03-21,19,65,466,531
27997,2014-03-21,20,35,301,336
27998,2014-03-21,21,19,235,254
27999,2014-03-21,22,19,170,189
28000,2014-03-21,23,14,143,157
28001,2014-03-22,0,10,102,112
28002,2014-03-22,1,9,83,92
28003,2014-03-22,2,12,51,63
28004,2014-03-22,3,1,25,26
28005,2014-03-22,4,1,9,10
28006,2014-03-22,5,0,8,8
28007,2014-03-22,6,5,22,27
28008,2014-03-22,7,2,63,65
28009,2014-03-22,8,30,162,192
28010,2014-03-22,9,73,248,321
28011,2014-03-22,10,160,339,499
28012,2014-03-22,11,309,445,754
28013,2014-03-22,12,347,462,809
28014,2014-03-22,13,415,500,915
28015,2014-03-22,14,572,547,1119
28016,2014-03-22,15,593,506,1099
28017,2014-03-22,16,602,489,1091
28018,2014-03-22,17,517,462,979
28019,2014-03-22,18,436,464,900
28020,2014-03-22,19,282,347,629
28021,2014-03-22,20,131,276,407
28022,2014-03-22,21,91,202,293
28023,2014-03-22,22,56,173,229
28024,2014-03-22,23,54,153,207
28025,2014-03-23,0,24,119,143
28026,2014-03-23,1,17,72,89
28027,2014-03-23,2,15,54,69
28028,2014-03-23,3,6,21,27
28029,2014-03-23,4,1,9,10
28030,2014-03-23,5,5,7,12
28031,2014-03-23,6,1,17,18
28032,2014-03-23,7,7,44,51
28033,2014-03-23,8,20,95,115
28034,2014-03-23,9,61,163,224
28035,2014-03-23,10,95,298,393
28036,2014-03-23,11,115,334,449
28037,2014-03-23,12,132,354,486
28038,2014-03-23,13,137,352,489
28039,2014-03-23,14,127,342,469
28040,2014-03-23,15,87,344,431
28041,2014-03-23,16,104,284,388
28042,2014-03-23,17,66,298,364
28043,2014-03-23,18,55,343,398
28044,2014-03-23,19,54,232,286
28045,2014-03-23,20,22,143,165
28046,2014-03-23,21,13,103,116
28047,2014-03-23,22,14,66,80
28048,2014-03-23,23,5,35,40
28049,2014-03-24,0,4,15,19
28050,2014-03-24,1,2,8,10
28051,2014-03-24,2,0,3,3
28052,2014-03-24,3,0,1,1
28053,2014-03-24,4,1,4,5
28054,2014-03-24,5,0,39,39
28055,2014-03-24,6,2,113,115
28056,2014-03-24,7,5,321,326
28057,2014-03-24,8,16,629,645
28058,2014-03-24,9,13,357,370
28059,2014-03-24,10,46,118,164
28060,2014-03-24,11,34,110,144
28061,2014-03-24,12,49,184,233
28062,2014-03-24,13,45,151,196
28063,2014-03-24,14,46,144,190
28064,2014-03-24,15,42,157,199
28065,2014-03-24,16,42,256,298
28066,2014-03-24,17,54,623,677
28067,2014-03-24,18,41,595,636
28068,2014-03-24,19,42,412,454
28069,2014-03-24,20,18,253,271
28070,2014-03-24,21,11,189,200
28071,2014-03-24,22,4,86,90
28072,2014-03-24,23,2,54,56
28073,2014-03-25,0,0,27,27
28074,2014-03-25,1,0,9,9
28075,2014-03-25,2,0,4,4
28076,2014-03-25,3,0,3,3
28077,2014-03-25,4,0,7,7
28078,2014-03-25,5,0,33,33
28079,2014-03-25,6,6,124,130
28080,2014-03-25,7,8,387,395
28081,2014-03-25,8,9,421,430
28082,2014-03-25,9,4,182,186
28083,2014-03-25,10,6,70,76
28084,2014-03-25,11,2,47,49
28085,2014-03-25,12,1,47,48
28086,2014-03-25,13,6,48,54
28087,2014-03-25,14,4,49,53
28088,2014-03-25,15,5,87,92
28089,2014-03-25,16,6,181,187
28090,2014-03-25,17,15,361,376
28091,2014-03-25,18,6,283,289
28092,2014-03-25,19,6,201,207
28093,2014-03-25,20,4,155,159
28094,2014-03-25,21,3,120,123
28095,2014-03-25,22,8,93,101
28096,2014-03-25,23,6,48,54
28097,2014-03-26,0,0,20,20
28098,2014-03-26,1,0,4,4
28099,2014-03-26,2,0,3,3
28100,2014-03-26,4,0,7,7
28101,2014-03-26,5,2,32,34
28102,2014-03-26,6,3,107,110
28103,2014-03-26,7,10,324,334
28104,2014-03-26,8,7,633,640
28105,2014-03-26,9,12,307,319
28106,2014-03-26,10,7,116,123
28107,2014-03-26,11,12,111,123
28108,2014-03-26,12,20,172,192
28109,2014-03-26,13,9,160,169
28110,2014-03-26,14,16,118,134
28111,2014-03-26,15,19,171,190
28112,2014-03-26,16,19,273,292
28113,2014-03-26,17,39,553,592
28114,2014-03-26,18,31,556,587
28115,2014-03-26,19,5,351,356
28116,2014-03-26,20,16,261,277
28117,2014-03-26,21,10,202,212
28118,2014-03-26,22,7,153,160
28119,2014-03-26,23,4,51,55
28120,2014-03-27,0,1,22,23
28121,2014-03-27,1,0,8,8
28122,2014-03-27,2,1,5,6
28123,2014-03-27,3,0,1,1
28124,2014-03-27,4,0,6,6
28125,2014-03-27,5,1,35,36
28126,2014-03-27,6,2,106,108
28127,2014-03-27,7,6,371,377
28128,2014-03-27,8,22,774,796
28129,2014-03-27,9,21,380,401
28130,2014-03-27,10,29,150,179
28131,2014-03-27,11,42,177,219
28132,2014-03-27,12,55,215,270
28133,2014-03-27,13,56,201,257
28134,2014-03-27,14,39,149,188
28135,2014-03-27,15,54,242,296
28136,2014-03-27,16,57,318,375
28137,2014-03-27,17,70,677,747
28138,2014-03-27,18,58,744,802
28139,2014-03-27,19,33,465,498
28140,2014-03-27,20,24,298,322
28141,2014-03-27,21,19,238,257
28142,2014-03-27,22,18,138,156
28143,2014-03-27,23,12,108,120
28144,2014-03-28,0,10,60,70
28145,2014-03-28,1,6,26,32
28146,2014-03-28,2,6,14,20
28147,2014-03-28,3,0,4,4
28148,2014-03-28,4,0,5,5
28149,2014-03-28,5,1,38,39
28150,2014-03-28,6,2,144,146
28151,2014-03-28,7,3,309,312
28152,2014-03-28,8,12,490,502
28153,2014-03-28,9,14,343,357
28154,2014-03-28,10,19,136,155
28155,2014-03-28,11,21,114,135
28156,2014-03-28,12,19,152,171
28157,2014-03-28,13,52,209,261
28158,2014-03-28,14,87,218,305
28159,2014-03-28,15,101,281,382
28160,2014-03-28,16,118,426,544
28161,2014-03-28,17,123,746,869
28162,2014-03-28,18,83,710,793
28163,2014-03-28,19,53,438,491
28164,2014-03-28,20,59,306,365
28165,2014-03-28,21,46,241,287
28166,2014-03-28,22,37,215,252
28167,2014-03-28,23,24,149,173
28168,2014-03-29,0,10,172,182
28169,2014-03-29,1,13,85,98
28170,2014-03-29,2,8,72,80
28171,2014-03-29,3,2,16,18
28172,2014-03-29,4,1,11,12
28173,2014-03-29,5,1,7,8
28174,2014-03-29,6,2,8,10
28175,2014-03-29,7,5,34,39
28176,2014-03-29,8,9,101,110
28177,2014-03-29,9,18,115,133
28178,2014-03-29,10,17,136,153
28179,2014-03-29,11,42,191,233
28180,2014-03-29,12,49,225,274
28181,2014-03-29,13,37,157,194
28182,2014-03-29,14,17,87,104
28183,2014-03-29,15,9,77,86
28184,2014-03-29,16,13,53,66
28185,2014-03-29,17,6,54,60
28186,2014-03-29,18,6,71,77
28187,2014-03-29,19,2,42,44
28188,2014-03-29,20,6,51,57
28189,2014-03-29,21,5,60,65
28190,2014-03-29,22,4,61,65
28191,2014-03-29,23,5,88,93
28192,2014-03-30,0,7,51,58
28193,2014-03-30,1,9,54,63
28194,2014-03-30,2,1,35,36
28195,2014-03-30,3,3,17,20
28196,2014-03-30,4,0,3,3
28197,2014-03-30,5,1,1,2
28198,2014-03-30,6,0,5,5
28199,2014-03-30,7,1,11,12
28200,2014-03-30,8,2,54,56
28201,2014-03-30,9,3,54,57
28202,2014-03-30,10,2,61,63
28203,2014-03-30,11,2,42,44
28204,2014-03-30,12,4,52,56
28205,2014-03-30,13,3,50,53
28206,2014-03-30,14,0,40,40
28207,2014-03-30,15,1,64,65
28208,2014-03-30,16,1,46,47
28209,2014-03-30,17,6,34,40
28210,2014-03-30,18,3,31,34
28211,2014-03-30,19,2,22,24
28212,2014-03-30,20,0,28,28
28213,2014-03-30,21,3,31,34
28214,2014-03-30,22,1,28,29
28215,2014-03-30,23,3,24,27
28216,2014-03-31,0,1,16,17
28217,2014-03-31,1,4,6,10
28218,2014-03-31,2,1,5,6
28219,2014-03-31,3,1,2,3
28220,2014-03-31,4,0,7,7
28221,2014-03-31,5,1,27,28
28222,2014-03-31,6,4,121,125
28223,2014-03-31,7,7,424,431
28224,2014-03-31,8,22,784,806
28225,2014-03-31,9,43,345,388
28226,2014-03-31,10,63,124,187
28227,2014-03-31,11,119,191,310
28228,2014-03-31,12,115,264,379
28229,2014-03-31,13,124,257,381
28230,2014-03-31,14,166,228,394
28231,2014-03-31,15,154,257,411
28232,2014-03-31,16,150,449,599
28233,2014-03-31,17,135,913,1048
28234,2014-03-31,18,107,881,988
28235,2014-03-31,19,67,617,684
28236,2014-03-31,20,51,385,436
28237,2014-03-31,21,17,248,265
28238,2014-03-31,22,28,149,177
28239,2014-03-31,23,12,66,78
28240,2014-04-01,0,1,29,30
28241,2014-04-01,1,4,12,16
28242,2014-04-01,2,3,9,12
28243,2014-04-01,4,0,8,8
28244,2014-04-01,5,4,51,55
28245,2014-04-01,6,8,171,179
28246,2014-04-01,7,18,559,577
28247,2014-04-01,8,19,979,998
28248,2014-04-01,9,43,411,454
28249,2014-04-01,10,75,193,268
28250,2014-04-01,11,112,179,291
28251,2014-04-01,12,100,257,357
28252,2014-04-01,13,150,277,427
28253,2014-04-01,14,114,250,364
28254,2014-04-01,15,171,278,449
28255,2014-04-01,16,143,444,587
28256,2014-04-01,17,154,1041,1195
28257,2014-04-01,18,143,1012,1155
28258,2014-04-01,19,105,653,758
28259,2014-04-01,20,53,449,502
28260,2014-04-01,21,50,291,341
28261,2014-04-01,22,27,206,233
28262,2014-04-01,23,10,104,114
28263,2014-04-02,0,6,44,50
28264,2014-04-02,1,2,23,25
28265,2014-04-02,2,3,7,10
28266,2014-04-02,3,1,4,5
28267,2014-04-02,4,0,7,7
28268,2014-04-02,5,2,46,48
28269,2014-04-02,6,8,207,215
28270,2014-04-02,7,23,550,573
28271,2014-04-02,8,24,967,991
28272,2014-04-02,9,42,391,433
28273,2014-04-02,10,64,165,229
28274,2014-04-02,11,68,177,245
28275,2014-04-02,12,74,270,344
28276,2014-04-02,13,98,256,354
28277,2014-04-02,14,135,235,370
28278,2014-04-02,15,144,268,412
28279,2014-04-02,16,111,420,531
28280,2014-04-02,17,158,958,1116
28281,2014-04-02,18,128,925,1053
28282,2014-04-02,19,107,625,732
28283,2014-04-02,20,54,399,453
28284,2014-04-02,21,34,339,373
28285,2014-04-02,22,35,174,209
28286,2014-04-02,23,7,101,108
28287,2014-04-03,0,3,38,41
28288,2014-04-03,1,1,19,20
28289,2014-04-03,2,0,6,6
28290,2014-04-03,3,1,3,4
28291,2014-04-03,4,1,7,8
28292,2014-04-03,5,1,38,39
28293,2014-04-03,6,6,173,179
28294,2014-04-03,7,18,558,576
28295,2014-04-03,8,26,956,982
28296,2014-04-03,9,75,489,564
28297,2014-04-03,10,116,197,313
28298,2014-04-03,11,93,224,317
28299,2014-04-03,12,123,314,437
28300,2014-04-03,13,108,304,412
28301,2014-04-03,14,137,266,403
28302,2014-04-03,15,145,314,459
28303,2014-04-03,16,130,410,540
28304,2014-04-03,17,128,878,1006
28305,2014-04-03,18,101,906,1007
28306,2014-04-03,19,84,569,653
28307,2014-04-03,20,47,379,426
28308,2014-04-03,21,43,296,339
28309,2014-04-03,22,34,205,239
28310,2014-04-03,23,11,126,137
28311,2014-04-04,0,4,44,48
28312,2014-04-04,1,1,34,35
28313,2014-04-04,2,0,11,11
28314,2014-04-04,3,7,5,12
28315,2014-04-04,4,3,8,11
28316,2014-04-04,5,2,50,52
28317,2014-04-04,6,5,149,154
28318,2014-04-04,7,10,443,453
28319,2014-04-04,8,37,918,955
28320,2014-04-04,9,48,418,466
28321,2014-04-04,10,80,240,320
28322,2014-04-04,11,105,273,378
28323,2014-04-04,12,147,354,501
28324,2014-04-04,13,94,309,403
28325,2014-04-04,14,165,248,413
28326,2014-04-04,15,151,337,488
28327,2014-04-04,16,170,569,739
28328,2014-04-04,17,154,890,1044
28329,2014-04-04,18,97,701,798
28330,2014-04-04,19,83,471,554
28331,2014-04-04,20,52,346,398
28332,2014-04-04,21,43,250,293
28333,2014-04-04,22,37,211,248
28334,2014-04-04,23,9,93,102
28335,2014-04-05,0,9,74,83
28336,2014-04-05,1,8,67,75
28337,2014-04-05,2,16,58,74
28338,2014-04-05,3,12,24,36
28339,2014-04-05,4,0,8,8
28340,2014-04-05,5,2,17,19
28341,2014-04-05,6,10,25,35
28342,2014-04-05,7,18,85,103
28343,2014-04-05,8,54,236,290
28344,2014-04-05,9,156,321,477
28345,2014-04-05,10,266,365,631
28346,2014-04-05,11,420,469,889
28347,2014-04-05,12,539,512,1051
28348,2014-04-05,13,571,515,1086
28349,2014-04-05,14,534,527,1061
28350,2014-04-05,15,515,498,1013
28351,2014-04-05,16,480,449,929
28352,2014-04-05,17,382,490,872
28353,2014-04-05,18,263,407,670
28354,2014-04-05,19,145,288,433
28355,2014-04-05,20,64,216,280
28356,2014-04-05,21,78,185,263
28357,2014-04-05,22,60,149,209
28358,2014-04-05,23,21,144,165
28359,2014-04-06,0,16,97,113
28360,2014-04-06,1,14,63,77
28361,2014-04-06,2,10,59,69
28362,2014-04-06,3,6,24,30
28363,2014-04-06,4,0,7,7
28364,2014-04-06,5,2,20,22
28365,2014-04-06,6,15,111,126
28366,2014-04-06,7,19,86,105
28367,2014-04-06,8,50,142,192
28368,2014-04-06,9,113,283,396
28369,2014-04-06,10,228,375,603
28370,2014-04-06,11,277,463,740
28371,2014-04-06,12,367,543,910
28372,2014-04-06,13,424,505,929
28373,2014-04-06,14,441,496,937
28374,2014-04-06,15,447,531,978
28375,2014-04-06,16,445,592,1037
28376,2014-04-06,17,334,493,827
28377,2014-04-06,18,231,409,640
28378,2014-04-06,19,111,323,434
28379,2014-04-06,20,46,230,276
28380,2014-04-06,21,20,107,127
28381,2014-04-06,22,40,117,157
28382,2014-04-06,23,19,64,83
28383,2014-04-07,0,11,24,35
28384,2014-04-07,1,10,4,14
28385,2014-04-07,2,2,4,6
28386,2014-04-07,3,1,2,3
28387,2014-04-07,4,0,12,12
28388,2014-04-07,5,0,40,40
28389,2014-04-07,6,7,109,116
28390,2014-04-07,7,6,269,275
28391,2014-04-07,8,15,447,462
28392,2014-04-07,9,6,137,143
28393,2014-04-07,10,7,50,57
28394,2014-04-07,11,6,34,40
28395,2014-04-07,12,5,51,56
28396,2014-04-07,13,4,42,46
28397,2014-04-07,14,8,71,79
28398,2014-04-07,15,4,36,40
28399,2014-04-07,16,8,79,87
28400,2014-04-07,17,8,261,269
28401,2014-04-07,18,13,244,257
28402,2014-04-07,19,9,258,267
28403,2014-04-07,20,6,188,194
28404,2014-04-07,21,7,118,125
28405,2014-04-07,22,0,93,93
28406,2014-04-07,23,5,80,85
28407,2014-04-08,0,5,29,34
28408,2014-04-08,1,3,9,12
28409,2014-04-08,2,0,4,4
28410,2014-04-08,3,0,2,2
28411,2014-04-08,4,0,5,5
28412,2014-04-08,5,1,40,41
28413,2014-04-08,6,6,168,174
28414,2014-04-08,7,12,475,487
28415,2014-04-08,8,10,880,890
28416,2014-04-08,9,23,376,399
28417,2014-04-08,10,52,198,250
28418,2014-04-08,11,74,191,265
28419,2014-04-08,12,88,305,393
28420,2014-04-08,13,87,302,389
28421,2014-04-08,14,113,254,367
28422,2014-04-08,15,98,322,420
28423,2014-04-08,16,108,473,581
28424,2014-04-08,17,119,1038,1157
28425,2014-04-08,18,107,987,1094
28426,2014-04-08,19,93,665,758
28427,2014-04-08,20,43,427,470
28428,2014-04-08,21,39,302,341
28429,2014-04-08,22,9,193,202
28430,2014-04-08,23,7,107,114
28431,2014-04-09,0,5,27,32
28432,2014-04-09,1,5,18,23
28433,2014-04-09,2,5,1,6
28434,2014-04-09,3,1,6,7
28435,2014-04-09,4,0,9,9
28436,2014-04-09,5,2,66,68
28437,2014-04-09,6,15,194,209
28438,2014-04-09,7,28,613,641
28439,2014-04-09,8,41,1001,1042
28440,2014-04-09,9,57,424,481
28441,2014-04-09,10,89,204,293
28442,2014-04-09,11,120,248,368
28443,2014-04-09,12,109,292,401
28444,2014-04-09,13,116,288,404
28445,2014-04-09,14,122,268,390
28446,2014-04-09,15,114,287,401
28447,2014-04-09,16,128,469,597
28448,2014-04-09,17,154,1051,1205
28449,2014-04-09,18,120,1057,1177
28450,2014-04-09,19,119,720,839
28451,2014-04-09,20,65,454,519
28452,2014-04-09,21,27,325,352
28453,2014-04-09,22,23,237,260
28454,2014-04-09,23,19,128,147
28455,2014-04-10,0,11,48,59
28456,2014-04-10,1,5,14,19
28457,2014-04-10,2,0,6,6
28458,2014-04-10,3,1,7,8
28459,2014-04-10,4,0,8,8
28460,2014-04-10,5,2,60,62
28461,2014-04-10,6,19,217,236
28462,2014-04-10,7,33,603,636
28463,2014-04-10,8,37,953,990
28464,2014-04-10,9,64,437,501
28465,2014-04-10,10,109,213,322
28466,2014-04-10,11,124,231,355
28467,2014-04-10,12,178,359,537
28468,2014-04-10,13,235,340,575
28469,2014-04-10,14,218,313,531
28470,2014-04-10,15,245,358,603
28471,2014-04-10,16,206,526,732
28472,2014-04-10,17,249,1061,1310
28473,2014-04-10,18,214,1078,1292
28474,2014-04-10,19,152,791,943
28475,2014-04-10,20,108,497,605
28476,2014-04-10,21,58,366,424
28477,2014-04-10,22,45,249,294
28478,2014-04-10,23,33,159,192
28479,2014-04-11,0,16,56,72
28480,2014-04-11,1,10,35,45
28481,2014-04-11,2,4,12,16
28482,2014-04-11,3,3,5,8
28483,2014-04-11,4,1,5,6
28484,2014-04-11,5,4,63,67
28485,2014-04-11,6,32,214,246
28486,2014-04-11,7,28,561,589
28487,2014-04-11,8,49,938,987
28488,2014-04-11,9,96,479,575
28489,2014-04-11,10,150,236,386
28490,2014-04-11,11,171,310,481
28491,2014-04-11,12,225,384,609
28492,2014-04-11,13,220,384,604
28493,2014-04-11,14,310,350,660
28494,2014-04-11,15,298,427,725
28495,2014-04-11,16,362,666,1028
28496,2014-04-11,17,326,1029,1355
28497,2014-04-11,18,275,887,1162
28498,2014-04-11,19,187,552,739
28499,2014-04-11,20,75,291,366
28500,2014-04-11,21,55,164,219
28501,2014-04-11,22,51,226,277
28502,2014-04-11,23,34,176,210
28503,2014-04-12,0,22,118,140
28504,2014-04-12,1,16,91,107
28505,2014-04-12,2,12,66,78
28506,2014-04-12,3,6,12,18
28507,2014-04-12,4,1,4,5
28508,2014-04-12,5,9,17,26
28509,2014-04-12,6,38,57,95
28510,2014-04-12,7,90,138,228
28511,2014-04-12,8,151,282,433
28512,2014-04-12,9,234,416,650
28513,2014-04-12,10,443,508,951
28514,2014-04-12,11,547,554,1101
28515,2014-04-12,12,753,569,1322
28516,2014-04-12,13,791,617,1408
28517,2014-04-12,14,817,601,1418
28518,2014-04-12,15,814,550,1364
28519,2014-04-12,16,764,551,1315
28520,2014-04-12,17,706,541,1247
28521,2014-04-12,18,612,549,1161
28522,2014-04-12,19,421,445,866
28523,2014-04-12,20,275,311,586
28524,2014-04-12,21,180,282,462
28525,2014-04-12,22,139,195,334
28526,2014-04-12,23,76,171,247
28527,2014-04-13,0,58,137,195
28528,2014-04-13,1,19,104,123
28529,2014-04-13,2,15,69,84
28530,2014-04-13,3,19,26,45
28531,2014-04-13,4,5,12,17
28532,2014-04-13,5,9,15,24
28533,2014-04-13,6,31,28,59
28534,2014-04-13,7,92,92,184
28535,2014-04-13,8,170,186,356
28536,2014-04-13,9,290,357,647
28537,2014-04-13,10,520,447,967
28538,2014-04-13,11,700,538,1238
28539,2014-04-13,12,722,543,1265
28540,2014-04-13,13,814,523,1337
28541,2014-04-13,14,783,534,1317
28542,2014-04-13,15,684,535,1219
28543,2014-04-13,16,652,553,1205
28544,2014-04-13,17,515,566,1081
28545,2014-04-13,18,453,489,942
28546,2014-04-13,19,389,430,819
28547,2014-04-13,20,216,358,574
28548,2014-04-13,21,148,183,331
28549,2014-04-13,22,81,167,248
28550,2014-04-13,23,65,76,141
28551,2014-04-14,0,21,41,62
28552,2014-04-14,1,10,17,27
28553,2014-04-14,2,2,0,2
28554,2014-04-14,3,0,1,1
28555,2014-04-14,4,2,6,8
28556,2014-04-14,5,6,48,54
28557,2014-04-14,6,14,204,218
28558,2014-04-14,7,29,603,632
28559,2014-04-14,8,85,811,896
28560,2014-04-14,9,157,351,508
28561,2014-04-14,10,230,157,387
28562,2014-04-14,11,253,221,474
28563,2014-04-14,12,264,289,553
28564,2014-04-14,13,267,296,563
28565,2014-04-14,14,279,238,517
28566,2014-04-14,15,313,286,599
28567,2014-04-14,16,299,497,796
28568,2014-04-14,17,247,1037,1284
28569,2014-04-14,18,210,914,1124
28570,2014-04-14,19,144,546,690
28571,2014-04-14,20,109,379,488
28572,2014-04-14,21,85,288,373
28573,2014-04-14,22,34,160,194
28574,2014-04-14,23,22,102,124
28575,2014-04-15,0,5,20,25
28576,2014-04-15,1,8,8,16
28577,2014-04-15,2,8,3,11
28578,2014-04-15,3,3,3,6
28579,2014-04-15,4,3,8,11
28580,2014-04-15,5,1,44,45
28581,2014-04-15,6,6,129,135
28582,2014-04-15,7,6,169,175
28583,2014-04-15,8,8,137,145
28584,2014-04-15,9,6,61,67
28585,2014-04-15,10,22,52,74
28586,2014-04-15,11,19,125,144
28587,2014-04-15,12,40,140,180
28588,2014-04-15,13,12,44,56
28589,2014-04-15,14,9,25,34
28590,2014-04-15,15,2,37,39
28591,2014-04-15,16,16,76,92
28592,2014-04-15,17,3,124,127
28593,2014-04-15,18,6,146,152
28594,2014-04-15,19,2,69,71
28595,2014-04-15,20,2,62,64
28596,2014-04-15,21,1,58,59
28597,2014-04-15,22,1,40,41
28598,2014-04-15,23,1,46,47
28599,2014-04-16,0,0,14,14
28600,2014-04-16,1,3,7,10
28601,2014-04-16,2,0,7,7
28602,2014-04-16,3,0,2,2
28603,2014-04-16,4,0,9,9
28604,2014-04-16,5,1,37,38
28605,2014-04-16,6,2,137,139
28606,2014-04-16,7,2,385,387
28607,2014-04-16,8,29,707,736
28608,2014-04-16,9,35,351,386
28609,2014-04-16,10,49,176,225
28610,2014-04-16,11,79,178,257
28611,2014-04-16,12,82,262,344
28612,2014-04-16,13,94,240,334
28613,2014-04-16,14,146,209,355
28614,2014-04-16,15,185,224,409
28615,2014-04-16,16,160,405,565
28616,2014-04-16,17,175,881,1056
28617,2014-04-16,18,124,778,902
28618,2014-04-16,19,87,570,657
28619,2014-04-16,20,40,346,386
28620,2014-04-16,21,33,247,280
28621,2014-04-16,22,23,143,166
28622,2014-04-16,23,6,100,106
28623,2014-04-17,0,1,38,39
28624,2014-04-17,1,7,11,18
28625,2014-04-17,2,1,10,11
28626,2014-04-17,3,0,4,4
28627,2014-04-17,4,1,7,8
28628,2014-04-17,5,2,38,40
28629,2014-04-17,6,5,170,175
28630,2014-04-17,7,7,460,467
28631,2014-04-17,8,42,872,914
28632,2014-04-17,9,70,363,433
28633,2014-04-17,10,101,182,283
28634,2014-04-17,11,96,214,310
28635,2014-04-17,12,129,276,405
28636,2014-04-17,13,143,303,446
28637,2014-04-17,14,137,259,396
28638,2014-04-17,15,172,283,455
28639,2014-04-17,16,161,452,613
28640,2014-04-17,17,156,913,1069
28641,2014-04-17,18,111,872,983
28642,2014-04-17,19,91,526,617
28643,2014-04-17,20,26,359,385
28644,2014-04-17,21,34,259,293
28645,2014-04-17,22,15,148,163
28646,2014-04-17,23,7,89,96
28647,2014-04-18,0,2,53,55
28648,2014-04-18,1,4,23,27
28649,2014-04-18,2,0,10,10
28650,2014-04-18,3,0,5,5
28651,2014-04-18,4,1,10,11
28652,2014-04-18,5,3,46,49
28653,2014-04-18,6,5,146,151
28654,2014-04-18,7,8,358,366
28655,2014-04-18,8,48,748,796
28656,2014-04-18,9,79,397,476
28657,2014-04-18,10,147,250,397
28658,2014-04-18,11,138,250,388
28659,2014-04-18,12,200,326,526
28660,2014-04-18,13,218,334,552
28661,2014-04-18,14,234,329,563
28662,2014-04-18,15,249,432,681
28663,2014-04-18,16,267,548,815
28664,2014-04-18,17,229,795,1024
28665,2014-04-18,18,165,635,800
28666,2014-04-18,19,114,465,579
28667,2014-04-18,20,66,283,349
28668,2014-04-18,21,75,247,322
28669,2014-04-18,22,38,199,237
28670,2014-04-18,23,33,129,162
28671,2014-04-19,0,16,84,100
28672,2014-04-19,1,17,60,77
28673,2014-04-19,2,3,45,48
28674,2014-04-19,3,2,25,27
28675,2014-04-19,4,3,4,7
28676,2014-04-19,5,3,11,14
28677,2014-04-19,6,8,14,22
28678,2014-04-19,7,22,75,97
28679,2014-04-19,8,71,181,252
28680,2014-04-19,9,141,293,434
28681,2014-04-19,10,301,335,636
28682,2014-04-19,11,476,434,910
28683,2014-04-19,12,518,534,1052
28684,2014-04-19,13,549,447,996
28685,2014-04-19,14,669,451,1120
28686,2014-04-19,15,736,519,1255
28687,2014-04-19,16,666,512,1178
28688,2014-04-19,17,574,456,1030
28689,2014-04-19,18,436,416,852
28690,2014-04-19,19,285,327,612
28691,2014-04-19,20,182,262,444
28692,2014-04-19,21,112,197,309
28693,2014-04-19,22,73,172,245
28694,2014-04-19,23,46,160,206
28695,2014-04-20,0,27,112,139
28696,2014-04-20,1,12,78,90
28697,2014-04-20,2,11,62,73
28698,2014-04-20,3,2,23,25
28699,2014-04-20,4,2,8,10
28700,2014-04-20,5,14,12,26
28701,2014-04-20,6,18,21,39
28702,2014-04-20,7,34,65,99
28703,2014-04-20,8,61,151,212
28704,2014-04-20,9,120,237,357
28705,2014-04-20,10,234,359,593
28706,2014-04-20,11,339,363,702
28707,2014-04-20,12,388,465,853
28708,2014-04-20,13,454,467,921
28709,2014-04-20,14,426,426,852
28710,2014-04-20,15,487,451,938
28711,2014-04-20,16,418,402,820
28712,2014-04-20,17,382,441,823
28713,2014-04-20,18,239,405,644
28714,2014-04-20,19,201,354,555
28715,2014-04-20,20,86,216,302
28716,2014-04-20,21,75,159,234
28717,2014-04-20,22,50,98,148
28718,2014-04-20,23,14,42,56
28719,2014-04-21,0,6,22,28
28720,2014-04-21,1,2,11,13
28721,2014-04-21,2,0,11,11
28722,2014-04-21,3,0,1,1
28723,2014-04-21,4,1,8,9
28724,2014-04-21,5,2,47,49
28725,2014-04-21,6,10,171,181
28726,2014-04-21,7,23,497,520
28727,2014-04-21,8,34,846,880
28728,2014-04-21,9,80,362,442
28729,2014-04-21,10,121,205,326
28730,2014-04-21,11,143,199,342
28731,2014-04-21,12,151,311,462
28732,2014-04-21,13,145,266,411
28733,2014-04-21,14,193,230,423
28734,2014-04-21,15,220,287,507
28735,2014-04-21,16,205,501,706
28736,2014-04-21,17,227,1082,1309
28737,2014-04-21,18,158,972,1130
28738,2014-04-21,19,115,642,757
28739,2014-04-21,20,78,400,478
28740,2014-04-21,21,65,292,357
28741,2014-04-21,22,36,178,214
28742,2014-04-21,23,12,100,112
28743,2014-04-22,0,15,38,53
28744,2014-04-22,1,14,12,26
28745,2014-04-22,2,9,4,13
28746,2014-04-22,3,9,1,10
28747,2014-04-22,4,0,5,5
28748,2014-04-22,5,4,55,59
28749,2014-04-22,6,8,231,239
28750,2014-04-22,7,16,671,687
28751,2014-04-22,8,48,1033,1081
28752,2014-04-22,9,57,403,460
28753,2014-04-22,10,90,220,310
28754,2014-04-22,11,95,219,314
28755,2014-04-22,12,148,347,495
28756,2014-04-22,13,97,217,314
28757,2014-04-22,14,26,89,115
28758,2014-04-22,15,87,219,306
28759,2014-04-22,16,112,425,537
28760,2014-04-22,17,145,986,1131
28761,2014-04-22,18,77,905,982
28762,2014-04-22,19,71,615,686
28763,2014-04-22,20,52,467,519
28764,2014-04-22,21,30,337,367
28765,2014-04-22,22,35,224,259
28766,2014-04-22,23,17,121,138
28767,2014-04-23,0,4,44,48
28768,2014-04-23,1,2,22,24
28769,2014-04-23,2,0,1,1
28770,2014-04-23,3,0,5,5
28771,2014-04-23,4,1,7,8
28772,2014-04-23,5,3,55,58
28773,2014-04-23,6,8,206,214
28774,2014-04-23,7,24,653,677
28775,2014-04-23,8,33,963,996
28776,2014-04-23,9,58,386,444
28777,2014-04-23,10,73,171,244
28778,2014-04-23,11,100,218,318
28779,2014-04-23,12,84,269,353
28780,2014-04-23,13,128,257,385
28781,2014-04-23,14,107,253,360
28782,2014-04-23,15,98,272,370
28783,2014-04-23,16,121,466,587
28784,2014-04-23,17,119,1019,1138
28785,2014-04-23,18,91,960,1051
28786,2014-04-23,19,68,551,619
28787,2014-04-23,20,37,384,421
28788,2014-04-23,21,26,271,297
28789,2014-04-23,22,13,199,212
28790,2014-04-23,23,3,92,95
28791,2014-04-24,0,2,39,41
28792,2014-04-24,1,0,14,14
28793,2014-04-24,2,0,7,7
28794,2014-04-24,3,0,1,1
28795,2014-04-24,4,0,4,4
28796,2014-04-24,5,4,43,47
28797,2014-04-24,6,4,211,215
28798,2014-04-24,7,15,563,578
28799,2014-04-24,8,31,960,991
28800,2014-04-24,9,66,419,485
28801,2014-04-24,10,80,199,279
28802,2014-04-24,11,107,208,315
28803,2014-04-24,12,151,331,482
28804,2014-04-24,13,130,313,443
28805,2014-04-24,14,111,281,392
28806,2014-04-24,15,162,320,482
28807,2014-04-24,16,173,505,678
28808,2014-04-24,17,137,1008,1145
28809,2014-04-24,18,122,950,1072
28810,2014-04-24,19,99,666,765
28811,2014-04-24,20,65,430,495
28812,2014-04-24,21,65,315,380
28813,2014-04-24,22,51,246,297
28814,2014-04-24,23,33,163,196
28815,2014-04-25,0,24,80,104
28816,2014-04-25,1,5,24,29
28817,2014-04-25,2,10,8,18
28818,2014-04-25,3,0,8,8
28819,2014-04-25,4,0,5,5
28820,2014-04-25,5,3,46,49
28821,2014-04-25,6,8,171,179
28822,2014-04-25,7,23,532,555
28823,2014-04-25,8,49,968,1017
28824,2014-04-25,9,69,432,501
28825,2014-04-25,10,98,236,334
28826,2014-04-25,11,135,278,413
28827,2014-04-25,12,169,354,523
28828,2014-04-25,13,159,360,519
28829,2014-04-25,14,203,305,508
28830,2014-04-25,15,170,424,594
28831,2014-04-25,16,163,495,658
28832,2014-04-25,17,23,142,165
28833,2014-04-25,18,13,131,144
28834,2014-04-25,19,47,287,334
28835,2014-04-25,20,50,230,280
28836,2014-04-25,21,41,167,208
28837,2014-04-25,22,52,196,248
28838,2014-04-25,23,34,145,179
28839,2014-04-26,0,11,111,122
28840,2014-04-26,1,19,63,82
28841,2014-04-26,2,10,50,60
28842,2014-04-26,3,3,15,18
28843,2014-04-26,4,3,7,10
28844,2014-04-26,5,2,12,14
28845,2014-04-26,6,7,33,40
28846,2014-04-26,7,29,110,139
28847,2014-04-26,8,58,223,281
28848,2014-04-26,9,169,346,515
28849,2014-04-26,10,299,452,751
28850,2014-04-26,11,454,533,987
28851,2014-04-26,12,476,559,1035
28852,2014-04-26,13,540,540,1080
28853,2014-04-26,14,529,480,1009
28854,2014-04-26,15,535,519,1054
28855,2014-04-26,16,500,527,1027
28856,2014-04-26,17,462,532,994
28857,2014-04-26,18,340,444,784
28858,2014-04-26,19,216,358,574
28859,2014-04-26,20,126,223,349
28860,2014-04-26,21,63,135,198
28861,2014-04-26,22,64,145,209
28862,2014-04-26,23,44,133,177
28863,2014-04-27,0,38,144,182
28864,2014-04-27,1,38,100,138
28865,2014-04-27,2,22,54,76
28866,2014-04-27,3,19,20,39
28867,2014-04-27,4,2,11,13
28868,2014-04-27,5,11,27,38
28869,2014-04-27,6,58,33,91
28870,2014-04-27,7,151,101,252
28871,2014-04-27,8,167,228,395
28872,2014-04-27,9,204,292,496
28873,2014-04-27,10,243,416,659
28874,2014-04-27,11,324,519,843
28875,2014-04-27,12,410,606,1016
28876,2014-04-27,13,424,552,976
28877,2014-04-27,14,405,454,859
28878,2014-04-27,15,381,502,883
28879,2014-04-27,16,351,484,835
28880,2014-04-27,17,396,525,921
28881,2014-04-27,18,296,472,768
28882,2014-04-27,19,193,364,557
28883,2014-04-27,20,136,288,424
28884,2014-04-27,21,89,159,248
28885,2014-04-27,22,83,118,201
28886,2014-04-27,23,53,76,129
28887,2014-04-28,0,25,49,74
28888,2014-04-28,1,15,11,26
28889,2014-04-28,2,7,9,16
28890,2014-04-28,3,0,3,3
28891,2014-04-28,4,0,2,2
28892,2014-04-28,5,5,57,62
28893,2014-04-28,6,4,200,204
28894,2014-04-28,7,17,591,608
28895,2014-04-28,8,46,924,970
28896,2014-04-28,9,100,357,457
28897,2014-04-28,10,140,177,317
28898,2014-04-28,11,147,209,356
28899,2014-04-28,12,169,277,446
28900,2014-04-28,13,139,286,425
28901,2014-04-28,14,150,249,399
28902,2014-04-28,15,108,260,368
28903,2014-04-28,16,63,243,306
28904,2014-04-28,17,48,432,480
28905,2014-04-28,18,38,262,300
28906,2014-04-28,19,10,227,237
28907,2014-04-28,20,6,92,98
28908,2014-04-28,21,7,101,108
28909,2014-04-28,22,4,90,94
28910,2014-04-28,23,5,54,59
28911,2014-04-29,0,2,14,16
28912,2014-04-29,1,1,4,5
28913,2014-04-29,2,0,10,10
28914,2014-04-29,3,0,2,2
28915,2014-04-29,4,0,2,2
28916,2014-04-29,5,0,51,51
28917,2014-04-29,6,3,156,159
28918,2014-04-29,7,13,321,334
28919,2014-04-29,8,26,552,578
28920,2014-04-29,9,5,122,127
28921,2014-04-29,10,11,63,74
28922,2014-04-29,11,6,62,68
28923,2014-04-29,12,7,59,66
28924,2014-04-29,13,10,81,91
28925,2014-04-29,14,10,54,64
28926,2014-04-29,15,12,53,65
28927,2014-04-29,16,13,88,101
28928,2014-04-29,17,31,291,322
28929,2014-04-29,18,18,335,353
28930,2014-04-29,19,16,303,319
28931,2014-04-29,20,17,192,209
28932,2014-04-29,21,5,44,49
28933,2014-04-29,22,0,27,27
28934,2014-04-29,23,2,20,22
28935,2014-04-30,0,1,15,16
28936,2014-04-30,1,1,11,12
28937,2014-04-30,2,0,7,7
28938,2014-04-30,4,0,3,3
28939,2014-04-30,5,0,31,31
28940,2014-04-30,6,6,81,87
28941,2014-04-30,7,1,103,104
28942,2014-04-30,8,3,148,151
28943,2014-04-30,9,0,55,55
28944,2014-04-30,10,4,31,35
28945,2014-04-30,11,2,45,47
28946,2014-04-30,12,1,25,26
28947,2014-04-30,13,4,46,50
28948,2014-04-30,14,3,38,41
28949,2014-04-30,15,6,45,51
28950,2014-04-30,16,8,132,140
28951,2014-04-30,17,1,126,127
28952,2014-04-30,18,3,92,95
28953,2014-04-30,19,2,158,160
28954,2014-04-30,20,4,202,206
28955,2014-04-30,21,4,146,150
28956,2014-04-30,22,3,122,125
28957,2014-04-30,23,0,74,74
28958,2014-05-01,0,0,35,35
28959,2014-05-01,1,0,11,11
28960,2014-05-01,2,1,3,4
28961,2014-05-01,3,0,4,4
28962,2014-05-01,4,1,5,6
28963,2014-05-01,5,1,37,38
28964,2014-05-01,6,3,176,179
28965,2014-05-01,7,16,480,496
28966,2014-05-01,8,25,856,881
28967,2014-05-01,9,36,434,470
28968,2014-05-01,10,55,247,302
28969,2014-05-01,11,71,248,319
28970,2014-05-01,12,99,335,434
28971,2014-05-01,13,108,335,443
28972,2014-05-01,14,94,278,372
28973,2014-05-01,15,116,285,401
28974,2014-05-01,16,111,521,632
28975,2014-05-01,17,134,1024,1158
28976,2014-05-01,18,136,1059,1195
28977,2014-05-01,19,105,685,790
28978,2014-05-01,20,65,521,586
28979,2014-05-01,21,52,335,387
28980,2014-05-01,22,25,219,244
28981,2014-05-01,23,18,172,190
28982,2014-05-02,0,5,74,79
28983,2014-05-02,1,4,32,36
28984,2014-05-02,2,3,24,27
28985,2014-05-02,3,0,5,5
28986,2014-05-02,4,0,7,7
28987,2014-05-02,5,1,66,67
28988,2014-05-02,6,3,156,159
28989,2014-05-02,7,22,531,553
28990,2014-05-02,8,40,965,1005
28991,2014-05-02,9,72,453,525
28992,2014-05-02,10,103,214,317
28993,2014-05-02,11,137,271,408
28994,2014-05-02,12,134,387,521
28995,2014-05-02,13,149,360,509
28996,2014-05-02,14,175,331,506
28997,2014-05-02,15,160,374,534
28998,2014-05-02,16,148,610,758
28999,2014-05-02,17,158,1019,1177
29000,2014-05-02,18,148,877,1025
29001,2014-05-02,19,151,568,719
29002,2014-05-02,20,105,381,486
29003,2014-05-02,21,65,306,371
29004,2014-05-02,22,52,265,317
29005,2014-05-02,23,45,177,222
29006,2014-05-03,0,25,151,176
29007,2014-05-03,1,18,77,95
29008,2014-05-03,2,10,68,78
29009,2014-05-03,3,3,22,25
29010,2014-05-03,4,3,7,10
29011,2014-05-03,5,7,9,16
29012,2014-05-03,6,2,39,41
29013,2014-05-03,7,21,113,134
29014,2014-05-03,8,35,229,264
29015,2014-05-03,9,134,410,544
29016,2014-05-03,10,237,415,652
29017,2014-05-03,11,300,486,786
29018,2014-05-03,12,382,540,922
29019,2014-05-03,13,425,555,980
29020,2014-05-03,14,446,516,962
29021,2014-05-03,15,458,486,944
29022,2014-05-03,16,421,527,948
29023,2014-05-03,17,402,520,922
29024,2014-05-03,18,284,429,713
29025,2014-05-03,19,225,402,627
29026,2014-05-03,20,115,303,418
29027,2014-05-03,21,113,264,377
29028,2014-05-03,22,91,225,316
29029,2014-05-03,23,51,179,230
29030,2014-05-04,0,46,135,181
29031,2014-05-04,1,13,102,115
29032,2014-05-04,2,12,59,71
29033,2014-05-04,3,2,29,31
29034,2014-05-04,4,5,7,12
29035,2014-05-04,5,3,3,6
29036,2014-05-04,6,7,16,23
29037,2014-05-04,7,21,81,102
29038,2014-05-04,8,65,167,232
29039,2014-05-04,9,154,274,428
29040,2014-05-04,10,273,469,742
29041,2014-05-04,11,365,507,872
29042,2014-05-04,12,436,554,990
29043,2014-05-04,13,363,597,960
29044,2014-05-04,14,373,513,886
29045,2014-05-04,15,347,512,859
29046,2014-05-04,16,347,528,875
29047,2014-05-04,17,315,539,854
29048,2014-05-04,18,244,504,748
29049,2014-05-04,19,158,414,572
29050,2014-05-04,20,101,282,383
29051,2014-05-04,21,75,167,242
29052,2014-05-04,22,54,165,219
29053,2014-05-04,23,29,75,104
29054,2014-05-05,0,9,25,34
29055,2014-05-05,1,4,8,12
29056,2014-05-05,2,0,2,2
29057,2014-05-05,3,0,3,3
29058,2014-05-05,4,0,3,3
29059,2014-05-05,5,2,43,45
29060,2014-05-05,6,8,213,221
29061,2014-05-05,7,41,581,622
29062,2014-05-05,8,30,898,928
29063,2014-05-05,9,84,384,468
29064,2014-05-05,10,103,203,306
29065,2014-05-05,11,135,211,346
29066,2014-05-05,12,143,286,429
29067,2014-05-05,13,119,308,427
29068,2014-05-05,14,106,255,361
29069,2014-05-05,15,138,298,436
29070,2014-05-05,16,147,460,607
29071,2014-05-05,17,168,1015,1183
29072,2014-05-05,18,101,927,1028
29073,2014-05-05,19,39,330,369
29074,2014-05-05,20,10,84,94
29075,2014-05-05,21,5,53,58
29076,2014-05-05,22,4,38,42
29077,2014-05-05,23,2,61,63
29078,2014-05-06,0,5,14,19
29079,2014-05-06,1,6,18,24
29080,2014-05-06,2,0,10,10
29081,2014-05-06,3,2,1,3
29082,2014-05-06,4,0,4,4
29083,2014-05-06,5,2,58,60
29084,2014-05-06,6,14,201,215
29085,2014-05-06,7,29,627,656
29086,2014-05-06,8,43,997,1040
29087,2014-05-06,9,55,394,449
29088,2014-05-06,10,88,199,287
29089,2014-05-06,11,82,248,330
29090,2014-05-06,12,101,321,422
29091,2014-05-06,13,114,292,406
29092,2014-05-06,14,133,285,418
29093,2014-05-06,15,119,275,394
29094,2014-05-06,16,164,543,707
29095,2014-05-06,17,233,1150,1383
29096,2014-05-06,18,154,1067,1221
29097,2014-05-06,19,127,692,819
29098,2014-05-06,20,98,502,600
29099,2014-05-06,21,83,356,439
29100,2014-05-06,22,55,268,323
29101,2014-05-06,23,36,137,173
29102,2014-05-07,0,24,50,74
29103,2014-05-07,1,11,22,33
29104,2014-05-07,2,9,6,15
29105,2014-05-07,3,1,1,2
29106,2014-05-07,4,0,3,3
29107,2014-05-07,5,4,74,78
29108,2014-05-07,6,17,240,257
29109,2014-05-07,7,39,673,712
29110,2014-05-07,8,49,1071,1120
29111,2014-05-07,9,63,415,478
29112,2014-05-07,10,63,196,259
29113,2014-05-07,11,75,221,296
29114,2014-05-07,12,16,67,83
29115,2014-05-07,13,18,63,81
29116,2014-05-07,14,44,159,203
29117,2014-05-07,15,60,253,313
29118,2014-05-07,16,66,453,519
29119,2014-05-07,17,85,987,1072
29120,2014-05-07,18,97,956,1053
29121,2014-05-07,19,67,607,674
29122,2014-05-07,20,36,463,499
29123,2014-05-07,21,34,319,353
29124,2014-05-07,22,28,219,247
29125,2014-05-07,23,23,115,138
29126,2014-05-08,0,11,49,60
29127,2014-05-08,1,7,17,24
29128,2014-05-08,2,3,10,13
29129,2014-05-08,3,0,6,6
29130,2014-05-08,4,8,5,13
29131,2014-05-08,5,0,50,50
29132,2014-05-08,6,12,225,237
29133,2014-05-08,7,16,608,624
29134,2014-05-08,8,48,927,975
29135,2014-05-08,9,69,411,480
29136,2014-05-08,10,57,199,256
29137,2014-05-08,11,92,241,333
29138,2014-05-08,12,103,345,448
29139,2014-05-08,13,127,309,436
29140,2014-05-08,14,134,258,392
29141,2014-05-08,15,101,317,418
29142,2014-05-08,16,108,529,637
29143,2014-05-08,17,149,1139,1288
29144,2014-05-08,18,138,1076,1214
29145,2014-05-08,19,127,757,884
29146,2014-05-08,20,91,498,589
29147,2014-05-08,21,53,398,451
29148,2014-05-08,22,72,292,364
29149,2014-05-08,23,33,177,210
29150,2014-05-09,0,24,78,102
29151,2014-05-09,1,9,42,51
29152,2014-05-09,2,7,14,21
29153,2014-05-09,3,2,10,12
29154,2014-05-09,4,0,8,8
29155,2014-05-09,5,1,49,50
29156,2014-05-09,6,12,208,220
29157,2014-05-09,7,14,541,555
29158,2014-05-09,8,36,926,962
29159,2014-05-09,9,59,407,466
29160,2014-05-09,10,90,199,289
29161,2014-05-09,11,149,279,428
29162,2014-05-09,12,183,396,579
29163,2014-05-09,13,167,356,523
29164,2014-05-09,14,185,357,542
29165,2014-05-09,15,226,430,656
29166,2014-05-09,16,194,566,760
29167,2014-05-09,17,193,975,1168
29168,2014-05-09,18,135,859,994
29169,2014-05-09,19,88,547,635
29170,2014-05-09,20,80,383,463
29171,2014-05-09,21,61,304,365
29172,2014-05-09,22,50,270,320
29173,2014-05-09,23,42,198,240
29174,2014-05-10,0,10,148,158
29175,2014-05-10,1,12,112,124
29176,2014-05-10,2,11,62,73
29177,2014-05-10,3,12,25,37
29178,2014-05-10,4,3,12,15
29179,2014-05-10,5,2,15,17
29180,2014-05-10,6,7,47,54
29181,2014-05-10,7,18,119,137
29182,2014-05-10,8,44,247,291
29183,2014-05-10,9,106,365,471
29184,2014-05-10,10,262,461,723
29185,2014-05-10,11,265,473,738
29186,2014-05-10,12,215,405,620
29187,2014-05-10,13,125,246,371
29188,2014-05-10,14,190,375,565
29189,2014-05-10,15,224,345,569
29190,2014-05-10,16,174,222,396
29191,2014-05-10,17,204,367,571
29192,2014-05-10,18,247,384,631
29193,2014-05-10,19,180,380,560
29194,2014-05-10,20,86,239,325
29195,2014-05-10,21,58,233,291
29196,2014-05-10,22,58,201,259
29197,2014-05-10,23,73,159,232
29198,2014-05-11,0,23,118,141
29199,2014-05-11,1,24,112,136
29200,2014-05-11,2,13,104,117
29201,2014-05-11,3,9,38,47
29202,2014-05-11,4,2,9,11
29203,2014-05-11,5,0,11,11
29204,2014-05-11,6,7,27,34
29205,2014-05-11,7,22,78,100
29206,2014-05-11,8,71,177,248
29207,2014-05-11,9,127,313,440
29208,2014-05-11,10,230,425,655
29209,2014-05-11,11,286,504,790
29210,2014-05-11,12,354,529,883
29211,2014-05-11,13,423,518,941
29212,2014-05-11,14,405,505,910
29213,2014-05-11,15,463,517,980
29214,2014-05-11,16,385,549,934
29215,2014-05-11,17,371,501,872
29216,2014-05-11,18,259,522,781
29217,2014-05-11,19,220,449,669
29218,2014-05-11,20,168,331,499
29219,2014-05-11,21,142,190,332
29220,2014-05-11,22,76,178,254
29221,2014-05-11,23,42,142,184
29222,2014-05-12,0,17,33,50
29223,2014-05-12,1,7,16,23
29224,2014-05-12,2,1,12,13
29225,2014-05-12,3,2,7,9
29226,2014-05-12,4,0,7,7
29227,2014-05-12,5,0,61,61
29228,2014-05-12,6,4,224,228
29229,2014-05-12,7,23,625,648
29230,2014-05-12,8,64,892,956
29231,2014-05-12,9,83,377,460
29232,2014-05-12,10,116,186,302
29233,2014-05-12,11,145,219,364
29234,2014-05-12,12,154,289,443
29235,2014-05-12,13,154,272,426
29236,2014-05-12,14,151,243,394
29237,2014-05-12,15,123,279,402
29238,2014-05-12,16,158,493,651
29239,2014-05-12,17,162,1012,1174
29240,2014-05-12,18,121,1001,1122
29241,2014-05-12,19,123,631,754
29242,2014-05-12,20,51,268,319
29243,2014-05-12,21,31,272,303
29244,2014-05-12,22,29,183,212
29245,2014-05-12,23,16,95,111
29246,2014-05-13,0,8,31,39
29247,2014-05-13,1,13,13,26
29248,2014-05-13,2,9,11,20
29249,2014-05-13,3,0,4,4
29250,2014-05-13,4,0,9,9
29251,2014-05-13,5,1,76,77
29252,2014-05-13,6,6,262,268
29253,2014-05-13,7,29,722,751
29254,2014-05-13,8,48,925,973
29255,2014-05-13,9,62,400,462
29256,2014-05-13,10,104,171,275
29257,2014-05-13,11,97,205,302
29258,2014-05-13,12,128,296,424
29259,2014-05-13,13,186,326,512
29260,2014-05-13,14,127,213,340
29261,2014-05-13,15,119,243,362
29262,2014-05-13,16,127,474,601
29263,2014-05-13,17,145,1046,1191
29264,2014-05-13,18,159,993,1152
29265,2014-05-13,19,115,719,834
29266,2014-05-13,20,93,475,568
29267,2014-05-13,21,30,333,363
29268,2014-05-13,22,31,227,258
29269,2014-05-13,23,22,97,119
29270,2014-05-14,0,5,48,53
29271,2014-05-14,1,7,27,34
29272,2014-05-14,2,2,10,12
29273,2014-05-14,3,0,3,3
29274,2014-05-14,4,1,7,8
29275,2014-05-14,5,3,61,64
29276,2014-05-14,6,9,237,246
29277,2014-05-14,7,29,620,649
29278,2014-05-14,8,57,928,985
29279,2014-05-14,9,61,446,507
29280,2014-05-14,10,94,205,299
29281,2014-05-14,11,106,221,327
29282,2014-05-14,12,109,282,391
29283,2014-05-14,13,132,299,431
29284,2014-05-14,14,147,280,427
29285,2014-05-14,15,114,299,413
29286,2014-05-14,16,143,520,663
29287,2014-05-14,17,142,1052,1194
29288,2014-05-14,18,123,961,1084
29289,2014-05-14,19,92,603,695
29290,2014-05-14,20,55,434,489
29291,2014-05-14,21,53,288,341
29292,2014-05-14,22,28,240,268
29293,2014-05-14,23,20,117,137
29294,2014-05-15,0,6,32,38
29295,2014-05-15,1,16,27,43
29296,2014-05-15,2,4,12,16
29297,2014-05-15,3,14,2,16
29298,2014-05-15,4,2,7,9
29299,2014-05-15,5,1,48,49
29300,2014-05-15,6,15,260,275
29301,2014-05-15,7,26,682,708
29302,2014-05-15,8,47,983,1030
29303,2014-05-15,9,47,441,488
29304,2014-05-15,10,98,191,289
29305,2014-05-15,11,125,239,364
29306,2014-05-15,12,94,291,385
29307,2014-05-15,13,119,294,413
29308,2014-05-15,14,154,251,405
29309,2014-05-15,15,140,329,469
29310,2014-05-15,16,146,577,723
29311,2014-05-15,17,167,1036,1203
29312,2014-05-15,18,105,773,878
29313,2014-05-15,19,71,563,634
29314,2014-05-15,20,57,370,427
29315,2014-05-15,21,36,307,343
29316,2014-05-15,22,13,85,98
29317,2014-05-15,23,13,83,96
29318,2014-05-16,0,0,37,37
29319,2014-05-16,1,0,7,7
29320,2014-05-16,2,1,4,5
29321,2014-05-16,3,0,4,4
29322,2014-05-16,4,0,3,3
29323,2014-05-16,5,0,14,14
29324,2014-05-16,6,2,23,25
29325,2014-05-16,7,9,90,99
29326,2014-05-16,8,8,161,169
29327,2014-05-16,9,26,317,343
29328,2014-05-16,10,21,187,208
29329,2014-05-16,11,54,233,287
29330,2014-05-16,12,103,337,440
29331,2014-05-16,13,143,337,480
29332,2014-05-16,14,122,340,462
29333,2014-05-16,15,175,357,532
29334,2014-05-16,16,199,578,777
29335,2014-05-16,17,173,943,1116
29336,2014-05-16,18,158,820,978
29337,2014-05-16,19,97,575,672
29338,2014-05-16,20,99,400,499
29339,2014-05-16,21,79,318,397
29340,2014-05-16,22,46,214,260
29341,2014-05-16,23,33,186,219
29342,2014-05-17,0,26,109,135
29343,2014-05-17,1,17,104,121
29344,2014-05-17,2,12,71,83
29345,2014-05-17,3,5,25,30
29346,2014-05-17,4,7,10,17
29347,2014-05-17,5,1,12,13
29348,2014-05-17,6,5,37,42
29349,2014-05-17,7,16,105,121
29350,2014-05-17,8,57,226,283
29351,2014-05-17,9,125,320,445
29352,2014-05-17,10,197,405,602
29353,2014-05-17,11,303,461,764
29354,2014-05-17,12,372,550,922
29355,2014-05-17,13,433,549,982
29356,2014-05-17,14,450,539,989
29357,2014-05-17,15,484,562,1046
29358,2014-05-17,16,416,508,924
29359,2014-05-17,17,386,466,852
29360,2014-05-17,18,292,469,761
29361,2014-05-17,19,214,433,647
29362,2014-05-17,20,160,297,457
29363,2014-05-17,21,127,282,409
29364,2014-05-17,22,89,235,324
29365,2014-05-17,23,57,175,232
29366,2014-05-18,0,29,144,173
29367,2014-05-18,1,17,115,132
29368,2014-05-18,2,12,79,91
29369,2014-05-18,3,10,49,59
29370,2014-05-18,4,4,11,15
29371,2014-05-18,5,9,12,21
29372,2014-05-18,6,4,28,32
29373,2014-05-18,7,19,78,97
29374,2014-05-18,8,48,171,219
29375,2014-05-18,9,131,286,417
29376,2014-05-18,10,208,423,631
29377,2014-05-18,11,316,458,774
29378,2014-05-18,12,344,617,961
29379,2014-05-18,13,400,561,961
29380,2014-05-18,14,371,515,886
29381,2014-05-18,15,382,478,860
29382,2014-05-18,16,326,523,849
29383,2014-05-18,17,329,498,827
29384,2014-05-18,18,200,469,669
29385,2014-05-18,19,157,360,517
29386,2014-05-18,20,100,303,403
29387,2014-05-18,21,89,189,278
29388,2014-05-18,22,71,152,223
29389,2014-05-18,23,32,79,111
29390,2014-05-19,0,13,33,46
29391,2014-05-19,1,1,10,11
29392,2014-05-19,2,4,8,12
29393,2014-05-19,3,0,2,2
29394,2014-05-19,4,0,7,7
29395,2014-05-19,5,8,54,62
29396,2014-05-19,6,10,202,212
29397,2014-05-19,7,40,636,676
29398,2014-05-19,8,48,846,894
29399,2014-05-19,9,84,334,418
29400,2014-05-19,10,159,203,362
29401,2014-05-19,11,173,215,388
29402,2014-05-19,12,146,318,464
29403,2014-05-19,13,172,327,499
29404,2014-05-19,14,195,292,487
29405,2014-05-19,15,171,334,505
29406,2014-05-19,16,171,526,697
29407,2014-05-19,17,229,1098,1327
29408,2014-05-19,18,163,999,1162
29409,2014-05-19,19,130,667,797
29410,2014-05-19,20,80,498,578
29411,2014-05-19,21,67,360,427
29412,2014-05-19,22,41,209,250
29413,2014-05-19,23,34,116,150
29414,2014-05-20,0,16,48,64
29415,2014-05-20,1,3,17,20
29416,2014-05-20,2,0,6,6
29417,2014-05-20,3,2,6,8
29418,2014-05-20,4,0,5,5
29419,2014-05-20,5,4,69,73
29420,2014-05-20,6,13,245,258
29421,2014-05-20,7,28,716,744
29422,2014-05-20,8,50,1036,1086
29423,2014-05-20,9,65,407,472
29424,2014-05-20,10,100,179,279
29425,2014-05-20,11,129,204,333
29426,2014-05-20,12,146,342,488
29427,2014-05-20,13,158,336,494
29428,2014-05-20,14,117,297,414
29429,2014-05-20,15,130,321,451
29430,2014-05-20,16,173,560,733
29431,2014-05-20,17,217,1054,1271
29432,2014-05-20,18,194,1025,1219
29433,2014-05-20,19,170,648,818
29434,2014-05-20,20,137,485,622
29435,2014-05-20,21,107,382,489
29436,2014-05-20,22,81,264,345
29437,2014-05-20,23,27,128,155
29438,2014-05-21,0,17,49,66
29439,2014-05-21,1,6,11,17
29440,2014-05-21,2,4,9,13
29441,2014-05-21,3,0,4,4
29442,2014-05-21,4,5,9,14
29443,2014-05-21,5,2,66,68
29444,2014-05-21,6,15,250,265
29445,2014-05-21,7,33,680,713
29446,2014-05-21,8,48,941,989
29447,2014-05-21,9,58,432,490
29448,2014-05-21,10,58,213,271
29449,2014-05-21,11,100,237,337
29450,2014-05-21,12,104,279,383
29451,2014-05-21,13,111,306,417
29452,2014-05-21,14,93,275,368
29453,2014-05-21,15,119,363,482
29454,2014-05-21,16,138,530,668
29455,2014-05-21,17,116,744,860
29456,2014-05-21,18,50,437,487
29457,2014-05-21,19,75,479,554
29458,2014-05-21,20,69,453,522
29459,2014-05-21,21,32,193,225
29460,2014-05-21,22,32,155,187
29461,2014-05-21,23,16,86,102
29462,2014-05-22,0,8,48,56
29463,2014-05-22,1,22,17,39
29464,2014-05-22,2,6,14,20
29465,2014-05-22,3,0,7,7
29466,2014-05-22,4,0,9,9
29467,2014-05-22,5,0,47,47
29468,2014-05-22,6,7,153,160
29469,2014-05-22,7,25,555,580
29470,2014-05-22,8,45,990,1035
29471,2014-05-22,9,65,432,497
29472,2014-05-22,10,119,215,334
29473,2014-05-22,11,157,226,383
29474,2014-05-22,12,166,340,506
29475,2014-05-22,13,126,321,447
29476,2014-05-22,14,104,285,389
29477,2014-05-22,15,116,318,434
29478,2014-05-22,16,164,498,662
29479,2014-05-22,17,149,1059,1208
29480,2014-05-22,18,148,960,1108
29481,2014-05-22,19,134,646,780
29482,2014-05-22,20,102,511,613
29483,2014-05-22,21,84,400,484
29484,2014-05-22,22,56,278,334
29485,2014-05-22,23,42,152,194
29486,2014-05-23,0,36,76,112
29487,2014-05-23,1,15,46,61
29488,2014-05-23,2,6,19,25
29489,2014-05-23,3,5,10,15
29490,2014-05-23,4,1,6,7
29491,2014-05-23,5,0,53,53
29492,2014-05-23,6,5,172,177
29493,2014-05-23,7,28,553,581
29494,2014-05-23,8,63,840,903
29495,2014-05-23,9,88,459,547
29496,2014-05-23,10,112,245,357
29497,2014-05-23,11,156,303,459
29498,2014-05-23,12,185,352,537
29499,2014-05-23,13,165,395,560
29500,2014-05-23,14,179,475,654
29501,2014-05-23,15,229,619,848
29502,2014-05-23,16,195,661,856
29503,2014-05-23,17,197,753,950
29504,2014-05-23,18,148,664,812
29505,2014-05-23,19,146,559,705
29506,2014-05-23,20,84,350,434
29507,2014-05-23,21,57,243,300
29508,2014-05-23,22,46,193,239
29509,2014-05-23,23,31,174,205
29510,2014-05-24,0,22,95,117
29511,2014-05-24,1,7,72,79
29512,2014-05-24,2,5,36,41
29513,2014-05-24,3,16,11,27
29514,2014-05-24,4,0,12,12
29515,2014-05-24,5,7,9,16
29516,2014-05-24,6,11,34,45
29517,2014-05-24,7,21,82,103
29518,2014-05-24,8,54,162,216
29519,2014-05-24,9,132,291,423
29520,2014-05-24,10,231,317,548
29521,2014-05-24,11,369,377,746
29522,2014-05-24,12,509,404,913
29523,2014-05-24,13,485,437,922
29524,2014-05-24,14,524,417,941
29525,2014-05-24,15,526,400,926
29526,2014-05-24,16,479,372,851
29527,2014-05-24,17,449,376,825
29528,2014-05-24,18,438,361,799
29529,2014-05-24,19,323,307,630
29530,2014-05-24,20,225,279,504
29531,2014-05-24,21,136,206,342
29532,2014-05-24,22,110,189,299
29533,2014-05-24,23,63,136,199
29534,2014-05-25,0,39,107,146
29535,2014-05-25,1,23,62,85
29536,2014-05-25,2,7,36,43
29537,2014-05-25,3,1,18,19
29538,2014-05-25,4,4,8,12
29539,2014-05-25,5,1,7,8
29540,2014-05-25,6,10,21,31
29541,2014-05-25,7,32,54,86
29542,2014-05-25,8,105,135,240
29543,2014-05-25,9,263,245,508
29544,2014-05-25,10,408,317,725
29545,2014-05-25,11,531,381,912
29546,2014-05-25,12,507,445,952
29547,2014-05-25,13,561,432,993
29548,2014-05-25,14,564,443,1007
29549,2014-05-25,15,638,409,1047
29550,2014-05-25,16,645,368,1013
29551,2014-05-25,17,499,370,869
29552,2014-05-25,18,519,341,860
29553,2014-05-25,19,434,346,780
29554,2014-05-25,20,320,255,575
29555,2014-05-25,21,278,240,518
29556,2014-05-25,22,207,159,366
29557,2014-05-25,23,144,143,287
29558,2014-05-26,0,76,116,192
29559,2014-05-26,1,48,70,118
29560,2014-05-26,2,13,44,57
29561,2014-05-26,3,1,16,17
29562,2014-05-26,4,1,8,9
29563,2014-05-26,5,2,18,20
29564,2014-05-26,6,16,27,43
29565,2014-05-26,7,36,60,96
29566,2014-05-26,8,85,109,194
29567,2014-05-26,9,224,212,436
29568,2014-05-26,10,389,320,709
29569,2014-05-26,11,468,378,846
29570,2014-05-26,12,474,483,957
29571,2014-05-26,13,507,474,981
29572,2014-05-26,14,425,410,835
29573,2014-05-26,15,506,393,899
29574,2014-05-26,16,415,485,900
29575,2014-05-26,17,331,426,757
29576,2014-05-26,18,338,390,728
29577,2014-05-26,19,243,379,622
29578,2014-05-26,20,181,357,538
29579,2014-05-26,21,156,262,418
29580,2014-05-26,22,46,123,169
29581,2014-05-26,23,48,99,147
29582,2014-05-27,0,13,26,39
29583,2014-05-27,1,5,25,30
29584,2014-05-27,2,1,9,10
29585,2014-05-27,3,1,5,6
29586,2014-05-27,4,1,6,7
29587,2014-05-27,5,4,54,58
29588,2014-05-27,6,11,238,249
29589,2014-05-27,7,35,667,702
29590,2014-05-27,8,71,896,967
29591,2014-05-27,9,94,400,494
29592,2014-05-27,10,135,176,311
29593,2014-05-27,11,184,220,404
29594,2014-05-27,12,159,285,444
29595,2014-05-27,13,106,306,412
29596,2014-05-27,14,138,229,367
29597,2014-05-27,15,141,300,441
29598,2014-05-27,16,141,475,616
29599,2014-05-27,17,202,1070,1272
29600,2014-05-27,18,86,536,622
29601,2014-05-27,19,22,66,88
29602,2014-05-27,20,22,196,218
29603,2014-05-27,21,33,209,242
29604,2014-05-27,22,18,125,143
29605,2014-05-27,23,8,70,78
29606,2014-05-28,0,3,25,28
29607,2014-05-28,1,0,11,11
29608,2014-05-28,2,0,8,8
29609,2014-05-28,3,6,1,7
29610,2014-05-28,4,2,9,11
29611,2014-05-28,5,3,58,61
29612,2014-05-28,6,10,264,274
29613,2014-05-28,7,36,735,771
29614,2014-05-28,8,49,901,950
29615,2014-05-28,9,55,415,470
29616,2014-05-28,10,100,200,300
29617,2014-05-28,11,146,212,358
29618,2014-05-28,12,113,317,430
29619,2014-05-28,13,130,300,430
29620,2014-05-28,14,107,268,375
29621,2014-05-28,15,80,295,375
29622,2014-05-28,16,114,432,546
29623,2014-05-28,17,153,1065,1218
29624,2014-05-28,18,124,1040,1164
29625,2014-05-28,19,105,712,817
29626,2014-05-28,20,66,529,595
29627,2014-05-28,21,36,289,325
29628,2014-05-28,22,34,216,250
29629,2014-05-28,23,25,123,148
29630,2014-05-29,0,11,41,52
29631,2014-05-29,1,1,16,17
29632,2014-05-29,2,1,3,4
29633,2014-05-29,4,0,5,5
29634,2014-05-29,5,4,46,50
29635,2014-05-29,6,15,134,149
29636,2014-05-29,7,28,337,365
29637,2014-05-29,8,31,718,749
29638,2014-05-29,9,50,373,423
29639,2014-05-29,10,33,185,218
29640,2014-05-29,11,51,168,219
29641,2014-05-29,12,40,186,226
29642,2014-05-29,13,25,120,145
29643,2014-05-29,14,25,77,102
29644,2014-05-29,15,11,53,64
29645,2014-05-29,16,29,109,138
29646,2014-05-29,17,28,438,466
29647,2014-05-29,18,34,482,516
29648,2014-05-29,19,49,481,530
29649,2014-05-29,20,28,329,357
29650,2014-05-29,21,36,259,295
29651,2014-05-29,22,12,135,147
29652,2014-05-29,23,5,63,68
29653,2014-05-30,0,1,47,48
29654,2014-05-30,1,3,16,19
29655,2014-05-30,2,2,7,9
29656,2014-05-30,3,1,3,4
29657,2014-05-30,4,0,6,6
29658,2014-05-30,5,4,48,52
29659,2014-05-30,6,8,173,181
29660,2014-05-30,7,20,557,577
29661,2014-05-30,8,31,915,946
29662,2014-05-30,9,51,430,481
29663,2014-05-30,10,90,220,310
29664,2014-05-30,11,142,274,416
29665,2014-05-30,12,155,378,533
29666,2014-05-30,13,157,370,527
29667,2014-05-30,14,173,348,521
29668,2014-05-30,15,175,366,541
29669,2014-05-30,16,171,645,816
29670,2014-05-30,17,190,1056,1246
29671,2014-05-30,18,168,907,1075
29672,2014-05-30,19,150,650,800
29673,2014-05-30,20,98,447,545
29674,2014-05-30,21,68,393,461
29675,2014-05-30,22,82,328,410
29676,2014-05-30,23,74,207,281
29677,2014-05-31,0,44,153,197
29678,2014-05-31,1,21,113,134
29679,2014-05-31,2,23,82,105
29680,2014-05-31,3,7,43,50
29681,2014-05-31,4,1,17,18
29682,2014-05-31,5,3,10,13
29683,2014-05-31,6,11,42,53
29684,2014-05-31,7,20,110,130
29685,2014-05-31,8,60,248,308
29686,2014-05-31,9,130,368,498
29687,2014-05-31,10,233,501,734
29688,2014-05-31,11,264,551,815
29689,2014-05-31,12,385,547,932
29690,2014-05-31,13,408,579,987
29691,2014-05-31,14,504,558,1062
29692,2014-05-31,15,456,602,1058
29693,2014-05-31,16,398,526,924
29694,2014-05-31,17,427,533,960
29695,2014-05-31,18,370,481,851
29696,2014-05-31,19,261,416,677
29697,2014-05-31,20,193,374,567
29698,2014-05-31,21,151,274,425
29699,2014-05-31,22,107,235,342
29700,2014-05-31,23,49,185,234
29701,2014-06-01,0,32,177,209
29702,2014-06-01,1,18,93,111
29703,2014-06-01,2,15,76,91
29704,2014-06-01,3,18,36,54
29705,2014-06-01,4,8,8,16
29706,2014-06-01,5,0,10,10
29707,2014-06-01,6,12,19,31
29708,2014-06-01,7,28,66,94
29709,2014-06-01,8,75,158,233
29710,2014-06-01,9,166,305,471
29711,2014-06-01,10,206,475,681
29712,2014-06-01,11,268,539,807
29713,2014-06-01,12,363,581,944
29714,2014-06-01,13,384,579,963
29715,2014-06-01,14,402,524,926
29716,2014-06-01,15,333,548,881
29717,2014-06-01,16,342,602,944
29718,2014-06-01,17,308,554,862
29719,2014-06-01,18,242,516,758
29720,2014-06-01,19,193,440,633
29721,2014-06-01,20,177,353,530
29722,2014-06-01,21,99,237,336
29723,2014-06-01,22,66,162,228
29724,2014-06-01,23,29,88,117
29725,2014-06-02,0,17,26,43
29726,2014-06-02,1,3,8,11
29727,2014-06-02,2,9,10,19
29728,2014-06-02,3,1,2,3
29729,2014-06-02,4,1,5,6
29730,2014-06-02,5,3,70,73
29731,2014-06-02,6,12,253,265
29732,2014-06-02,7,33,671,704
29733,2014-06-02,8,57,953,1010
29734,2014-06-02,9,72,375,447
29735,2014-06-02,10,109,175,284
29736,2014-06-02,11,144,210,354
29737,2014-06-02,12,164,317,481
29738,2014-06-02,13,135,303,438
29739,2014-06-02,14,152,282,434
29740,2014-06-02,15,141,309,450
29741,2014-06-02,16,142,510,652
29742,2014-06-02,17,181,1155,1336
29743,2014-06-02,18,174,1070,1244
29744,2014-06-02,19,117,673,790
29745,2014-06-02,20,66,451,517
29746,2014-06-02,21,58,370,428
29747,2014-06-02,22,40,199,239
29748,2014-06-02,23,32,94,126
29749,2014-06-03,0,23,36,59
29750,2014-06-03,1,1,15,16
29751,2014-06-03,2,1,11,12
29752,2014-06-03,3,0,3,3
29753,2014-06-03,4,1,5,6
29754,2014-06-03,5,3,65,68
29755,2014-06-03,6,19,286,305
29756,2014-06-03,7,26,784,810
29757,2014-06-03,8,53,1017,1070
29758,2014-06-03,9,60,423,483
29759,2014-06-03,10,97,211,308
29760,2014-06-03,11,109,257,366
29761,2014-06-03,12,97,336,433
29762,2014-06-03,13,83,185,268
29763,2014-06-03,14,66,137,203
29764,2014-06-03,15,107,283,390
29765,2014-06-03,16,118,493,611
29766,2014-06-03,17,160,1085,1245
29767,2014-06-03,18,169,1104,1273
29768,2014-06-03,19,113,692,805
29769,2014-06-03,20,109,488,597
29770,2014-06-03,21,85,427,512
29771,2014-06-03,22,80,281,361
29772,2014-06-03,23,36,126,162
29773,2014-06-04,0,15,69,84
29774,2014-06-04,1,0,18,18
29775,2014-06-04,2,0,6,6
29776,2014-06-04,3,3,4,7
29777,2014-06-04,4,7,4,11
29778,2014-06-04,5,9,67,76
29779,2014-06-04,6,20,285,305
29780,2014-06-04,7,38,772,810
29781,2014-06-04,8,48,1004,1052
29782,2014-06-04,9,69,479,548
29783,2014-06-04,10,96,211,307
29784,2014-06-04,11,112,239,351
29785,2014-06-04,12,96,305,401
29786,2014-06-04,13,110,269,379
29787,2014-06-04,14,132,297,429
29788,2014-06-04,15,108,315,423
29789,2014-06-04,16,121,561,682
29790,2014-06-04,17,147,1162,1309
29791,2014-06-04,18,142,1084,1226
29792,2014-06-04,19,121,691,812
29793,2014-06-04,20,66,462,528
29794,2014-06-04,21,22,173,195
29795,2014-06-04,22,9,88,97
29796,2014-06-04,23,18,92,110
29797,2014-06-05,0,9,31,40
29798,2014-06-05,1,5,14,19
29799,2014-06-05,2,6,5,11
29800,2014-06-05,3,3,1,4
29801,2014-06-05,4,0,8,8
29802,2014-06-05,5,2,44,46
29803,2014-06-05,6,9,243,252
29804,2014-06-05,7,29,588,617
29805,2014-06-05,8,42,982,1024
29806,2014-06-05,9,51,471,522
29807,2014-06-05,10,69,200,269
29808,2014-06-05,11,84,253,337
29809,2014-06-05,12,97,348,445
29810,2014-06-05,13,91,328,419
29811,2014-06-05,14,119,295,414
29812,2014-06-05,15,113,397,510
29813,2014-06-05,16,111,563,674
29814,2014-06-05,17,168,1086,1254
29815,2014-06-05,18,138,1067,1205
29816,2014-06-05,19,119,743,862
29817,2014-06-05,20,121,615,736
29818,2014-06-05,21,68,452,520
29819,2014-06-05,22,41,294,335
29820,2014-06-05,23,23,191,214
29821,2014-06-06,0,16,92,108
29822,2014-06-06,1,3,39,42
29823,2014-06-06,2,3,14,17
29824,2014-06-06,3,2,4,6
29825,2014-06-06,4,2,3,5
29826,2014-06-06,5,6,57,63
29827,2014-06-06,6,9,227,236
29828,2014-06-06,7,38,682,720
29829,2014-06-06,8,64,987,1051
29830,2014-06-06,9,85,518,603
29831,2014-06-06,10,74,264,338
29832,2014-06-06,11,113,283,396
29833,2014-06-06,12,164,388,552
29834,2014-06-06,13,180,408,588
29835,2014-06-06,14,181,424,605
29836,2014-06-06,15,141,428,569
29837,2014-06-06,16,202,712,914
29838,2014-06-06,17,199,1152,1351
29839,2014-06-06,18,151,881,1032
29840,2014-06-06,19,129,674,803
29841,2014-06-06,20,134,483,617
29842,2014-06-06,21,126,326,452
29843,2014-06-06,22,86,323,409
29844,2014-06-06,23,74,256,330
29845,2014-06-07,0,49,159,208
29846,2014-06-07,1,20,126,146
29847,2014-06-07,2,21,90,111
29848,2014-06-07,3,14,39,53
29849,2014-06-07,4,4,11,15
29850,2014-06-07,5,7,16,23
29851,2014-06-07,6,14,42,56
29852,2014-06-07,7,25,116,141
29853,2014-06-07,8,58,218,276
29854,2014-06-07,9,132,373,505
29855,2014-06-07,10,238,479,717
29856,2014-06-07,11,374,568,942
29857,2014-06-07,12,340,586,926
29858,2014-06-07,13,383,607,990
29859,2014-06-07,14,426,578,1004
29860,2014-06-07,15,363,528,891
29861,2014-06-07,16,323,491,814
29862,2014-06-07,17,319,447,766
29863,2014-06-07,18,271,396,667
29864,2014-06-07,19,274,496,770
29865,2014-06-07,20,219,380,599
29866,2014-06-07,21,167,284,451
29867,2014-06-07,22,130,303,433
29868,2014-06-07,23,103,231,334
29869,2014-06-08,0,86,175,261
29870,2014-06-08,1,38,110,148
29871,2014-06-08,2,30,99,129
29872,2014-06-08,3,21,37,58
29873,2014-06-08,4,6,10,16
29874,2014-06-08,5,1,12,13
29875,2014-06-08,6,9,19,28
29876,2014-06-08,7,26,71,97
29877,2014-06-08,8,70,161,231
29878,2014-06-08,9,153,274,427
29879,2014-06-08,10,254,404,658
29880,2014-06-08,11,308,506,814
29881,2014-06-08,12,377,566,943
29882,2014-06-08,13,370,579,949
29883,2014-06-08,14,364,532,896
29884,2014-06-08,15,345,556,901
29885,2014-06-08,16,306,548,854
29886,2014-06-08,17,292,504,796
29887,2014-06-08,18,245,545,790
29888,2014-06-08,19,233,394,627
29889,2014-06-08,20,143,294,437
29890,2014-06-08,21,96,193,289
29891,2014-06-08,22,54,119,173
29892,2014-06-08,23,16,36,52
29893,2014-06-09,0,1,5,6
29894,2014-06-09,1,1,5,6
29895,2014-06-09,2,0,8,8
29896,2014-06-09,3,0,5,5
29897,2014-06-09,4,2,6,8
29898,2014-06-09,5,1,55,56
29899,2014-06-09,6,11,261,272
29900,2014-06-09,7,38,660,698
29901,2014-06-09,8,53,935,988
29902,2014-06-09,9,101,402,503
29903,2014-06-09,10,116,184,300
29904,2014-06-09,11,167,241,408
29905,2014-06-09,12,164,285,449
29906,2014-06-09,13,176,276,452
29907,2014-06-09,14,148,266,414
29908,2014-06-09,15,156,285,441
29909,2014-06-09,16,145,493,638
29910,2014-06-09,17,179,1127,1306
29911,2014-06-09,18,154,1042,1196
29912,2014-06-09,19,141,726,867
29913,2014-06-09,20,97,541,638
29914,2014-06-09,21,76,364,440
29915,2014-06-09,22,52,213,265
29916,2014-06-09,23,25,106,131
29917,2014-06-10,0,8,35,43
29918,2014-06-10,1,1,17,18
29919,2014-06-10,2,3,3,6
29920,2014-06-10,3,3,3,6
29921,2014-06-10,4,0,10,10
29922,2014-06-10,5,7,71,78
29923,2014-06-10,6,15,254,269
29924,2014-06-10,7,41,744,785
29925,2014-06-10,8,42,900,942
29926,2014-06-10,9,39,342,381
29927,2014-06-10,10,66,152,218
29928,2014-06-10,11,93,158,251
29929,2014-06-10,12,78,193,271
29930,2014-06-10,13,63,188,251
29931,2014-06-10,14,108,210,318
29932,2014-06-10,15,104,270,374
29933,2014-06-10,16,117,544,661
29934,2014-06-10,17,163,1069,1232
29935,2014-06-10,18,149,953,1102
29936,2014-06-10,19,106,651,757
29937,2014-06-10,20,72,543,615
29938,2014-06-10,21,96,350,446
29939,2014-06-10,22,66,263,329
29940,2014-06-10,23,30,153,183
29941,2014-06-11,0,23,43,66
29942,2014-06-11,1,6,16,22
29943,2014-06-11,2,4,9,13
29944,2014-06-11,3,1,1,2
29945,2014-06-11,4,1,9,10
29946,2014-06-11,5,2,65,67
29947,2014-06-11,6,8,102,110
29948,2014-06-11,7,20,445,465
29949,2014-06-11,8,39,985,1024
29950,2014-06-11,9,48,443,491
29951,2014-06-11,10,61,244,305
29952,2014-06-11,11,87,256,343
29953,2014-06-11,12,103,326,429
29954,2014-06-11,13,95,304,399
29955,2014-06-11,14,87,242,329
29956,2014-06-11,15,131,321,452
29957,2014-06-11,16,126,525,651
29958,2014-06-11,17,139,1155,1294
29959,2014-06-11,18,108,866,974
29960,2014-06-11,19,66,569,635
29961,2014-06-11,20,38,270,308
29962,2014-06-11,21,9,55,64
29963,2014-06-11,22,2,90,92
29964,2014-06-11,23,9,57,66
29965,2014-06-12,0,2,44,46
29966,2014-06-12,1,2,11,13
29967,2014-06-12,2,4,3,7
29968,2014-06-12,3,0,2,2
29969,2014-06-12,4,1,5,6
29970,2014-06-12,5,1,50,51
29971,2014-06-12,6,11,192,203
29972,2014-06-12,7,17,562,579
29973,2014-06-12,8,39,918,957
29974,2014-06-12,9,45,383,428
29975,2014-06-12,10,60,216,276
29976,2014-06-12,11,84,234,318
29977,2014-06-12,12,94,306,400
29978,2014-06-12,13,82,311,393
29979,2014-06-12,14,87,241,328
29980,2014-06-12,15,65,234,299
29981,2014-06-12,16,55,360,415
29982,2014-06-12,17,115,920,1035
29983,2014-06-12,18,122,973,1095
29984,2014-06-12,19,97,673,770
29985,2014-06-12,20,80,554,634
29986,2014-06-12,21,51,408,459
29987,2014-06-12,22,35,247,282
29988,2014-06-12,23,18,196,214
29989,2014-06-13,0,21,81,102
29990,2014-06-13,1,5,40,45
29991,2014-06-13,2,4,15,19
29992,2014-06-13,3,1,2,3
29993,2014-06-13,4,2,5,7
29994,2014-06-13,5,5,58,63
29995,2014-06-13,6,10,237,247
29996,2014-06-13,7,17,586,603
29997,2014-06-13,8,60,1002,1062
29998,2014-06-13,9,89,511,600
29999,2014-06-13,10,108,245,353
30000,2014-06-13,11,121,272,393
30001,2014-06-13,12,167,363,530
30002,2014-06-13,13,80,219,299
30003,2014-06-13,14,42,134,176
30004,2014-06-13,15,95,335,430
30005,2014-06-13,16,139,484,623
30006,2014-06-13,17,164,1040,1204
30007,2014-06-13,18,85,676,761
30008,2014-06-13,19,98,508,606
30009,2014-06-13,20,67,410,477
30010,2014-06-13,21,55,293,348
30011,2014-06-13,22,50,227,277
30012,2014-06-13,23,36,192,228
30013,2014-06-14,0,26,139,165
30014,2014-06-14,1,18,87,105
30015,2014-06-14,2,13,54,67
30016,2014-06-14,3,3,29,32
30017,2014-06-14,4,4,10,14
30018,2014-06-14,5,3,10,13
30019,2014-06-14,6,15,77,92
30020,2014-06-14,7,34,158,192
30021,2014-06-14,8,77,229,306
30022,2014-06-14,9,138,418,556
30023,2014-06-14,10,205,460,665
30024,2014-06-14,11,333,517,850
30025,2014-06-14,12,333,541,874
30026,2014-06-14,13,366,518,884
30027,2014-06-14,14,438,593,1031
30028,2014-06-14,15,431,544,975
30029,2014-06-14,16,387,533,920
30030,2014-06-14,17,418,603,1021
30031,2014-06-14,18,302,434,736
30032,2014-06-14,19,226,364,590
30033,2014-06-14,20,240,446,686
30034,2014-06-14,21,128,326,454
30035,2014-06-14,22,99,237,336
30036,2014-06-14,23,80,249,329
30037,2014-06-15,0,30,140,170
30038,2014-06-15,1,18,100,118
30039,2014-06-15,2,22,77,99
30040,2014-06-15,3,9,35,44
30041,2014-06-15,4,1,11,12
30042,2014-06-15,5,1,12,13
30043,2014-06-15,6,10,27,37
30044,2014-06-15,7,26,68,94
30045,2014-06-15,8,60,181,241
30046,2014-06-15,9,152,297,449
30047,2014-06-15,10,223,418,641
30048,2014-06-15,11,305,562,867
30049,2014-06-15,12,369,586,955
30050,2014-06-15,13,404,512,916
30051,2014-06-15,14,406,570,976
30052,2014-06-15,15,428,514,942
30053,2014-06-15,16,315,576,891
30054,2014-06-15,17,297,559,856
30055,2014-06-15,18,251,465,716
30056,2014-06-15,19,243,367,610
30057,2014-06-15,20,183,413,596
30058,2014-06-15,21,91,246,337
30059,2014-06-15,22,86,202,288
30060,2014-06-15,23,50,113,163
30061,2014-06-16,0,21,40,61
30062,2014-06-16,1,5,15,20
30063,2014-06-16,2,0,2,2
30064,2014-06-16,3,0,2,2
30065,2014-06-16,4,2,10,12
30066,2014-06-16,5,4,63,67
30067,2014-06-16,6,10,260,270
30068,2014-06-16,7,35,659,694
30069,2014-06-16,8,72,920,992
30070,2014-06-16,9,61,396,457
30071,2014-06-16,10,160,213,373
30072,2014-06-16,11,160,223,383
30073,2014-06-16,12,115,274,389
30074,2014-06-16,13,131,269,400
30075,2014-06-16,14,144,259,403
30076,2014-06-16,15,124,292,416
30077,2014-06-16,16,162,542,704
30078,2014-06-16,17,158,1271,1429
30079,2014-06-16,18,122,881,1003
30080,2014-06-16,19,120,502,622
30081,2014-06-16,20,147,696,843
30082,2014-06-16,21,96,386,482
30083,2014-06-16,22,57,221,278
30084,2014-06-16,23,16,113,129
30085,2014-06-17,0,7,36,43
30086,2014-06-17,1,1,15,16
30087,2014-06-17,2,1,5,6
30088,2014-06-17,3,1,3,4
30089,2014-06-17,4,3,11,14
30090,2014-06-17,5,6,76,82
30091,2014-06-17,6,16,283,299
30092,2014-06-17,7,41,777,818
30093,2014-06-17,8,58,1049,1107
30094,2014-06-17,9,72,394,466
30095,2014-06-17,10,109,192,301
30096,2014-06-17,11,102,207,309
30097,2014-06-17,12,85,269,354
30098,2014-06-17,13,93,227,320
30099,2014-06-17,14,116,260,376
30100,2014-06-17,15,124,276,400
30101,2014-06-17,16,123,481,604
30102,2014-06-17,17,170,1083,1253
30103,2014-06-17,18,153,1033,1186
30104,2014-06-17,19,119,699,818
30105,2014-06-17,20,138,604,742
30106,2014-06-17,21,85,378,463
30107,2014-06-17,22,57,281,338
30108,2014-06-17,23,43,143,186
30109,2014-06-18,0,23,52,75
30110,2014-06-18,1,7,14,21
30111,2014-06-18,2,1,8,9
30112,2014-06-18,3,0,5,5
30113,2014-06-18,4,2,6,8
30114,2014-06-18,5,6,71,77
30115,2014-06-18,6,22,289,311
30116,2014-06-18,7,40,729,769
30117,2014-06-18,8,62,979,1041
30118,2014-06-18,9,59,406,465
30119,2014-06-18,10,82,191,273
30120,2014-06-18,11,79,207,286
30121,2014-06-18,12,86,277,363
30122,2014-06-18,13,117,266,383
30123,2014-06-18,14,85,242,327
30124,2014-06-18,15,134,271,405
30125,2014-06-18,16,79,469,548
30126,2014-06-18,17,128,1009,1137
30127,2014-06-18,18,144,955,1099
30128,2014-06-18,19,110,653,763
30129,2014-06-18,20,104,517,621
30130,2014-06-18,21,84,410,494
30131,2014-06-18,22,46,258,304
30132,2014-06-18,23,36,171,207
30133,2014-06-19,0,8,52,60
30134,2014-06-19,1,0,15,15
30135,2014-06-19,2,2,10,12
30136,2014-06-19,3,0,2,2
30137,2014-06-19,4,0,7,7
30138,2014-06-19,5,5,60,65
30139,2014-06-19,6,17,260,277
30140,2014-06-19,7,26,725,751
30141,2014-06-19,8,57,1006,1063
30142,2014-06-19,9,57,407,464
30143,2014-06-19,10,70,196,266
30144,2014-06-19,11,106,229,335
30145,2014-06-19,12,121,307,428
30146,2014-06-19,13,134,284,418
30147,2014-06-19,14,112,274,386
30148,2014-06-19,15,136,321,457
30149,2014-06-19,16,145,492,637
30150,2014-06-19,17,125,1113,1238
30151,2014-06-19,18,123,927,1050
30152,2014-06-19,19,156,653,809
30153,2014-06-19,20,137,500,637
30154,2014-06-19,21,80,389,469
30155,2014-06-19,22,70,310,380
30156,2014-06-19,23,30,168,198
30157,2014-06-20,0,22,66,88
30158,2014-06-20,1,10,36,46
30159,2014-06-20,2,2,24,26
30160,2014-06-20,3,0,7,7
30161,2014-06-20,4,0,12,12
30162,2014-06-20,5,7,55,62
30163,2014-06-20,6,17,241,258
30164,2014-06-20,7,37,661,698
30165,2014-06-20,8,58,954,1012
30166,2014-06-20,9,92,417,509
30167,2014-06-20,10,124,274,398
30168,2014-06-20,11,153,320,473
30169,2014-06-20,12,149,367,516
30170,2014-06-20,13,188,345,533
30171,2014-06-20,14,155,364,519
30172,2014-06-20,15,217,403,620
30173,2014-06-20,16,177,637,814
30174,2014-06-20,17,223,1078,1301
30175,2014-06-20,18,194,925,1119
30176,2014-06-20,19,173,604,777
30177,2014-06-20,20,125,449,574
30178,2014-06-20,21,122,376,498
30179,2014-06-20,22,100,303,403
30180,2014-06-20,23,96,272,368
30181,2014-06-21,0,39,135,174
30182,2014-06-21,1,22,102,124
30183,2014-06-21,2,16,58,74
30184,2014-06-21,3,8,23,31
30185,2014-06-21,4,10,16,26
30186,2014-06-21,5,5,17,22
30187,2014-06-21,6,9,30,39
30188,2014-06-21,7,23,103,126
30189,2014-06-21,8,39,178,217
30190,2014-06-21,9,98,174,272
30191,2014-06-21,10,103,280,383
30192,2014-06-21,11,235,412,647
30193,2014-06-21,12,276,478,754
30194,2014-06-21,13,275,439,714
30195,2014-06-21,14,334,522,856
30196,2014-06-21,15,355,419,774
30197,2014-06-21,16,294,409,703
30198,2014-06-21,17,390,502,892
30199,2014-06-21,18,313,445,758
30200,2014-06-21,19,241,406,647
30201,2014-06-21,20,171,318,489
30202,2014-06-21,21,170,277,447
30203,2014-06-21,22,133,267,400
30204,2014-06-21,23,80,156,236
30205,2014-06-22,0,65,153,218
30206,2014-06-22,1,22,115,137
30207,2014-06-22,2,16,98,114
30208,2014-06-22,3,10,41,51
30209,2014-06-22,4,1,17,18
30210,2014-06-22,5,7,9,16
30211,2014-06-22,6,10,21,31
30212,2014-06-22,7,23,56,79
30213,2014-06-22,8,81,141,222
30214,2014-06-22,9,146,245,391
30215,2014-06-22,10,229,423,652
30216,2014-06-22,11,282,511,793
30217,2014-06-22,12,375,572,947
30218,2014-06-22,13,388,490,878
30219,2014-06-22,14,349,557,906
30220,2014-06-22,15,381,539,920
30221,2014-06-22,16,327,614,941
30222,2014-06-22,17,253,664,917
30223,2014-06-22,18,215,373,588
30224,2014-06-22,19,156,222,378
30225,2014-06-22,20,198,573,771
30226,2014-06-22,21,134,294,428
30227,2014-06-22,22,90,182,272
30228,2014-06-22,23,54,105,159
30229,2014-06-23,0,11,43,54
30230,2014-06-23,1,7,16,23
30231,2014-06-23,2,2,9,11
30232,2014-06-23,3,0,4,4
30233,2014-06-23,4,1,9,10
30234,2014-06-23,5,10,56,66
30235,2014-06-23,6,25,239,264
30236,2014-06-23,7,40,683,723
30237,2014-06-23,8,51,977,1028
30238,2014-06-23,9,96,391,487
30239,2014-06-23,10,136,194,330
30240,2014-06-23,11,150,245,395
30241,2014-06-23,12,176,316,492
30242,2014-06-23,13,135,298,433
30243,2014-06-23,14,155,270,425
30244,2014-06-23,15,148,315,463
30245,2014-06-23,16,186,480,666
30246,2014-06-23,17,161,1117,1278
30247,2014-06-23,18,170,1049,1219
30248,2014-06-23,19,207,717,924
30249,2014-06-23,20,160,524,684
30250,2014-06-23,21,93,357,450
30251,2014-06-23,22,70,205,275
30252,2014-06-23,23,22,110,132
30253,2014-06-24,0,11,48,59
30254,2014-06-24,1,7,19,26
30255,2014-06-24,2,4,5,9
30256,2014-06-24,3,0,2,2
30257,2014-06-24,4,2,17,19
30258,2014-06-24,5,5,78,83
30259,2014-06-24,6,28,285,313
30260,2014-06-24,7,38,786,824
30261,2014-06-24,8,76,1021,1097
30262,2014-06-24,9,116,461,577
30263,2014-06-24,10,90,188,278
30264,2014-06-24,11,118,244,362
30265,2014-06-24,12,113,290,403
30266,2014-06-24,13,118,298,416
30267,2014-06-24,14,137,277,414
30268,2014-06-24,15,124,332,456
30269,2014-06-24,16,108,544,652
30270,2014-06-24,17,177,1085,1262
30271,2014-06-24,18,182,1096,1278
30272,2014-06-24,19,174,760,934
30273,2014-06-24,20,127,572,699
30274,2014-06-24,21,112,418,530
30275,2014-06-24,22,62,246,308
30276,2014-06-24,23,29,139,168
30277,2014-06-25,0,29,54,83
30278,2014-06-25,1,7,17,24
30279,2014-06-25,2,9,6,15
30280,2014-06-25,3,4,3,7
30281,2014-06-25,4,5,10,15
30282,2014-06-25,5,7,71,78
30283,2014-06-25,6,20,276,296
30284,2014-06-25,7,42,755,797
30285,2014-06-25,8,79,1009,1088
30286,2014-06-25,9,94,449,543
30287,2014-06-25,10,110,217,327
30288,2014-06-25,11,117,242,359
30289,2014-06-25,12,108,304,412
30290,2014-06-25,13,108,301,409
30291,2014-06-25,14,116,265,381
30292,2014-06-25,15,111,287,398
30293,2014-06-25,16,100,512,612
30294,2014-06-25,17,191,1055,1246
30295,2014-06-25,18,163,982,1145
30296,2014-06-25,19,146,709,855
30297,2014-06-25,20,83,475,558
30298,2014-06-25,21,31,267,298
30299,2014-06-25,22,14,124,138
30300,2014-06-25,23,11,100,111
30301,2014-06-26,0,5,34,39
30302,2014-06-26,1,1,14,15
30303,2014-06-26,2,0,3,3
30304,2014-06-26,3,0,2,2
30305,2014-06-26,4,1,6,7
30306,2014-06-26,5,1,46,47
30307,2014-06-26,6,17,285,302
30308,2014-06-26,7,31,707,738
30309,2014-06-26,8,66,972,1038
30310,2014-06-26,9,84,462,546
30311,2014-06-26,10,79,255,334
30312,2014-06-26,11,130,432,562
30313,2014-06-26,12,93,288,381
30314,2014-06-26,13,73,258,331
30315,2014-06-26,14,116,355,471
30316,2014-06-26,15,117,332,449
30317,2014-06-26,16,123,512,635
30318,2014-06-26,17,168,1023,1191
30319,2014-06-26,18,144,1012,1156
30320,2014-06-26,19,127,748,875
30321,2014-06-26,20,118,617,735
30322,2014-06-26,21,114,423,537
30323,2014-06-26,22,91,276,367
30324,2014-06-26,23,38,166,204
30325,2014-06-27,0,18,62,80
30326,2014-06-27,1,3,36,39
30327,2014-06-27,2,5,12,17
30328,2014-06-27,3,1,5,6
30329,2014-06-27,4,2,6,8
30330,2014-06-27,5,8,48,56
30331,2014-06-27,6,22,198,220
30332,2014-06-27,7,30,616,646
30333,2014-06-27,8,73,891,964
30334,2014-06-27,9,96,443,539
30335,2014-06-27,10,110,211,321
30336,2014-06-27,11,140,283,423
30337,2014-06-27,12,149,347,496
30338,2014-06-27,13,136,331,467
30339,2014-06-27,14,177,299,476
30340,2014-06-27,15,173,368,541
30341,2014-06-27,16,183,578,761
30342,2014-06-27,17,202,984,1186
30343,2014-06-27,18,167,787,954
30344,2014-06-27,19,188,576,764
30345,2014-06-27,20,152,448,600
30346,2014-06-27,21,97,340,437
30347,2014-06-27,22,98,281,379
30348,2014-06-27,23,44,214,258
30349,2014-06-28,0,27,147,174
30350,2014-06-28,1,14,102,116
30351,2014-06-28,2,10,63,73
30352,2014-06-28,3,10,28,38
30353,2014-06-28,4,1,11,12
30354,2014-06-28,5,3,30,33
30355,2014-06-28,6,19,52,71
30356,2014-06-28,7,29,126,155
30357,2014-06-28,8,71,214,285
30358,2014-06-28,9,143,328,471
30359,2014-06-28,10,223,458,681
30360,2014-06-28,11,296,527,823
30361,2014-06-28,12,283,518,801
30362,2014-06-28,13,320,434,754
30363,2014-06-28,14,250,415,665
30364,2014-06-28,15,390,630,1020
30365,2014-06-28,16,339,457,796
30366,2014-06-28,17,335,450,785
30367,2014-06-28,18,312,437,749
30368,2014-06-28,19,267,431,698
30369,2014-06-28,20,244,310,554
30370,2014-06-28,21,177,306,483
30371,2014-06-28,22,97,232,329
30372,2014-06-28,23,74,209,283
30373,2014-06-29,0,49,154,203
30374,2014-06-29,1,18,99,117
30375,2014-06-29,2,19,101,120
30376,2014-06-29,3,13,32,45
30377,2014-06-29,4,2,13,15
30378,2014-06-29,5,6,11,17
30379,2014-06-29,6,14,20,34
30380,2014-06-29,7,33,73,106
30381,2014-06-29,8,90,135,225
30382,2014-06-29,9,152,301,453
30383,2014-06-29,10,282,425,707
30384,2014-06-29,11,387,581,968
30385,2014-06-29,12,333,518,851
30386,2014-06-29,13,341,428,769
30387,2014-06-29,14,350,551,901
30388,2014-06-29,15,344,515,859
30389,2014-06-29,16,298,507,805
30390,2014-06-29,17,298,409,707
30391,2014-06-29,18,242,430,672
30392,2014-06-29,19,276,492,768
30393,2014-06-29,20,247,354,601
30394,2014-06-29,21,165,258,423
30395,2014-06-29,22,94,145,239
30396,2014-06-29,23,65,105,170
30397,2014-06-30,0,36,41,77
30398,2014-06-30,1,11,8,19
30399,2014-06-30,2,0,10,10
30400,2014-06-30,3,1,6,7
30401,2014-06-30,4,2,5,7
30402,2014-06-30,5,4,75,79
30403,2014-06-30,6,16,243,259
30404,2014-06-30,7,43,658,701
30405,2014-06-30,8,56,927,983
30406,2014-06-30,9,87,442,529
30407,2014-06-30,10,101,165,266
30408,2014-06-30,11,157,215,372
30409,2014-06-30,12,159,283,442
30410,2014-06-30,13,149,265,414
30411,2014-06-30,14,139,245,384
30412,2014-06-30,15,159,320,479
30413,2014-06-30,16,180,521,701
30414,2014-06-30,17,159,1069,1228
30415,2014-06-30,18,145,1015,1160
30416,2014-06-30,19,133,668,801
30417,2014-06-30,20,129,488,617
30418,2014-06-30,21,94,342,436
30419,2014-06-30,22,80,286,366
30420,2014-06-30,23,29,105,134
30421,2014-07-01,0,22,36,58
30422,2014-07-01,1,7,12,19
30423,2014-07-01,2,0,8,8
30424,2014-07-01,3,0,3,3
30425,2014-07-01,4,1,6,7
30426,2014-07-01,5,2,71,73
30427,2014-07-01,6,24,307,331
30428,2014-07-01,7,46,746,792
30429,2014-07-01,8,73,941,1014
30430,2014-07-01,9,102,414,516
30431,2014-07-01,10,114,188,302
30432,2014-07-01,11,108,210,318
30433,2014-07-01,12,128,251,379
30434,2014-07-01,13,152,261,413
30435,2014-07-01,14,112,325,437
30436,2014-07-01,15,121,592,713
30437,2014-07-01,16,85,496,581
30438,2014-07-01,17,101,649,750
30439,2014-07-01,18,137,944,1081
30440,2014-07-01,19,171,803,974
30441,2014-07-01,20,136,536,672
30442,2014-07-01,21,116,369,485
30443,2014-07-01,22,89,303,392
30444,2014-07-01,23,50,133,183
30445,2014-07-02,0,28,62,90
30446,2014-07-02,1,11,14,25
30447,2014-07-02,2,0,10,10
30448,2014-07-02,3,0,2,2
30449,2014-07-02,4,3,3,6
30450,2014-07-02,5,5,66,71
30451,2014-07-02,6,20,265,285
30452,2014-07-02,7,48,701,749
30453,2014-07-02,8,72,966,1038
30454,2014-07-02,9,80,422,502
30455,2014-07-02,10,113,214,327
30456,2014-07-02,11,122,216,338
30457,2014-07-02,12,102,280,382
30458,2014-07-02,13,98,249,347
30459,2014-07-02,14,101,242,343
30460,2014-07-02,15,112,276,388
30461,2014-07-02,16,130,449,579
30462,2014-07-02,17,127,984,1111
30463,2014-07-02,18,130,798,928
30464,2014-07-02,19,100,571,671
30465,2014-07-02,20,100,462,562
30466,2014-07-02,21,96,338,434
30467,2014-07-02,22,83,216,299
30468,2014-07-02,23,10,67,77
30469,2014-07-03,0,15,40,55
30470,2014-07-03,1,7,17,24
30471,2014-07-03,2,8,16,24
30472,2014-07-03,3,8,2,10
30473,2014-07-03,4,0,8,8
30474,2014-07-03,5,2,45,47
30475,2014-07-03,6,14,219,233
30476,2014-07-03,7,43,537,580
30477,2014-07-03,8,80,872,952
30478,2014-07-03,9,118,443,561
30479,2014-07-03,10,130,243,373
30480,2014-07-03,11,192,249,441
30481,2014-07-03,12,162,343,505
30482,2014-07-03,13,152,375,527
30483,2014-07-03,14,173,431,604
30484,2014-07-03,15,186,619,805
30485,2014-07-03,16,110,488,598
30486,2014-07-03,17,51,263,314
30487,2014-07-03,18,115,373,488
30488,2014-07-03,19,85,309,394
30489,2014-07-03,20,87,225,312
30490,2014-07-03,21,97,238,335
30491,2014-07-03,22,53,162,215
30492,2014-07-03,23,37,156,193
30493,2014-07-04,0,29,89,118
30494,2014-07-04,1,13,48,61
30495,2014-07-04,2,8,33,41
30496,2014-07-04,3,5,26,31
30497,2014-07-04,4,5,9,14
30498,2014-07-04,5,12,17,29
30499,2014-07-04,6,14,36,50
30500,2014-07-04,7,25,85,110
30501,2014-07-04,8,50,137,187
30502,2014-07-04,9,166,254,420
30503,2014-07-04,10,302,356,658
30504,2014-07-04,11,354,493,847
30505,2014-07-04,12,385,399,784
30506,2014-07-04,13,443,358,801
30507,2014-07-04,14,532,512,1044
30508,2014-07-04,15,558,439,997
30509,2014-07-04,16,498,354,852
30510,2014-07-04,17,411,281,692
30511,2014-07-04,18,451,421,872
30512,2014-07-04,19,463,309,772
30513,2014-07-04,20,413,319,732
30514,2014-07-04,21,395,373,768
30515,2014-07-04,22,330,326,656
30516,2014-07-04,23,133,225,358
30517,2014-07-05,0,65,153,218
30518,2014-07-05,1,50,78,128
30519,2014-07-05,2,30,39,69
30520,2014-07-05,3,9,26,35
30521,2014-07-05,4,0,3,3
30522,2014-07-05,5,3,10,13
30523,2014-07-05,6,18,23,41
30524,2014-07-05,7,30,70,100
30525,2014-07-05,8,89,115,204
30526,2014-07-05,9,191,185,376
30527,2014-07-05,10,368,305,673
30528,2014-07-05,11,515,405,920
30529,2014-07-05,12,547,452,999
30530,2014-07-05,13,601,428,1029
30531,2014-07-05,14,687,501,1188
30532,2014-07-05,15,665,491,1156
30533,2014-07-05,16,593,411,1004
30534,2014-07-05,17,537,345,882
30535,2014-07-05,18,426,349,775
30536,2014-07-05,19,531,424,955
30537,2014-07-05,20,455,321,776
30538,2014-07-05,21,316,244,560
30539,2014-07-05,22,246,214,460
30540,2014-07-05,23,123,137,260
30541,2014-07-06,0,101,136,237
30542,2014-07-06,1,45,77,122
30543,2014-07-06,2,34,61,95
30544,2014-07-06,3,17,31,48
30545,2014-07-06,4,3,11,14
30546,2014-07-06,5,3,10,13
30547,2014-07-06,6,18,27,45
30548,2014-07-06,7,42,48,90
30549,2014-07-06,8,88,114,202
30550,2014-07-06,9,184,231,415
30551,2014-07-06,10,309,363,672
30552,2014-07-06,11,444,420,864
30553,2014-07-06,12,469,526,995
30554,2014-07-06,13,464,525,989
30555,2014-07-06,14,426,442,868
30556,2014-07-06,15,407,465,872
30557,2014-07-06,16,415,512,927
30558,2014-07-06,17,396,452,848
30559,2014-07-06,18,299,380,679
30560,2014-07-06,19,262,366,628
30561,2014-07-06,20,212,319,531
30562,2014-07-06,21,163,230,393
30563,2014-07-06,22,116,155,271
30564,2014-07-06,23,55,52,107
30565,2014-07-07,0,19,40,59
30566,2014-07-07,1,5,14,19
30567,2014-07-07,2,0,8,8
30568,2014-07-07,3,0,7,7
30569,2014-07-07,4,1,10,11
30570,2014-07-07,5,7,67,74
30571,2014-07-07,6,10,260,270
30572,2014-07-07,7,33,596,629
30573,2014-07-07,8,60,872,932
30574,2014-07-07,9,106,354,460
30575,2014-07-07,10,138,159,297
30576,2014-07-07,11,138,203,341
30577,2014-07-07,12,110,260,370
30578,2014-07-07,13,143,253,396
30579,2014-07-07,14,151,249,400
30580,2014-07-07,15,179,273,452
30581,2014-07-07,16,136,506,642
30582,2014-07-07,17,190,1012,1202
30583,2014-07-07,18,172,929,1101
30584,2014-07-07,19,181,716,897
30585,2014-07-07,20,140,519,659
30586,2014-07-07,21,107,320,427
30587,2014-07-07,22,61,206,267
30588,2014-07-07,23,23,109,132
30589,2014-07-08,0,23,43,66
30590,2014-07-08,1,21,27,48
30591,2014-07-08,2,6,3,9
30592,2014-07-08,3,1,0,1
30593,2014-07-08,4,1,7,8
30594,2014-07-08,5,6,57,63
30595,2014-07-08,6,16,274,290
30596,2014-07-08,7,44,692,736
30597,2014-07-08,8,56,916,972
30598,2014-07-08,9,78,394,472
30599,2014-07-08,10,85,160,245
30600,2014-07-08,11,143,163,306
30601,2014-07-08,12,101,253,354
30602,2014-07-08,13,97,258,355
30603,2014-07-08,14,85,225,310
30604,2014-07-08,15,113,343,456
30605,2014-07-08,16,86,515,601
30606,2014-07-08,17,119,952,1071
30607,2014-07-08,18,182,980,1162
30608,2014-07-08,19,53,349,402
30609,2014-07-08,20,13,120,133
30610,2014-07-08,21,13,170,183
30611,2014-07-08,22,24,171,195
30612,2014-07-08,23,17,87,104
30613,2014-07-09,0,6,37,43
30614,2014-07-09,1,2,13,15
30615,2014-07-09,2,2,8,10
30616,2014-07-09,3,0,1,1
30617,2014-07-09,4,1,9,10
30618,2014-07-09,5,3,80,83
30619,2014-07-09,6,17,277,294
30620,2014-07-09,7,43,715,758
30621,2014-07-09,8,46,862,908
30622,2014-07-09,9,62,397,459
30623,2014-07-09,10,62,145,207
30624,2014-07-09,11,120,198,318
30625,2014-07-09,12,105,291,396
30626,2014-07-09,13,129,269,398
30627,2014-07-09,14,111,257,368
30628,2014-07-09,15,138,346,484
30629,2014-07-09,16,121,523,644
30630,2014-07-09,17,84,416,500
30631,2014-07-09,18,97,568,665
30632,2014-07-09,19,132,695,827
30633,2014-07-09,20,87,490,577
30634,2014-07-09,21,76,336,412
30635,2014-07-09,22,48,231,279
30636,2014-07-09,23,24,119,143
30637,2014-07-10,0,32,53,85
30638,2014-07-10,1,6,28,34
30639,2014-07-10,2,0,7,7
30640,2014-07-10,3,0,4,4
30641,2014-07-10,4,1,11,12
30642,2014-07-10,5,6,68,74
30643,2014-07-10,6,22,286,308
30644,2014-07-10,7,42,679,721
30645,2014-07-10,8,77,948,1025
30646,2014-07-10,9,67,434,501
30647,2014-07-10,10,99,204,303
30648,2014-07-10,11,127,205,332
30649,2014-07-10,12,152,257,409
30650,2014-07-10,13,142,310,452
30651,2014-07-10,14,129,254,383
30652,2014-07-10,15,133,297,430
30653,2014-07-10,16,137,524,661
30654,2014-07-10,17,147,1063,1210
30655,2014-07-10,18,112,616,728
30656,2014-07-10,19,29,232,261
30657,2014-07-10,20,41,247,288
30658,2014-07-10,21,11,149,160
30659,2014-07-10,22,19,165,184
30660,2014-07-10,23,11,105,116
30661,2014-07-11,0,3,59,62
30662,2014-07-11,1,3,30,33
30663,2014-07-11,2,5,14,19
30664,2014-07-11,3,1,9,10
30665,2014-07-11,4,1,5,6
30666,2014-07-11,5,3,49,52
30667,2014-07-11,6,22,241,263
30668,2014-07-11,7,35,574,609
30669,2014-07-11,8,92,900,992
30670,2014-07-11,9,117,487,604
30671,2014-07-11,10,135,226,361
30672,2014-07-11,11,152,251,403
30673,2014-07-11,12,154,379,533
30674,2014-07-11,13,138,371,509
30675,2014-07-11,14,135,313,448
30676,2014-07-11,15,187,395,582
30677,2014-07-11,16,181,602,783
30678,2014-07-11,17,209,988,1197
30679,2014-07-11,18,226,852,1078
30680,2014-07-11,19,233,648,881
30681,2014-07-11,20,189,459,648
30682,2014-07-11,21,159,337,496
30683,2014-07-11,22,101,293,394
30684,2014-07-11,23,65,200,265
30685,2014-07-12,0,33,147,180
30686,2014-07-12,1,13,107,120
30687,2014-07-12,2,15,73,88
30688,2014-07-12,3,7,31,38
30689,2014-07-12,4,5,8,13
30690,2014-07-12,5,3,18,21
30691,2014-07-12,6,13,49,62
30692,2014-07-12,7,33,101,134
30693,2014-07-12,8,65,199,264
30694,2014-07-12,9,178,326,504
30695,2014-07-12,10,318,398,716
30696,2014-07-12,11,390,460,850
30697,2014-07-12,12,410,500,910
30698,2014-07-12,13,464,482,946
30699,2014-07-12,14,439,448,887
30700,2014-07-12,15,491,477,968
30701,2014-07-12,16,344,451,795
30702,2014-07-12,17,353,388,741
30703,2014-07-12,18,340,471,811
30704,2014-07-12,19,299,407,706
30705,2014-07-12,20,259,355,614
30706,2014-07-12,21,208,281,489
30707,2014-07-12,22,121,235,356
30708,2014-07-12,23,91,205,296
30709,2014-07-13,0,84,164,248
30710,2014-07-13,1,40,126,166
30711,2014-07-13,2,25,61,86
30712,2014-07-13,3,13,28,41
30713,2014-07-13,4,2,7,9
30714,2014-07-13,5,2,14,16
30715,2014-07-13,6,10,20,30
30716,2014-07-13,7,26,67,93
30717,2014-07-13,8,96,150,246
30718,2014-07-13,9,188,274,462
30719,2014-07-13,10,318,399,717
30720,2014-07-13,11,356,457,813
30721,2014-07-13,12,351,525,876
30722,2014-07-13,13,288,555,843
30723,2014-07-13,14,267,595,862
30724,2014-07-13,15,239,332,571
30725,2014-07-13,16,150,269,419
30726,2014-07-13,17,201,355,556
30727,2014-07-13,18,279,512,791
30728,2014-07-13,19,243,377,620
30729,2014-07-13,20,166,287,453
30730,2014-07-13,21,99,197,296
30731,2014-07-13,22,16,56,72
30732,2014-07-13,23,11,42,53
30733,2014-07-14,0,6,22,28
30734,2014-07-14,1,5,6,11
30735,2014-07-14,2,2,12,14
30736,2014-07-14,3,1,2,3
30737,2014-07-14,4,4,8,12
30738,2014-07-14,5,4,45,49
30739,2014-07-14,6,30,253,283
30740,2014-07-14,7,50,623,673
30741,2014-07-14,8,69,867,936
30742,2014-07-14,9,86,374,460
30743,2014-07-14,10,136,175,311
30744,2014-07-14,11,150,189,339
30745,2014-07-14,12,172,237,409
30746,2014-07-14,13,116,225,341
30747,2014-07-14,14,134,210,344
30748,2014-07-14,15,128,264,392
30749,2014-07-14,16,128,413,541
30750,2014-07-14,17,74,447,521
30751,2014-07-14,18,139,700,839
30752,2014-07-14,19,131,578,709
30753,2014-07-14,20,131,429,560
30754,2014-07-14,21,91,297,388
30755,2014-07-14,22,76,176,252
30756,2014-07-14,23,22,102,124
30757,2014-07-15,0,16,49,65
30758,2014-07-15,1,3,10,13
30759,2014-07-15,2,4,4,8
30760,2014-07-15,3,1,3,4
30761,2014-07-15,4,1,5,6
30762,2014-07-15,5,5,62,67
30763,2014-07-15,6,20,288,308
30764,2014-07-15,7,46,703,749
30765,2014-07-15,8,61,963,1024
30766,2014-07-15,9,73,381,454
30767,2014-07-15,10,98,176,274
30768,2014-07-15,11,137,203,340
30769,2014-07-15,12,118,264,382
30770,2014-07-15,13,147,255,402
30771,2014-07-15,14,90,217,307
30772,2014-07-15,15,44,98,142
30773,2014-07-15,16,124,403,527
30774,2014-07-15,17,160,987,1147
30775,2014-07-15,18,142,937,1079
30776,2014-07-15,19,43,211,254
30777,2014-07-15,20,23,78,101
30778,2014-07-15,21,7,63,70
30779,2014-07-15,22,2,46,48
30780,2014-07-15,23,9,71,80
30781,2014-07-16,0,2,28,30
30782,2014-07-16,1,8,10,18
30783,2014-07-16,2,4,7,11
30784,2014-07-16,3,0,3,3
30785,2014-07-16,4,2,12,14
30786,2014-07-16,5,6,76,82
30787,2014-07-16,6,22,282,304
30788,2014-07-16,7,45,717,762
30789,2014-07-16,8,83,969,1052
30790,2014-07-16,9,72,397,469
30791,2014-07-16,10,100,220,320
30792,2014-07-16,11,111,234,345
30793,2014-07-16,12,135,317,452
30794,2014-07-16,13,141,309,450
30795,2014-07-16,14,167,250,417
30796,2014-07-16,15,179,316,495
30797,2014-07-16,16,160,537,697
30798,2014-07-16,17,257,1100,1357
30799,2014-07-16,18,200,1015,1215
30800,2014-07-16,19,180,764,944
30801,2014-07-16,20,162,591,753
30802,2014-07-16,21,133,409,542
30803,2014-07-16,22,74,307,381
30804,2014-07-16,23,38,155,193
30805,2014-07-17,0,30,60,90
30806,2014-07-17,1,15,20,35
30807,2014-07-17,2,3,17,20
30808,2014-07-17,3,3,3,6
30809,2014-07-17,4,5,4,9
30810,2014-07-17,5,4,73,77
30811,2014-07-17,6,24,298,322
30812,2014-07-17,7,57,701,758
30813,2014-07-17,8,75,967,1042
30814,2014-07-17,9,101,464,565
30815,2014-07-17,10,161,209,370
30816,2014-07-17,11,137,222,359
30817,2014-07-17,12,150,311,461
30818,2014-07-17,13,185,317,502
30819,2014-07-17,14,203,253,456
30820,2014-07-17,15,227,302,529
30821,2014-07-17,16,222,532,754
30822,2014-07-17,17,228,1106,1334
30823,2014-07-17,18,219,1039,1258
30824,2014-07-17,19,193,654,847
30825,2014-07-17,20,134,577,711
30826,2014-07-17,21,99,419,518
30827,2014-07-17,22,73,291,364
30828,2014-07-17,23,41,181,222
30829,2014-07-18,0,17,47,64
30830,2014-07-18,1,9,40,49
30831,2014-07-18,2,3,21,24
30832,2014-07-18,3,3,11,14
30833,2014-07-18,4,3,6,9
30834,2014-07-18,5,4,52,56
30835,2014-07-18,6,23,203,226
30836,2014-07-18,7,41,572,613
30837,2014-07-18,8,89,956,1045
30838,2014-07-18,9,119,426,545
30839,2014-07-18,10,186,241,427
30840,2014-07-18,11,189,253,442
30841,2014-07-18,12,214,363,577
30842,2014-07-18,13,203,353,556
30843,2014-07-18,14,250,316,566
30844,2014-07-18,15,230,410,640
30845,2014-07-18,16,221,627,848
30846,2014-07-18,17,290,1066,1356
30847,2014-07-18,18,250,762,1012
30848,2014-07-18,19,210,575,785
30849,2014-07-18,20,188,377,565
30850,2014-07-18,21,158,318,476
30851,2014-07-18,22,98,297,395
30852,2014-07-18,23,128,239,367
30853,2014-07-19,0,59,171,230
30854,2014-07-19,1,21,102,123
30855,2014-07-19,2,9,63,72
30856,2014-07-19,3,9,33,42
30857,2014-07-19,4,1,16,17
30858,2014-07-19,5,4,14,18
30859,2014-07-19,6,11,32,43
30860,2014-07-19,7,26,110,136
30861,2014-07-19,8,85,206,291
30862,2014-07-19,9,172,298,470
30863,2014-07-19,10,289,383,672
30864,2014-07-19,11,414,452,866
30865,2014-07-19,12,415,482,897
30866,2014-07-19,13,452,484,936
30867,2014-07-19,14,458,474,932
30868,2014-07-19,15,437,461,898
30869,2014-07-19,16,486,484,970
30870,2014-07-19,17,443,463,906
30871,2014-07-19,18,419,438,857
30872,2014-07-19,19,317,445,762
30873,2014-07-19,20,272,311,583
30874,2014-07-19,21,185,235,420
30875,2014-07-19,22,168,182,350
30876,2014-07-19,23,94,178,272
30877,2014-07-20,0,86,132,218
30878,2014-07-20,1,27,118,145
30879,2014-07-20,2,30,97,127
30880,2014-07-20,3,20,49,69
30881,2014-07-20,4,6,12,18
30882,2014-07-20,5,7,10,17
30883,2014-07-20,6,21,19,40
30884,2014-07-20,7,31,52,83
30885,2014-07-20,8,84,134,218
30886,2014-07-20,9,185,284,469
30887,2014-07-20,10,294,385,679
30888,2014-07-20,11,366,501,867
30889,2014-07-20,12,416,531,947
30890,2014-07-20,13,450,470,920
30891,2014-07-20,14,459,479,938
30892,2014-07-20,15,408,463,871
30893,2014-07-20,16,437,419,856
30894,2014-07-20,17,343,490,833
30895,2014-07-20,18,284,448,732
30896,2014-07-20,19,228,309,537
30897,2014-07-20,20,198,286,484
30898,2014-07-20,21,161,213,374
30899,2014-07-20,22,82,150,232
30900,2014-07-20,23,41,90,131
30901,2014-07-21,0,12,32,44
30902,2014-07-21,1,2,13,15
30903,2014-07-21,2,0,6,6
30904,2014-07-21,3,2,2,4
30905,2014-07-21,4,0,7,7
30906,2014-07-21,5,3,62,65
30907,2014-07-21,6,16,250,266
30908,2014-07-21,7,43,629,672
30909,2014-07-21,8,93,872,965
30910,2014-07-21,9,128,409,537
30911,2014-07-21,10,185,178,363
30912,2014-07-21,11,235,205,440
30913,2014-07-21,12,209,264,473
30914,2014-07-21,13,197,273,470
30915,2014-07-21,14,222,265,487
30916,2014-07-21,15,225,269,494
30917,2014-07-21,16,213,454,667
30918,2014-07-21,17,229,1078,1307
30919,2014-07-21,18,246,982,1228
30920,2014-07-21,19,196,703,899
30921,2014-07-21,20,168,512,680
30922,2014-07-21,21,102,351,453
30923,2014-07-21,22,80,213,293
30924,2014-07-21,23,45,148,193
30925,2014-07-22,0,27,26,53
30926,2014-07-22,1,5,13,18
30927,2014-07-22,2,1,6,7
30928,2014-07-22,3,2,3,5
30929,2014-07-22,4,1,11,12
30930,2014-07-22,5,7,63,70
30931,2014-07-22,6,30,283,313
30932,2014-07-22,7,46,700,746
30933,2014-07-22,8,89,991,1080
30934,2014-07-22,9,116,407,523
30935,2014-07-22,10,140,195,335
30936,2014-07-22,11,182,217,399
30937,2014-07-22,12,207,263,470
30938,2014-07-22,13,183,297,480
30939,2014-07-22,14,172,247,419
30940,2014-07-22,15,157,266,423
30941,2014-07-22,16,202,497,699
30942,2014-07-22,17,232,1093,1325
30943,2014-07-22,18,259,974,1233
30944,2014-07-22,19,199,744,943
30945,2014-07-22,20,166,541,707
30946,2014-07-22,21,89,352,441
30947,2014-07-22,22,74,243,317
30948,2014-07-22,23,26,146,172
30949,2014-07-23,0,8,53,61
30950,2014-07-23,1,7,17,24
30951,2014-07-23,2,7,4,11
30952,2014-07-23,3,1,9,10
30953,2014-07-23,4,3,14,17
30954,2014-07-23,5,8,73,81
30955,2014-07-23,6,37,282,319
30956,2014-07-23,7,60,700,760
30957,2014-07-23,8,90,975,1065
30958,2014-07-23,9,141,385,526
30959,2014-07-23,10,106,197,303
30960,2014-07-23,11,133,196,329
30961,2014-07-23,12,135,276,411
30962,2014-07-23,13,169,246,415
30963,2014-07-23,14,119,196,315
30964,2014-07-23,15,160,247,407
30965,2014-07-23,16,189,443,632
30966,2014-07-23,17,171,1013,1184
30967,2014-07-23,18,228,952,1180
30968,2014-07-23,19,187,682,869
30969,2014-07-23,20,86,395,481
30970,2014-07-23,21,92,324,416
30971,2014-07-23,22,34,227,261
30972,2014-07-23,23,20,124,144
30973,2014-07-24,0,9,40,49
30974,2014-07-24,1,4,23,27
30975,2014-07-24,2,5,11,16
30976,2014-07-24,3,2,5,7
30977,2014-07-24,4,3,8,11
30978,2014-07-24,5,2,52,54
30979,2014-07-24,6,27,223,250
30980,2014-07-24,7,55,580,635
30981,2014-07-24,8,92,945,1037
30982,2014-07-24,9,90,438,528
30983,2014-07-24,10,104,188,292
30984,2014-07-24,11,134,209,343
30985,2014-07-24,12,121,273,394
30986,2014-07-24,13,164,264,428
30987,2014-07-24,14,164,256,420
30988,2014-07-24,15,179,312,491
30989,2014-07-24,16,162,468,630
30990,2014-07-24,17,211,1010,1221
30991,2014-07-24,18,233,957,1190
30992,2014-07-24,19,190,681,871
30993,2014-07-24,20,173,542,715
30994,2014-07-24,21,137,372,509
30995,2014-07-24,22,90,274,364
30996,2014-07-24,23,46,161,207
30997,2014-07-25,0,19,80,99
30998,2014-07-25,1,20,35,55
30999,2014-07-25,2,5,25,30
31000,2014-07-25,3,2,12,14
31001,2014-07-25,4,5,8,13
31002,2014-07-25,5,7,53,60
31003,2014-07-25,6,30,222,252
31004,2014-07-25,7,55,615,670
31005,2014-07-25,8,123,900,1023
31006,2014-07-25,9,123,467,590
31007,2014-07-25,10,181,250,431
31008,2014-07-25,11,225,308,533
31009,2014-07-25,12,235,383,618
31010,2014-07-25,13,255,379,634
31011,2014-07-25,14,244,362,606
31012,2014-07-25,15,291,377,668
31013,2014-07-25,16,292,600,892
31014,2014-07-25,17,310,987,1297
31015,2014-07-25,18,279,765,1044
31016,2014-07-25,19,238,604,842
31017,2014-07-25,20,235,438,673
31018,2014-07-25,21,172,332,504
31019,2014-07-25,22,152,277,429
31020,2014-07-25,23,119,212,331
31021,2014-07-26,0,65,161,226
31022,2014-07-26,1,29,99,128
31023,2014-07-26,2,14,82,96
31024,2014-07-26,3,13,32,45
31025,2014-07-26,4,0,12,12
31026,2014-07-26,5,2,21,23
31027,2014-07-26,6,12,42,54
31028,2014-07-26,7,27,89,116
31029,2014-07-26,8,95,189,284
31030,2014-07-26,9,181,282,463
31031,2014-07-26,10,282,386,668
31032,2014-07-26,11,456,445,901
31033,2014-07-26,12,499,488,987
31034,2014-07-26,13,458,495,953
31035,2014-07-26,14,470,468,938
31036,2014-07-26,15,462,394,856
31037,2014-07-26,16,467,396,863
31038,2014-07-26,17,409,465,874
31039,2014-07-26,18,399,428,827
31040,2014-07-26,19,329,405,734
31041,2014-07-26,20,294,325,619
31042,2014-07-26,21,282,278,560
31043,2014-07-26,22,180,224,404
31044,2014-07-26,23,132,218,350
31045,2014-07-27,0,65,160,225
31046,2014-07-27,1,20,115,135
31047,2014-07-27,2,22,70,92
31048,2014-07-27,3,19,48,67
31049,2014-07-27,4,5,6,11
31050,2014-07-27,5,1,7,8
31051,2014-07-27,6,10,11,21
31052,2014-07-27,7,21,54,75
31053,2014-07-27,8,79,113,192
31054,2014-07-27,9,149,230,379
31055,2014-07-27,10,215,333,548
31056,2014-07-27,11,338,430,768
31057,2014-07-27,12,426,497,923
31058,2014-07-27,13,391,477,868
31059,2014-07-27,14,433,487,920
31060,2014-07-27,15,386,442,828
31061,2014-07-27,16,321,431,752
31062,2014-07-27,17,277,443,720
31063,2014-07-27,18,262,419,681
31064,2014-07-27,19,262,361,623
31065,2014-07-27,20,198,298,496
31066,2014-07-27,21,110,201,311
31067,2014-07-27,22,96,120,216
31068,2014-07-27,23,52,92,144
31069,2014-07-28,0,14,39,53
31070,2014-07-28,1,4,10,14
31071,2014-07-28,2,1,8,9
31072,2014-07-28,3,1,10,11
31073,2014-07-28,4,3,8,11
31074,2014-07-28,5,6,54,60
31075,2014-07-28,6,22,235,257
31076,2014-07-28,7,48,598,646
31077,2014-07-28,8,95,893,988
31078,2014-07-28,9,107,408,515
31079,2014-07-28,10,162,196,358
31080,2014-07-28,11,194,223,417
31081,2014-07-28,12,194,259,453
31082,2014-07-28,13,219,274,493
31083,2014-07-28,14,181,213,394
31084,2014-07-28,15,160,302,462
31085,2014-07-28,16,208,467,675
31086,2014-07-28,17,270,1119,1389
31087,2014-07-28,18,218,946,1164
31088,2014-07-28,19,160,712,872
31089,2014-07-28,20,133,491,624
31090,2014-07-28,21,99,303,402
31091,2014-07-28,22,78,189,267
31092,2014-07-28,23,44,110,154
31093,2014-07-29,0,24,41,65
31094,2014-07-29,1,11,10,21
31095,2014-07-29,2,3,5,8
31096,2014-07-29,3,2,6,8
31097,2014-07-29,4,3,7,10
31098,2014-07-29,5,6,67,73
31099,2014-07-29,6,24,289,313
31100,2014-07-29,7,65,706,771
31101,2014-07-29,8,85,1066,1151
31102,2014-07-29,9,104,442,546
31103,2014-07-29,10,122,204,326
31104,2014-07-29,11,150,265,415
31105,2014-07-29,12,174,341,515
31106,2014-07-29,13,193,340,533
31107,2014-07-29,14,208,279,487
31108,2014-07-29,15,188,290,478
31109,2014-07-29,16,231,526,757
31110,2014-07-29,17,213,1077,1290
31111,2014-07-29,18,227,956,1183
31112,2014-07-29,19,187,678,865
31113,2014-07-29,20,136,511,647
31114,2014-07-29,21,107,345,452
31115,2014-07-29,22,69,230,299
31116,2014-07-29,23,38,106,144
31117,2014-07-30,0,9,49,58
31118,2014-07-30,1,6,12,18
31119,2014-07-30,2,0,11,11
31120,2014-07-30,3,1,4,5
31121,2014-07-30,4,4,11,15
31122,2014-07-30,5,8,67,75
31123,2014-07-30,6,14,264,278
31124,2014-07-30,7,56,731,787
31125,2014-07-30,8,95,1058,1153
31126,2014-07-30,9,99,469,568
31127,2014-07-30,10,130,208,338
31128,2014-07-30,11,160,236,396
31129,2014-07-30,12,212,320,532
31130,2014-07-30,13,150,302,452
31131,2014-07-30,14,227,259,486
31132,2014-07-30,15,163,299,462
31133,2014-07-30,16,210,505,715
31134,2014-07-30,17,190,1102,1292
31135,2014-07-30,18,254,1015,1269
31136,2014-07-30,19,178,695,873
31137,2014-07-30,20,120,454,574
31138,2014-07-30,21,99,410,509
31139,2014-07-30,22,65,255,320
31140,2014-07-30,23,27,146,173
31141,2014-07-31,0,22,54,76
31142,2014-07-31,1,6,25,31
31143,2014-07-31,2,3,12,15
31144,2014-07-31,3,0,5,5
31145,2014-07-31,4,2,12,14
31146,2014-07-31,5,10,61,71
31147,2014-07-31,6,25,231,256
31148,2014-07-31,7,49,654,703
31149,2014-07-31,8,85,971,1056
31150,2014-07-31,9,107,457,564
31151,2014-07-31,10,156,208,364
31152,2014-07-31,11,179,214,393
31153,2014-07-31,12,135,325,460
31154,2014-07-31,13,180,300,480
31155,2014-07-31,14,193,267,460
31156,2014-07-31,15,181,294,475
31157,2014-07-31,16,177,506,683
31158,2014-07-31,17,243,1018,1261
31159,2014-07-31,18,231,949,1180
31160,2014-07-31,19,168,613,781
31161,2014-07-31,20,119,465,584
31162,2014-07-31,21,99,367,466
31163,2014-07-31,22,89,286,375
31164,2014-07-31,23,36,192,228
31165,2014-08-01,0,28,78,106
31166,2014-08-01,1,9,35,44
31167,2014-08-01,2,9,17,26
31168,2014-08-01,3,1,10,11
31169,2014-08-01,4,1,15,16
31170,2014-08-01,5,6,55,61
31171,2014-08-01,6,18,224,242
31172,2014-08-01,7,47,520,567
31173,2014-08-01,8,97,892,989
31174,2014-08-01,9,107,440,547
31175,2014-08-01,10,128,185,313
31176,2014-08-01,11,156,176,332
31177,2014-08-01,12,97,243,340
31178,2014-08-01,13,126,336,462
31179,2014-08-01,14,142,303,445
31180,2014-08-01,15,127,320,447
31181,2014-08-01,16,214,577,791
31182,2014-08-01,17,224,914,1138
31183,2014-08-01,18,173,780,953
31184,2014-08-01,19,114,482,596
31185,2014-08-01,20,107,368,475
31186,2014-08-01,21,141,308,449
31187,2014-08-01,22,90,241,331
31188,2014-08-01,23,48,121,169
31189,2014-08-02,0,9,43,52
31190,2014-08-02,1,7,43,50
31191,2014-08-02,2,5,38,43
31192,2014-08-02,3,14,24,38
31193,2014-08-02,4,5,7,12
31194,2014-08-02,5,0,18,18
31195,2014-08-02,6,5,34,39
31196,2014-08-02,7,24,80,104
31197,2014-08-02,8,77,187,264
31198,2014-08-02,9,143,282,425
31199,2014-08-02,10,232,369,601
31200,2014-08-02,11,356,418,774
31201,2014-08-02,12,450,451,901
31202,2014-08-02,13,430,422,852
31203,2014-08-02,14,508,441,949
31204,2014-08-02,15,555,437,992
31205,2014-08-02,16,481,392,873
31206,2014-08-02,17,481,423,904
31207,2014-08-02,18,366,367,733
31208,2014-08-02,19,316,327,643
31209,2014-08-02,20,243,253,496
31210,2014-08-02,21,232,202,434
31211,2014-08-02,22,182,205,387
31212,2014-08-02,23,93,157,250
31213,2014-08-03,0,63,137,200
31214,2014-08-03,1,49,108,157
31215,2014-08-03,2,26,65,91
31216,2014-08-03,3,8,35,43
31217,2014-08-03,4,4,7,11
31218,2014-08-03,5,3,7,10
31219,2014-08-03,6,7,23,30
31220,2014-08-03,7,26,51,77
31221,2014-08-03,8,47,136,183
31222,2014-08-03,9,136,224,360
31223,2014-08-03,10,273,363,636
31224,2014-08-03,11,292,408,700
31225,2014-08-03,12,362,534,896
31226,2014-08-03,13,374,473,847
31227,2014-08-03,14,356,468,824
31228,2014-08-03,15,325,522,847
31229,2014-08-03,16,324,481,805
31230,2014-08-03,17,336,441,777
31231,2014-08-03,18,264,468,732
31232,2014-08-03,19,246,342,588
31233,2014-08-03,20,206,292,498
31234,2014-08-03,21,133,194,327
31235,2014-08-03,22,52,97,149
31236,2014-08-03,23,11,23,34
31237,2014-08-04,0,4,12,16
31238,2014-08-04,1,1,11,12
31239,2014-08-04,2,1,7,8
31240,2014-08-04,3,2,7,9
31241,2014-08-04,4,1,8,9
31242,2014-08-04,5,7,63,70
31243,2014-08-04,6,12,223,235
31244,2014-08-04,7,52,565,617
31245,2014-08-04,8,107,929,1036
31246,2014-08-04,9,154,412,566
31247,2014-08-04,10,217,179,396
31248,2014-08-04,11,194,208,402
31249,2014-08-04,12,188,285,473
31250,2014-08-04,13,187,310,497
31251,2014-08-04,14,227,226,453
31252,2014-08-04,15,233,261,494
31253,2014-08-04,16,249,478,727
31254,2014-08-04,17,281,1018,1299
31255,2014-08-04,18,274,920,1194
31256,2014-08-04,19,179,649,828
31257,2014-08-04,20,176,489,665
31258,2014-08-04,21,93,329,422
31259,2014-08-04,22,71,273,344
31260,2014-08-04,23,28,86,114
31261,2014-08-05,0,9,41,50
31262,2014-08-05,1,5,15,20
31263,2014-08-05,2,3,7,10
31264,2014-08-05,3,1,0,1
31265,2014-08-05,4,1,13,14
31266,2014-08-05,5,5,75,80
31267,2014-08-05,6,28,251,279
31268,2014-08-05,7,47,660,707
31269,2014-08-05,8,87,921,1008
31270,2014-08-05,9,118,416,534
31271,2014-08-05,10,134,186,320
31272,2014-08-05,11,165,222,387
31273,2014-08-05,12,158,314,472
31274,2014-08-05,13,174,315,489
31275,2014-08-05,14,171,257,428
31276,2014-08-05,15,188,294,482
31277,2014-08-05,16,196,487,683
31278,2014-08-05,17,208,992,1200
31279,2014-08-05,18,223,893,1116
31280,2014-08-05,19,194,585,779
31281,2014-08-05,20,168,448,616
31282,2014-08-05,21,137,359,496
31283,2014-08-05,22,88,315,403
31284,2014-08-05,23,37,104,141
31285,2014-08-06,0,5,18,23
31286,2014-08-06,1,2,19,21
31287,2014-08-06,2,0,2,2
31288,2014-08-06,3,0,3,3
31289,2014-08-06,4,0,7,7
31290,2014-08-06,5,7,65,72
31291,2014-08-06,6,27,258,285
31292,2014-08-06,7,42,611,653
31293,2014-08-06,8,104,891,995
31294,2014-08-06,9,78,419,497
31295,2014-08-06,10,115,205,320
31296,2014-08-06,11,161,216,377
31297,2014-08-06,12,166,335,501
31298,2014-08-06,13,142,305,447
31299,2014-08-06,14,187,276,463
31300,2014-08-06,15,211,258,469
31301,2014-08-06,16,227,478,705
31302,2014-08-06,17,251,1040,1291
31303,2014-08-06,18,231,989,1220
31304,2014-08-06,19,238,716,954
31305,2014-08-06,20,150,466,616
31306,2014-08-06,21,109,379,488
31307,2014-08-06,22,90,267,357
31308,2014-08-06,23,60,125,185
31309,2014-08-07,0,15,49,64
31310,2014-08-07,1,4,19,23
31311,2014-08-07,2,6,6,12
31312,2014-08-07,3,0,5,5
31313,2014-08-07,4,4,14,18
31314,2014-08-07,5,2,63,65
31315,2014-08-07,6,27,256,283
31316,2014-08-07,7,56,617,673
31317,2014-08-07,8,111,974,1085
31318,2014-08-07,9,89,451,540
31319,2014-08-07,10,148,223,371
31320,2014-08-07,11,175,251,426
31321,2014-08-07,12,174,347,521
31322,2014-08-07,13,172,317,489
31323,2014-08-07,14,146,242,388
31324,2014-08-07,15,204,263,467
31325,2014-08-07,16,187,487,674
31326,2014-08-07,17,221,974,1195
31327,2014-08-07,18,222,983,1205
31328,2014-08-07,19,193,699,892
31329,2014-08-07,20,148,495,643
31330,2014-08-07,21,124,339,463
31331,2014-08-07,22,103,249,352
31332,2014-08-07,23,47,161,208
31333,2014-08-08,0,23,83,106
31334,2014-08-08,1,11,33,44
31335,2014-08-08,2,3,20,23
31336,2014-08-08,3,5,4,9
31337,2014-08-08,4,0,10,10
31338,2014-08-08,5,5,53,58
31339,2014-08-08,6,25,221,246
31340,2014-08-08,7,62,550,612
31341,2014-08-08,8,107,854,961
31342,2014-08-08,9,154,434,588
31343,2014-08-08,10,181,223,404
31344,2014-08-08,11,237,276,513
31345,2014-08-08,12,227,362,589
31346,2014-08-08,13,207,332,539
31347,2014-08-08,14,254,283,537
31348,2014-08-08,15,223,325,548
31349,2014-08-08,16,293,517,810
31350,2014-08-08,17,292,945,1237
31351,2014-08-08,18,226,791,1017
31352,2014-08-08,19,203,591,794
31353,2014-08-08,20,203,388,591
31354,2014-08-08,21,147,246,393
31355,2014-08-08,22,154,221,375
31356,2014-08-08,23,84,186,270
31357,2014-08-09,0,44,157,201
31358,2014-08-09,1,27,93,120
31359,2014-08-09,2,13,73,86
31360,2014-08-09,3,11,22,33
31361,2014-08-09,4,10,7,17
31362,2014-08-09,5,8,14,22
31363,2014-08-09,6,14,38,52
31364,2014-08-09,7,24,68,92
31365,2014-08-09,8,80,183,263
31366,2014-08-09,9,197,309,506
31367,2014-08-09,10,248,362,610
31368,2014-08-09,11,288,452,740
31369,2014-08-09,12,369,437,806
31370,2014-08-09,13,433,458,891
31371,2014-08-09,14,415,410,825
31372,2014-08-09,15,478,386,864
31373,2014-08-09,16,443,338,781
31374,2014-08-09,17,424,320,744
31375,2014-08-09,18,331,385,716
31376,2014-08-09,19,289,324,613
31377,2014-08-09,20,216,229,445
31378,2014-08-09,21,155,212,367
31379,2014-08-09,22,110,186,296
31380,2014-08-09,23,96,169,265
31381,2014-08-10,0,47,129,176
31382,2014-08-10,1,45,94,139
31383,2014-08-10,2,15,73,88
31384,2014-08-10,3,13,36,49
31385,2014-08-10,4,3,11,14
31386,2014-08-10,5,6,14,20
31387,2014-08-10,6,13,21,34
31388,2014-08-10,7,36,41,77
31389,2014-08-10,8,74,106,180
31390,2014-08-10,9,171,268,439
31391,2014-08-10,10,294,333,627
31392,2014-08-10,11,369,429,798
31393,2014-08-10,12,451,483,934
31394,2014-08-10,13,506,451,957
31395,2014-08-10,14,489,459,948
31396,2014-08-10,15,466,477,943
31397,2014-08-10,16,408,440,848
31398,2014-08-10,17,409,390,799
31399,2014-08-10,18,273,438,711
31400,2014-08-10,19,332,374,706
31401,2014-08-10,20,201,238,439
31402,2014-08-10,21,140,195,335
31403,2014-08-10,22,136,154,290
31404,2014-08-10,23,61,67,128
31405,2014-08-11,0,30,29,59
31406,2014-08-11,1,2,11,13
31407,2014-08-11,2,9,2,11
31408,2014-08-11,3,4,9,13
31409,2014-08-11,4,0,8,8
31410,2014-08-11,5,9,55,64
31411,2014-08-11,6,22,251,273
31412,2014-08-11,7,63,581,644
31413,2014-08-11,8,117,898,1015
31414,2014-08-11,9,118,383,501
31415,2014-08-11,10,217,211,428
31416,2014-08-11,11,217,194,411
31417,2014-08-11,12,194,247,441
31418,2014-08-11,13,213,270,483
31419,2014-08-11,14,208,247,455
31420,2014-08-11,15,236,234,470
31421,2014-08-11,16,288,482,770
31422,2014-08-11,17,253,944,1197
31423,2014-08-11,18,193,780,973
31424,2014-08-11,19,176,473,649
31425,2014-08-11,20,79,160,239
31426,2014-08-11,21,71,162,233
31427,2014-08-11,22,35,124,159
31428,2014-08-11,23,22,80,102
31429,2014-08-12,0,8,29,37
31430,2014-08-12,1,11,7,18
31431,2014-08-12,2,1,4,5
31432,2014-08-12,3,0,1,1
31433,2014-08-12,4,1,7,8
31434,2014-08-12,5,6,64,70
31435,2014-08-12,6,6,119,125
31436,2014-08-12,7,29,385,414
31437,2014-08-12,8,38,498,536
31438,2014-08-12,9,38,263,301
31439,2014-08-12,10,18,25,43
31440,2014-08-12,11,6,32,38
31441,2014-08-12,12,9,39,48
31442,2014-08-12,13,5,28,33
31443,2014-08-12,14,4,30,34
31444,2014-08-12,15,21,118,139
31445,2014-08-12,16,89,349,438
31446,2014-08-12,17,123,797,920
31447,2014-08-12,18,106,808,914
31448,2014-08-12,19,122,564,686
31449,2014-08-12,20,109,389,498
31450,2014-08-12,21,69,254,323
31451,2014-08-12,22,37,192,229
31452,2014-08-12,23,24,88,112
31453,2014-08-13,0,8,29,37
31454,2014-08-13,1,8,20,28
31455,2014-08-13,2,4,4,8
31456,2014-08-13,3,0,7,7
31457,2014-08-13,4,1,10,11
31458,2014-08-13,5,6,76,82
31459,2014-08-13,6,19,251,270
31460,2014-08-13,7,52,648,700
31461,2014-08-13,8,67,927,994
31462,2014-08-13,9,102,389,491
31463,2014-08-13,10,143,199,342
31464,2014-08-13,11,160,233,393
31465,2014-08-13,12,160,335,495
31466,2014-08-13,13,242,312,554
31467,2014-08-13,14,180,247,427
31468,2014-08-13,15,180,256,436
31469,2014-08-13,16,206,473,679
31470,2014-08-13,17,244,1059,1303
31471,2014-08-13,18,206,947,1153
31472,2014-08-13,19,165,714,879
31473,2014-08-13,20,150,496,646
31474,2014-08-13,21,121,332,453
31475,2014-08-13,22,69,246,315
31476,2014-08-13,23,38,140,178
31477,2014-08-14,0,18,54,72
31478,2014-08-14,1,12,24,36
31479,2014-08-14,2,4,11,15
31480,2014-08-14,3,2,10,12
31481,2014-08-14,4,1,6,7
31482,2014-08-14,5,4,68,72
31483,2014-08-14,6,18,246,264
31484,2014-08-14,7,46,587,633
31485,2014-08-14,8,78,917,995
31486,2014-08-14,9,117,408,525
31487,2014-08-14,10,147,222,369
31488,2014-08-14,11,200,213,413
31489,2014-08-14,12,179,328,507
31490,2014-08-14,13,189,348,537
31491,2014-08-14,14,187,265,452
31492,2014-08-14,15,214,286,500
31493,2014-08-14,16,202,519,721
31494,2014-08-14,17,225,1024,1249
31495,2014-08-14,18,212,984,1196
31496,2014-08-14,19,195,643,838
31497,2014-08-14,20,147,450,597
31498,2014-08-14,21,121,346,467
31499,2014-08-14,22,103,245,348
31500,2014-08-14,23,39,141,180
31501,2014-08-15,0,28,90,118
31502,2014-08-15,1,5,28,33
31503,2014-08-15,2,1,14,15
31504,2014-08-15,3,0,7,7
31505,2014-08-15,4,1,9,10
31506,2014-08-15,5,4,59,63
31507,2014-08-15,6,22,218,240
31508,2014-08-15,7,35,548,583
31509,2014-08-15,8,109,961,1070
31510,2014-08-15,9,124,475,599
31511,2014-08-15,10,163,240,403
31512,2014-08-15,11,217,338,555
31513,2014-08-15,12,277,366,643
31514,2014-08-15,13,239,333,572
31515,2014-08-15,14,296,337,633
31516,2014-08-15,15,277,407,684
31517,2014-08-15,16,308,584,892
31518,2014-08-15,17,305,982,1287
31519,2014-08-15,18,244,764,1008
31520,2014-08-15,19,252,546,798
31521,2014-08-15,20,237,413,650
31522,2014-08-15,21,170,285,455
31523,2014-08-15,22,114,239,353
31524,2014-08-15,23,53,218,271
31525,2014-08-16,0,53,145,198
31526,2014-08-16,1,44,92,136
31527,2014-08-16,2,12,70,82
31528,2014-08-16,3,13,33,46
31529,2014-08-16,4,4,18,22
31530,2014-08-16,5,4,14,18
31531,2014-08-16,6,13,42,55
31532,2014-08-16,7,19,107,126
31533,2014-08-16,8,75,198,273
31534,2014-08-16,9,154,301,455
31535,2014-08-16,10,307,347,654
31536,2014-08-16,11,392,455,847
31537,2014-08-16,12,494,472,966
31538,2014-08-16,13,537,508,1045
31539,2014-08-16,14,565,495,1060
31540,2014-08-16,15,556,495,1051
31541,2014-08-16,16,511,456,967
31542,2014-08-16,17,494,433,927
31543,2014-08-16,18,439,463,902
31544,2014-08-16,19,350,371,721
31545,2014-08-16,20,295,258,553
31546,2014-08-16,21,179,238,417
31547,2014-08-16,22,176,237,413
31548,2014-08-16,23,141,174,315
31549,2014-08-17,0,67,148,215
31550,2014-08-17,1,42,89,131
31551,2014-08-17,2,37,69,106
31552,2014-08-17,3,27,32,59
31553,2014-08-17,4,6,6,12
31554,2014-08-17,5,19,10,29
31555,2014-08-17,6,22,18,40
31556,2014-08-17,7,23,57,80
31557,2014-08-17,8,105,146,251
31558,2014-08-17,9,134,200,334
31559,2014-08-17,10,261,364,625
31560,2014-08-17,11,350,440,790
31561,2014-08-17,12,435,527,962
31562,2014-08-17,13,457,488,945
31563,2014-08-17,14,435,469,904
31564,2014-08-17,15,334,465,799
31565,2014-08-17,16,368,510,878
31566,2014-08-17,17,342,424,766
31567,2014-08-17,18,260,491,751
31568,2014-08-17,19,235,439,674
31569,2014-08-17,20,180,313,493
31570,2014-08-17,21,116,227,343
31571,2014-08-17,22,82,173,255
31572,2014-08-17,23,48,96,144
31573,2014-08-18,0,20,28,48
31574,2014-08-18,1,6,17,23
31575,2014-08-18,2,4,8,12
31576,2014-08-18,3,0,4,4
31577,2014-08-18,4,2,11,13
31578,2014-08-18,5,4,57,61
31579,2014-08-18,6,24,250,274
31580,2014-08-18,7,45,593,638
31581,2014-08-18,8,89,954,1043
31582,2014-08-18,9,122,391,513
31583,2014-08-18,10,143,169,312
31584,2014-08-18,11,205,202,407
31585,2014-08-18,12,173,261,434
31586,2014-08-18,13,204,295,499
31587,2014-08-18,14,195,248,443
31588,2014-08-18,15,195,295,490
31589,2014-08-18,16,206,511,717
31590,2014-08-18,17,226,1072,1298
31591,2014-08-18,18,222,971,1193
31592,2014-08-18,19,160,761,921
31593,2014-08-18,20,102,431,533
31594,2014-08-18,21,78,292,370
31595,2014-08-18,22,57,277,334
31596,2014-08-18,23,31,102,133
31597,2014-08-19,0,6,38,44
31598,2014-08-19,1,10,18,28
31599,2014-08-19,2,1,8,9
31600,2014-08-19,3,0,6,6
31601,2014-08-19,4,0,10,10
31602,2014-08-19,5,2,73,75
31603,2014-08-19,6,15,275,290
31604,2014-08-19,7,40,713,753
31605,2014-08-19,8,85,946,1031
31606,2014-08-19,9,99,418,517
31607,2014-08-19,10,97,174,271
31608,2014-08-19,11,100,173,273
31609,2014-08-19,12,101,287,388
31610,2014-08-19,13,101,270,371
31611,2014-08-19,14,134,264,398
31612,2014-08-19,15,184,321,505
31613,2014-08-19,16,140,518,658
31614,2014-08-19,17,177,1173,1350
31615,2014-08-19,18,167,1054,1221
31616,2014-08-19,19,160,680,840
31617,2014-08-19,20,94,534,628
31618,2014-08-19,21,77,336,413
31619,2014-08-19,22,39,248,287
31620,2014-08-19,23,36,128,164
31621,2014-08-20,0,7,47,54
31622,2014-08-20,1,0,20,20
31623,2014-08-20,2,3,9,12
31624,2014-08-20,3,0,1,1
31625,2014-08-20,4,1,14,15
31626,2014-08-20,5,3,70,73
31627,2014-08-20,6,11,280,291
31628,2014-08-20,7,43,721,764
31629,2014-08-20,8,67,950,1017
31630,2014-08-20,9,107,424,531
31631,2014-08-20,10,125,200,325
31632,2014-08-20,11,130,255,385
31633,2014-08-20,12,156,315,471
31634,2014-08-20,13,159,338,497
31635,2014-08-20,14,162,246,408
31636,2014-08-20,15,170,342,512
31637,2014-08-20,16,206,545,751
31638,2014-08-20,17,59,329,388
31639,2014-08-20,18,76,442,518
31640,2014-08-20,19,148,585,733
31641,2014-08-20,20,121,407,528
31642,2014-08-20,21,93,324,417
31643,2014-08-20,22,52,247,299
31644,2014-08-20,23,29,111,140
31645,2014-08-21,0,11,53,64
31646,2014-08-21,1,8,22,30
31647,2014-08-21,2,8,15,23
31648,2014-08-21,3,0,1,1
31649,2014-08-21,4,1,6,7
31650,2014-08-21,5,3,64,67
31651,2014-08-21,6,19,263,282
31652,2014-08-21,7,33,695,728
31653,2014-08-21,8,66,945,1011
31654,2014-08-21,9,90,434,524
31655,2014-08-21,10,119,195,314
31656,2014-08-21,11,161,245,406
31657,2014-08-21,12,160,306,466
31658,2014-08-21,13,141,309,450
31659,2014-08-21,14,175,291,466
31660,2014-08-21,15,179,319,498
31661,2014-08-21,16,184,488,672
31662,2014-08-21,17,107,633,740
31663,2014-08-21,18,95,713,808
31664,2014-08-21,19,124,606,730
31665,2014-08-21,20,116,413,529
31666,2014-08-21,21,124,320,444
31667,2014-08-21,22,70,222,292
31668,2014-08-21,23,25,158,183
31669,2014-08-22,0,20,68,88
31670,2014-08-22,1,6,25,31
31671,2014-08-22,2,3,16,19
31672,2014-08-22,3,2,10,12
31673,2014-08-22,4,1,8,9
31674,2014-08-22,5,2,66,68
31675,2014-08-22,6,12,222,234
31676,2014-08-22,7,47,597,644
31677,2014-08-22,8,59,851,910
31678,2014-08-22,9,83,494,577
31679,2014-08-22,10,106,232,338
31680,2014-08-22,11,132,201,333
31681,2014-08-22,12,185,323,508
31682,2014-08-22,13,154,301,455
31683,2014-08-22,14,155,294,449
31684,2014-08-22,15,154,366,520
31685,2014-08-22,16,197,544,741
31686,2014-08-22,17,192,907,1099
31687,2014-08-22,18,180,814,994
31688,2014-08-22,19,172,544,716
31689,2014-08-22,20,107,386,493
31690,2014-08-22,21,97,295,392
31691,2014-08-22,22,72,277,349
31692,2014-08-22,23,66,198,264
31693,2014-08-23,0,33,177,210
31694,2014-08-23,1,33,118,151
31695,2014-08-23,2,25,64,89
31696,2014-08-23,3,10,31,41
31697,2014-08-23,4,4,11,15
31698,2014-08-23,5,12,21,33
31699,2014-08-23,6,12,53,65
31700,2014-08-23,7,32,112,144
31701,2014-08-23,8,43,234,277
31702,2014-08-23,9,91,300,391
31703,2014-08-23,10,121,242,363
31704,2014-08-23,11,145,277,422
31705,2014-08-23,12,225,375,600
31706,2014-08-23,13,231,397,628
31707,2014-08-23,14,155,214,369
31708,2014-08-23,15,55,117,172
31709,2014-08-23,16,67,142,209
31710,2014-08-23,17,113,175,288
31711,2014-08-23,18,103,273,376
31712,2014-08-23,19,141,274,415
31713,2014-08-23,20,127,244,371
31714,2014-08-23,21,120,194,314
31715,2014-08-23,22,93,188,281
31716,2014-08-23,23,54,153,207
31717,2014-08-24,0,42,136,178
31718,2014-08-24,1,17,113,130
31719,2014-08-24,2,32,98,130
31720,2014-08-24,3,9,34,43
31721,2014-08-24,4,7,13,20
31722,2014-08-24,5,4,4,8
31723,2014-08-24,6,3,25,28
31724,2014-08-24,7,21,82,103
31725,2014-08-24,8,38,149,187
31726,2014-08-24,9,143,270,413
31727,2014-08-24,10,227,389,616
31728,2014-08-24,11,332,522,854
31729,2014-08-24,12,384,619,1003
31730,2014-08-24,13,419,602,1021
31731,2014-08-24,14,371,521,892
31732,2014-08-24,15,377,534,911
31733,2014-08-24,16,303,512,815
31734,2014-08-24,17,335,570,905
31735,2014-08-24,18,276,556,832
31736,2014-08-24,19,209,455,664
31737,2014-08-24,20,128,302,430
31738,2014-08-24,21,85,203,288
31739,2014-08-24,22,52,162,214
31740,2014-08-24,23,25,78,103
31741,2014-08-25,0,17,31,48
31742,2014-08-25,1,2,16,18
31743,2014-08-25,2,0,7,7
31744,2014-08-25,3,0,4,4
31745,2014-08-25,4,1,10,11
31746,2014-08-25,5,0,60,60
31747,2014-08-25,6,14,246,260
31748,2014-08-25,7,39,683,722
31749,2014-08-25,8,63,916,979
31750,2014-08-25,9,91,378,469
31751,2014-08-25,10,118,216,334
31752,2014-08-25,11,163,235,398
31753,2014-08-25,12,168,306,474
31754,2014-08-25,13,138,348,486
31755,2014-08-25,14,168,250,418
31756,2014-08-25,15,200,317,517
31757,2014-08-25,16,179,569,748
31758,2014-08-25,17,184,1168,1352
31759,2014-08-25,18,166,1065,1231
31760,2014-08-25,19,142,694,836
31761,2014-08-25,20,127,500,627
31762,2014-08-25,21,83,302,385
31763,2014-08-25,22,54,169,223
31764,2014-08-25,23,28,107,135
31765,2014-08-26,0,18,35,53
31766,2014-08-26,1,5,10,15
31767,2014-08-26,2,1,6,7
31768,2014-08-26,3,0,1,1
31769,2014-08-26,4,1,13,14
31770,2014-08-26,5,1,74,75
31771,2014-08-26,6,12,291,303
31772,2014-08-26,7,35,798,833
31773,2014-08-26,8,74,1042,1116
31774,2014-08-26,9,72,444,516
31775,2014-08-26,10,107,200,307
31776,2014-08-26,11,141,240,381
31777,2014-08-26,12,120,293,413
31778,2014-08-26,13,123,308,431
31779,2014-08-26,14,137,272,409
31780,2014-08-26,15,160,331,491
31781,2014-08-26,16,150,564,714
31782,2014-08-26,17,166,1134,1300
31783,2014-08-26,18,197,1021,1218
31784,2014-08-26,19,145,742,887
31785,2014-08-26,20,85,478,563
31786,2014-08-26,21,79,336,415
31787,2014-08-26,22,61,221,282
31788,2014-08-26,23,31,99,130
31789,2014-08-27,0,18,43,61
31790,2014-08-27,1,5,11,16
31791,2014-08-27,2,2,7,9
31792,2014-08-27,3,2,1,3
31793,2014-08-27,4,4,8,12
31794,2014-08-27,5,3,85,88
31795,2014-08-27,6,15,286,301
31796,2014-08-27,7,39,763,802
31797,2014-08-27,8,55,1027,1082
31798,2014-08-27,9,99,427,526
31799,2014-08-27,10,109,229,338
31800,2014-08-27,11,123,253,376
31801,2014-08-27,12,180,346,526
31802,2014-08-27,13,131,323,454
31803,2014-08-27,14,176,285,461
31804,2014-08-27,15,152,328,480
31805,2014-08-27,16,140,560,700
31806,2014-08-27,17,206,1090,1296
31807,2014-08-27,18,201,1040,1241
31808,2014-08-27,19,167,708,875
31809,2014-08-27,20,84,493,577
31810,2014-08-27,21,88,369,457
31811,2014-08-27,22,47,258,305
31812,2014-08-27,23,30,120,150
31813,2014-08-28,0,22,42,64
31814,2014-08-28,1,11,16,27
31815,2014-08-28,2,0,7,7
31816,2014-08-28,3,0,7,7
31817,2014-08-28,4,0,8,8
31818,2014-08-28,5,1,57,58
31819,2014-08-28,6,14,290,304
31820,2014-08-28,7,33,705,738
31821,2014-08-28,8,59,1007,1066
31822,2014-08-28,9,95,454,549
31823,2014-08-28,10,98,242,340
31824,2014-08-28,11,134,269,403
31825,2014-08-28,12,118,355,473
31826,2014-08-28,13,156,367,523
31827,2014-08-28,14,136,304,440
31828,2014-08-28,15,182,345,527
31829,2014-08-28,16,184,599,783
31830,2014-08-28,17,207,1033,1240
31831,2014-08-28,18,141,1001,1142
31832,2014-08-28,19,131,643,774
31833,2014-08-28,20,99,500,599
31834,2014-08-28,21,92,364,456
31835,2014-08-28,22,72,282,354
31836,2014-08-28,23,31,147,178
31837,2014-08-29,0,11,71,82
31838,2014-08-29,1,8,28,36
31839,2014-08-29,2,7,17,24
31840,2014-08-29,3,1,6,7
31841,2014-08-29,4,0,5,5
31842,2014-08-29,5,1,62,63
31843,2014-08-29,6,17,226,243
31844,2014-08-29,7,29,555,584
31845,2014-08-29,8,64,955,1019
31846,2014-08-29,9,99,494,593
31847,2014-08-29,10,148,265,413
31848,2014-08-29,11,177,292,469
31849,2014-08-29,12,207,422,629
31850,2014-08-29,13,235,442,677
31851,2014-08-29,14,222,483,705
31852,2014-08-29,15,298,636,934
31853,2014-08-29,16,279,741,1020
31854,2014-08-29,17,271,833,1104
31855,2014-08-29,18,222,640,862
31856,2014-08-29,19,164,512,676
31857,2014-08-29,20,138,398,536
31858,2014-08-29,21,121,270,391
31859,2014-08-29,22,65,237,302
31860,2014-08-29,23,63,172,235
31861,2014-08-30,0,31,97,128
31862,2014-08-30,1,29,70,99
31863,2014-08-30,2,19,51,70
31864,2014-08-30,3,10,17,27
31865,2014-08-30,4,5,7,12
31866,2014-08-30,5,13,19,32
31867,2014-08-30,6,15,54,69
31868,2014-08-30,7,28,98,126
31869,2014-08-30,8,53,158,211
31870,2014-08-30,9,131,255,386
31871,2014-08-30,10,244,322,566
31872,2014-08-30,11,314,368,682
31873,2014-08-30,12,416,426,842
31874,2014-08-30,13,437,404,841
31875,2014-08-30,14,441,385,826
31876,2014-08-30,15,481,377,858
31877,2014-08-30,16,518,363,881
31878,2014-08-30,17,442,353,795
31879,2014-08-30,18,412,370,782
31880,2014-08-30,19,305,332,637
31881,2014-08-30,20,212,226,438
31882,2014-08-30,21,158,194,352
31883,2014-08-30,22,134,171,305
31884,2014-08-30,23,95,152,247
31885,2014-08-31,0,50,111,161
31886,2014-08-31,1,32,104,136
31887,2014-08-31,2,10,57,67
31888,2014-08-31,3,4,24,28
31889,2014-08-31,4,4,4,8
31890,2014-08-31,5,4,5,9
31891,2014-08-31,6,4,16,20
31892,2014-08-31,7,31,52,83
31893,2014-08-31,8,74,140,214
31894,2014-08-31,9,195,212,407
31895,2014-08-31,10,370,319,689
31896,2014-08-31,11,438,435,873
31897,2014-08-31,12,441,455,896
31898,2014-08-31,13,498,367,865
31899,2014-08-31,14,471,384,855
31900,2014-08-31,15,479,282,761
31901,2014-08-31,16,464,362,826
31902,2014-08-31,17,419,371,790
31903,2014-08-31,18,311,329,640
31904,2014-08-31,19,132,110,242
31905,2014-08-31,20,29,62,91
31906,2014-08-31,21,24,49,73
31907,2014-08-31,22,14,50,64
31908,2014-08-31,23,49,93,142
31909,2014-09-01,0,36,58,94
31910,2014-09-01,1,12,36,48
31911,2014-09-01,2,7,31,38
31912,2014-09-01,3,1,8,9
31913,2014-09-01,4,1,7,8
31914,2014-09-01,5,4,11,15
31915,2014-09-01,6,8,28,36
31916,2014-09-01,7,21,52,73
31917,2014-09-01,8,68,134,202
31918,2014-09-01,9,160,226,386
31919,2014-09-01,10,279,314,593
31920,2014-09-01,11,325,404,729
31921,2014-09-01,12,345,418,763
31922,2014-09-01,13,334,407,741
31923,2014-09-01,14,343,418,761
31924,2014-09-01,15,358,395,753
31925,2014-09-01,16,192,292,484
31926,2014-09-01,17,197,375,572
31927,2014-09-01,18,188,399,587
31928,2014-09-01,19,179,366,545
31929,2014-09-01,20,95,214,309
31930,2014-09-01,21,71,188,259
31931,2014-09-01,22,56,131,187
31932,2014-09-01,23,25,85,110
31933,2014-09-02,0,11,21,32
31934,2014-09-02,1,7,9,16
31935,2014-09-02,2,3,13,16
31936,2014-09-02,3,1,1,2
31937,2014-09-02,4,1,14,15
31938,2014-09-02,5,3,70,73
31939,2014-09-02,6,17,288,305
31940,2014-09-02,7,31,705,736
31941,2014-09-02,8,37,892,929
31942,2014-09-02,9,64,396,460
31943,2014-09-02,10,94,159,253
31944,2014-09-02,11,123,175,298
31945,2014-09-02,12,99,299,398
31946,2014-09-02,13,125,240,365
31947,2014-09-02,14,122,202,324
31948,2014-09-02,15,101,269,370
31949,2014-09-02,16,120,473,593
31950,2014-09-02,17,133,983,1116
31951,2014-09-02,18,115,950,1065
31952,2014-09-02,19,61,413,474
31953,2014-09-02,20,28,204,232
31954,2014-09-02,21,29,199,228
31955,2014-09-02,22,43,160,203
31956,2014-09-02,23,33,85,118
31957,2014-09-03,0,0,23,23
31958,2014-09-03,1,1,13,14
31959,2014-09-03,2,0,12,12
31960,2014-09-03,3,0,3,3
31961,2014-09-03,4,1,10,11
31962,2014-09-03,5,3,76,79
31963,2014-09-03,6,15,308,323
31964,2014-09-03,7,33,731,764
31965,2014-09-03,8,62,1075,1137
31966,2014-09-03,9,68,382,450
31967,2014-09-03,10,90,199,289
31968,2014-09-03,11,94,219,313
31969,2014-09-03,12,84,317,401
31970,2014-09-03,13,99,316,415
31971,2014-09-03,14,84,267,351
31972,2014-09-03,15,82,307,389
31973,2014-09-03,16,121,545,666
31974,2014-09-03,17,134,1138,1272
31975,2014-09-03,18,138,1033,1171
31976,2014-09-03,19,111,762,873
31977,2014-09-03,20,70,518,588
31978,2014-09-03,21,53,350,403
31979,2014-09-03,22,47,259,306
31980,2014-09-03,23,26,132,158
31981,2014-09-04,0,7,43,50
31982,2014-09-04,1,1,27,28
31983,2014-09-04,2,0,8,8
31984,2014-09-04,3,1,4,5
31985,2014-09-04,4,0,10,10
31986,2014-09-04,5,3,65,68
31987,2014-09-04,6,17,294,311
31988,2014-09-04,7,26,750,776
31989,2014-09-04,8,69,1068,1137
31990,2014-09-04,9,68,421,489
31991,2014-09-04,10,68,204,272
31992,2014-09-04,11,115,227,342
31993,2014-09-04,12,107,348,455
31994,2014-09-04,13,101,350,451
31995,2014-09-04,14,110,267,377
31996,2014-09-04,15,153,333,486
31997,2014-09-04,16,124,542,666
31998,2014-09-04,17,137,1132,1269
31999,2014-09-04,18,150,1041,1191
32000,2014-09-04,19,112,784,896
32001,2014-09-04,20,69,547,616
32002,2014-09-04,21,45,368,413
32003,2014-09-04,22,42,230,272
32004,2014-09-04,23,36,206,242
32005,2014-09-05,0,9,87,96
32006,2014-09-05,1,9,31,40
32007,2014-09-05,2,4,12,16
32008,2014-09-05,3,1,9,10
32009,2014-09-05,4,1,8,9
32010,2014-09-05,5,4,67,71
32011,2014-09-05,6,16,294,310
32012,2014-09-05,7,27,711,738
32013,2014-09-05,8,58,1061,1119
32014,2014-09-05,9,66,443,509
32015,2014-09-05,10,113,264,377
32016,2014-09-05,11,109,292,401
32017,2014-09-05,12,129,339,468
32018,2014-09-05,13,142,378,520
32019,2014-09-05,14,138,341,479
32020,2014-09-05,15,138,370,508
32021,2014-09-05,16,116,576,692
32022,2014-09-05,17,181,1014,1195
32023,2014-09-05,18,138,870,1008
32024,2014-09-05,19,132,696,828
32025,2014-09-05,20,134,434,568
32026,2014-09-05,21,82,327,409
32027,2014-09-05,22,63,292,355
32028,2014-09-05,23,46,230,276
32029,2014-09-06,0,22,182,204
32030,2014-09-06,1,11,124,135
32031,2014-09-06,2,5,71,76
32032,2014-09-06,3,5,30,35
32033,2014-09-06,4,1,14,15
32034,2014-09-06,5,4,13,17
32035,2014-09-06,6,10,50,60
32036,2014-09-06,7,17,116,133
32037,2014-09-06,8,62,245,307
32038,2014-09-06,9,81,345,426
32039,2014-09-06,10,210,429,639
32040,2014-09-06,11,267,567,834
32041,2014-09-06,12,267,537,804
32042,2014-09-06,13,293,531,824
32043,2014-09-06,14,313,502,815
32044,2014-09-06,15,239,501,740
32045,2014-09-06,16,250,413,663
32046,2014-09-06,17,247,474,721
32047,2014-09-06,18,225,491,716
32048,2014-09-06,19,85,230,315
32049,2014-09-06,20,46,155,201
32050,2014-09-06,21,43,180,223
32051,2014-09-06,22,44,176,220
32052,2014-09-06,23,32,158,190
32053,2014-09-07,0,31,159,190
32054,2014-09-07,1,11,91,102
32055,2014-09-07,2,10,85,95
32056,2014-09-07,3,2,34,36
32057,2014-09-07,4,3,14,17
32058,2014-09-07,5,20,47,67
32059,2014-09-07,6,23,58,81
32060,2014-09-07,7,32,80,112
32061,2014-09-07,8,80,198,278
32062,2014-09-07,9,140,342,482
32063,2014-09-07,10,231,477,708
32064,2014-09-07,11,325,599,924
32065,2014-09-07,12,334,748,1082
32066,2014-09-07,13,309,571,880
32067,2014-09-07,14,327,574,901
32068,2014-09-07,15,315,544,859
32069,2014-09-07,16,332,670,1002
32070,2014-09-07,17,306,596,902
32071,2014-09-07,18,252,564,816
32072,2014-09-07,19,184,460,644
32073,2014-09-07,20,129,285,414
32074,2014-09-07,21,110,208,318
32075,2014-09-07,22,85,134,219
32076,2014-09-07,23,31,69,100
32077,2014-09-08,0,14,30,44
32078,2014-09-08,1,1,13,14
32079,2014-09-08,2,0,6,6
32080,2014-09-08,3,0,9,9
32081,2014-09-08,4,0,11,11
32082,2014-09-08,5,2,63,65
32083,2014-09-08,6,12,298,310
32084,2014-09-08,7,27,765,792
32085,2014-09-08,8,54,1054,1108
32086,2014-09-08,9,72,399,471
32087,2014-09-08,10,94,200,294
32088,2014-09-08,11,157,243,400
32089,2014-09-08,12,173,271,444
32090,2014-09-08,13,167,263,430
32091,2014-09-08,14,136,251,387
32092,2014-09-08,15,133,272,405
32093,2014-09-08,16,141,532,673
32094,2014-09-08,17,147,1156,1303
32095,2014-09-08,18,139,1035,1174
32096,2014-09-08,19,97,684,781
32097,2014-09-08,20,47,433,480
32098,2014-09-08,21,64,337,401
32099,2014-09-08,22,33,234,267
32100,2014-09-08,23,18,89,107
32101,2014-09-09,0,7,33,40
32102,2014-09-09,1,12,14,26
32103,2014-09-09,2,3,4,7
32104,2014-09-09,3,0,5,5
32105,2014-09-09,4,1,7,8
32106,2014-09-09,5,3,80,83
32107,2014-09-09,6,11,322,333
32108,2014-09-09,7,36,871,907
32109,2014-09-09,8,61,1092,1153
32110,2014-09-09,9,47,411,458
32111,2014-09-09,10,96,217,313
32112,2014-09-09,11,99,215,314
32113,2014-09-09,12,92,322,414
32114,2014-09-09,13,128,291,419
32115,2014-09-09,14,92,291,383
32116,2014-09-09,15,90,335,425
32117,2014-09-09,16,90,603,693
32118,2014-09-09,17,165,1290,1455
32119,2014-09-09,18,143,1102,1245
32120,2014-09-09,19,103,711,814
32121,2014-09-09,20,65,441,506
32122,2014-09-09,21,54,366,420
32123,2014-09-09,22,53,361,414
32124,2014-09-09,23,20,123,143
32125,2014-09-10,0,5,55,60
32126,2014-09-10,1,10,15,25
32127,2014-09-10,2,0,8,8
32128,2014-09-10,3,0,2,2
32129,2014-09-10,4,1,9,10
32130,2014-09-10,5,2,90,92
32131,2014-09-10,6,12,333,345
32132,2014-09-10,7,29,851,880
32133,2014-09-10,8,48,1096,1144
32134,2014-09-10,9,54,420,474
32135,2014-09-10,10,75,246,321
32136,2014-09-10,11,83,239,322
32137,2014-09-10,12,73,335,408
32138,2014-09-10,13,79,305,384
32139,2014-09-10,14,101,279,380
32140,2014-09-10,15,88,435,523
32141,2014-09-10,16,91,639,730
32142,2014-09-10,17,141,1214,1355
32143,2014-09-10,18,151,1156,1307
32144,2014-09-10,19,108,794,902
32145,2014-09-10,20,81,511,592
32146,2014-09-10,21,75,401,476
32147,2014-09-10,22,53,255,308
32148,2014-09-10,23,43,141,184
32149,2014-09-11,0,13,58,71
32150,2014-09-11,1,8,18,26
32151,2014-09-11,2,0,8,8
32152,2014-09-11,3,1,6,7
32153,2014-09-11,4,3,11,14
32154,2014-09-11,5,4,71,75
32155,2014-09-11,6,16,301,317
32156,2014-09-11,7,30,837,867
32157,2014-09-11,8,53,1063,1116
32158,2014-09-11,9,58,477,535
32159,2014-09-11,10,79,248,327
32160,2014-09-11,11,74,286,360
32161,2014-09-11,12,105,361,466
32162,2014-09-11,13,79,332,411
32163,2014-09-11,14,98,313,411
32164,2014-09-11,15,94,354,448
32165,2014-09-11,16,95,548,643
32166,2014-09-11,17,138,1190,1328
32167,2014-09-11,18,121,1137,1258
32168,2014-09-11,19,99,746,845
32169,2014-09-11,20,71,522,593
32170,2014-09-11,21,40,339,379
32171,2014-09-11,22,25,274,299
32172,2014-09-11,23,21,172,193
32173,2014-09-12,0,14,86,100
32174,2014-09-12,1,2,37,39
32175,2014-09-12,2,8,20,28
32176,2014-09-12,3,1,10,11
32177,2014-09-12,4,6,5,11
32178,2014-09-12,5,1,69,70
32179,2014-09-12,6,5,292,297
32180,2014-09-12,7,35,748,783
32181,2014-09-12,8,52,1039,1091
32182,2014-09-12,9,68,475,543
32183,2014-09-12,10,110,253,363
32184,2014-09-12,11,140,323,463
32185,2014-09-12,12,164,445,609
32186,2014-09-12,13,186,456,642
32187,2014-09-12,14,190,408,598
32188,2014-09-12,15,210,441,651
32189,2014-09-12,16,220,669,889
32190,2014-09-12,17,220,1117,1337
32191,2014-09-12,18,186,1008,1194
32192,2014-09-12,19,137,716,853
32193,2014-09-12,20,92,472,564
32194,2014-09-12,21,57,372,429
32195,2014-09-12,22,55,291,346
32196,2014-09-12,23,34,234,268
32197,2014-09-13,0,31,171,202
32198,2014-09-13,1,15,95,110
32199,2014-09-13,2,12,60,72
32200,2014-09-13,3,7,42,49
32201,2014-09-13,4,6,11,17
32202,2014-09-13,5,0,23,23
32203,2014-09-13,6,3,40,43
32204,2014-09-13,7,27,124,151
32205,2014-09-13,8,50,271,321
32206,2014-09-13,9,131,403,534
32207,2014-09-13,10,184,488,672
32208,2014-09-13,11,155,410,565
32209,2014-09-13,12,156,367,523
32210,2014-09-13,13,72,193,265
32211,2014-09-13,14,54,134,188
32212,2014-09-13,15,137,323,460
32213,2014-09-13,16,182,398,580
32214,2014-09-13,17,228,504,732
32215,2014-09-13,18,244,533,777
32216,2014-09-13,19,166,443,609
32217,2014-09-13,20,108,324,432
32218,2014-09-13,21,82,267,349
32219,2014-09-13,22,50,210,260
32220,2014-09-13,23,47,225,272
32221,2014-09-14,0,47,163,210
32222,2014-09-14,1,43,133,176
32223,2014-09-14,2,42,89,131
32224,2014-09-14,3,26,48,74
32225,2014-09-14,4,3,22,25
32226,2014-09-14,5,3,17,20
32227,2014-09-14,6,13,57,70
32228,2014-09-14,7,27,72,99
32229,2014-09-14,8,69,203,272
32230,2014-09-14,9,121,358,479
32231,2014-09-14,10,244,491,735
32232,2014-09-14,11,322,601,923
32233,2014-09-14,12,364,676,1040
32234,2014-09-14,13,406,627,1033
32235,2014-09-14,14,383,632,1015
32236,2014-09-14,15,412,622,1034
32237,2014-09-14,16,410,663,1073
32238,2014-09-14,17,366,592,958
32239,2014-09-14,18,337,550,887
32240,2014-09-14,19,181,490,671
32241,2014-09-14,20,105,298,403
32242,2014-09-14,21,84,206,290
32243,2014-09-14,22,48,147,195
32244,2014-09-14,23,30,68,98
32245,2014-09-15,0,1,32,33
32246,2014-09-15,1,2,12,14
32247,2014-09-15,2,2,8,10
32248,2014-09-15,3,0,5,5
32249,2014-09-15,4,0,9,9
32250,2014-09-15,5,2,73,75
32251,2014-09-15,6,7,292,299
32252,2014-09-15,7,35,811,846
32253,2014-09-15,8,53,1049,1102
32254,2014-09-15,9,67,389,456
32255,2014-09-15,10,109,185,294
32256,2014-09-15,11,117,266,383
32257,2014-09-15,12,161,348,509
32258,2014-09-15,13,152,359,511
32259,2014-09-15,14,177,313,490
32260,2014-09-15,15,163,364,527
32261,2014-09-15,16,175,655,830
32262,2014-09-15,17,183,1230,1413
32263,2014-09-15,18,134,1154,1288
32264,2014-09-15,19,138,778,916
32265,2014-09-15,20,84,513,597
32266,2014-09-15,21,51,328,379
32267,2014-09-15,22,35,199,234
32268,2014-09-15,23,13,115,128
32269,2014-09-16,0,12,51,63
32270,2014-09-16,1,5,24,29
32271,2014-09-16,2,2,4,6
32272,2014-09-16,3,0,5,5
32273,2014-09-16,4,2,11,13
32274,2014-09-16,5,2,77,79
32275,2014-09-16,6,12,339,351
32276,2014-09-16,7,40,942,982
32277,2014-09-16,8,61,1140,1201
32278,2014-09-16,9,97,469,566
32279,2014-09-16,10,97,236,333
32280,2014-09-16,11,114,285,399
32281,2014-09-16,12,132,379,511
32282,2014-09-16,13,147,315,462
32283,2014-09-16,14,134,290,424
32284,2014-09-16,15,165,396,561
32285,2014-09-16,16,167,627,794
32286,2014-09-16,17,215,1287,1502
32287,2014-09-16,18,185,1246,1431
32288,2014-09-16,19,124,798,922
32289,2014-09-16,20,87,536,623
32290,2014-09-16,21,59,386,445
32291,2014-09-16,22,35,260,295
32292,2014-09-16,23,11,126,137
32293,2014-09-17,0,5,44,49
32294,2014-09-17,1,4,19,23
32295,2014-09-17,2,0,9,9
32296,2014-09-17,3,0,5,5
32297,2014-09-17,4,1,12,13
32298,2014-09-17,5,2,77,79
32299,2014-09-17,6,6,351,357
32300,2014-09-17,7,41,896,937
32301,2014-09-17,8,53,1157,1210
32302,2014-09-17,9,64,425,489
32303,2014-09-17,10,117,231,348
32304,2014-09-17,11,121,265,386
32305,2014-09-17,12,129,349,478
32306,2014-09-17,13,167,348,515
32307,2014-09-17,14,122,307,429
32308,2014-09-17,15,142,387,529
32309,2014-09-17,16,152,632,784
32310,2014-09-17,17,159,1241,1400
32311,2014-09-17,18,126,1156,1282
32312,2014-09-17,19,109,788,897
32313,2014-09-17,20,61,505,566
32314,2014-09-17,21,67,368,435
32315,2014-09-17,22,30,242,272
32316,2014-09-17,23,15,126,141
32317,2014-09-18,0,7,45,52
32318,2014-09-18,1,3,22,25
32319,2014-09-18,2,1,2,3
32320,2014-09-18,3,2,3,5
32321,2014-09-18,4,0,13,13
32322,2014-09-18,5,3,75,78
32323,2014-09-18,6,6,315,321
32324,2014-09-18,7,34,844,878
32325,2014-09-18,8,41,1106,1147
32326,2014-09-18,9,53,476,529
32327,2014-09-18,10,73,221,294
32328,2014-09-18,11,111,280,391
32329,2014-09-18,12,92,404,496
32330,2014-09-18,13,127,395,522
32331,2014-09-18,14,111,368,479
32332,2014-09-18,15,122,379,501
32333,2014-09-18,16,141,639,780
32334,2014-09-18,17,149,1222,1371
32335,2014-09-18,18,130,1111,1241
32336,2014-09-18,19,96,795,891
32337,2014-09-18,20,56,486,542
32338,2014-09-18,21,45,407,452
32339,2014-09-18,22,33,283,316
32340,2014-09-18,23,11,168,179
32341,2014-09-19,0,13,80,93
32342,2014-09-19,1,3,44,47
32343,2014-09-19,2,5,22,27
32344,2014-09-19,3,2,5,7
32345,2014-09-19,4,2,15,17
32346,2014-09-19,5,4,79,83
32347,2014-09-19,6,14,296,310
32348,2014-09-19,7,27,711,738
32349,2014-09-19,8,50,1091,1141
32350,2014-09-19,9,59,503,562
32351,2014-09-19,10,93,263,356
32352,2014-09-19,11,124,342,466
32353,2014-09-19,12,176,430,606
32354,2014-09-19,13,161,458,619
32355,2014-09-19,14,191,400,591
32356,2014-09-19,15,200,461,661
32357,2014-09-19,16,205,703,908
32358,2014-09-19,17,209,1105,1314
32359,2014-09-19,18,148,958,1106
32360,2014-09-19,19,142,642,784
32361,2014-09-19,20,65,393,458
32362,2014-09-19,21,46,327,373
32363,2014-09-19,22,34,313,347
32364,2014-09-19,23,44,195,239
32365,2014-09-20,0,28,168,196
32366,2014-09-20,1,17,117,134
32367,2014-09-20,2,12,76,88
32368,2014-09-20,3,8,28,36
32369,2014-09-20,4,5,11,16
32370,2014-09-20,5,1,13,14
32371,2014-09-20,6,5,37,42
32372,2014-09-20,7,20,124,144
32373,2014-09-20,8,52,272,324
32374,2014-09-20,9,166,413,579
32375,2014-09-20,10,276,553,829
32376,2014-09-20,11,368,593,961
32377,2014-09-20,12,393,644,1037
32378,2014-09-20,13,449,683,1132
32379,2014-09-20,14,425,626,1051
32380,2014-09-20,15,454,572,1026
32381,2014-09-20,16,426,561,987
32382,2014-09-20,17,398,585,983
32383,2014-09-20,18,323,574,897
32384,2014-09-20,19,261,533,794
32385,2014-09-20,20,140,304,444
32386,2014-09-20,21,110,305,415
32387,2014-09-20,22,94,212,306
32388,2014-09-20,23,41,201,242
32389,2014-09-21,0,44,186,230
32390,2014-09-21,1,27,121,148
32391,2014-09-21,2,14,97,111
32392,2014-09-21,3,19,38,57
32393,2014-09-21,4,0,10,10
32394,2014-09-21,5,4,11,15
32395,2014-09-21,6,6,24,30
32396,2014-09-21,7,31,76,107
32397,2014-09-21,8,72,183,255
32398,2014-09-21,9,158,316,474
32399,2014-09-21,10,242,523,765
32400,2014-09-21,11,294,562,856
32401,2014-09-21,12,295,686,981
32402,2014-09-21,13,348,582,930
32403,2014-09-21,14,316,524,840
32404,2014-09-21,15,299,558,857
32405,2014-09-21,16,330,605,935
32406,2014-09-21,17,298,575,873
32407,2014-09-21,18,228,542,770
32408,2014-09-21,19,162,406,568
32409,2014-09-21,20,75,284,359
32410,2014-09-21,21,73,174,247
32411,2014-09-21,22,59,154,213
32412,2014-09-21,23,27,78,105
32413,2014-09-22,0,21,40,61
32414,2014-09-22,1,4,12,16
32415,2014-09-22,2,4,4,8
32416,2014-09-22,3,2,7,9
32417,2014-09-22,4,1,13,14
32418,2014-09-22,5,1,92,93
32419,2014-09-22,6,9,273,282
32420,2014-09-22,7,40,815,855
32421,2014-09-22,8,52,1102,1154
32422,2014-09-22,9,76,449,525
32423,2014-09-22,10,92,209,301
32424,2014-09-22,11,138,262,400
32425,2014-09-22,12,121,342,463
32426,2014-09-22,13,93,339,432
32427,2014-09-22,14,112,315,427
32428,2014-09-22,15,111,347,458
32429,2014-09-22,16,158,648,806
32430,2014-09-22,17,187,1273,1460
32431,2014-09-22,18,118,1159,1277
32432,2014-09-22,19,78,684,762
32433,2014-09-22,20,52,454,506
32434,2014-09-22,21,50,305,355
32435,2014-09-22,22,38,208,246
32436,2014-09-22,23,5,85,90
32437,2014-09-23,0,5,41,46
32438,2014-09-23,1,2,11,13
32439,2014-09-23,2,0,5,5
32440,2014-09-23,3,0,1,1
32441,2014-09-23,4,0,5,5
32442,2014-09-23,5,3,79,82
32443,2014-09-23,6,8,354,362
32444,2014-09-23,7,29,873,902
32445,2014-09-23,8,53,1162,1215
32446,2014-09-23,9,53,467,520
32447,2014-09-23,10,85,252,337
32448,2014-09-23,11,95,272,367
32449,2014-09-23,12,98,358,456
32450,2014-09-23,13,107,361,468
32451,2014-09-23,14,107,329,436
32452,2014-09-23,15,108,388,496
32453,2014-09-23,16,113,649,762
32454,2014-09-23,17,140,1332,1472
32455,2014-09-23,18,131,1207,1338
32456,2014-09-23,19,91,767,858
32457,2014-09-23,20,65,497,562
32458,2014-09-23,21,32,375,407
32459,2014-09-23,22,26,303,329
32460,2014-09-23,23,15,136,151
32461,2014-09-24,0,8,46,54
32462,2014-09-24,1,1,11,12
32463,2014-09-24,2,1,10,11
32464,2014-09-24,3,4,1,5
32465,2014-09-24,4,0,9,9
32466,2014-09-24,5,1,78,79
32467,2014-09-24,6,6,299,305
32468,2014-09-24,7,23,845,868
32469,2014-09-24,8,48,1196,1244
32470,2014-09-24,9,43,480,523
32471,2014-09-24,10,102,249,351
32472,2014-09-24,11,117,305,422
32473,2014-09-24,12,111,390,501
32474,2014-09-24,13,102,353,455
32475,2014-09-24,14,129,277,406
32476,2014-09-24,15,118,390,508
32477,2014-09-24,16,100,619,719
32478,2014-09-24,17,98,1041,1139
32479,2014-09-24,18,42,488,530
32480,2014-09-24,19,23,323,346
32481,2014-09-24,20,16,282,298
32482,2014-09-24,21,9,250,259
32483,2014-09-24,22,7,155,162
32484,2014-09-24,23,3,100,103
32485,2014-09-25,0,4,28,32
32486,2014-09-25,1,1,4,5
32487,2014-09-25,2,0,3,3
32488,2014-09-25,3,0,2,2
32489,2014-09-25,4,0,2,2
32490,2014-09-25,5,0,24,24
32491,2014-09-25,6,0,66,66
32492,2014-09-25,7,1,190,191
32493,2014-09-25,8,12,446,458
32494,2014-09-25,9,21,318,339
32495,2014-09-25,10,20,106,126
32496,2014-09-25,11,17,123,140
32497,2014-09-25,12,9,133,142
32498,2014-09-25,13,18,149,167
32499,2014-09-25,14,33,157,190
32500,2014-09-25,15,37,288,325
32501,2014-09-25,16,67,487,554
32502,2014-09-25,17,66,962,1028
32503,2014-09-25,18,41,928,969
32504,2014-09-25,19,30,567,597
32505,2014-09-25,20,40,394,434
32506,2014-09-25,21,28,293,321
32507,2014-09-25,22,34,304,338
32508,2014-09-25,23,39,153,192
32509,2014-09-26,0,16,84,100
32510,2014-09-26,1,7,32,39
32511,2014-09-26,2,3,17,20
32512,2014-09-26,3,1,6,7
32513,2014-09-26,4,0,7,7
32514,2014-09-26,5,1,68,69
32515,2014-09-26,6,7,259,266
32516,2014-09-26,7,23,655,678
32517,2014-09-26,8,47,1102,1149
32518,2014-09-26,9,87,482,569
32519,2014-09-26,10,102,292,394
32520,2014-09-26,11,188,394,582
32521,2014-09-26,12,185,480,665
32522,2014-09-26,13,177,439,616
32523,2014-09-26,14,247,415,662
32524,2014-09-26,15,218,466,684
32525,2014-09-26,16,211,654,865
32526,2014-09-26,17,171,1209,1380
32527,2014-09-26,18,189,990,1179
32528,2014-09-26,19,108,597,705
32529,2014-09-26,20,84,392,476
32530,2014-09-26,21,76,313,389
32531,2014-09-26,22,56,313,369
32532,2014-09-26,23,45,213,258
32533,2014-09-27,0,20,147,167
32534,2014-09-27,1,16,88,104
32535,2014-09-27,2,3,93,96
32536,2014-09-27,3,4,43,47
32537,2014-09-27,4,0,9,9
32538,2014-09-27,5,4,9,13
32539,2014-09-27,6,4,49,53
32540,2014-09-27,7,21,132,153
32541,2014-09-27,8,57,255,312
32542,2014-09-27,9,152,374,526
32543,2014-09-27,10,276,516,792
32544,2014-09-27,11,361,542,903
32545,2014-09-27,12,399,648,1047
32546,2014-09-27,13,463,624,1087
32547,2014-09-27,14,456,658,1114
32548,2014-09-27,15,439,613,1052
32549,2014-09-27,16,444,583,1027
32550,2014-09-27,17,385,587,972
32551,2014-09-27,18,321,535,856
32552,2014-09-27,19,208,518,726
32553,2014-09-27,20,140,371,511
32554,2014-09-27,21,106,294,400
32555,2014-09-27,22,80,261,341
32556,2014-09-27,23,62,253,315
32557,2014-09-28,0,49,206,255
32558,2014-09-28,1,21,151,172
32559,2014-09-28,2,11,107,118
32560,2014-09-28,3,12,48,60
32561,2014-09-28,4,3,12,15
32562,2014-09-28,5,1,10,11
32563,2014-09-28,6,2,24,26
32564,2014-09-28,7,14,60,74
32565,2014-09-28,8,67,157,224
32566,2014-09-28,9,124,317,441
32567,2014-09-28,10,260,418,678
32568,2014-09-28,11,324,556,880
32569,2014-09-28,12,341,690,1031
32570,2014-09-28,13,366,593,959
32571,2014-09-28,14,340,486,826
32572,2014-09-28,15,342,542,884
32573,2014-09-28,16,327,609,936
32574,2014-09-28,17,320,553,873
32575,2014-09-28,18,239,546,785
32576,2014-09-28,19,165,453,618
32577,2014-09-28,20,107,341,448
32578,2014-09-28,21,94,206,300
32579,2014-09-28,22,55,144,199
32580,2014-09-28,23,18,69,87
32581,2014-09-29,0,5,20,25
32582,2014-09-29,1,7,13,20
32583,2014-09-29,2,3,7,10
32584,2014-09-29,3,0,7,7
32585,2014-09-29,4,1,7,8
32586,2014-09-29,5,0,80,80
32587,2014-09-29,6,3,256,259
32588,2014-09-29,7,28,789,817
32589,2014-09-29,8,51,1088,1139
32590,2014-09-29,9,67,411,478
32591,2014-09-29,10,137,204,341
32592,2014-09-29,11,157,227,384
32593,2014-09-29,12,126,314,440
32594,2014-09-29,13,154,312,466
32595,2014-09-29,14,144,269,413
32596,2014-09-29,15,115,342,457
32597,2014-09-29,16,157,580,737
32598,2014-09-29,17,142,1217,1359
32599,2014-09-29,18,109,1114,1223
32600,2014-09-29,19,64,704,768
32601,2014-09-29,20,50,470,520
32602,2014-09-29,21,37,315,352
32603,2014-09-29,22,11,186,197
32604,2014-09-29,23,19,107,126
32605,2014-09-30,0,4,33,37
32606,2014-09-30,1,1,15,16
32607,2014-09-30,2,2,9,11
32608,2014-09-30,3,0,2,2
32609,2014-09-30,4,0,11,11
32610,2014-09-30,5,5,78,83
32611,2014-09-30,6,2,325,327
32612,2014-09-30,7,16,901,917
32613,2014-09-30,8,62,1230,1292
32614,2014-09-30,9,53,519,572
32615,2014-09-30,10,100,274,374
32616,2014-09-30,11,96,286,382
32617,2014-09-30,12,112,358,470
32618,2014-09-30,13,95,367,462
32619,2014-09-30,14,127,303,430
32620,2014-09-30,15,146,417,563
32621,2014-09-30,16,154,631,785
32622,2014-09-30,17,120,1256,1376
32623,2014-09-30,18,103,1181,1284
32624,2014-09-30,19,81,794,875
32625,2014-09-30,20,55,523,578
32626,2014-09-30,21,44,398,442
32627,2014-09-30,22,28,183,211
32628,2014-09-30,23,10,98,108
32629,2014-10-01,0,3,25,28
32630,2014-10-01,1,2,20,22
32631,2014-10-01,2,1,12,13
32632,2014-10-01,3,0,4,4
32633,2014-10-01,4,2,8,10
32634,2014-10-01,5,1,97,98
32635,2014-10-01,6,3,183,186
32636,2014-10-01,7,15,574,589
32637,2014-10-01,8,36,943,979
32638,2014-10-01,9,43,463,506
32639,2014-10-01,10,92,251,343
32640,2014-10-01,11,83,252,335
32641,2014-10-01,12,101,331,432
32642,2014-10-01,13,77,334,411
32643,2014-10-01,14,93,306,399
32644,2014-10-01,15,96,353,449
32645,2014-10-01,16,113,674,787
32646,2014-10-01,17,155,1312,1467
32647,2014-10-01,18,109,1094,1203
32648,2014-10-01,19,89,763,852
32649,2014-10-01,20,54,474,528
32650,2014-10-01,21,28,422,450
32651,2014-10-01,22,20,283,303
32652,2014-10-01,23,13,143,156
32653,2014-10-02,0,9,41,50
32654,2014-10-02,1,2,20,22
32655,2014-10-02,2,0,7,7
32656,2014-10-02,3,0,2,2
32657,2014-10-02,4,2,12,14
32658,2014-10-02,5,3,71,74
32659,2014-10-02,6,6,307,313
32660,2014-10-02,7,22,804,826
32661,2014-10-02,8,38,1180,1218
32662,2014-10-02,9,67,433,500
32663,2014-10-02,10,88,227,315
32664,2014-10-02,11,135,308,443
32665,2014-10-02,12,96,349,445
32666,2014-10-02,13,103,368,471
32667,2014-10-02,14,118,342,460
32668,2014-10-02,15,147,424,571
32669,2014-10-02,16,135,664,799
32670,2014-10-02,17,175,1290,1465
32671,2014-10-02,18,113,1118,1231
32672,2014-10-02,19,78,803,881
32673,2014-10-02,20,73,499,572
32674,2014-10-02,21,44,449,493
32675,2014-10-02,22,29,289,318
32676,2014-10-02,23,21,185,206
32677,2014-10-03,0,14,81,95
32678,2014-10-03,1,9,43,52
32679,2014-10-03,2,2,15,17
32680,2014-10-03,3,1,9,10
32681,2014-10-03,4,2,17,19
32682,2014-10-03,5,2,77,79
32683,2014-10-03,6,6,270,276
32684,2014-10-03,7,20,734,754
32685,2014-10-03,8,57,1143,1200
32686,2014-10-03,9,96,494,590
32687,2014-10-03,10,96,302,398
32688,2014-10-03,11,132,336,468
32689,2014-10-03,12,146,442,588
32690,2014-10-03,13,192,461,653
32691,2014-10-03,14,175,464,639
32692,2014-10-03,15,145,438,583
32693,2014-10-03,16,136,635,771
32694,2014-10-03,17,159,1067,1226
32695,2014-10-03,18,94,783,877
32696,2014-10-03,19,123,725,848
32697,2014-10-03,20,44,261,305
32698,2014-10-03,21,11,131,142
32699,2014-10-03,22,17,173,190
32700,2014-10-03,23,8,113,121
32701,2014-10-04,0,1,72,73
32702,2014-10-04,1,4,86,90
32703,2014-10-04,2,6,42,48
32704,2014-10-04,3,10,21,31
32705,2014-10-04,4,8,9,17
32706,2014-10-04,5,3,18,21
32707,2014-10-04,6,12,44,56
32708,2014-10-04,7,9,99,108
32709,2014-10-04,8,41,210,251
32710,2014-10-04,9,107,384,491
32711,2014-10-04,10,189,470,659
32712,2014-10-04,11,278,526,804
32713,2014-10-04,12,338,602,940
32714,2014-10-04,13,355,657,1012
32715,2014-10-04,14,349,551,900
32716,2014-10-04,15,412,665,1077
32717,2014-10-04,16,356,635,991
32718,2014-10-04,17,325,585,910
32719,2014-10-04,18,251,491,742
32720,2014-10-04,19,98,345,443
32721,2014-10-04,20,80,239,319
32722,2014-10-04,21,59,165,224
32723,2014-10-04,22,46,193,239
32724,2014-10-04,23,32,162,194
32725,2014-10-05,0,37,230,267
32726,2014-10-05,1,18,97,115
32727,2014-10-05,2,12,73,85
32728,2014-10-05,3,6,34,40
32729,2014-10-05,4,6,11,17
32730,2014-10-05,5,1,16,17
32731,2014-10-05,6,3,16,19
32732,2014-10-05,7,8,69,77
32733,2014-10-05,8,26,160,186
32734,2014-10-05,9,91,276,367
32735,2014-10-05,10,204,423,627
32736,2014-10-05,11,271,482,753
32737,2014-10-05,12,317,611,928
32738,2014-10-05,13,264,585,849
32739,2014-10-05,14,265,609,874
32740,2014-10-05,15,305,546,851
32741,2014-10-05,16,287,530,817
32742,2014-10-05,17,279,561,840
32743,2014-10-05,18,144,508,652
32744,2014-10-05,19,86,358,444
32745,2014-10-05,20,83,262,345
32746,2014-10-05,21,35,160,195
32747,2014-10-05,22,42,143,185
32748,2014-10-05,23,19,77,96
32749,2014-10-06,0,21,33,54
32750,2014-10-06,1,9,14,23
32751,2014-10-06,2,10,7,17
32752,2014-10-06,3,1,1,2
32753,2014-10-06,4,2,8,10
32754,2014-10-06,5,1,80,81
32755,2014-10-06,6,1,266,267
32756,2014-10-06,7,21,756,777
32757,2014-10-06,8,57,1006,1063
32758,2014-10-06,9,65,407,472
32759,2014-10-06,10,89,199,288
32760,2014-10-06,11,107,239,346
32761,2014-10-06,12,130,341,471
32762,2014-10-06,13,161,320,481
32763,2014-10-06,14,178,274,452
32764,2014-10-06,15,150,341,491
32765,2014-10-06,16,176,684,860
32766,2014-10-06,17,168,1291,1459
32767,2014-10-06,18,115,1065,1180
32768,2014-10-06,19,68,656,724
32769,2014-10-06,20,58,415,473
32770,2014-10-06,21,22,292,314
32771,2014-10-06,22,33,206,239
32772,2014-10-06,23,12,99,111
32773,2014-10-07,0,17,46,63
32774,2014-10-07,1,6,18,24
32775,2014-10-07,2,1,6,7
32776,2014-10-07,3,2,4,6
32777,2014-10-07,4,1,12,13
32778,2014-10-07,5,1,79,80
32779,2014-10-07,6,3,305,308
32780,2014-10-07,7,30,804,834
32781,2014-10-07,8,43,1179,1222
32782,2014-10-07,9,69,446,515
32783,2014-10-07,10,83,198,281
32784,2014-10-07,11,74,203,277
32785,2014-10-07,12,71,273,344
32786,2014-10-07,13,95,230,325
32787,2014-10-07,14,84,222,306
32788,2014-10-07,15,100,348,448
32789,2014-10-07,16,116,622,738
32790,2014-10-07,17,148,1206,1354
32791,2014-10-07,18,94,1053,1147
32792,2014-10-07,19,47,451,498
32793,2014-10-07,20,15,253,268
32794,2014-10-07,21,13,244,257
32795,2014-10-07,22,4,64,68
32796,2014-10-07,23,5,76,81
32797,2014-10-08,0,6,56,62
32798,2014-10-08,1,0,19,19
32799,2014-10-08,2,3,10,13
32800,2014-10-08,3,0,3,3
32801,2014-10-08,4,0,13,13
32802,2014-10-08,5,2,99,101
32803,2014-10-08,6,9,334,343
32804,2014-10-08,7,25,817,842
32805,2014-10-08,8,41,1166,1207
32806,2014-10-08,9,70,453,523
32807,2014-10-08,10,104,224,328
32808,2014-10-08,11,105,265,370
32809,2014-10-08,12,97,344,441
32810,2014-10-08,13,104,326,430
32811,2014-10-08,14,82,336,418
32812,2014-10-08,15,132,393,525
32813,2014-10-08,16,140,654,794
32814,2014-10-08,17,142,1255,1397
32815,2014-10-08,18,109,1132,1241
32816,2014-10-08,19,91,687,778
32817,2014-10-08,20,53,472,525
32818,2014-10-08,21,55,376,431
32819,2014-10-08,22,38,255,293
32820,2014-10-08,23,26,137,163
32821,2014-10-09,0,10,44,54
32822,2014-10-09,1,0,22,22
32823,2014-10-09,2,2,7,9
32824,2014-10-09,3,2,4,6
32825,2014-10-09,4,0,9,9
32826,2014-10-09,5,1,82,83
32827,2014-10-09,6,6,280,286
32828,2014-10-09,7,16,781,797
32829,2014-10-09,8,44,1124,1168
32830,2014-10-09,9,64,481,545
32831,2014-10-09,10,116,241,357
32832,2014-10-09,11,100,303,403
32833,2014-10-09,12,158,357,515
32834,2014-10-09,13,119,371,490
32835,2014-10-09,14,158,307,465
32836,2014-10-09,15,130,375,505
32837,2014-10-09,16,151,640,791
32838,2014-10-09,17,160,1192,1352
32839,2014-10-09,18,131,1089,1220
32840,2014-10-09,19,66,681,747
32841,2014-10-09,20,55,426,481
32842,2014-10-09,21,49,327,376
32843,2014-10-09,22,55,307,362
32844,2014-10-09,23,21,166,187
32845,2014-10-10,0,14,88,102
32846,2014-10-10,1,3,30,33
32847,2014-10-10,2,10,22,32
32848,2014-10-10,3,1,5,6
32849,2014-10-10,4,0,10,10
32850,2014-10-10,5,4,67,71
32851,2014-10-10,6,8,216,224
32852,2014-10-10,7,24,565,589
32853,2014-10-10,8,49,1034,1083
32854,2014-10-10,9,85,533,618
32855,2014-10-10,10,122,266,388
32856,2014-10-10,11,170,288,458
32857,2014-10-10,12,64,226,290
32858,2014-10-10,13,88,215,303
32859,2014-10-10,14,101,215,316
32860,2014-10-10,15,119,213,332
32861,2014-10-10,16,104,409,513
32862,2014-10-10,17,102,752,854
32863,2014-10-10,18,77,680,757
32864,2014-10-10,19,53,455,508
32865,2014-10-10,20,47,231,278
32866,2014-10-10,21,38,159,197
32867,2014-10-10,22,12,89,101
32868,2014-10-10,23,7,71,78
32869,2014-10-11,0,6,59,65
32870,2014-10-11,1,7,57,64
32871,2014-10-11,2,2,42,44
32872,2014-10-11,3,5,16,21
32873,2014-10-11,4,0,9,9
32874,2014-10-11,5,1,6,7
32875,2014-10-11,6,1,11,12
32876,2014-10-11,7,1,20,21
32877,2014-10-11,8,8,69,77
32878,2014-10-11,9,43,110,153
32879,2014-10-11,10,37,148,185
32880,2014-10-11,11,51,235,286
32881,2014-10-11,12,105,251,356
32882,2014-10-11,13,77,295,372
32883,2014-10-11,14,134,317,451
32884,2014-10-11,15,202,384,586
32885,2014-10-11,16,197,392,589
32886,2014-10-11,17,211,368,579
32887,2014-10-11,18,164,361,525
32888,2014-10-11,19,80,262,342
32889,2014-10-11,20,80,210,290
32890,2014-10-11,21,72,192,264
32891,2014-10-11,22,48,170,218
32892,2014-10-11,23,40,141,181
32893,2014-10-12,0,29,127,156
32894,2014-10-12,1,18,98,116
32895,2014-10-12,2,8,70,78
32896,2014-10-12,3,4,34,38
32897,2014-10-12,4,2,12,14
32898,2014-10-12,5,0,9,9
32899,2014-10-12,6,6,36,42
32900,2014-10-12,7,17,65,82
32901,2014-10-12,8,24,161,185
32902,2014-10-12,9,105,253,358
32903,2014-10-12,10,230,370,600
32904,2014-10-12,11,346,510,856
32905,2014-10-12,12,396,535,931
32906,2014-10-12,13,385,483,868
32907,2014-10-12,14,391,476,867
32908,2014-10-12,15,375,486,861
32909,2014-10-12,16,320,465,785
32910,2014-10-12,17,275,451,726
32911,2014-10-12,18,213,400,613
32912,2014-10-12,19,110,303,413
32913,2014-10-12,20,99,200,299
32914,2014-10-12,21,56,144,200
32915,2014-10-12,22,46,134,180
32916,2014-10-12,23,36,104,140
32917,2014-10-13,0,15,67,82
32918,2014-10-13,1,4,34,38
32919,2014-10-13,2,5,13,18
32920,2014-10-13,3,1,8,9
32921,2014-10-13,4,4,12,16
32922,2014-10-13,5,0,33,33
32923,2014-10-13,6,4,92,96
32924,2014-10-13,7,7,266,273
32925,2014-10-13,8,32,431,463
32926,2014-10-13,9,78,289,367
32927,2014-10-13,10,51,183,234
32928,2014-10-13,11,31,104,135
32929,2014-10-13,12,72,211,283
32930,2014-10-13,13,83,253,336
32931,2014-10-13,14,100,276,376
32932,2014-10-13,15,95,294,389
32933,2014-10-13,16,112,424,536
32934,2014-10-13,17,112,631,743
32935,2014-10-13,18,81,690,771
32936,2014-10-13,19,62,468,530
32937,2014-10-13,20,41,304,345
32938,2014-10-13,21,27,202,229
32939,2014-10-13,22,36,154,190
32940,2014-10-13,23,27,92,119
32941,2014-10-14,0,5,44,49
32942,2014-10-14,1,8,17,25
32943,2014-10-14,2,3,8,11
32944,2014-10-14,3,2,4,6
32945,2014-10-14,4,1,11,12
32946,2014-10-14,5,2,77,79
32947,2014-10-14,6,5,291,296
32948,2014-10-14,7,19,748,767
32949,2014-10-14,8,50,1039,1089
32950,2014-10-14,9,60,449,509
32951,2014-10-14,10,102,219,321
32952,2014-10-14,11,98,252,350
32953,2014-10-14,12,117,310,427
32954,2014-10-14,13,152,323,475
32955,2014-10-14,14,172,318,490
32956,2014-10-14,15,149,393,542
32957,2014-10-14,16,157,569,726
32958,2014-10-14,17,140,1230,1370
32959,2014-10-14,18,96,1141,1237
32960,2014-10-14,19,84,716,800
32961,2014-10-14,20,56,474,530
32962,2014-10-14,21,40,334,374
32963,2014-10-14,22,20,259,279
32964,2014-10-14,23,22,114,136
32965,2014-10-15,0,9,46,55
32966,2014-10-15,1,5,19,24
32967,2014-10-15,2,0,9,9
32968,2014-10-15,3,0,3,3
32969,2014-10-15,4,0,12,12
32970,2014-10-15,5,0,83,83
32971,2014-10-15,6,14,288,302
32972,2014-10-15,7,11,702,713
32973,2014-10-15,8,28,1039,1067
32974,2014-10-15,9,57,496,553
32975,2014-10-15,10,68,223,291
32976,2014-10-15,11,77,240,317
32977,2014-10-15,12,29,149,178
32978,2014-10-15,13,15,98,113
32979,2014-10-15,14,10,62,72
32980,2014-10-15,15,5,37,42
32981,2014-10-15,16,20,139,159
32982,2014-10-15,17,24,538,562
32983,2014-10-15,18,28,464,492
32984,2014-10-15,19,7,229,236
32985,2014-10-15,20,11,318,329
32986,2014-10-15,21,9,205,214
32987,2014-10-15,22,11,163,174
32988,2014-10-15,23,6,94,100
32989,2014-10-16,0,3,38,41
32990,2014-10-16,1,5,22,27
32991,2014-10-16,2,0,11,11
32992,2014-10-16,3,0,2,2
32993,2014-10-16,4,2,13,15
32994,2014-10-16,5,3,67,70
32995,2014-10-16,6,6,278,284
32996,2014-10-16,7,7,687,694
32997,2014-10-16,8,39,1020,1059
32998,2014-10-16,9,38,428,466
32999,2014-10-16,10,56,225,281
33000,2014-10-16,11,67,270,337
33001,2014-10-16,12,74,335,409
33002,2014-10-16,13,94,309,403
33003,2014-10-16,14,74,232,306
33004,2014-10-16,15,99,358,457
33005,2014-10-16,16,119,588,707
33006,2014-10-16,17,139,1112,1251
33007,2014-10-16,18,97,1080,1177
33008,2014-10-16,19,63,605,668
33009,2014-10-16,20,62,426,488
33010,2014-10-16,21,72,368,440
33011,2014-10-16,22,36,279,315
33012,2014-10-16,23,23,143,166
33013,2014-10-17,0,22,74,96
33014,2014-10-17,1,13,35,48
33015,2014-10-17,2,4,7,11
33016,2014-10-17,3,5,3,8
33017,2014-10-17,4,0,11,11
33018,2014-10-17,5,0,65,65
33019,2014-10-17,6,1,186,187
33020,2014-10-17,7,25,617,642
33021,2014-10-17,8,63,1093,1156
33022,2014-10-17,9,113,462,575
33023,2014-10-17,10,157,256,413
33024,2014-10-17,11,215,315,530
33025,2014-10-17,12,238,446,684
33026,2014-10-17,13,235,416,651
33027,2014-10-17,14,270,384,654
33028,2014-10-17,15,273,452,725
33029,2014-10-17,16,247,664,911
33030,2014-10-17,17,229,1153,1382
33031,2014-10-17,18,168,925,1093
33032,2014-10-17,19,130,597,727
33033,2014-10-17,20,84,382,466
33034,2014-10-17,21,51,293,344
33035,2014-10-17,22,60,241,301
33036,2014-10-17,23,55,204,259
33037,2014-10-18,0,34,156,190
33038,2014-10-18,1,30,100,130
33039,2014-10-18,2,23,78,101
33040,2014-10-18,3,10,31,41
33041,2014-10-18,4,1,17,18
33042,2014-10-18,5,1,12,13
33043,2014-10-18,6,10,38,48
33044,2014-10-18,7,29,94,123
33045,2014-10-18,8,55,233,288
33046,2014-10-18,9,139,344,483
33047,2014-10-18,10,244,443,687
33048,2014-10-18,11,373,506,879
33049,2014-10-18,12,384,549,933
33050,2014-10-18,13,417,541,958
33051,2014-10-18,14,450,573,1023
33052,2014-10-18,15,459,580,1039
33053,2014-10-18,16,381,540,921
33054,2014-10-18,17,337,484,821
33055,2014-10-18,18,208,392,600
33056,2014-10-18,19,108,334,442
33057,2014-10-18,20,76,250,326
33058,2014-10-18,21,74,250,324
33059,2014-10-18,22,62,199,261
33060,2014-10-18,23,31,166,197
33061,2014-10-19,0,31,162,193
33062,2014-10-19,1,25,110,135
33063,2014-10-19,2,26,92,118
33064,2014-10-19,3,9,47,56
33065,2014-10-19,4,2,9,11
33066,2014-10-19,5,2,14,16
33067,2014-10-19,6,5,15,20
33068,2014-10-19,7,22,67,89
33069,2014-10-19,8,31,109,140
33070,2014-10-19,9,98,270,368
33071,2014-10-19,10,149,415,564
33072,2014-10-19,11,180,447,627
33073,2014-10-19,12,213,563,776
33074,2014-10-19,13,242,487,729
33075,2014-10-19,14,222,445,667
33076,2014-10-19,15,245,487,732
33077,2014-10-19,16,215,477,692
33078,2014-10-19,17,238,424,662
33079,2014-10-19,18,125,435,560
33080,2014-10-19,19,85,265,350
33081,2014-10-19,20,40,195,235
33082,2014-10-19,21,29,146,175
33083,2014-10-19,22,21,100,121
33084,2014-10-19,23,18,67,85
33085,2014-10-20,0,6,21,27
33086,2014-10-20,1,2,20,22
33087,2014-10-20,2,0,5,5
33088,2014-10-20,3,0,4,4
33089,2014-10-20,4,0,8,8
33090,2014-10-20,5,0,54,54
33091,2014-10-20,6,5,242,247
33092,2014-10-20,7,15,620,635
33093,2014-10-20,8,46,1086,1132
33094,2014-10-20,9,60,421,481
33095,2014-10-20,10,61,193,254
33096,2014-10-20,11,80,226,306
33097,2014-10-20,12,86,280,366
33098,2014-10-20,13,91,301,392
33099,2014-10-20,14,119,283,402
33100,2014-10-20,15,106,312,418
33101,2014-10-20,16,124,546,670
33102,2014-10-20,17,129,1148,1277
33103,2014-10-20,18,91,957,1048
33104,2014-10-20,19,56,614,670
33105,2014-10-20,20,42,386,428
33106,2014-10-20,21,32,288,320
33107,2014-10-20,22,35,150,185
33108,2014-10-20,23,16,59,75
33109,2014-10-21,0,4,33,37
33110,2014-10-21,1,0,16,16
33111,2014-10-21,2,0,5,5
33112,2014-10-21,3,1,2,3
33113,2014-10-21,4,2,7,9
33114,2014-10-21,5,2,69,71
33115,2014-10-21,6,2,287,289
33116,2014-10-21,7,27,706,733
33117,2014-10-21,8,47,1123,1170
33118,2014-10-21,9,33,479,512
33119,2014-10-21,10,63,200,263
33120,2014-10-21,11,57,240,297
33121,2014-10-21,12,102,306,408
33122,2014-10-21,13,93,362,455
33123,2014-10-21,14,84,308,392
33124,2014-10-21,15,56,350,406
33125,2014-10-21,16,83,527,610
33126,2014-10-21,17,42,480,522
33127,2014-10-21,18,16,397,413
33128,2014-10-21,19,15,349,364
33129,2014-10-21,20,7,246,253
33130,2014-10-21,21,7,134,141
33131,2014-10-21,22,2,63,65
33132,2014-10-21,23,0,33,33
33133,2014-10-22,0,0,24,24
33134,2014-10-22,1,3,9,12
33135,2014-10-22,2,0,7,7
33136,2014-10-22,3,0,4,4
33137,2014-10-22,4,0,4,4
33138,2014-10-22,5,0,31,31
33139,2014-10-22,6,2,121,123
33140,2014-10-22,7,2,113,115
33141,2014-10-22,8,5,186,191
33142,2014-10-22,9,4,115,119
33143,2014-10-22,10,3,44,47
33144,2014-10-22,11,4,37,41
33145,2014-10-22,12,9,88,97
33146,2014-10-22,13,6,69,75
33147,2014-10-22,14,15,102,117
33148,2014-10-22,15,22,175,197
33149,2014-10-22,16,17,270,287
33150,2014-10-22,17,42,764,806
33151,2014-10-22,18,30,691,721
33152,2014-10-22,19,20,416,436
33153,2014-10-22,20,15,333,348
33154,2014-10-22,21,20,276,296
33155,2014-10-22,22,13,186,199
33156,2014-10-22,23,8,81,89
33157,2014-10-23,0,2,36,38
33158,2014-10-23,1,0,17,17
33159,2014-10-23,2,0,6,6
33160,2014-10-23,3,0,4,4
33161,2014-10-23,4,0,8,8
33162,2014-10-23,5,0,69,69
33163,2014-10-23,6,3,239,242
33164,2014-10-23,7,17,617,634
33165,2014-10-23,8,32,1044,1076
33166,2014-10-23,9,34,519,553
33167,2014-10-23,10,52,258,310
33168,2014-10-23,11,63,230,293
33169,2014-10-23,12,79,291,370
33170,2014-10-23,13,112,332,444
33171,2014-10-23,14,91,269,360
33172,2014-10-23,15,96,318,414
33173,2014-10-23,16,102,552,654
33174,2014-10-23,17,122,1070,1192
33175,2014-10-23,18,105,1017,1122
33176,2014-10-23,19,49,604,653
33177,2014-10-23,20,38,450,488
33178,2014-10-23,21,24,365,389
33179,2014-10-23,22,14,237,251
33180,2014-10-23,23,20,147,167
33181,2014-10-24,0,6,67,73
33182,2014-10-24,1,4,28,32
33183,2014-10-24,2,0,25,25
33184,2014-10-24,3,2,9,11
33185,2014-10-24,4,2,9,11
33186,2014-10-24,5,4,40,44
33187,2014-10-24,6,7,224,231
33188,2014-10-24,7,13,607,620
33189,2014-10-24,8,32,1004,1036
33190,2014-10-24,9,61,544,605
33191,2014-10-24,10,106,250,356
33192,2014-10-24,11,121,325,446
33193,2014-10-24,12,154,389,543
33194,2014-10-24,13,147,405,552
33195,2014-10-24,14,204,337,541
33196,2014-10-24,15,192,409,601
33197,2014-10-24,16,177,634,811
33198,2014-10-24,17,180,1073,1253
33199,2014-10-24,18,105,879,984
33200,2014-10-24,19,74,512,586
33201,2014-10-24,20,47,324,371
33202,2014-10-24,21,31,262,293
33203,2014-10-24,22,35,217,252
33204,2014-10-24,23,12,164,176
33205,2014-10-25,0,20,125,145
33206,2014-10-25,1,3,81,84
33207,2014-10-25,2,9,56,65
33208,2014-10-25,3,8,30,38
33209,2014-10-25,4,1,4,5
33210,2014-10-25,5,1,7,8
33211,2014-10-25,6,10,32,42
33212,2014-10-25,7,18,104,122
33213,2014-10-25,8,36,231,267
33214,2014-10-25,9,134,372,506
33215,2014-10-25,10,182,472,654
33216,2014-10-25,11,323,574,897
33217,2014-10-25,12,371,604,975
33218,2014-10-25,13,409,607,1016
33219,2014-10-25,14,404,622,1026
33220,2014-10-25,15,444,579,1023
33221,2014-10-25,16,416,594,1010
33222,2014-10-25,17,406,539,945
33223,2014-10-25,18,232,489,721
33224,2014-10-25,19,139,365,504
33225,2014-10-25,20,105,226,331
33226,2014-10-25,21,76,247,323
33227,2014-10-25,22,54,206,260
33228,2014-10-25,23,27,188,215
33229,2014-10-26,0,20,145,165
33230,2014-10-26,1,12,119,131
33231,2014-10-26,2,26,80,106
33232,2014-10-26,3,16,54,70
33233,2014-10-26,4,2,9,11
33234,2014-10-26,5,7,17,24
33235,2014-10-26,6,10,50,60
33236,2014-10-26,7,31,106,137
33237,2014-10-26,8,122,192,314
33238,2014-10-26,9,213,334,547
33239,2014-10-26,10,264,420,684
33240,2014-10-26,11,327,558,885
33241,2014-10-26,12,301,593,894
33242,2014-10-26,13,307,611,918
33243,2014-10-26,14,356,605,961
33244,2014-10-26,15,338,566,904
33245,2014-10-26,16,301,561,862
33246,2014-10-26,17,247,509,756
33247,2014-10-26,18,172,459,631
33248,2014-10-26,19,68,323,391
33249,2014-10-26,20,56,250,306
33250,2014-10-26,21,38,197,235
33251,2014-10-26,22,51,112,163
33252,2014-10-26,23,21,74,95
33253,2014-10-27,0,9,41,50
33254,2014-10-27,1,7,16,23
33255,2014-10-27,2,7,5,12
33256,2014-10-27,3,9,2,11
33257,2014-10-27,4,0,5,5
33258,2014-10-27,5,1,62,63
33259,2014-10-27,6,2,249,251
33260,2014-10-27,7,6,636,642
33261,2014-10-27,8,47,1048,1095
33262,2014-10-27,9,54,427,481
33263,2014-10-27,10,130,207,337
33264,2014-10-27,11,130,227,357
33265,2014-10-27,12,144,360,504
33266,2014-10-27,13,180,361,541
33267,2014-10-27,14,133,310,443
33268,2014-10-27,15,144,346,490
33269,2014-10-27,16,108,631,739
33270,2014-10-27,17,148,1225,1373
33271,2014-10-27,18,127,1132,1259
33272,2014-10-27,19,54,687,741
33273,2014-10-27,20,34,435,469
33274,2014-10-27,21,45,297,342
33275,2014-10-27,22,34,166,200
33276,2014-10-27,23,24,86,110
33277,2014-10-28,0,13,46,59
33278,2014-10-28,1,1,17,18
33279,2014-10-28,2,4,5,9
33280,2014-10-28,3,0,2,2
33281,2014-10-28,4,0,7,7
33282,2014-10-28,5,0,70,70
33283,2014-10-28,6,1,307,308
33284,2014-10-28,7,11,739,750
33285,2014-10-28,8,59,1223,1282
33286,2014-10-28,9,50,490,540
33287,2014-10-28,10,93,226,319
33288,2014-10-28,11,108,283,391
33289,2014-10-28,12,142,378,520
33290,2014-10-28,13,118,404,522
33291,2014-10-28,14,128,342,470
33292,2014-10-28,15,109,405,514
33293,2014-10-28,16,106,651,757
33294,2014-10-28,17,149,1285,1434
33295,2014-10-28,18,95,1177,1272
33296,2014-10-28,19,92,765,857
33297,2014-10-28,20,55,488,543
33298,2014-10-28,21,30,439,469
33299,2014-10-28,22,35,252,287
33300,2014-10-28,23,20,161,181
33301,2014-10-29,0,10,45,55
33302,2014-10-29,1,4,22,26
33303,2014-10-29,2,13,7,20
33304,2014-10-29,3,1,2,3
33305,2014-10-29,4,0,8,8
33306,2014-10-29,5,0,76,76
33307,2014-10-29,6,6,311,317
33308,2014-10-29,7,19,748,767
33309,2014-10-29,8,43,1134,1177
33310,2014-10-29,9,60,489,549
33311,2014-10-29,10,83,255,338
33312,2014-10-29,11,91,262,353
33313,2014-10-29,12,60,370,430
33314,2014-10-29,13,52,342,394
33315,2014-10-29,14,32,124,156
33316,2014-10-29,15,41,222,263
33317,2014-10-29,16,52,461,513
33318,2014-10-29,17,52,1041,1093
33319,2014-10-29,18,58,932,990
33320,2014-10-29,19,35,602,637
33321,2014-10-29,20,17,440,457
33322,2014-10-29,21,15,351,366
33323,2014-10-29,22,14,217,231
33324,2014-10-29,23,13,164,177
33325,2014-10-30,0,2,47,49
33326,2014-10-30,1,2,18,20
33327,2014-10-30,2,0,10,10
33328,2014-10-30,3,0,3,3
33329,2014-10-30,4,0,6,6
33330,2014-10-30,5,1,60,61
33331,2014-10-30,6,2,256,258
33332,2014-10-30,7,10,663,673
33333,2014-10-30,8,23,1149,1172
33334,2014-10-30,9,31,470,501
33335,2014-10-30,10,48,261,309
33336,2014-10-30,11,92,287,379
33337,2014-10-30,12,76,352,428
33338,2014-10-30,13,86,361,447
33339,2014-10-30,14,70,335,405
33340,2014-10-30,15,101,367,468
33341,2014-10-30,16,83,555,638
33342,2014-10-30,17,92,1173,1265
33343,2014-10-30,18,55,1008,1063
33344,2014-10-30,19,32,675,707
33345,2014-10-30,20,32,443,475
33346,2014-10-30,21,18,302,320
33347,2014-10-30,22,24,225,249
33348,2014-10-30,23,7,132,139
33349,2014-10-31,0,6,76,82
33350,2014-10-31,1,4,32,36
33351,2014-10-31,2,0,12,12
33352,2014-10-31,3,0,4,4
33353,2014-10-31,4,1,7,8
33354,2014-10-31,5,0,52,52
33355,2014-10-31,6,2,221,223
33356,2014-10-31,7,8,534,542
33357,2014-10-31,8,37,1062,1099
33358,2014-10-31,9,50,500,550
33359,2014-10-31,10,69,273,342
33360,2014-10-31,11,79,334,413
33361,2014-10-31,12,114,423,537
33362,2014-10-31,13,108,371,479
33363,2014-10-31,14,122,393,515
33364,2014-10-31,15,123,453,576
33365,2014-10-31,16,115,730,845
33366,2014-10-31,17,105,1069,1174
33367,2014-10-31,18,52,668,720
33368,2014-10-31,19,35,430,465
33369,2014-10-31,20,30,274,304
33370,2014-10-31,21,18,209,227
33371,2014-10-31,22,26,170,196
33372,2014-10-31,23,27,147,174
33373,2014-11-01,0,15,123,138
33374,2014-11-01,1,11,135,146
33375,2014-11-01,2,13,124,137
33376,2014-11-01,3,13,61,74
33377,2014-11-01,4,10,10,20
33378,2014-11-01,5,1,17,18
33379,2014-11-01,6,1,23,24
33380,2014-11-01,7,9,77,86
33381,2014-11-01,8,8,166,174
33382,2014-11-01,9,34,238,272
33383,2014-11-01,10,60,311,371
33384,2014-11-01,11,92,379,471
33385,2014-11-01,12,89,342,431
33386,2014-11-01,13,104,383,487
33387,2014-11-01,14,125,330,455
33388,2014-11-01,15,115,335,450
33389,2014-11-01,16,125,376,501
33390,2014-11-01,17,116,359,475
33391,2014-11-01,18,79,306,385
33392,2014-11-01,19,35,222,257
33393,2014-11-01,20,24,214,238
33394,2014-11-01,21,18,163,181
33395,2014-11-01,22,14,129,143
33396,2014-11-01,23,17,112,129
33397,2014-11-02,0,12,103,115
33398,2014-11-02,1,15,128,143
33399,2014-11-02,2,5,25,30
33400,2014-11-02,3,1,13,14
33401,2014-11-02,4,0,3,3
33402,2014-11-02,5,1,4,5
33403,2014-11-02,6,3,22,25
33404,2014-11-02,7,3,73,76
33405,2014-11-02,8,13,148,161
33406,2014-11-02,9,37,257,294
33407,2014-11-02,10,77,297,374
33408,2014-11-02,11,72,362,434
33409,2014-11-02,12,104,450,554
33410,2014-11-02,13,110,411,521
33411,2014-11-02,14,103,406,509
33412,2014-11-02,15,104,398,502
33413,2014-11-02,16,104,439,543
33414,2014-11-02,17,62,342,404
33415,2014-11-02,18,20,275,295
33416,2014-11-02,19,17,211,228
33417,2014-11-02,20,11,141,152
33418,2014-11-02,21,6,109,115
33419,2014-11-02,22,11,84,95
33420,2014-11-02,23,3,48,51
33421,2014-11-03,0,3,17,20
33422,2014-11-03,1,2,6,8
33423,2014-11-03,2,1,1,2
33424,2014-11-03,3,0,3,3
33425,2014-11-03,4,0,10,10
33426,2014-11-03,5,1,53,54
33427,2014-11-03,6,1,264,265
33428,2014-11-03,7,12,726,738
33429,2014-11-03,8,22,972,994
33430,2014-11-03,9,26,426,452
33431,2014-11-03,10,36,198,234
33432,2014-11-03,11,55,207,262
33433,2014-11-03,12,59,276,335
33434,2014-11-03,13,58,303,361
33435,2014-11-03,14,73,247,320
33436,2014-11-03,15,67,337,404
33437,2014-11-03,16,83,558,641
33438,2014-11-03,17,42,1073,1115
33439,2014-11-03,18,25,894,919
33440,2014-11-03,19,22,531,553
33441,2014-11-03,20,13,334,347
33442,2014-11-03,21,9,274,283
33443,2014-11-03,22,8,159,167
33444,2014-11-03,23,1,75,76
33445,2014-11-04,0,3,25,28
33446,2014-11-04,1,1,15,16
33447,2014-11-04,2,1,5,6
33448,2014-11-04,3,0,1,1
33449,2014-11-04,4,0,12,12
33450,2014-11-04,5,1,80,81
33451,2014-11-04,6,3,302,305
33452,2014-11-04,7,16,806,822
33453,2014-11-04,8,20,1044,1064
33454,2014-11-04,9,25,506,531
33455,2014-11-04,10,32,220,252
33456,2014-11-04,11,99,256,355
33457,2014-11-04,12,86,356,442
33458,2014-11-04,13,85,322,407
33459,2014-11-04,14,68,311,379
33460,2014-11-04,15,60,346,406
33461,2014-11-04,16,80,647,727
33462,2014-11-04,17,67,1136,1203
33463,2014-11-04,18,25,986,1011
33464,2014-11-04,19,22,551,573
33465,2014-11-04,20,24,438,462
33466,2014-11-04,21,10,353,363
33467,2014-11-04,22,14,238,252
33468,2014-11-04,23,8,102,110
33469,2014-11-05,0,0,50,50
33470,2014-11-05,1,6,29,35
33471,2014-11-05,2,0,9,9
33472,2014-11-05,3,0,9,9
33473,2014-11-05,4,0,9,9
33474,2014-11-05,5,2,90,92
33475,2014-11-05,6,8,323,331
33476,2014-11-05,7,19,797,816
33477,2014-11-05,8,40,1108,1148
33478,2014-11-05,9,32,479,511
33479,2014-11-05,10,36,223,259
33480,2014-11-05,11,60,226,286
33481,2014-11-05,12,73,369,442
33482,2014-11-05,13,70,323,393
33483,2014-11-05,14,57,266,323
33484,2014-11-05,15,64,318,382
33485,2014-11-05,16,79,615,694
33486,2014-11-05,17,64,1084,1148
33487,2014-11-05,18,43,831,874
33488,2014-11-05,19,23,451,474
33489,2014-11-05,20,8,326,334
33490,2014-11-05,21,9,250,259
33491,2014-11-05,22,5,161,166
33492,2014-11-05,23,2,71,73
33493,2014-11-06,0,2,30,32
33494,2014-11-06,1,0,10,10
33495,2014-11-06,2,2,4,6
33496,2014-11-06,4,0,3,3
33497,2014-11-06,5,0,22,22
33498,2014-11-06,6,2,57,59
33499,2014-11-06,7,5,365,370
33500,2014-11-06,8,11,761,772
33501,2014-11-06,9,27,531,558
33502,2014-11-06,10,41,271,312
33503,2014-11-06,11,36,250,286
33504,2014-11-06,12,34,386,420
33505,2014-11-06,13,55,343,398
33506,2014-11-06,14,20,125,145
33507,2014-11-06,15,17,227,244
33508,2014-11-06,16,36,469,505
33509,2014-11-06,17,40,709,749
33510,2014-11-06,18,24,766,790
33511,2014-11-06,19,20,514,534
33512,2014-11-06,20,12,388,400
33513,2014-11-06,21,15,324,339
33514,2014-11-06,22,12,205,217
33515,2014-11-06,23,11,124,135
33516,2014-11-07,0,4,68,72
33517,2014-11-07,1,3,27,30
33518,2014-11-07,2,0,6,6
33519,2014-11-07,3,0,3,3
33520,2014-11-07,4,0,8,8
33521,2014-11-07,5,0,50,50
33522,2014-11-07,6,5,237,242
33523,2014-11-07,7,13,655,668
33524,2014-11-07,8,23,1082,1105
33525,2014-11-07,9,36,513,549
33526,2014-11-07,10,62,273,335
33527,2014-11-07,11,74,301,375
33528,2014-11-07,12,83,382,465
33529,2014-11-07,13,79,340,419
33530,2014-11-07,14,89,299,388
33531,2014-11-07,15,78,339,417
33532,2014-11-07,16,86,481,567
33533,2014-11-07,17,87,955,1042
33534,2014-11-07,18,28,684,712
33535,2014-11-07,19,10,377,387
33536,2014-11-07,20,17,281,298
33537,2014-11-07,21,18,189,207
33538,2014-11-07,22,26,158,184
33539,2014-11-07,23,24,136,160
33540,2014-11-08,0,11,81,92
33541,2014-11-08,1,4,64,68
33542,2014-11-08,2,2,52,54
33543,2014-11-08,3,1,23,24
33544,2014-11-08,4,1,8,9
33545,2014-11-08,5,1,9,10
33546,2014-11-08,6,0,25,25
33547,2014-11-08,7,9,89,98
33548,2014-11-08,8,32,206,238
33549,2014-11-08,9,59,300,359
33550,2014-11-08,10,88,362,450
33551,2014-11-08,11,127,479,606
33552,2014-11-08,12,173,517,690
33553,2014-11-08,13,205,449,654
33554,2014-11-08,14,230,472,702
33555,2014-11-08,15,229,460,689
33556,2014-11-08,16,160,421,581
33557,2014-11-08,17,176,444,620
33558,2014-11-08,18,57,332,389
33559,2014-11-08,19,77,311,388
33560,2014-11-08,20,30,210,240
33561,2014-11-08,21,33,170,203
33562,2014-11-08,22,41,147,188
33563,2014-11-08,23,26,147,173
33564,2014-11-09,0,11,118,129
33565,2014-11-09,1,7,100,107
33566,2014-11-09,2,6,76,82
33567,2014-11-09,3,8,25,33
33568,2014-11-09,4,0,10,10
33569,2014-11-09,5,2,7,9
33570,2014-11-09,6,2,20,22
33571,2014-11-09,7,16,77,93
33572,2014-11-09,8,33,145,178
33573,2014-11-09,9,69,274,343
33574,2014-11-09,10,158,406,564
33575,2014-11-09,11,172,423,595
33576,2014-11-09,12,211,524,735
33577,2014-11-09,13,270,471,741
33578,2014-11-09,14,232,506,738
33579,2014-11-09,15,244,529,773
33580,2014-11-09,16,201,579,780
33581,2014-11-09,17,125,407,532
33582,2014-11-09,18,77,348,425
33583,2014-11-09,19,58,271,329
33584,2014-11-09,20,32,190,222
33585,2014-11-09,21,42,136,178
33586,2014-11-09,22,9,117,126
33587,2014-11-09,23,17,64,81
33588,2014-11-10,0,7,35,42
33589,2014-11-10,1,0,14,14
33590,2014-11-10,2,0,7,7
33591,2014-11-10,3,0,5,5
33592,2014-11-10,4,0,7,7
33593,2014-11-10,5,3,59,62
33594,2014-11-10,6,5,214,219
33595,2014-11-10,7,17,647,664
33596,2014-11-10,8,36,1013,1049
33597,2014-11-10,9,60,429,489
33598,2014-11-10,10,79,203,282
33599,2014-11-10,11,107,253,360
33600,2014-11-10,12,87,334,421
33601,2014-11-10,13,113,292,405
33602,2014-11-10,14,132,295,427
33603,2014-11-10,15,137,374,511
33604,2014-11-10,16,99,624,723
33605,2014-11-10,17,103,1000,1103
33606,2014-11-10,18,52,847,899
33607,2014-11-10,19,38,546,584
33608,2014-11-10,20,29,366,395
33609,2014-11-10,21,34,246,280
33610,2014-11-10,22,23,196,219
33611,2014-11-10,23,14,112,126
33612,2014-11-11,0,5,55,60
33613,2014-11-11,1,16,22,38
33614,2014-11-11,2,0,10,10
33615,2014-11-11,3,1,2,3
33616,2014-11-11,4,2,4,6
33617,2014-11-11,5,4,34,38
33618,2014-11-11,6,11,107,118
33619,2014-11-11,7,17,376,393
33620,2014-11-11,8,41,772,813
33621,2014-11-11,9,54,475,529
33622,2014-11-11,10,95,405,500
33623,2014-11-11,11,109,418,527
33624,2014-11-11,12,150,533,683
33625,2014-11-11,13,175,504,679
33626,2014-11-11,14,169,527,696
33627,2014-11-11,15,176,547,723
33628,2014-11-11,16,171,666,837
33629,2014-11-11,17,121,853,974
33630,2014-11-11,18,83,799,882
33631,2014-11-11,19,76,552,628
33632,2014-11-11,20,74,435,509
33633,2014-11-11,21,91,451,542
33634,2014-11-11,22,75,388,463
33635,2014-11-11,23,4,115,119
33636,2014-11-12,0,12,38,50
33637,2014-11-12,1,6,12,18
33638,2014-11-12,2,0,12,12
33639,2014-11-12,3,0,4,4
33640,2014-11-12,4,1,10,11
33641,2014-11-12,5,2,79,81
33642,2014-11-12,6,8,295,303
33643,2014-11-12,7,12,816,828
33644,2014-11-12,8,31,1193,1224
33645,2014-11-12,9,36,498,534
33646,2014-11-12,10,61,247,308
33647,2014-11-12,11,73,252,325
33648,2014-11-12,12,63,303,366
33649,2014-11-12,13,68,318,386
33650,2014-11-12,14,73,277,350
33651,2014-11-12,15,76,396,472
33652,2014-11-12,16,77,564,641
33653,2014-11-12,17,62,1068,1130
33654,2014-11-12,18,36,852,888
33655,2014-11-12,19,37,568,605
33656,2014-11-12,20,20,392,412
33657,2014-11-12,21,13,297,310
33658,2014-11-12,22,8,161,169
33659,2014-11-12,23,3,108,111
33660,2014-11-13,0,1,25,26
33661,2014-11-13,1,2,10,12
33662,2014-11-13,2,1,2,3
33663,2014-11-13,3,1,3,4
33664,2014-11-13,4,1,7,8
33665,2014-11-13,5,1,63,64
33666,2014-11-13,6,3,242,245
33667,2014-11-13,7,11,671,682
33668,2014-11-13,8,36,1062,1098
33669,2014-11-13,9,26,422,448
33670,2014-11-13,10,29,221,250
33671,2014-11-13,11,41,201,242
33672,2014-11-13,12,58,299,357
33673,2014-11-13,13,41,256,297
33674,2014-11-13,14,49,234,283
33675,2014-11-13,15,46,267,313
33676,2014-11-13,16,36,480,516
33677,2014-11-13,17,41,807,848
33678,2014-11-13,18,23,532,555
33679,2014-11-13,19,8,263,271
33680,2014-11-13,20,11,187,198
33681,2014-11-13,21,8,172,180
33682,2014-11-13,22,6,117,123
33683,2014-11-13,23,5,96,101
33684,2014-11-14,0,1,47,48
33685,2014-11-14,1,2,16,18
33686,2014-11-14,2,0,7,7
33687,2014-11-14,3,0,3,3
33688,2014-11-14,4,0,3,3
33689,2014-11-14,5,0,55,55
33690,2014-11-14,6,1,176,177
33691,2014-11-14,7,7,526,533
33692,2014-11-14,8,24,866,890
33693,2014-11-14,9,17,407,424
33694,2014-11-14,10,31,202,233
33695,2014-11-14,11,42,213,255
33696,2014-11-14,12,54,318,372
33697,2014-11-14,13,56,245,301
33698,2014-11-14,14,60,239,299
33699,2014-11-14,15,42,301,343
33700,2014-11-14,16,47,496,543
33701,2014-11-14,17,30,771,801
33702,2014-11-14,18,13,604,617
33703,2014-11-14,19,8,366,374
33704,2014-11-14,20,18,246,264
33705,2014-11-14,21,14,174,188
33706,2014-11-14,22,4,149,153
33707,2014-11-14,23,8,109,117
33708,2014-11-15,0,0,89,89
33709,2014-11-15,1,4,42,46
33710,2014-11-15,2,1,37,38
33711,2014-11-15,3,2,13,15
33712,2014-11-15,4,0,6,6
33713,2014-11-15,5,0,4,4
33714,2014-11-15,6,3,16,19
33715,2014-11-15,7,2,72,74
33716,2014-11-15,8,14,121,135
33717,2014-11-15,9,38,237,275
33718,2014-11-15,10,74,343,417
33719,2014-11-15,11,133,424,557
33720,2014-11-15,12,148,395,543
33721,2014-11-15,13,136,390,526
33722,2014-11-15,14,135,446,581
33723,2014-11-15,15,159,435,594
33724,2014-11-15,16,148,347,495
33725,2014-11-15,17,76,294,370
33726,2014-11-15,18,45,250,295
33727,2014-11-15,19,32,206,238
33728,2014-11-15,20,18,155,173
33729,2014-11-15,21,19,146,165
33730,2014-11-15,22,21,129,150
33731,2014-11-15,23,9,124,133
33732,2014-11-16,0,10,79,89
33733,2014-11-16,1,5,78,83
33734,2014-11-16,2,8,59,67
33735,2014-11-16,3,2,28,30
33736,2014-11-16,4,0,3,3
33737,2014-11-16,5,0,11,11
33738,2014-11-16,6,1,10,11
33739,2014-11-16,7,11,41,52
33740,2014-11-16,8,28,115,143
33741,2014-11-16,9,44,196,240
33742,2014-11-16,10,76,344,420
33743,2014-11-16,11,102,348,450
33744,2014-11-16,12,94,424,518
33745,2014-11-16,13,93,379,472
33746,2014-11-16,14,103,352,455
33747,2014-11-16,15,88,327,415
33748,2014-11-16,16,66,323,389
33749,2014-11-16,17,21,146,167
33750,2014-11-16,18,21,132,153
33751,2014-11-16,19,18,125,143
33752,2014-11-16,20,24,115,139
33753,2014-11-16,21,24,93,117
33754,2014-11-16,22,15,90,105
33755,2014-11-16,23,8,56,64
33756,2014-11-17,0,1,18,19
33757,2014-11-17,1,1,7,8
33758,2014-11-17,2,0,3,3
33759,2014-11-17,3,0,2,2
33760,2014-11-17,4,1,2,3
33761,2014-11-17,5,1,35,36
33762,2014-11-17,6,2,89,91
33763,2014-11-17,7,4,299,303
33764,2014-11-17,8,7,269,276
33765,2014-11-17,9,9,123,132
33766,2014-11-17,10,3,40,43
33767,2014-11-17,11,2,29,31
33768,2014-11-17,12,8,54,62
33769,2014-11-17,13,12,108,120
33770,2014-11-17,14,11,106,117
33771,2014-11-17,15,13,140,153
33772,2014-11-17,16,11,294,305
33773,2014-11-17,17,23,592,615
33774,2014-11-17,18,26,624,650
33775,2014-11-17,19,7,431,438
33776,2014-11-17,20,12,279,291
33777,2014-11-17,21,5,181,186
33778,2014-11-17,22,4,128,132
33779,2014-11-17,23,6,61,67
33780,2014-11-18,0,4,23,27
33781,2014-11-18,1,0,8,8
33782,2014-11-18,2,0,3,3
33783,2014-11-18,3,1,6,7
33784,2014-11-18,4,0,4,4
33785,2014-11-18,5,0,41,41
33786,2014-11-18,6,0,155,155
33787,2014-11-18,7,11,489,500
33788,2014-11-18,8,23,835,858
33789,2014-11-18,9,14,360,374
33790,2014-11-18,10,16,140,156
33791,2014-11-18,11,16,142,158
33792,2014-11-18,12,24,200,224
33793,2014-11-18,13,14,161,175
33794,2014-11-18,14,22,147,169
33795,2014-11-18,15,36,202,238
33796,2014-11-18,16,28,345,373
33797,2014-11-18,17,21,625,646
33798,2014-11-18,18,15,530,545
33799,2014-11-18,19,5,309,314
33800,2014-11-18,20,4,236,240
33801,2014-11-18,21,7,160,167
33802,2014-11-18,22,5,96,101
33803,2014-11-18,23,5,40,45
33804,2014-11-19,0,1,23,24
33805,2014-11-19,1,1,8,9
33806,2014-11-19,2,2,2,4
33807,2014-11-19,3,2,2,4
33808,2014-11-19,4,0,5,5
33809,2014-11-19,5,0,48,48
33810,2014-11-19,6,0,177,177
33811,2014-11-19,7,6,454,460
33812,2014-11-19,8,11,774,785
33813,2014-11-19,9,15,405,420
33814,2014-11-19,10,17,164,181
33815,2014-11-19,11,12,182,194
33816,2014-11-19,12,30,214,244
33817,2014-11-19,13,9,171,180
33818,2014-11-19,14,7,189,196
33819,2014-11-19,15,11,213,224
33820,2014-11-19,16,24,370,394
33821,2014-11-19,17,26,657,683
33822,2014-11-19,18,6,648,654
33823,2014-11-19,19,3,402,405
33824,2014-11-19,20,3,229,232
33825,2014-11-19,21,3,237,240
33826,2014-11-19,22,4,152,156
33827,2014-11-19,23,1,62,63
33828,2014-11-20,0,0,31,31
33829,2014-11-20,1,1,15,16
33830,2014-11-20,2,0,3,3
33831,2014-11-20,3,0,4,4
33832,2014-11-20,4,0,5,5
33833,2014-11-20,5,0,47,47
33834,2014-11-20,6,2,175,177
33835,2014-11-20,7,3,543,546
33836,2014-11-20,8,8,890,898
33837,2014-11-20,9,12,444,456
33838,2014-11-20,10,14,199,213
33839,2014-11-20,11,20,203,223
33840,2014-11-20,12,19,286,305
33841,2014-11-20,13,38,276,314
33842,2014-11-20,14,33,248,281
33843,2014-11-20,15,42,282,324
33844,2014-11-20,16,22,494,516
33845,2014-11-20,17,30,819,849
33846,2014-11-20,18,24,699,723
33847,2014-11-20,19,13,470,483
33848,2014-11-20,20,6,346,352
33849,2014-11-20,21,19,210,229
33850,2014-11-20,22,4,163,167
33851,2014-11-20,23,1,71,72
33852,2014-11-21,0,2,36,38
33853,2014-11-21,1,0,19,19
33854,2014-11-21,2,0,6,6
33855,2014-11-21,3,0,1,1
33856,2014-11-21,4,0,4,4
33857,2014-11-21,5,0,47,47
33858,2014-11-21,6,0,141,141
33859,2014-11-21,7,2,428,430
33860,2014-11-21,8,20,848,868
33861,2014-11-21,9,19,411,430
33862,2014-11-21,10,26,196,222
33863,2014-11-21,11,50,216,266
33864,2014-11-21,12,31,242,273
33865,2014-11-21,13,47,266,313
33866,2014-11-21,14,31,215,246
33867,2014-11-21,15,34,258,292
33868,2014-11-21,16,41,445,486
33869,2014-11-21,17,46,692,738
33870,2014-11-21,18,12,558,570
33871,2014-11-21,19,13,338,351
33872,2014-11-21,20,10,200,210
33873,2014-11-21,21,13,169,182
33874,2014-11-21,22,8,113,121
33875,2014-11-21,23,8,83,91
33876,2014-11-22,0,3,76,79
33877,2014-11-22,1,4,58,62
33878,2014-11-22,2,4,52,56
33879,2014-11-22,3,3,26,29
33880,2014-11-22,4,0,4,4
33881,2014-11-22,5,1,9,10
33882,2014-11-22,6,0,19,19
33883,2014-11-22,7,8,52,60
33884,2014-11-22,8,6,147,153
33885,2014-11-22,9,20,222,242
33886,2014-11-22,10,35,306,341
33887,2014-11-22,11,84,352,436
33888,2014-11-22,12,60,398,458
33889,2014-11-22,13,90,414,504
33890,2014-11-22,14,107,418,525
33891,2014-11-22,15,142,400,542
33892,2014-11-22,16,120,366,486
33893,2014-11-22,17,73,309,382
33894,2014-11-22,18,50,275,325
33895,2014-11-22,19,38,218,256
33896,2014-11-22,20,23,163,186
33897,2014-11-22,21,15,154,169
33898,2014-11-22,22,11,97,108
33899,2014-11-22,23,11,118,129
33900,2014-11-23,0,8,99,107
33901,2014-11-23,1,3,75,78
33902,2014-11-23,2,3,47,50
33903,2014-11-23,3,3,21,24
33904,2014-11-23,4,1,9,10
33905,2014-11-23,5,0,7,7
33906,2014-11-23,6,0,7,7
33907,2014-11-23,7,2,34,36
33908,2014-11-23,8,17,89,106
33909,2014-11-23,9,31,182,213
33910,2014-11-23,10,76,323,399
33911,2014-11-23,11,121,375,496
33912,2014-11-23,12,116,432,548
33913,2014-11-23,13,128,428,556
33914,2014-11-23,14,120,411,531
33915,2014-11-23,15,140,400,540
33916,2014-11-23,16,108,373,481
33917,2014-11-23,17,82,335,417
33918,2014-11-23,18,55,314,369
33919,2014-11-23,19,41,216,257
33920,2014-11-23,20,24,111,135
33921,2014-11-23,21,21,78,99
33922,2014-11-23,22,7,59,66
33923,2014-11-23,23,0,28,28
33924,2014-11-24,0,1,9,10
33925,2014-11-24,1,0,2,2
33926,2014-11-24,2,0,6,6
33927,2014-11-24,3,0,3,3
33928,2014-11-24,4,0,4,4
33929,2014-11-24,5,1,57,58
33930,2014-11-24,6,0,196,196
33931,2014-11-24,7,5,594,599
33932,2014-11-24,8,15,999,1014
33933,2014-11-24,9,44,437,481
33934,2014-11-24,10,77,198,275
33935,2014-11-24,11,73,181,254
33936,2014-11-24,12,89,321,410
33937,2014-11-24,13,102,298,400
33938,2014-11-24,14,144,320,464
33939,2014-11-24,15,144,341,485
33940,2014-11-24,16,92,539,631
33941,2014-11-24,17,91,1095,1186
33942,2014-11-24,18,41,869,910
33943,2014-11-24,19,39,607,646
33944,2014-11-24,20,21,407,428
33945,2014-11-24,21,30,288,318
33946,2014-11-24,22,39,206,245
33947,2014-11-24,23,21,95,116
33948,2014-11-25,0,25,44,69
33949,2014-11-25,1,13,21,34
33950,2014-11-25,2,8,4,12
33951,2014-11-25,3,2,2,4
33952,2014-11-25,4,0,5,5
33953,2014-11-25,5,0,64,64
33954,2014-11-25,6,2,219,221
33955,2014-11-25,7,9,651,660
33956,2014-11-25,8,32,991,1023
33957,2014-11-25,9,37,419,456
33958,2014-11-25,10,62,238,300
33959,2014-11-25,11,59,260,319
33960,2014-11-25,12,80,252,332
33961,2014-11-25,13,60,287,347
33962,2014-11-25,14,94,234,328
33963,2014-11-25,15,86,298,384
33964,2014-11-25,16,102,537,639
33965,2014-11-25,17,74,866,940
33966,2014-11-25,18,45,644,689
33967,2014-11-25,19,16,432,448
33968,2014-11-25,20,29,300,329
33969,2014-11-25,21,28,228,256
33970,2014-11-25,22,13,167,180
33971,2014-11-25,23,11,75,86
33972,2014-11-26,0,7,34,41
33973,2014-11-26,1,0,19,19
33974,2014-11-26,2,0,7,7
33975,2014-11-26,3,0,3,3
33976,2014-11-26,4,0,2,2
33977,2014-11-26,5,0,15,15
33978,2014-11-26,6,0,39,39
33979,2014-11-26,7,0,59,59
33980,2014-11-26,8,2,98,100
33981,2014-11-26,9,2,51,53
33982,2014-11-26,10,3,37,40
33983,2014-11-26,11,2,36,38
33984,2014-11-26,12,3,56,59
33985,2014-11-26,13,5,89,94
33986,2014-11-26,14,2,54,56
33987,2014-11-26,15,0,91,91
33988,2014-11-26,16,7,92,99
33989,2014-11-26,17,2,102,104
33990,2014-11-26,18,1,124,125
33991,2014-11-26,19,6,107,113
33992,2014-11-26,20,6,77,83
33993,2014-11-26,21,2,76,78
33994,2014-11-26,22,1,64,65
33995,2014-11-26,23,2,39,41
33996,2014-11-27,0,0,30,30
33997,2014-11-27,1,1,31,32
33998,2014-11-27,2,2,18,20
33999,2014-11-27,3,0,4,4
34000,2014-11-27,4,0,6,6
34001,2014-11-27,5,0,9,9
34002,2014-11-27,6,0,21,21
34003,2014-11-27,7,0,42,42
34004,2014-11-27,8,9,81,90
34005,2014-11-27,9,9,108,117
34006,2014-11-27,10,30,130,160
34007,2014-11-27,11,45,125,170
34008,2014-11-27,12,58,148,206
34009,2014-11-27,13,60,127,187
34010,2014-11-27,14,46,127,173
34011,2014-11-27,15,39,93,132
34012,2014-11-27,16,62,61,123
34013,2014-11-27,17,25,33,58
34014,2014-11-27,18,10,28,38
34015,2014-11-27,19,4,41,45
34016,2014-11-27,20,10,31,41
34017,2014-11-27,21,4,40,44
34018,2014-11-27,22,2,40,42
34019,2014-11-27,23,15,38,53
34020,2014-11-28,0,10,17,27
34021,2014-11-28,1,3,6,9
34022,2014-11-28,2,0,4,4
34023,2014-11-28,3,0,2,2
34024,2014-11-28,4,0,4,4
34025,2014-11-28,5,0,9,9
34026,2014-11-28,6,2,31,33
34027,2014-11-28,7,6,75,81
34028,2014-11-28,8,9,115,124
34029,2014-11-28,9,15,132,147
34030,2014-11-28,10,31,95,126
34031,2014-11-28,11,52,111,163
34032,2014-11-28,12,45,162,207
34033,2014-11-28,13,64,144,208
34034,2014-11-28,14,48,177,225
34035,2014-11-28,15,53,184,237
34036,2014-11-28,16,70,176,246
34037,2014-11-28,17,34,170,204
34038,2014-11-28,18,25,122,147
34039,2014-11-28,19,22,101,123
34040,2014-11-28,20,20,92,112
34041,2014-11-28,21,4,66,70
34042,2014-11-28,22,1,55,56
34043,2014-11-28,23,6,39,45
34044,2014-11-29,0,5,33,38
34045,2014-11-29,1,3,28,31
34046,2014-11-29,2,6,19,25
34047,2014-11-29,3,2,5,7
34048,2014-11-29,4,0,2,2
34049,2014-11-29,5,0,6,6
34050,2014-11-29,6,0,5,5
34051,2014-11-29,7,0,31,31
34052,2014-11-29,8,14,69,83
34053,2014-11-29,9,41,106,147
34054,2014-11-29,10,63,147,210
34055,2014-11-29,11,73,168,241
34056,2014-11-29,12,115,210,325
34057,2014-11-29,13,100,237,337
34058,2014-11-29,14,116,231,347
34059,2014-11-29,15,142,229,371
34060,2014-11-29,16,101,230,331
34061,2014-11-29,17,79,179,258
34062,2014-11-29,18,45,183,228
34063,2014-11-29,19,47,151,198
34064,2014-11-29,20,9,106,115
34065,2014-11-29,21,26,96,122
34066,2014-11-29,22,15,95,110
34067,2014-11-29,23,8,75,83
34068,2014-11-30,0,6,61,67
34069,2014-11-30,1,9,42,51
34070,2014-11-30,2,5,26,31
34071,2014-11-30,3,3,25,28
34072,2014-11-30,4,6,2,8
34073,2014-11-30,5,1,5,6
34074,2014-11-30,6,0,7,7
34075,2014-11-30,7,7,37,44
34076,2014-11-30,8,15,62,77
34077,2014-11-30,9,31,150,181
34078,2014-11-30,10,54,220,274
34079,2014-11-30,11,64,257,321
34080,2014-11-30,12,102,309,411
34081,2014-11-30,13,119,387,506
34082,2014-11-30,14,131,352,483
34083,2014-11-30,15,141,415,556
34084,2014-11-30,16,115,433,548
34085,2014-11-30,17,55,349,404
34086,2014-11-30,18,46,272,318
34087,2014-11-30,19,23,171,194
34088,2014-11-30,20,14,158,172
34089,2014-11-30,21,15,121,136
34090,2014-11-30,22,6,83,89
34091,2014-11-30,23,5,49,54
34092,2014-12-01,0,4,20,24
34093,2014-12-01,1,2,12,14
34094,2014-12-01,2,0,4,4
34095,2014-12-01,3,0,2,2
34096,2014-12-01,4,0,4,4
34097,2014-12-01,5,0,53,53
34098,2014-12-01,6,2,191,193
34099,2014-12-01,7,7,625,632
34100,2014-12-01,8,11,966,977
34101,2014-12-01,9,21,381,402
34102,2014-12-01,10,28,214,242
34103,2014-12-01,11,51,217,268
34104,2014-12-01,12,49,305,354
34105,2014-12-01,13,74,261,335
34106,2014-12-01,14,69,269,338
34107,2014-12-01,15,49,309,358
34108,2014-12-01,16,40,433,473
34109,2014-12-01,17,24,552,576
34110,2014-12-01,18,4,364,368
34111,2014-12-01,19,5,179,184
34112,2014-12-01,20,7,181,188
34113,2014-12-01,21,6,169,175
34114,2014-12-01,22,4,94,98
34115,2014-12-01,23,3,49,52
34116,2014-12-02,0,3,17,20
34117,2014-12-02,1,0,9,9
34118,2014-12-02,2,0,4,4
34119,2014-12-02,3,0,2,2
34120,2014-12-02,4,0,1,1
34121,2014-12-02,5,2,39,41
34122,2014-12-02,6,1,135,136
34123,2014-12-02,7,1,158,159
34124,2014-12-02,8,1,142,143
34125,2014-12-02,9,0,68,68
34126,2014-12-02,10,3,74,77
34127,2014-12-02,11,2,103,105
34128,2014-12-02,12,1,118,119
34129,2014-12-02,13,7,93,100
34130,2014-12-02,14,3,98,101
34131,2014-12-02,15,5,115,120
34132,2014-12-02,16,7,167,174
34133,2014-12-02,17,6,407,413
34134,2014-12-02,18,7,425,432
34135,2014-12-02,19,5,181,186
34136,2014-12-02,20,0,74,74
34137,2014-12-02,21,2,66,68
34138,2014-12-02,22,1,51,52
34139,2014-12-02,23,0,49,49
34140,2014-12-03,0,0,20,20
34141,2014-12-03,1,0,9,9
34142,2014-12-03,2,0,5,5
34143,2014-12-03,3,0,1,1
34144,2014-12-03,4,0,4,4
34145,2014-12-03,5,0,51,51
34146,2014-12-03,6,2,150,152
34147,2014-12-03,7,5,419,424
34148,2014-12-03,8,6,824,830
34149,2014-12-03,9,6,401,407
34150,2014-12-03,10,10,162,172
34151,2014-12-03,11,17,179,196
34152,2014-12-03,12,10,263,273
34153,2014-12-03,13,22,222,244
34154,2014-12-03,14,17,209,226
34155,2014-12-03,15,24,273,297
34156,2014-12-03,16,25,421,446
34157,2014-12-03,17,22,847,869
34158,2014-12-03,18,17,787,804
34159,2014-12-03,19,9,477,486
34160,2014-12-03,20,13,363,376
34161,2014-12-03,21,9,277,286
34162,2014-12-03,22,3,175,178
34163,2014-12-03,23,6,91,97
34164,2014-12-04,0,1,38,39
34165,2014-12-04,1,2,15,17
34166,2014-12-04,2,0,6,6
34167,2014-12-04,3,0,1,1
34168,2014-12-04,4,0,4,4
34169,2014-12-04,5,0,49,49
34170,2014-12-04,6,1,188,189
34171,2014-12-04,7,9,543,552
34172,2014-12-04,8,11,961,972
34173,2014-12-04,9,19,456,475
34174,2014-12-04,10,22,192,214
34175,2014-12-04,11,30,208,238
34176,2014-12-04,12,23,262,285
34177,2014-12-04,13,44,235,279
34178,2014-12-04,14,31,229,260
34179,2014-12-04,15,26,281,307
34180,2014-12-04,16,24,450,474
34181,2014-12-04,17,28,782,810
34182,2014-12-04,18,20,782,802
34183,2014-12-04,19,22,453,475
34184,2014-12-04,20,15,325,340
34185,2014-12-04,21,8,283,291
34186,2014-12-04,22,8,135,143
34187,2014-12-04,23,2,108,110
34188,2014-12-05,0,1,52,53
34189,2014-12-05,1,0,16,16
34190,2014-12-05,2,0,12,12
34191,2014-12-05,3,0,1,1
34192,2014-12-05,4,0,5,5
34193,2014-12-05,5,0,53,53
34194,2014-12-05,6,3,148,151
34195,2014-12-05,7,2,383,385
34196,2014-12-05,8,12,827,839
34197,2014-12-05,9,24,391,415
34198,2014-12-05,10,30,187,217
34199,2014-12-05,11,20,182,202
34200,2014-12-05,12,29,261,290
34201,2014-12-05,13,24,251,275
34202,2014-12-05,14,17,206,223
34203,2014-12-05,15,16,183,199
34204,2014-12-05,16,21,301,322
34205,2014-12-05,17,18,613,631
34206,2014-12-05,18,12,545,557
34207,2014-12-05,19,14,368,382
34208,2014-12-05,20,5,236,241
34209,2014-12-05,21,19,203,222
34210,2014-12-05,22,9,158,167
34211,2014-12-05,23,3,125,128
34212,2014-12-06,0,4,102,106
34213,2014-12-06,1,2,77,79
34214,2014-12-06,2,8,57,65
34215,2014-12-06,3,7,24,31
34216,2014-12-06,4,2,8,10
34217,2014-12-06,5,0,7,7
34218,2014-12-06,6,1,15,16
34219,2014-12-06,7,1,71,72
34220,2014-12-06,8,10,141,151
34221,2014-12-06,9,31,237,268
34222,2014-12-06,10,43,303,346
34223,2014-12-06,11,57,318,375
34224,2014-12-06,12,27,182,209
34225,2014-12-06,13,18,162,180
34226,2014-12-06,14,14,67,81
34227,2014-12-06,15,10,86,96
34228,2014-12-06,16,15,182,197
34229,2014-12-06,17,12,80,92
34230,2014-12-06,18,7,80,87
34231,2014-12-06,19,4,63,67
34232,2014-12-06,20,6,39,45
34233,2014-12-06,21,1,18,19
34234,2014-12-06,22,5,26,31
34235,2014-12-06,23,2,45,47
34236,2014-12-07,0,0,67,67
34237,2014-12-07,1,0,63,63
34238,2014-12-07,2,2,50,52
34239,2014-12-07,3,2,28,30
34240,2014-12-07,4,1,11,12
34241,2014-12-07,5,0,8,8
34242,2014-12-07,6,2,12,14
34243,2014-12-07,7,3,38,41
34244,2014-12-07,8,12,133,145
34245,2014-12-07,9,41,189,230
34246,2014-12-07,10,52,299,351
34247,2014-12-07,11,75,349,424
34248,2014-12-07,12,73,441,514
34249,2014-12-07,13,103,410,513
34250,2014-12-07,14,108,435,543
34251,2014-12-07,15,85,390,475
34252,2014-12-07,16,61,412,473
34253,2014-12-07,17,34,347,381
34254,2014-12-07,18,22,274,296
34255,2014-12-07,19,10,203,213
34256,2014-12-07,20,7,137,144
34257,2014-12-07,21,2,124,126
34258,2014-12-07,22,6,91,97
34259,2014-12-07,23,2,39,41
34260,2014-12-08,0,0,24,24
34261,2014-12-08,1,0,7,7
34262,2014-12-08,2,0,9,9
34263,2014-12-08,3,0,1,1
34264,2014-12-08,4,0,6,6
34265,2014-12-08,5,0,51,51
34266,2014-12-08,6,3,180,183
34267,2014-12-08,7,4,493,497
34268,2014-12-08,8,11,844,855
34269,2014-12-08,9,19,368,387
34270,2014-12-08,10,20,149,169
34271,2014-12-08,11,20,143,163
34272,2014-12-08,12,32,195,227
34273,2014-12-08,13,20,192,212
34274,2014-12-08,14,11,183,194
34275,2014-12-08,15,22,209,231
34276,2014-12-08,16,37,392,429
34277,2014-12-08,17,21,666,687
34278,2014-12-08,18,10,619,629
34279,2014-12-08,19,12,411,423
34280,2014-12-08,20,4,256,260
34281,2014-12-08,21,7,170,177
34282,2014-12-08,22,8,132,140
34283,2014-12-08,23,2,63,65
34284,2014-12-09,0,0,27,27
34285,2014-12-09,1,0,8,8
34286,2014-12-09,2,0,2,2
34287,2014-12-09,4,0,1,1
34288,2014-12-09,5,0,25,25
34289,2014-12-09,6,0,75,75
34290,2014-12-09,7,0,143,143
34291,2014-12-09,8,4,209,213
34292,2014-12-09,9,1,124,125
34293,2014-12-09,10,1,45,46
34294,2014-12-09,11,6,67,73
34295,2014-12-09,12,5,84,89
34296,2014-12-09,13,5,100,105
34297,2014-12-09,14,0,73,73
34298,2014-12-09,15,5,89,94
34299,2014-12-09,16,8,214,222
34300,2014-12-09,17,4,451,455
34301,2014-12-09,18,16,518,534
34302,2014-12-09,19,6,335,341
34303,2014-12-09,20,5,207,212
34304,2014-12-09,21,2,185,187
34305,2014-12-09,22,5,165,170
34306,2014-12-09,23,2,68,70
34307,2014-12-10,0,1,20,21
34308,2014-12-10,1,1,11,12
34309,2014-12-10,2,0,4,4
34310,2014-12-10,3,0,2,2
34311,2014-12-10,4,1,6,7
34312,2014-12-10,5,0,51,51
34313,2014-12-10,6,2,182,184
34314,2014-12-10,7,5,530,535
34315,2014-12-10,8,14,945,959
34316,2014-12-10,9,18,468,486
34317,2014-12-10,10,21,191,212
34318,2014-12-10,11,11,186,197
34319,2014-12-10,12,16,266,282
34320,2014-12-10,13,14,224,238
34321,2014-12-10,14,18,212,230
34322,2014-12-10,15,22,221,243
34323,2014-12-10,16,31,387,418
34324,2014-12-10,17,23,754,777
34325,2014-12-10,18,16,652,668
34326,2014-12-10,19,15,435,450
34327,2014-12-10,20,10,254,264
34328,2014-12-10,21,12,219,231
34329,2014-12-10,22,6,144,150
34330,2014-12-10,23,4,72,76
34331,2014-12-11,0,2,39,41
34332,2014-12-11,1,0,10,10
34333,2014-12-11,2,0,8,8
34334,2014-12-11,3,0,3,3
34335,2014-12-11,4,1,6,7
34336,2014-12-11,5,2,34,36
34337,2014-12-11,6,2,173,175
34338,2014-12-11,7,5,486,491
34339,2014-12-11,8,13,879,892
34340,2014-12-11,9,28,434,462
34341,2014-12-11,10,21,165,186
34342,2014-12-11,11,27,187,214
34343,2014-12-11,12,19,196,215
34344,2014-12-11,13,26,212,238
34345,2014-12-11,14,19,165,184
34346,2014-12-11,15,16,216,232
34347,2014-12-11,16,25,372,397
34348,2014-12-11,17,26,674,700
34349,2014-12-11,18,18,657,675
34350,2014-12-11,19,13,393,406
34351,2014-12-11,20,15,281,296
34352,2014-12-11,21,8,208,216
34353,2014-12-11,22,7,149,156
34354,2014-12-11,23,0,80,80
34355,2014-12-12,0,2,43,45
34356,2014-12-12,1,0,28,28
34357,2014-12-12,2,2,12,14
34358,2014-12-12,3,0,3,3
34359,2014-12-12,4,0,3,3
34360,2014-12-12,5,0,48,48
34361,2014-12-12,6,2,165,167
34362,2014-12-12,7,5,438,443
34363,2014-12-12,8,7,904,911
34364,2014-12-12,9,16,427,443
34365,2014-12-12,10,42,204,246
34366,2014-12-12,11,38,197,235
34367,2014-12-12,12,52,295,347
34368,2014-12-12,13,42,254,296
34369,2014-12-12,14,42,261,303
34370,2014-12-12,15,56,315,371
34371,2014-12-12,16,25,453,478
34372,2014-12-12,17,30,698,728
34373,2014-12-12,18,21,538,559
34374,2014-12-12,19,4,318,322
34375,2014-12-12,20,15,249,264
34376,2014-12-12,21,18,172,190
34377,2014-12-12,22,20,161,181
34378,2014-12-12,23,7,128,135
34379,2014-12-13,0,0,103,103
34380,2014-12-13,1,2,76,78
34381,2014-12-13,2,4,45,49
34382,2014-12-13,3,3,18,21
34383,2014-12-13,4,1,7,8
34384,2014-12-13,5,0,9,9
34385,2014-12-13,6,2,17,19
34386,2014-12-13,7,1,59,60
34387,2014-12-13,8,3,152,155
34388,2014-12-13,9,17,241,258
34389,2014-12-13,10,55,304,359
34390,2014-12-13,11,56,374,430
34391,2014-12-13,12,67,387,454
34392,2014-12-13,13,70,489,559
34393,2014-12-13,14,94,425,519
34394,2014-12-13,15,100,421,521
34395,2014-12-13,16,92,340,432
34396,2014-12-13,17,69,359,428
34397,2014-12-13,18,29,259,288
34398,2014-12-13,19,16,232,248
34399,2014-12-13,20,24,176,200
34400,2014-12-13,21,14,153,167
34401,2014-12-13,22,15,138,153
34402,2014-12-13,23,4,101,105
34403,2014-12-14,0,0,98,98
34404,2014-12-14,1,0,82,82
34405,2014-12-14,2,5,67,72
34406,2014-12-14,3,0,27,27
34407,2014-12-14,4,1,12,13
34408,2014-12-14,5,0,5,5
34409,2014-12-14,6,7,7,14
34410,2014-12-14,7,2,33,35
34411,2014-12-14,8,7,82,89
34412,2014-12-14,9,18,173,191
34413,2014-12-14,10,37,249,286
34414,2014-12-14,11,69,331,400
34415,2014-12-14,12,126,428,554
34416,2014-12-14,13,104,428,532
34417,2014-12-14,14,90,364,454
34418,2014-12-14,15,70,397,467
34419,2014-12-14,16,61,458,519
34420,2014-12-14,17,59,375,434
34421,2014-12-14,18,27,274,301
34422,2014-12-14,19,13,191,204
34423,2014-12-14,20,11,148,159
34424,2014-12-14,21,18,117,135
34425,2014-12-14,22,22,96,118
34426,2014-12-14,23,7,51,58
34427,2014-12-15,0,5,25,30
34428,2014-12-15,1,4,13,17
34429,2014-12-15,2,3,11,14
34430,2014-12-15,3,0,3,3
34431,2014-12-15,4,1,7,8
34432,2014-12-15,5,1,64,65
34433,2014-12-15,6,2,203,205
34434,2014-12-15,7,6,536,542
34435,2014-12-15,8,8,968,976
34436,2014-12-15,9,30,470,500
34437,2014-12-15,10,34,196,230
34438,2014-12-15,11,54,184,238
34439,2014-12-15,12,44,280,324
34440,2014-12-15,13,64,264,328
34441,2014-12-15,14,60,255,315
34442,2014-12-15,15,47,304,351
34443,2014-12-15,16,63,469,532
34444,2014-12-15,17,43,833,876
34445,2014-12-15,18,18,762,780
34446,2014-12-15,19,17,500,517
34447,2014-12-15,20,18,298,316
34448,2014-12-15,21,11,212,223
34449,2014-12-15,22,18,160,178
34450,2014-12-15,23,3,67,70
34451,2014-12-16,0,2,32,34
34452,2014-12-16,1,0,17,17
34453,2014-12-16,2,0,4,4
34454,2014-12-16,3,0,4,4
34455,2014-12-16,4,0,3,3
34456,2014-12-16,5,2,63,65
34457,2014-12-16,6,3,211,214
34458,2014-12-16,7,10,624,634
34459,2014-12-16,8,35,1090,1125
34460,2014-12-16,9,31,505,536
34461,2014-12-16,10,14,141,155
34462,2014-12-16,11,3,41,44
34463,2014-12-16,12,4,38,42
34464,2014-12-16,13,6,104,110
34465,2014-12-16,14,3,63,66
34466,2014-12-16,15,15,150,165
34467,2014-12-16,16,10,320,330
34468,2014-12-16,17,12,641,653
34469,2014-12-16,18,7,571,578
34470,2014-12-16,19,15,416,431
34471,2014-12-16,20,15,267,282
34472,2014-12-16,21,15,227,242
34473,2014-12-16,22,8,130,138
34474,2014-12-16,23,2,73,75
34475,2014-12-17,0,4,26,30
34476,2014-12-17,1,1,15,16
34477,2014-12-17,2,0,12,12
34478,2014-12-17,3,0,2,2
34479,2014-12-17,4,0,8,8
34480,2014-12-17,5,0,64,64
34481,2014-12-17,6,5,203,208
34482,2014-12-17,7,11,610,621
34483,2014-12-17,8,13,949,962
34484,2014-12-17,9,20,444,464
34485,2014-12-17,10,34,227,261
34486,2014-12-17,11,64,186,250
34487,2014-12-17,12,32,257,289
34488,2014-12-17,13,58,272,330
34489,2014-12-17,14,45,238,283
34490,2014-12-17,15,52,293,345
34491,2014-12-17,16,43,441,484
34492,2014-12-17,17,34,742,776
34493,2014-12-17,18,36,706,742
34494,2014-12-17,19,11,450,461
34495,2014-12-17,20,16,253,269
34496,2014-12-17,21,3,211,214
34497,2014-12-17,22,10,184,194
34498,2014-12-17,23,3,81,84
34499,2014-12-18,0,1,33,34
34500,2014-12-18,1,1,12,13
34501,2014-12-18,2,0,7,7
34502,2014-12-18,3,1,8,9
34503,2014-12-18,4,0,3,3
34504,2014-12-18,5,0,60,60
34505,2014-12-18,6,0,172,172
34506,2014-12-18,7,2,498,500
34507,2014-12-18,8,7,864,871
34508,2014-12-18,9,16,448,464
34509,2014-12-18,10,9,159,168
34510,2014-12-18,11,33,226,259
34511,2014-12-18,12,17,216,233
34512,2014-12-18,13,21,209,230
34513,2014-12-18,14,17,240,257
34514,2014-12-18,15,12,258,270
34515,2014-12-18,16,26,406,432
34516,2014-12-18,17,18,656,674
34517,2014-12-18,18,19,571,590
34518,2014-12-18,19,5,403,408
34519,2014-12-18,20,20,251,271
34520,2014-12-18,21,9,164,173
34521,2014-12-18,22,3,133,136
34522,2014-12-18,23,4,75,79
34523,2014-12-19,0,3,47,50
34524,2014-12-19,1,2,14,16
34525,2014-12-19,2,0,13,13
34526,2014-12-19,3,0,6,6
34527,2014-12-19,4,0,6,6
34528,2014-12-19,5,1,40,41
34529,2014-12-19,6,3,133,136
34530,2014-12-19,7,7,394,401
34531,2014-12-19,8,9,757,766
34532,2014-12-19,9,22,399,421
34533,2014-12-19,10,17,215,232
34534,2014-12-19,11,23,225,248
34535,2014-12-19,12,33,289,322
34536,2014-12-19,13,25,239,264
34537,2014-12-19,14,25,217,242
34538,2014-12-19,15,44,282,326
34539,2014-12-19,16,31,383,414
34540,2014-12-19,17,36,615,651
34541,2014-12-19,18,7,510,517
34542,2014-12-19,19,4,277,281
34543,2014-12-19,20,8,185,193
34544,2014-12-19,21,4,134,138
34545,2014-12-19,22,2,111,113
34546,2014-12-19,23,2,68,70
34547,2014-12-20,0,2,69,71
34548,2014-12-20,1,1,62,63
34549,2014-12-20,2,2,35,37
34550,2014-12-20,3,0,10,10
34551,2014-12-20,4,1,3,4
34552,2014-12-20,5,0,6,6
34553,2014-12-20,6,0,15,15
34554,2014-12-20,7,0,31,31
34555,2014-12-20,8,4,88,92
34556,2014-12-20,9,17,148,165
34557,2014-12-20,10,21,243,264
34558,2014-12-20,11,47,301,348
34559,2014-12-20,12,34,321,355
34560,2014-12-20,13,63,293,356
34561,2014-12-20,14,62,246,308
34562,2014-12-20,15,49,320,369
34563,2014-12-20,16,62,268,330
34564,2014-12-20,17,23,209,232
34565,2014-12-20,18,22,174,196
34566,2014-12-20,19,16,166,182
34567,2014-12-20,20,4,133,137
34568,2014-12-20,21,8,122,130
34569,2014-12-20,22,1,85,86
34570,2014-12-20,23,3,57,60
34571,2014-12-21,0,4,60,64
34572,2014-12-21,1,3,63,66
34573,2014-12-21,2,1,35,36
34574,2014-12-21,3,2,19,21
34575,2014-12-21,4,1,7,8
34576,2014-12-21,5,0,2,2
34577,2014-12-21,6,1,12,13
34578,2014-12-21,7,1,36,37
34579,2014-12-21,8,7,69,76
34580,2014-12-21,9,36,118,154
34581,2014-12-21,10,35,200,235
34582,2014-12-21,11,74,242,316
34583,2014-12-21,12,74,271,345
34584,2014-12-21,13,56,266,322
34585,2014-12-21,14,69,267,336
34586,2014-12-21,15,71,267,338
34587,2014-12-21,16,55,266,321
34588,2014-12-21,17,39,191,230
34589,2014-12-21,18,34,154,188
34590,2014-12-21,19,22,138,160
34591,2014-12-21,20,15,101,116
34592,2014-12-21,21,8,56,64
34593,2014-12-21,22,12,56,68
34594,2014-12-21,23,2,33,35
34595,2014-12-22,0,2,14,16
34596,2014-12-22,1,0,5,5
34597,2014-12-22,2,0,2,2
34598,2014-12-22,3,0,2,2
34599,2014-12-22,4,0,7,7
34600,2014-12-22,5,1,35,36
34601,2014-12-22,6,0,130,130
34602,2014-12-22,7,3,307,310
34603,2014-12-22,8,7,619,626
34604,2014-12-22,9,23,341,364
34605,2014-12-22,10,38,146,184
34606,2014-12-22,11,24,137,161
34607,2014-12-22,12,16,100,116
34608,2014-12-22,13,9,79,88
34609,2014-12-22,14,11,60,71
34610,2014-12-22,15,7,76,83
34611,2014-12-22,16,0,90,90
34612,2014-12-22,17,2,193,195
34613,2014-12-22,18,2,167,169
34614,2014-12-22,19,1,77,78
34615,2014-12-22,20,2,86,88
34616,2014-12-22,21,1,71,72
34617,2014-12-22,22,5,43,48
34618,2014-12-22,23,1,21,22
34619,2014-12-23,0,0,15,15
34620,2014-12-23,1,0,3,3
34621,2014-12-23,2,0,6,6
34622,2014-12-23,3,0,3,3
34623,2014-12-23,4,1,8,9
34624,2014-12-23,5,1,29,30
34625,2014-12-23,6,0,65,65
34626,2014-12-23,7,0,215,215
34627,2014-12-23,8,3,390,393
34628,2014-12-23,9,12,272,284
34629,2014-12-23,10,17,124,141
34630,2014-12-23,11,23,156,179
34631,2014-12-23,12,25,206,231
34632,2014-12-23,13,28,199,227
34633,2014-12-23,14,24,195,219
34634,2014-12-23,15,22,189,211
34635,2014-12-23,16,24,271,295
34636,2014-12-23,17,15,390,405
34637,2014-12-23,18,9,285,294
34638,2014-12-23,19,4,171,175
34639,2014-12-23,20,2,135,137
34640,2014-12-23,21,4,85,89
34641,2014-12-23,22,8,53,61
34642,2014-12-23,23,2,31,33
34643,2014-12-24,0,0,4,4
34644,2014-12-24,1,0,3,3
34645,2014-12-24,2,0,4,4
34646,2014-12-24,3,1,1,2
34647,2014-12-24,4,0,1,1
34648,2014-12-24,5,0,13,13
34649,2014-12-24,6,0,39,39
34650,2014-12-24,7,0,66,66
34651,2014-12-24,8,0,52,52
34652,2014-12-24,9,1,51,52
34653,2014-12-24,10,1,42,43
34654,2014-12-24,11,0,64,64
34655,2014-12-24,12,0,55,55
34656,2014-12-24,13,5,53,58
34657,2014-12-24,14,5,108,113
34658,2014-12-24,15,0,137,137
34659,2014-12-24,16,8,129,137
34660,2014-12-24,17,6,90,96
34661,2014-12-24,18,5,68,73
34662,2014-12-24,19,4,50,54
34663,2014-12-24,20,10,46,56
34664,2014-12-24,21,4,30,34
34665,2014-12-24,22,5,28,33
34666,2014-12-24,23,2,21,23
34667,2014-12-25,0,5,11,16
34668,2014-12-25,1,6,11,17
34669,2014-12-25,2,0,1,1
34670,2014-12-25,3,0,1,1
34671,2014-12-25,4,0,1,1
34672,2014-12-25,5,1,2,3
34673,2014-12-25,6,0,5,5
34674,2014-12-25,7,0,7,7
34675,2014-12-25,8,12,17,29
34676,2014-12-25,9,7,34,41
34677,2014-12-25,10,30,42,72
34678,2014-12-25,11,55,78,133
34679,2014-12-25,12,74,67,141
34680,2014-12-25,13,110,82,192
34681,2014-12-25,14,137,97,234
34682,2014-12-25,15,124,89,213
34683,2014-12-25,16,96,78,174
34684,2014-12-25,17,35,48,83
34685,2014-12-25,18,18,33,51
34686,2014-12-25,19,25,43,68
34687,2014-12-25,20,22,34,56
34688,2014-12-25,21,13,28,41
34689,2014-12-25,22,3,32,35
34690,2014-12-25,23,6,14,20
34691,2014-12-26,0,0,9,9
34692,2014-12-26,1,4,3,7
34693,2014-12-26,4,0,3,3
34694,2014-12-26,5,0,7,7
34695,2014-12-26,6,3,10,13
34696,2014-12-26,7,9,28,37
34697,2014-12-26,8,16,69,85
34698,2014-12-26,9,47,82,129
34699,2014-12-26,10,60,90,150
34700,2014-12-26,11,88,112,200
34701,2014-12-26,12,109,177,286
34702,2014-12-26,13,126,188,314
34703,2014-12-26,14,152,174,326
34704,2014-12-26,15,175,170,345
34705,2014-12-26,16,128,153,281
34706,2014-12-26,17,72,112,184
34707,2014-12-26,18,34,91,125
34708,2014-12-26,19,35,77,112
34709,2014-12-26,20,37,54,91
34710,2014-12-26,21,31,54,85
34711,2014-12-26,22,29,48,77
34712,2014-12-26,23,15,30,45
34713,2014-12-27,0,4,26,30
34714,2014-12-27,1,2,22,24
34715,2014-12-27,2,1,5,6
34716,2014-12-27,3,3,3,6
34717,2014-12-27,4,0,2,2
34718,2014-12-27,5,1,6,7
34719,2014-12-27,6,1,16,17
34720,2014-12-27,7,5,29,34
34721,2014-12-27,8,27,49,76
34722,2014-12-27,9,58,69,127
34723,2014-12-27,10,120,110,230
34724,2014-12-27,11,146,149,295
34725,2014-12-27,12,235,175,410
34726,2014-12-27,13,240,175,415
34727,2014-12-27,14,316,209,525
34728,2014-12-27,15,302,225,527
34729,2014-12-27,16,204,189,393
34730,2014-12-27,17,184,138,322
34731,2014-12-27,18,101,132,233
34732,2014-12-27,19,82,98,180
34733,2014-12-27,20,48,60,108
34734,2014-12-27,21,28,59,87
34735,2014-12-27,22,29,53,82
34736,2014-12-27,23,14,31,45
34737,2014-12-28,0,9,35,44
34738,2014-12-28,1,3,30,33
34739,2014-12-28,2,1,21,22
34740,2014-12-28,3,0,13,13
34741,2014-12-28,4,0,4,4
34742,2014-12-28,5,1,7,8
34743,2014-12-28,6,2,4,6
34744,2014-12-28,7,8,18,26
34745,2014-12-28,8,18,49,67
34746,2014-12-28,9,71,93,164
34747,2014-12-28,10,126,119,245
34748,2014-12-28,11,151,150,301
34749,2014-12-28,12,157,206,363
34750,2014-12-28,13,142,173,315
34751,2014-12-28,14,114,152,266
34752,2014-12-28,15,91,141,232
34753,2014-12-28,16,63,77,140
34754,2014-12-28,17,32,87,119
34755,2014-12-28,18,33,79,112
34756,2014-12-28,19,48,86,134
34757,2014-12-28,20,32,82,114
34758,2014-12-28,21,12,63,75
34759,2014-12-28,22,12,33,45
34760,2014-12-28,23,0,13,13
34761,2014-12-29,0,2,11,13
34762,2014-12-29,1,2,4,6
34763,2014-12-29,2,0,6,6
34764,2014-12-29,3,0,3,3
34765,2014-12-29,4,0,3,3
34766,2014-12-29,5,0,23,23
34767,2014-12-29,6,0,100,100
34768,2014-12-29,7,10,251,261
34769,2014-12-29,8,24,467,491
34770,2014-12-29,9,56,272,328
34771,2014-12-29,10,86,156,242
34772,2014-12-29,11,124,144,268
34773,2014-12-29,12,133,199,332
34774,2014-12-29,13,104,196,300
34775,2014-12-29,14,118,180,298
34776,2014-12-29,15,150,217,367
34777,2014-12-29,16,115,302,417
34778,2014-12-29,17,81,467,548
34779,2014-12-29,18,67,366,433
34780,2014-12-29,19,37,245,282
34781,2014-12-29,20,32,130,162
34782,2014-12-29,21,18,91,109
34783,2014-12-29,22,13,85,98
34784,2014-12-29,23,3,49,52
34785,2014-12-30,0,3,26,29
34786,2014-12-30,1,0,12,12
34787,2014-12-30,2,2,3,5
34788,2014-12-30,3,0,1,1
34789,2014-12-30,4,0,3,3
34790,2014-12-30,5,1,30,31
34791,2014-12-30,6,1,103,104
34792,2014-12-30,7,4,274,278
34793,2014-12-30,8,25,456,481
34794,2014-12-30,9,41,307,348
34795,2014-12-30,10,39,166,205
34796,2014-12-30,11,97,191,288
34797,2014-12-30,12,97,202,299
34798,2014-12-30,13,86,214,300
34799,2014-12-30,14,121,215,336
34800,2014-12-30,15,103,248,351
34801,2014-12-30,16,74,351,425
34802,2014-12-30,17,41,516,557
34803,2014-12-30,18,22,408,430
34804,2014-12-30,19,13,246,259
34805,2014-12-30,20,9,168,177
34806,2014-12-30,21,17,106,123
34807,2014-12-30,22,4,79,83
34808,2014-12-30,23,1,36,37
34809,2014-12-31,0,2,15,17
34810,2014-12-31,1,0,11,11
34811,2014-12-31,2,0,6,6
34812,2014-12-31,3,0,4,4
34813,2014-12-31,4,0,3,3
34814,2014-12-31,5,1,28,29
34815,2014-12-31,6,0,83,83
34816,2014-12-31,7,2,194,196
34817,2014-12-31,8,15,395,410
34818,2014-12-31,9,24,273,297
34819,2014-12-31,10,33,149,182
34820,2014-12-31,11,68,200,268
34821,2014-12-31,12,74,237,311
34822,2014-12-31,13,64,248,312
34823,2014-12-31,14,52,282,334
34824,2014-12-31,15,63,348,411
34825,2014-12-31,16,64,319,383
34826,2014-12-31,17,43,262,305
34827,2014-12-31,18,11,176,187
34828,2014-12-31,19,5,157,162
34829,2014-12-31,20,9,93,102
34830,2014-12-31,21,7,77,84
34831,2014-12-31,22,7,72,79
34832,2014-12-31,23,5,28,33
34833,2015-01-01,0,11,43,54
34834,2015-01-01,1,9,105,114
34835,2015-01-01,2,5,95,100
34836,2015-01-01,3,0,16,16
34837,2015-01-01,4,0,8,8
34838,2015-01-01,5,0,6,6
34839,2015-01-01,6,3,4,7
34840,2015-01-01,7,3,8,11
34841,2015-01-01,8,6,26,32
34842,2015-01-01,9,7,39,46
34843,2015-01-01,10,26,77,103
34844,2015-01-01,11,55,159,214
34845,2015-01-01,12,42,160,202
34846,2015-01-01,13,40,166,206
34847,2015-01-01,14,80,151,231
34848,2015-01-01,15,53,196,249
34849,2015-01-01,16,95,190,285
34850,2015-01-01,17,56,145,201
34851,2015-01-01,18,27,122,149
34852,2015-01-01,19,14,83,97
34853,2015-01-01,20,7,83,90
34854,2015-01-01,21,11,60,71
34855,2015-01-01,22,8,46,54
34856,2015-01-01,23,1,31,32
34857,2015-01-02,0,3,22,25
34858,2015-01-02,1,1,17,18
34859,2015-01-02,2,0,8,8
34860,2015-01-02,3,3,2,5
34861,2015-01-02,4,2,3,5
34862,2015-01-02,5,0,24,24
34863,2015-01-02,6,0,69,69
34864,2015-01-02,7,0,162,162
34865,2015-01-02,8,8,337,345
34866,2015-01-02,9,31,275,306
34867,2015-01-02,10,39,152,191
34868,2015-01-02,11,76,208,284
34869,2015-01-02,12,137,272,409
34870,2015-01-02,13,102,273,375
34871,2015-01-02,14,123,274,397
34872,2015-01-02,15,109,308,417
34873,2015-01-02,16,106,387,493
34874,2015-01-02,17,69,394,463
34875,2015-01-02,18,56,326,382
34876,2015-01-02,19,40,208,248
34877,2015-01-02,20,10,139,149
34878,2015-01-02,21,4,133,137
34879,2015-01-02,22,19,97,116
34880,2015-01-02,23,0,80,80
34881,2015-01-03,0,10,51,61
34882,2015-01-03,1,10,40,50
34883,2015-01-03,2,0,21,21
34884,2015-01-03,3,2,12,14
34885,2015-01-03,4,0,6,6
34886,2015-01-03,5,0,2,2
34887,2015-01-03,6,0,11,11
34888,2015-01-03,7,0,25,25
34889,2015-01-03,8,7,33,40
34890,2015-01-03,9,11,73,84
34891,2015-01-03,10,24,135,159
34892,2015-01-03,11,24,109,133
34893,2015-01-03,12,11,84,95
34894,2015-01-03,13,19,99,118
34895,2015-01-03,14,29,115,144
34896,2015-01-03,15,28,127,155
34897,2015-01-03,16,11,111,122
34898,2015-01-03,17,11,93,104
34899,2015-01-03,18,9,105,114
34900,2015-01-03,19,6,79,85
34901,2015-01-03,20,3,48,51
34902,2015-01-03,21,0,26,26
34903,2015-01-03,22,2,24,26
34904,2015-01-03,23,0,57,57
34905,2015-01-04,0,2,33,35
34906,2015-01-04,1,2,30,32
34907,2015-01-04,2,1,28,29
34908,2015-01-04,3,0,10,10
34909,2015-01-04,4,0,3,3
34910,2015-01-04,5,0,4,4
34911,2015-01-04,6,2,5,7
34912,2015-01-04,7,0,12,12
34913,2015-01-04,8,4,39,43
34914,2015-01-04,9,5,107,112
34915,2015-01-04,10,21,189,210
34916,2015-01-04,11,34,224,258
34917,2015-01-04,12,44,296,340
34918,2015-01-04,13,65,278,343
34919,2015-01-04,14,69,307,376
34920,2015-01-04,15,56,383,439
34921,2015-01-04,16,61,347,408
34922,2015-01-04,17,59,276,335
34923,2015-01-04,18,38,233,271
34924,2015-01-04,19,10,91,101
34925,2015-01-04,20,9,92,101
34926,2015-01-04,21,6,72,78
34927,2015-01-04,22,13,60,73
34928,2015-01-04,23,1,37,38
34929,2015-01-05,0,0,17,17
34930,2015-01-05,1,0,3,3
34931,2015-01-05,2,0,2,2
34932,2015-01-05,3,0,2,2
34933,2015-01-05,4,0,6,6
34934,2015-01-05,5,1,54,55
34935,2015-01-05,6,0,175,175
34936,2015-01-05,7,3,468,471
34937,2015-01-05,8,18,786,804
34938,2015-01-05,9,16,332,348
34939,2015-01-05,10,39,151,190
34940,2015-01-05,11,30,127,157
34941,2015-01-05,12,34,172,206
34942,2015-01-05,13,27,190,217
34943,2015-01-05,14,29,143,172
34944,2015-01-05,15,25,167,192
34945,2015-01-05,16,20,345,365
34946,2015-01-05,17,27,603,630
34947,2015-01-05,18,13,515,528
34948,2015-01-05,19,3,322,325
34949,2015-01-05,20,1,167,168
34950,2015-01-05,21,0,102,102
34951,2015-01-05,22,3,53,56
34952,2015-01-05,23,4,26,30
34953,2015-01-06,0,0,12,12
34954,2015-01-06,1,0,6,6
34955,2015-01-06,2,0,1,1
34956,2015-01-06,4,0,1,1
34957,2015-01-06,5,0,23,23
34958,2015-01-06,6,1,57,58
34959,2015-01-06,7,0,104,104
34960,2015-01-06,8,3,142,145
34961,2015-01-06,9,1,78,79
34962,2015-01-06,10,1,42,43
34963,2015-01-06,11,2,57,59
34964,2015-01-06,12,0,65,65
34965,2015-01-06,13,0,73,73
34966,2015-01-06,14,1,73,74
34967,2015-01-06,15,3,95,98
34968,2015-01-06,16,10,164,174
34969,2015-01-06,17,9,295,304
34970,2015-01-06,18,1,274,275
34971,2015-01-06,19,3,196,199
34972,2015-01-06,20,4,124,128
34973,2015-01-06,21,4,61,65
34974,2015-01-06,22,0,50,50
34975,2015-01-06,23,2,22,24
34976,2015-01-07,0,0,8,8
34977,2015-01-07,1,1,5,6
34978,2015-01-07,2,0,1,1
34979,2015-01-07,4,0,4,4
34980,2015-01-07,5,0,31,31
34981,2015-01-07,6,0,85,85
34982,2015-01-07,7,1,225,226
34983,2015-01-07,8,4,424,428
34984,2015-01-07,9,5,265,270
34985,2015-01-07,10,7,92,99
34986,2015-01-07,11,7,101,108
34987,2015-01-07,12,4,105,109
34988,2015-01-07,13,6,101,107
34989,2015-01-07,14,7,95,102
34990,2015-01-07,15,5,122,127
34991,2015-01-07,16,4,187,191
34992,2015-01-07,17,4,354,358
34993,2015-01-07,18,4,332,336
34994,2015-01-07,19,3,168,171
34995,2015-01-07,20,1,113,114
34996,2015-01-07,21,2,81,83
34997,2015-01-07,22,0,56,56
34998,2015-01-07,23,0,15,15
34999,2015-01-08,0,0,9,9
35000,2015-01-08,1,0,5,5
35001,2015-01-08,2,0,1,1
35002,2015-01-08,3,1,2,3
35003,2015-01-08,5,0,22,22
35004,2015-01-08,6,0,50,50
35005,2015-01-08,7,0,204,204
35006,2015-01-08,8,6,419,425
35007,2015-01-08,9,0,246,246
35008,2015-01-08,10,3,97,100
35009,2015-01-08,11,0,90,90
35010,2015-01-08,12,3,97,100
35011,2015-01-08,13,4,118,122
35012,2015-01-08,14,2,88,90
35013,2015-01-08,15,8,101,109
35014,2015-01-08,16,2,170,172
35015,2015-01-08,17,3,357,360
35016,2015-01-08,18,3,352,355
35017,2015-01-08,19,3,177,180
35018,2015-01-08,20,0,129,129
35019,2015-01-08,21,2,97,99
35020,2015-01-08,22,0,54,54
35021,2015-01-08,23,0,27,27
35022,2015-01-09,0,1,6,7
35023,2015-01-09,1,1,6,7
35024,2015-01-09,2,0,7,7
35025,2015-01-09,4,0,3,3
35026,2015-01-09,5,0,22,22
35027,2015-01-09,6,0,72,72
35028,2015-01-09,7,2,259,261
35029,2015-01-09,8,2,532,534
35030,2015-01-09,9,5,338,343
35031,2015-01-09,10,7,141,148
35032,2015-01-09,11,7,152,159
35033,2015-01-09,12,8,205,213
35034,2015-01-09,13,3,195,198
35035,2015-01-09,14,14,145,159
35036,2015-01-09,15,8,213,221
35037,2015-01-09,16,13,282,295
35038,2015-01-09,17,7,544,551
35039,2015-01-09,18,4,397,401
35040,2015-01-09,19,1,232,233
35041,2015-01-09,20,2,160,162
35042,2015-01-09,21,0,95,95
35043,2015-01-09,22,0,83,83
35044,2015-01-09,23,2,38,40
35045,2015-01-10,0,2,48,50
35046,2015-01-10,1,1,33,34
35047,2015-01-10,2,0,13,13
35048,2015-01-10,3,1,6,7
35049,2015-01-10,5,0,4,4
35050,2015-01-10,6,0,9,9
35051,2015-01-10,7,1,27,28
35052,2015-01-10,8,2,94,96
35053,2015-01-10,9,11,148,159
35054,2015-01-10,10,7,150,157
35055,2015-01-10,11,18,178,196
35056,2015-01-10,12,8,210,218
35057,2015-01-10,13,18,177,195
35058,2015-01-10,14,19,201,220
35059,2015-01-10,15,16,224,240
35060,2015-01-10,16,11,221,232
35061,2015-01-10,17,16,179,195
35062,2015-01-10,18,7,171,178
35063,2015-01-10,19,10,122,132
35064,2015-01-10,20,5,109,114
35065,2015-01-10,21,0,68,68
35066,2015-01-10,22,3,65,68
35067,2015-01-10,23,3,57,60
35068,2015-01-11,0,1,56,57
35069,2015-01-11,1,1,47,48
35070,2015-01-11,2,0,24,24
35071,2015-01-11,3,0,6,6
35072,2015-01-11,4,0,2,2
35073,2015-01-11,5,0,5,5
35074,2015-01-11,6,0,2,2
35075,2015-01-11,7,0,25,25
35076,2015-01-11,8,10,70,80
35077,2015-01-11,9,12,111,123
35078,2015-01-11,10,16,167,183
35079,2015-01-11,11,50,255,305
35080,2015-01-11,12,35,304,339
35081,2015-01-11,13,42,335,377
35082,2015-01-11,14,33,294,327
35083,2015-01-11,15,46,276,322
35084,2015-01-11,16,44,285,329
35085,2015-01-11,17,34,246,280
35086,2015-01-11,18,15,193,208
35087,2015-01-11,19,4,135,139
35088,2015-01-11,20,8,112,120
35089,2015-01-11,21,6,62,68
35090,2015-01-11,22,4,54,58
35091,2015-01-11,23,2,21,23
35092,2015-01-12,0,1,12,13
35093,2015-01-12,1,1,7,8
35094,2015-01-12,2,0,2,2
35095,2015-01-12,4,0,1,1
35096,2015-01-12,5,0,34,34
35097,2015-01-12,6,1,47,48
35098,2015-01-12,7,6,58,64
35099,2015-01-12,8,2,113,115
35100,2015-01-12,9,4,124,128
35101,2015-01-12,10,3,80,83
35102,2015-01-12,11,1,38,39
35103,2015-01-12,12,1,27,28
35104,2015-01-12,13,1,30,31
35105,2015-01-12,14,2,44,46
35106,2015-01-12,15,3,67,70
35107,2015-01-12,16,10,135,145
35108,2015-01-12,17,8,314,322
35109,2015-01-12,18,11,334,345
35110,2015-01-12,19,9,280,289
35111,2015-01-12,20,4,130,134
35112,2015-01-12,21,5,87,92
35113,2015-01-12,22,5,82,87
35114,2015-01-12,23,5,26,31
35115,2015-01-13,0,7,33,40
35116,2015-01-13,1,0,13,13
35117,2015-01-13,2,0,4,4
35118,2015-01-13,4,0,8,8
35119,2015-01-13,5,0,49,49
35120,2015-01-13,6,1,128,129
35121,2015-01-13,7,10,434,444
35122,2015-01-13,8,11,815,826
35123,2015-01-13,9,11,403,414
35124,2015-01-13,10,18,147,165
35125,2015-01-13,11,15,159,174
35126,2015-01-13,12,25,161,186
35127,2015-01-13,13,12,174,186
35128,2015-01-13,14,18,140,158
35129,2015-01-13,15,14,183,197
35130,2015-01-13,16,14,311,325
35131,2015-01-13,17,21,600,621
35132,2015-01-13,18,7,573,580
35133,2015-01-13,19,15,336,351
35134,2015-01-13,20,13,225,238
35135,2015-01-13,21,17,186,203
35136,2015-01-13,22,9,98,107
35137,2015-01-13,23,8,47,55
35138,2015-01-14,0,9,19,28
35139,2015-01-14,1,6,7,13
35140,2015-01-14,2,0,3,3
35141,2015-01-14,3,0,1,1
35142,2015-01-14,4,0,2,2
35143,2015-01-14,5,0,30,30
35144,2015-01-14,6,1,84,85
35145,2015-01-14,7,5,289,294
35146,2015-01-14,8,9,469,478
35147,2015-01-14,9,15,311,326
35148,2015-01-14,10,8,152,160
35149,2015-01-14,11,10,148,158
35150,2015-01-14,12,6,171,177
35151,2015-01-14,13,7,162,169
35152,2015-01-14,14,23,120,143
35153,2015-01-14,15,14,161,175
35154,2015-01-14,16,21,294,315
35155,2015-01-14,17,23,557,580
35156,2015-01-14,18,11,540,551
35157,2015-01-14,19,14,314,328
35158,2015-01-14,20,5,206,211
35159,2015-01-14,21,8,160,168
35160,2015-01-14,22,8,105,113
35161,2015-01-14,23,2,45,47
35162,2015-01-15,0,3,18,21
35163,2015-01-15,1,12,11,23
35164,2015-01-15,2,0,3,3
35165,2015-01-15,4,0,3,3
35166,2015-01-15,5,0,46,46
35167,2015-01-15,6,1,141,142
35168,2015-01-15,7,2,434,436
35169,2015-01-15,8,9,816,825
35170,2015-01-15,9,10,356,366
35171,2015-01-15,10,16,149,165
35172,2015-01-15,11,17,142,159
35173,2015-01-15,12,19,223,242
35174,2015-01-15,13,25,213,238
35175,2015-01-15,14,18,178,196
35176,2015-01-15,15,36,207,243
35177,2015-01-15,16,33,341,374
35178,2015-01-15,17,33,617,650
35179,2015-01-15,18,8,616,624
35180,2015-01-15,19,9,375,384
35181,2015-01-15,20,6,251,257
35182,2015-01-15,21,3,176,179
35183,2015-01-15,22,4,123,127
35184,2015-01-15,23,8,63,71
35185,2015-01-16,0,0,26,26
35186,2015-01-16,1,0,16,16
35187,2015-01-16,2,0,11,11
35188,2015-01-16,3,0,1,1
35189,2015-01-16,4,0,5,5
35190,2015-01-16,5,0,42,42
35191,2015-01-16,6,0,106,106
35192,2015-01-16,7,3,358,361
35193,2015-01-16,8,9,757,766
35194,2015-01-16,9,12,397,409
35195,2015-01-16,10,15,168,183
35196,2015-01-16,11,16,172,188
35197,2015-01-16,12,26,225,251
35198,2015-01-16,13,39,224,263
35199,2015-01-16,14,17,212,229
35200,2015-01-16,15,33,267,300
35201,2015-01-16,16,20,390,410
35202,2015-01-16,17,33,647,680
35203,2015-01-16,18,14,524,538
35204,2015-01-16,19,9,303,312
35205,2015-01-16,20,7,224,231
35206,2015-01-16,21,9,128,137
35207,2015-01-16,22,1,124,125
35208,2015-01-16,23,0,93,93
35209,2015-01-17,0,7,68,75
35210,2015-01-17,1,1,62,63
35211,2015-01-17,2,2,30,32
35212,2015-01-17,3,0,12,12
35213,2015-01-17,4,0,7,7
35214,2015-01-17,5,0,6,6
35215,2015-01-17,6,0,16,16
35216,2015-01-17,7,2,48,50
35217,2015-01-17,8,13,98,111
35218,2015-01-17,9,25,177,202
35219,2015-01-17,10,42,233,275
35220,2015-01-17,11,70,274,344
35221,2015-01-17,12,79,316,395
35222,2015-01-17,13,86,317,403
35223,2015-01-17,14,101,305,406
35224,2015-01-17,15,83,364,447
35225,2015-01-17,16,73,245,318
35226,2015-01-17,17,45,238,283
35227,2015-01-17,18,23,199,222
35228,2015-01-17,19,4,169,173
35229,2015-01-17,20,11,114,125
35230,2015-01-17,21,15,83,98
35231,2015-01-17,22,7,77,84
35232,2015-01-17,23,4,66,70
35233,2015-01-18,0,2,62,64
35234,2015-01-18,1,2,34,36
35235,2015-01-18,2,6,40,46
35236,2015-01-18,3,0,17,17
35237,2015-01-18,4,0,6,6
35238,2015-01-18,5,0,3,3
35239,2015-01-18,6,2,10,12
35240,2015-01-18,7,1,22,23
35241,2015-01-18,8,0,9,9
35242,2015-01-18,9,1,24,25
35243,2015-01-18,10,5,36,41
35244,2015-01-18,11,6,78,84
35245,2015-01-18,12,20,134,154
35246,2015-01-18,13,20,172,192
35247,2015-01-18,14,33,182,215
35248,2015-01-18,15,38,229,267
35249,2015-01-18,16,31,227,258
35250,2015-01-18,17,43,213,256
35251,2015-01-18,18,29,237,266
35252,2015-01-18,19,10,138,148
35253,2015-01-18,20,8,114,122
35254,2015-01-18,21,10,97,107
35255,2015-01-18,22,4,99,103
35256,2015-01-18,23,6,62,68
35257,2015-01-19,0,8,34,42
35258,2015-01-19,1,4,22,26
35259,2015-01-19,2,1,21,22
35260,2015-01-19,3,4,9,13
35261,2015-01-19,4,0,10,10
35262,2015-01-19,5,4,8,12
35263,2015-01-19,6,3,31,34
35264,2015-01-19,7,2,99,101
35265,2015-01-19,8,3,204,207
35266,2015-01-19,9,10,166,176
35267,2015-01-19,10,35,204,239
35268,2015-01-19,11,61,238,299
35269,2015-01-19,12,43,323,366
35270,2015-01-19,13,78,321,399
35271,2015-01-19,14,87,317,404
35272,2015-01-19,15,66,309,375
35273,2015-01-19,16,82,347,429
35274,2015-01-19,17,65,358,423
35275,2015-01-19,18,27,309,336
35276,2015-01-19,19,13,235,248
35277,2015-01-19,20,9,169,178
35278,2015-01-19,21,8,120,128
35279,2015-01-19,22,2,95,97
35280,2015-01-19,23,3,67,70
35281,2015-01-20,0,0,12,12
35282,2015-01-20,1,0,5,5
35283,2015-01-20,2,1,5,6
35284,2015-01-20,4,0,7,7
35285,2015-01-20,5,0,47,47
35286,2015-01-20,6,1,168,169
35287,2015-01-20,7,4,472,476
35288,2015-01-20,8,8,836,844
35289,2015-01-20,9,7,361,368
35290,2015-01-20,10,9,183,192
35291,2015-01-20,11,8,185,193
35292,2015-01-20,12,17,195,212
35293,2015-01-20,13,17,191,208
35294,2015-01-20,14,18,181,199
35295,2015-01-20,15,26,218,244
35296,2015-01-20,16,23,383,406
35297,2015-01-20,17,24,716,740
35298,2015-01-20,18,11,697,708
35299,2015-01-20,19,12,466,478
35300,2015-01-20,20,7,339,346
35301,2015-01-20,21,4,187,191
35302,2015-01-20,22,4,118,122
35303,2015-01-20,23,1,89,90
35304,2015-01-21,0,1,25,26
35305,2015-01-21,1,0,7,7
35306,2015-01-21,2,0,1,1
35307,2015-01-21,3,0,3,3
35308,2015-01-21,4,0,8,8
35309,2015-01-21,5,0,72,72
35310,2015-01-21,6,1,186,187
35311,2015-01-21,7,4,487,491
35312,2015-01-21,8,4,874,878
35313,2015-01-21,9,6,412,418
35314,2015-01-21,10,10,142,152
35315,2015-01-21,11,18,143,161
35316,2015-01-21,12,5,156,161
35317,2015-01-21,13,1,76,77
35318,2015-01-21,14,8,73,81
35319,2015-01-21,15,4,122,126
35320,2015-01-21,16,10,228,238
35321,2015-01-21,17,15,558,573
35322,2015-01-21,18,11,565,576
35323,2015-01-21,19,8,387,395
35324,2015-01-21,20,4,301,305
35325,2015-01-21,21,4,203,207
35326,2015-01-21,22,6,109,115
35327,2015-01-21,23,1,91,92
35328,2015-01-22,0,3,20,23
35329,2015-01-22,1,2,10,12
35330,2015-01-22,2,1,3,4
35331,2015-01-22,3,0,2,2
35332,2015-01-22,4,0,3,3
35333,2015-01-22,5,1,51,52
35334,2015-01-22,6,0,143,143
35335,2015-01-22,7,9,433,442
35336,2015-01-22,8,10,810,820
35337,2015-01-22,9,17,353,370
35338,2015-01-22,10,27,185,212
35339,2015-01-22,11,29,210,239
35340,2015-01-22,12,32,261,293
35341,2015-01-22,13,20,234,254
35342,2015-01-22,14,8,181,189
35343,2015-01-22,15,29,231,260
35344,2015-01-22,16,29,375,404
35345,2015-01-22,17,30,713,743
35346,2015-01-22,18,16,663,679
35347,2015-01-22,19,5,438,443
35348,2015-01-22,20,15,304,319
35349,2015-01-22,21,11,234,245
35350,2015-01-22,22,8,129,137
35351,2015-01-22,23,7,74,81
35352,2015-01-23,0,2,32,34
35353,2015-01-23,1,0,9,9
35354,2015-01-23,2,0,12,12
35355,2015-01-23,3,0,2,2
35356,2015-01-23,4,0,5,5
35357,2015-01-23,5,0,48,48
35358,2015-01-23,6,0,145,145
35359,2015-01-23,7,6,407,413
35360,2015-01-23,8,15,846,861
35361,2015-01-23,9,18,407,425
35362,2015-01-23,10,21,181,202
35363,2015-01-23,11,23,214,237
35364,2015-01-23,12,33,279,312
35365,2015-01-23,13,27,280,307
35366,2015-01-23,14,21,251,272
35367,2015-01-23,15,51,246,297
35368,2015-01-23,16,17,330,347
35369,2015-01-23,17,19,336,355
35370,2015-01-23,18,2,191,193
35371,2015-01-23,19,4,117,121
35372,2015-01-23,20,3,70,73
35373,2015-01-23,21,6,21,27
35374,2015-01-23,22,0,19,19
35375,2015-01-23,23,0,17,17
35376,2015-01-24,0,0,12,12
35377,2015-01-24,1,0,7,7
35378,2015-01-24,2,0,6,6
35379,2015-01-24,3,0,7,7
35380,2015-01-24,4,0,2,2
35381,2015-01-24,5,0,2,2
35382,2015-01-24,6,0,7,7
35383,2015-01-24,7,1,30,31
35384,2015-01-24,8,5,63,68
35385,2015-01-24,9,7,144,151
35386,2015-01-24,10,12,197,209
35387,2015-01-24,11,13,232,245
35388,2015-01-24,12,25,258,283
35389,2015-01-24,13,22,249,271
35390,2015-01-24,14,16,236,252
35391,2015-01-24,15,31,291,322
35392,2015-01-24,16,34,276,310
35393,2015-01-24,17,28,290,318
35394,2015-01-24,18,9,269,278
35395,2015-01-24,19,5,211,216
35396,2015-01-24,20,7,121,128
35397,2015-01-24,21,10,130,140
35398,2015-01-24,22,3,109,112
35399,2015-01-24,23,3,92,95
35400,2015-01-25,0,1,54,55
35401,2015-01-25,1,4,74,78
35402,2015-01-25,2,2,57,59
35403,2015-01-25,3,2,20,22
35404,2015-01-25,4,1,8,9
35405,2015-01-25,5,0,1,1
35406,2015-01-25,6,1,11,12
35407,2015-01-25,7,3,30,33
35408,2015-01-25,8,1,84,85
35409,2015-01-25,9,16,159,175
35410,2015-01-25,10,43,316,359
35411,2015-01-25,11,72,370,442
35412,2015-01-25,12,84,437,521
35413,2015-01-25,13,95,436,531
35414,2015-01-25,14,65,420,485
35415,2015-01-25,15,101,433,534
35416,2015-01-25,16,65,411,476
35417,2015-01-25,17,35,315,350
35418,2015-01-25,18,19,281,300
35419,2015-01-25,19,22,202,224
35420,2015-01-25,20,12,138,150
35421,2015-01-25,21,5,113,118
35422,2015-01-25,22,6,93,99
35423,2015-01-25,23,2,39,41
35424,2015-01-26,0,0,23,23
35425,2015-01-26,1,0,5,5
35426,2015-01-26,2,0,3,3
35427,2015-01-26,3,0,1,1
35428,2015-01-26,5,0,31,31
35429,2015-01-26,6,0,68,68
35430,2015-01-26,7,3,156,159
35431,2015-01-26,8,3,324,327
35432,2015-01-26,9,0,203,203
35433,2015-01-26,10,0,78,78
35434,2015-01-26,11,1,58,59
35435,2015-01-26,12,0,83,83
35436,2015-01-26,13,3,73,76
35437,2015-01-26,14,3,68,71
35438,2015-01-26,15,2,105,107
35439,2015-01-26,16,7,153,160
35440,2015-01-26,17,3,329,332
35441,2015-01-26,18,6,276,282
35442,2015-01-26,19,1,131,132
35443,2015-01-26,20,0,120,120
35444,2015-01-26,21,1,57,58
35445,2015-01-26,22,0,29,29
35446,2015-01-26,23,1,21,22
35447,2015-01-27,0,0,11,11
35448,2015-01-27,1,0,5,5
35449,2015-01-27,2,0,1,1
35450,2015-01-27,3,0,1,1
35451,2015-01-27,4,0,2,2
35452,2015-01-27,5,0,24,24
35453,2015-01-27,6,1,57,58
35454,2015-01-27,7,1,167,168
35455,2015-01-27,8,1,328,329
35456,2015-01-27,9,2,302,304
35457,2015-01-27,10,11,229,240
35458,2015-01-27,11,4,129,133
35459,2015-01-27,12,4,129,133
35460,2015-01-27,13,6,147,153
35461,2015-01-27,14,9,127,136
35462,2015-01-27,15,11,171,182
35463,2015-01-27,16,5,249,254
35464,2015-01-27,17,11,558,569
35465,2015-01-27,18,3,487,490
35466,2015-01-27,19,0,341,341
35467,2015-01-27,20,0,250,250
35468,2015-01-27,21,2,155,157
35469,2015-01-27,22,1,82,83
35470,2015-01-27,23,0,43,43
35471,2015-01-28,0,0,14,14
35472,2015-01-28,1,0,7,7
35473,2015-01-28,2,0,1,1
35474,2015-01-28,3,0,1,1
35475,2015-01-28,4,0,4,4
35476,2015-01-28,5,1,43,44
35477,2015-01-28,6,1,141,142
35478,2015-01-28,7,2,382,384
35479,2015-01-28,8,6,648,654
35480,2015-01-28,9,6,345,351
35481,2015-01-28,10,4,141,145
35482,2015-01-28,11,3,132,135
35483,2015-01-28,12,7,198,205
35484,2015-01-28,13,9,174,183
35485,2015-01-28,14,6,159,165
35486,2015-01-28,15,9,184,193
35487,2015-01-28,16,7,303,310
35488,2015-01-28,17,18,604,622
35489,2015-01-28,18,8,544,552
35490,2015-01-28,19,9,353,362
35491,2015-01-28,20,3,245,248
35492,2015-01-28,21,2,181,183
35493,2015-01-28,22,2,150,152
35494,2015-01-28,23,0,37,37
35495,2015-01-29,0,0,14,14
35496,2015-01-29,1,0,5,5
35497,2015-01-29,2,0,3,3
35498,2015-01-29,3,0,4,4
35499,2015-01-29,4,0,5,5
35500,2015-01-29,5,0,46,46
35501,2015-01-29,6,0,122,122
35502,2015-01-29,7,4,407,411
35503,2015-01-29,8,5,763,768
35504,2015-01-29,9,7,377,384
35505,2015-01-29,10,10,161,171
35506,2015-01-29,11,6,155,161
35507,2015-01-29,12,11,207,218
35508,2015-01-29,13,13,171,184
35509,2015-01-29,14,8,151,159
35510,2015-01-29,15,6,177,183
35511,2015-01-29,16,1,164,165
35512,2015-01-29,17,3,357,360
35513,2015-01-29,18,8,420,428
35514,2015-01-29,19,4,297,301
35515,2015-01-29,20,6,213,219
35516,2015-01-29,21,2,156,158
35517,2015-01-29,22,1,104,105
35518,2015-01-29,23,0,54,54
35519,2015-01-30,0,0,35,35
35520,2015-01-30,1,2,12,14
35521,2015-01-30,2,0,9,9
35522,2015-01-30,3,0,2,2
35523,2015-01-30,4,0,4,4
35524,2015-01-30,5,0,43,43
35525,2015-01-30,6,0,137,137
35526,2015-01-30,7,2,398,400
35527,2015-01-30,8,9,738,747
35528,2015-01-30,9,8,412,420
35529,2015-01-30,10,6,165,171
35530,2015-01-30,11,9,170,179
35531,2015-01-30,12,7,211,218
35532,2015-01-30,13,18,209,227
35533,2015-01-30,14,13,179,192
35534,2015-01-30,15,20,193,213
35535,2015-01-30,16,11,329,340
35536,2015-01-30,17,11,529,540
35537,2015-01-30,18,8,383,391
35538,2015-01-30,19,2,241,243
35539,2015-01-30,20,4,125,129
35540,2015-01-30,21,0,81,81
35541,2015-01-30,22,1,66,67
35542,2015-01-30,23,0,46,46
35543,2015-01-31,0,2,46,48
35544,2015-01-31,1,2,34,36
35545,2015-01-31,2,1,12,13
35546,2015-01-31,3,0,8,8
35547,2015-01-31,4,0,5,5
35548,2015-01-31,5,0,3,3
35549,2015-01-31,6,0,13,13
35550,2015-01-31,7,0,44,44
35551,2015-01-31,8,6,94,100
35552,2015-01-31,9,6,160,166
35553,2015-01-31,10,9,182,191
35554,2015-01-31,11,28,216,244
35555,2015-01-31,12,30,250,280
35556,2015-01-31,13,40,240,280
35557,2015-01-31,14,54,241,295
35558,2015-01-31,15,20,259,279
35559,2015-01-31,16,49,244,293
35560,2015-01-31,17,25,204,229
35561,2015-01-31,18,2,181,183
35562,2015-01-31,19,16,200,216
35563,2015-01-31,20,10,117,127
35564,2015-01-31,21,9,85,94
35565,2015-01-31,22,8,98,106
35566,2015-01-31,23,4,74,78
35567,2015-02-01,0,4,80,84
35568,2015-02-01,1,3,46,49
35569,2015-02-01,2,0,40,40
35570,2015-02-01,3,0,12,12
35571,2015-02-01,4,0,4,4
35572,2015-02-01,5,1,4,5
35573,2015-02-01,6,0,1,1
35574,2015-02-01,7,2,25,27
35575,2015-02-01,8,6,89,95
35576,2015-02-01,9,12,129,141
35577,2015-02-01,10,22,243,265
35578,2015-02-01,11,27,248,275
35579,2015-02-01,12,24,303,327
35580,2015-02-01,13,34,283,317
35581,2015-02-01,14,23,233,256
35582,2015-02-01,15,31,290,321
35583,2015-02-01,16,27,309,336
35584,2015-02-01,17,29,337,366
35585,2015-02-01,18,9,229,238
35586,2015-02-01,19,3,86,89
35587,2015-02-01,20,5,66,71
35588,2015-02-01,21,4,60,64
35589,2015-02-01,22,3,164,167
35590,2015-02-01,23,0,37,37
35591,2015-02-02,0,1,10,11
35592,2015-02-02,1,0,7,7
35593,2015-02-02,2,0,3,3
35594,2015-02-02,3,0,1,1
35595,2015-02-02,4,0,2,2
35596,2015-02-02,5,1,47,48
35597,2015-02-02,6,0,127,127
35598,2015-02-02,7,3,320,323
35599,2015-02-02,8,1,517,518
35600,2015-02-02,9,3,170,173
35601,2015-02-02,10,2,103,105
35602,2015-02-02,11,5,111,116
35603,2015-02-02,12,5,136,141
35604,2015-02-02,13,6,159,165
35605,2015-02-02,14,6,134,140
35606,2015-02-02,15,5,179,184
35607,2015-02-02,16,5,262,267
35608,2015-02-02,17,6,531,537
35609,2015-02-02,18,3,416,419
35610,2015-02-02,19,0,255,255
35611,2015-02-02,20,0,148,148
35612,2015-02-02,21,1,105,106
35613,2015-02-02,22,0,61,61
35614,2015-02-02,23,1,23,24
35615,2015-02-03,0,0,8,8
35616,2015-02-03,1,0,7,7
35617,2015-02-03,4,0,3,3
35618,2015-02-03,5,0,34,34
35619,2015-02-03,6,0,117,117
35620,2015-02-03,7,1,374,375
35621,2015-02-03,8,0,755,755
35622,2015-02-03,9,1,357,358
35623,2015-02-03,10,0,112,112
35624,2015-02-03,11,0,124,124
35625,2015-02-03,12,0,166,166
35626,2015-02-03,13,2,188,190
35627,2015-02-03,14,0,158,158
35628,2015-02-03,15,1,220,221
35629,2015-02-03,16,1,318,319
35630,2015-02-03,17,0,654,654
35631,2015-02-03,18,0,569,569
35632,2015-02-03,19,0,399,399
35633,2015-02-03,20,0,237,237
35634,2015-02-03,21,0,176,176
35635,2015-02-03,22,0,100,100
35636,2015-02-03,23,0,35,35
35637,2015-02-04,0,0,20,20
35638,2015-02-04,1,0,6,6
35639,2015-02-04,4,0,3,3
35640,2015-02-04,5,0,54,54
35641,2015-02-04,6,0,179,179
35642,2015-02-04,7,0,477,477
35643,2015-02-04,8,0,810,810
35644,2015-02-04,9,0,347,347
35645,2015-02-04,10,0,160,160
35646,2015-02-04,11,0,168,168
35647,2015-02-04,12,0,248,248
35648,2015-02-04,13,0,194,194
35649,2015-02-04,14,0,169,169
35650,2015-02-04,15,0,212,212
35651,2015-02-04,16,4,389,393
35652,2015-02-04,17,8,727,735
35653,2015-02-04,18,11,715,726
35654,2015-02-04,19,2,444,446
35655,2015-02-04,20,3,303,306
35656,2015-02-04,21,4,206,210
35657,2015-02-04,22,5,121,126
35658,2015-02-04,23,2,83,85
35659,2015-02-05,0,1,30,31
35660,2015-02-05,1,0,11,11
35661,2015-02-05,2,0,4,4
35662,2015-02-05,3,0,4,4
35663,2015-02-05,4,0,6,6
35664,2015-02-05,5,1,39,40
35665,2015-02-05,6,0,150,150
35666,2015-02-05,7,2,444,446
35667,2015-02-05,8,3,836,839
35668,2015-02-05,9,9,354,363
35669,2015-02-05,10,17,146,163
35670,2015-02-05,11,3,144,147
35671,2015-02-05,12,12,174,186
35672,2015-02-05,13,17,152,169
35673,2015-02-05,14,26,141,167
35674,2015-02-05,15,18,164,182
35675,2015-02-05,16,16,279,295
35676,2015-02-05,17,15,536,551
35677,2015-02-05,18,0,449,449
35678,2015-02-05,19,1,303,304
35679,2015-02-05,20,8,208,216
35680,2015-02-05,21,2,141,143
35681,2015-02-05,22,2,77,79
35682,2015-02-05,23,0,41,41
35683,2015-02-06,0,0,19,19
35684,2015-02-06,1,0,12,12
35685,2015-02-06,2,1,3,4
35686,2015-02-06,4,0,5,5
35687,2015-02-06,5,0,35,35
35688,2015-02-06,6,1,105,106
35689,2015-02-06,7,3,308,311
35690,2015-02-06,8,3,607,610
35691,2015-02-06,9,5,353,358
35692,2015-02-06,10,17,150,167
35693,2015-02-06,11,3,175,178
35694,2015-02-06,12,12,195,207
35695,2015-02-06,13,23,205,228
35696,2015-02-06,14,10,154,164
35697,2015-02-06,15,15,205,220
35698,2015-02-06,16,17,330,347
35699,2015-02-06,17,24,581,605
35700,2015-02-06,18,10,471,481
35701,2015-02-06,19,9,320,329
35702,2015-02-06,20,11,191,202
35703,2015-02-06,21,8,139,147
35704,2015-02-06,22,1,105,106
35705,2015-02-06,23,3,83,86
35706,2015-02-07,0,5,80,85
35707,2015-02-07,1,0,41,41
35708,2015-02-07,2,2,19,21
35709,2015-02-07,3,4,11,15
35710,2015-02-07,4,0,2,2
35711,2015-02-07,5,1,1,2
35712,2015-02-07,6,2,11,13
35713,2015-02-07,7,4,43,47
35714,2015-02-07,8,13,110,123
35715,2015-02-07,9,20,181,201
35716,2015-02-07,10,26,255,281
35717,2015-02-07,11,50,312,362
35718,2015-02-07,12,100,363,463
35719,2015-02-07,13,88,374,462
35720,2015-02-07,14,95,343,438
35721,2015-02-07,15,105,365,470
35722,2015-02-07,16,52,338,390
35723,2015-02-07,17,54,306,360
35724,2015-02-07,18,43,264,307
35725,2015-02-07,19,27,237,264
35726,2015-02-07,20,18,175,193
35727,2015-02-07,21,14,130,144
35728,2015-02-07,22,6,123,129
35729,2015-02-07,23,8,104,112
35730,2015-02-08,0,18,76,94
35731,2015-02-08,1,10,63,73
35732,2015-02-08,2,4,55,59
35733,2015-02-08,3,2,20,22
35734,2015-02-08,4,0,3,3
35735,2015-02-08,5,1,7,8
35736,2015-02-08,6,0,3,3
35737,2015-02-08,7,2,22,24
35738,2015-02-08,8,9,86,95
35739,2015-02-08,9,21,157,178
35740,2015-02-08,10,42,263,305
35741,2015-02-08,11,85,348,433
35742,2015-02-08,12,126,394,520
35743,2015-02-08,13,188,516,704
35744,2015-02-08,14,204,495,699
35745,2015-02-08,15,258,598,856
35746,2015-02-08,16,267,583,850
35747,2015-02-08,17,169,452,621
35748,2015-02-08,18,65,355,420
35749,2015-02-08,19,42,239,281
35750,2015-02-08,20,14,135,149
35751,2015-02-08,21,12,108,120
35752,2015-02-08,22,11,69,80
35753,2015-02-08,23,4,45,49
35754,2015-02-09,0,2,15,17
35755,2015-02-09,1,2,13,15
35756,2015-02-09,2,1,8,9
35757,2015-02-09,3,0,1,1
35758,2015-02-09,4,1,5,6
35759,2015-02-09,5,0,48,48
35760,2015-02-09,6,1,155,156
35761,2015-02-09,7,13,494,507
35762,2015-02-09,8,11,835,846
35763,2015-02-09,9,11,351,362
35764,2015-02-09,10,12,142,154
35765,2015-02-09,11,25,120,145
35766,2015-02-09,12,13,184,197
35767,2015-02-09,13,21,180,201
35768,2015-02-09,14,9,145,154
35769,2015-02-09,15,9,212,221
35770,2015-02-09,16,14,313,327
35771,2015-02-09,17,3,429,432
35772,2015-02-09,18,5,490,495
35773,2015-02-09,19,4,321,325
35774,2015-02-09,20,5,160,165
35775,2015-02-09,21,1,79,80
35776,2015-02-09,22,1,55,56
35777,2015-02-09,23,0,20,20
35778,2015-02-10,0,0,8,8
35779,2015-02-10,1,0,3,3
35780,2015-02-10,3,0,2,2
35781,2015-02-10,4,0,4,4
35782,2015-02-10,5,0,40,40
35783,2015-02-10,6,0,126,126
35784,2015-02-10,7,4,395,399
35785,2015-02-10,8,13,797,810
35786,2015-02-10,9,7,346,353
35787,2015-02-10,10,10,153,163
35788,2015-02-10,11,11,145,156
35789,2015-02-10,12,19,199,218
35790,2015-02-10,13,19,193,212
35791,2015-02-10,14,13,161,174
35792,2015-02-10,15,13,199,212
35793,2015-02-10,16,27,289,316
35794,2015-02-10,17,20,720,740
35795,2015-02-10,18,20,605,625
35796,2015-02-10,19,5,409,414
35797,2015-02-10,20,12,306,318
35798,2015-02-10,21,3,213,216
35799,2015-02-10,22,7,103,110
35800,2015-02-10,23,1,47,48
35801,2015-02-11,0,0,17,17
35802,2015-02-11,1,0,4,4
35803,2015-02-11,2,0,3,3
35804,2015-02-11,3,1,1,2
35805,2015-02-11,4,0,1,1
35806,2015-02-11,5,2,48,50
35807,2015-02-11,6,5,163,168
35808,2015-02-11,7,8,450,458
35809,2015-02-11,8,17,903,920
35810,2015-02-11,9,27,398,425
35811,2015-02-11,10,24,142,166
35812,2015-02-11,11,24,221,245
35813,2015-02-11,12,28,225,253
35814,2015-02-11,13,28,218,246
35815,2015-02-11,14,32,180,212
35816,2015-02-11,15,30,223,253
35817,2015-02-11,16,46,388,434
35818,2015-02-11,17,69,760,829
35819,2015-02-11,18,23,677,700
35820,2015-02-11,19,27,432,459
35821,2015-02-11,20,7,282,289
35822,2015-02-11,21,7,253,260
35823,2015-02-11,22,8,118,126
35824,2015-02-11,23,3,69,72
35825,2015-02-12,0,2,22,24
35826,2015-02-12,1,4,7,11
35827,2015-02-12,2,2,0,2
35828,2015-02-12,4,0,1,1
35829,2015-02-12,5,0,45,45
35830,2015-02-12,6,3,153,156
35831,2015-02-12,7,5,460,465
35832,2015-02-12,8,22,893,915
35833,2015-02-12,9,20,360,380
35834,2015-02-12,10,12,158,170
35835,2015-02-12,11,20,164,184
35836,2015-02-12,12,12,181,193
35837,2015-02-12,13,16,205,221
35838,2015-02-12,14,14,154,168
35839,2015-02-12,15,15,189,204
35840,2015-02-12,16,16,320,336
35841,2015-02-12,17,22,597,619
35842,2015-02-12,18,8,559,567
35843,2015-02-12,19,14,306,320
35844,2015-02-12,20,9,219,228
35845,2015-02-12,21,6,114,120
35846,2015-02-12,22,1,77,78
35847,2015-02-12,23,0,32,32
35848,2015-02-13,0,0,21,21
35849,2015-02-13,1,0,6,6
35850,2015-02-13,2,0,3,3
35851,2015-02-13,3,2,1,3
35852,2015-02-13,4,0,4,4
35853,2015-02-13,5,0,26,26
35854,2015-02-13,6,2,58,60
35855,2015-02-13,7,3,250,253
35856,2015-02-13,8,4,506,510
35857,2015-02-13,9,9,301,310
35858,2015-02-13,10,3,135,138
35859,2015-02-13,11,8,131,139
35860,2015-02-13,12,14,180,194
35861,2015-02-13,13,19,190,209
35862,2015-02-13,14,12,144,156
35863,2015-02-13,15,17,210,227
35864,2015-02-13,16,25,278,303
35865,2015-02-13,17,17,439,456
35866,2015-02-13,18,11,361,372
35867,2015-02-13,19,7,220,227
35868,2015-02-13,20,2,172,174
35869,2015-02-13,21,2,97,99
35870,2015-02-13,22,6,70,76
35871,2015-02-13,23,2,42,44
35872,2015-02-14,0,0,44,44
35873,2015-02-14,1,0,39,39
35874,2015-02-14,2,0,23,23
35875,2015-02-14,3,0,6,6
35876,2015-02-14,4,0,3,3
35877,2015-02-14,5,0,2,2
35878,2015-02-14,6,0,11,11
35879,2015-02-14,7,4,31,35
35880,2015-02-14,8,10,105,115
35881,2015-02-14,9,11,140,151
35882,2015-02-14,10,29,192,221
35883,2015-02-14,11,28,217,245
35884,2015-02-14,12,46,199,245
35885,2015-02-14,13,47,219,266
35886,2015-02-14,14,78,203,281
35887,2015-02-14,15,82,260,342
35888,2015-02-14,16,58,256,314
35889,2015-02-14,17,65,221,286
35890,2015-02-14,18,18,144,162
35891,2015-02-14,19,4,46,50
35892,2015-02-14,20,1,24,25
35893,2015-02-14,21,0,27,27
35894,2015-02-14,22,0,26,26
35895,2015-02-14,23,0,14,14
35896,2015-02-15,0,1,10,11
35897,2015-02-15,1,0,7,7
35898,2015-02-15,2,0,11,11
35899,2015-02-15,3,1,4,5
35900,2015-02-15,5,0,1,1
35901,2015-02-15,6,1,3,4
35902,2015-02-15,7,0,7,7
35903,2015-02-15,8,1,22,23
35904,2015-02-15,9,5,36,41
35905,2015-02-15,10,4,60,64
35906,2015-02-15,11,6,66,72
35907,2015-02-15,12,5,72,77
35908,2015-02-15,13,5,79,84
35909,2015-02-15,14,8,94,102
35910,2015-02-15,15,4,80,84
35911,2015-02-15,16,5,92,97
35912,2015-02-15,17,16,88,104
35913,2015-02-15,18,4,68,72
35914,2015-02-15,19,2,49,51
35915,2015-02-15,20,0,37,37
35916,2015-02-15,21,3,35,38
35917,2015-02-15,22,0,34,34
35918,2015-02-15,23,0,15,15
35919,2015-02-16,0,0,8,8
35920,2015-02-16,1,0,2,2
35921,2015-02-16,2,0,3,3
35922,2015-02-16,3,0,1,1
35923,2015-02-16,4,0,1,1
35924,2015-02-16,5,0,4,4
35925,2015-02-16,6,2,13,15
35926,2015-02-16,7,2,41,43
35927,2015-02-16,8,2,92,94
35928,2015-02-16,9,9,90,99
35929,2015-02-16,10,9,86,95
35930,2015-02-16,11,13,107,120
35931,2015-02-16,12,12,130,142
35932,2015-02-16,13,13,136,149
35933,2015-02-16,14,12,118,130
35934,2015-02-16,15,8,111,119
35935,2015-02-16,16,5,91,96
35936,2015-02-16,17,8,62,70
35937,2015-02-16,18,0,46,46
35938,2015-02-16,19,0,30,30
35939,2015-02-16,20,0,13,13
35940,2015-02-16,21,1,10,11
35941,2015-02-16,22,0,15,15
35942,2015-02-16,23,0,9,9
35943,2015-02-17,0,0,12,12
35944,2015-02-17,1,0,7,7
35945,2015-02-17,3,0,1,1
35946,2015-02-17,5,0,2,2
35947,2015-02-17,6,0,5,5
35948,2015-02-17,7,0,11,11
35949,2015-02-17,8,0,35,35
35950,2015-02-17,9,0,40,40
35951,2015-02-17,10,0,41,41
35952,2015-02-17,11,4,47,51
35953,2015-02-17,12,2,68,70
35954,2015-02-17,13,3,83,86
35955,2015-02-17,14,4,76,80
35956,2015-02-17,15,5,89,94
35957,2015-02-17,16,5,104,109
35958,2015-02-17,17,5,122,127
35959,2015-02-17,18,2,121,123
35960,2015-02-17,19,3,94,97
35961,2015-02-17,20,0,71,71
35962,2015-02-17,21,1,49,50
35963,2015-02-17,22,1,48,49
35964,2015-02-17,23,0,17,17
35965,2015-02-18,0,0,10,10
35966,2015-02-18,1,0,4,4
35967,2015-02-18,4,0,4,4
35968,2015-02-18,5,0,20,20
35969,2015-02-18,6,0,67,67
35970,2015-02-18,7,0,210,210
35971,2015-02-18,8,3,381,384
35972,2015-02-18,9,5,235,240
35973,2015-02-18,10,4,115,119
35974,2015-02-18,11,1,96,97
35975,2015-02-18,12,4,137,141
35976,2015-02-18,13,3,118,121
35977,2015-02-18,14,1,109,110
35978,2015-02-18,15,3,126,129
35979,2015-02-18,16,7,201,208
35980,2015-02-18,17,7,418,425
35981,2015-02-18,18,3,338,341
35982,2015-02-18,19,2,201,203
35983,2015-02-18,20,0,148,148
35984,2015-02-18,21,0,81,81
35985,2015-02-18,22,0,54,54
35986,2015-02-18,23,0,27,27
35987,2015-02-19,0,0,9,9
35988,2015-02-19,1,0,3,3
35989,2015-02-19,2,0,3,3
35990,2015-02-19,4,0,3,3
35991,2015-02-19,5,0,17,17
35992,2015-02-19,6,0,77,77
35993,2015-02-19,7,0,232,232
35994,2015-02-19,8,3,432,435
35995,2015-02-19,9,8,224,232
35996,2015-02-19,10,1,83,84
35997,2015-02-19,11,9,93,102
35998,2015-02-19,12,7,85,92
35999,2015-02-19,13,4,85,89
36000,2015-02-19,14,3,63,66
36001,2015-02-19,15,6,102,108
36002,2015-02-19,16,2,153,155
36003,2015-02-19,17,5,294,299
36004,2015-02-19,18,2,267,269
36005,2015-02-19,19,1,164,165
36006,2015-02-19,20,1,105,106
36007,2015-02-19,21,3,78,81
36008,2015-02-19,22,2,40,42
36009,2015-02-19,23,0,13,13
36010,2015-02-20,0,0,9,9
36011,2015-02-20,1,0,3,3
36012,2015-02-20,2,0,1,1
36013,2015-02-20,3,0,1,1
36014,2015-02-20,4,0,2,2
36015,2015-02-20,5,0,16,16
36016,2015-02-20,6,0,47,47
36017,2015-02-20,7,2,153,155
36018,2015-02-20,8,5,318,323
36019,2015-02-20,9,2,171,173
36020,2015-02-20,10,3,66,69
36021,2015-02-20,11,6,75,81
36022,2015-02-20,12,7,93,100
36023,2015-02-20,13,7,103,110
36024,2015-02-20,14,4,94,98
36025,2015-02-20,15,2,124,126
36026,2015-02-20,16,10,179,189
36027,2015-02-20,17,7,317,324
36028,2015-02-20,18,1,241,242
36029,2015-02-20,19,0,154,154
36030,2015-02-20,20,3,104,107
36031,2015-02-20,21,0,68,68
36032,2015-02-20,22,1,42,43
36033,2015-02-20,23,1,42,43
36034,2015-02-21,0,0,24,24
36035,2015-02-21,1,0,13,13
36036,2015-02-21,2,0,15,15
36037,2015-02-21,3,0,4,4
36038,2015-02-21,4,0,3,3
36039,2015-02-21,5,0,5,5
36040,2015-02-21,6,1,6,7
36041,2015-02-21,7,0,28,28
36042,2015-02-21,8,3,68,71
36043,2015-02-21,9,1,118,119
36044,2015-02-21,10,6,153,159
36045,2015-02-21,11,4,60,64
36046,2015-02-21,12,0,46,46
36047,2015-02-21,13,1,27,28
36048,2015-02-21,14,0,21,21
36049,2015-02-21,15,2,15,17
36050,2015-02-21,16,0,27,27
36051,2015-02-21,17,0,21,21
36052,2015-02-21,18,1,18,19
36053,2015-02-21,19,1,12,13
36054,2015-02-21,20,0,6,6
36055,2015-02-21,21,0,7,7
36056,2015-02-21,22,0,13,13
36057,2015-02-21,23,2,9,11
36058,2015-02-22,0,0,8,8
36059,2015-02-22,1,0,12,12
36060,2015-02-22,2,0,6,6
36061,2015-02-22,3,0,5,5
36062,2015-02-22,4,0,2,2
36063,2015-02-22,6,1,1,2
36064,2015-02-22,7,0,8,8
36065,2015-02-22,8,1,26,27
36066,2015-02-22,9,2,38,40
36067,2015-02-22,10,4,71,75
36068,2015-02-22,11,5,117,122
36069,2015-02-22,12,7,132,139
36070,2015-02-22,13,17,145,162
36071,2015-02-22,14,10,181,191
36072,2015-02-22,15,28,253,281
36073,2015-02-22,16,22,220,242
36074,2015-02-22,17,22,181,203
36075,2015-02-22,18,12,155,167
36076,2015-02-22,19,2,111,113
36077,2015-02-22,20,4,64,68
36078,2015-02-22,21,0,44,44
36079,2015-02-22,22,4,39,43
36080,2015-02-22,23,0,29,29
36081,2015-02-23,0,2,39,41
36082,2015-02-23,1,3,5,8
36083,2015-02-23,2,1,3,4
36084,2015-02-23,3,1,2,3
36085,2015-02-23,4,0,5,5
36086,2015-02-23,5,0,36,36
36087,2015-02-23,6,2,99,101
36088,2015-02-23,7,3,323,326
36089,2015-02-23,8,10,528,538
36090,2015-02-23,9,1,283,284
36091,2015-02-23,10,1,81,82
36092,2015-02-23,11,1,88,89
36093,2015-02-23,12,7,116,123
36094,2015-02-23,13,1,108,109
36095,2015-02-23,14,9,91,100
36096,2015-02-23,15,12,126,138
36097,2015-02-23,16,6,232,238
36098,2015-02-23,17,7,422,429
36099,2015-02-23,18,6,367,373
36100,2015-02-23,19,2,245,247
36101,2015-02-23,20,1,154,155
36102,2015-02-23,21,3,102,105
36103,2015-02-23,22,0,41,41
36104,2015-02-23,23,0,22,22
36105,2015-02-24,0,0,10,10
36106,2015-02-24,1,0,4,4
36107,2015-02-24,2,0,1,1
36108,2015-02-24,3,0,1,1
36109,2015-02-24,4,0,5,5
36110,2015-02-24,5,0,21,21
36111,2015-02-24,6,0,90,90
36112,2015-02-24,7,1,312,313
36113,2015-02-24,8,4,520,524
36114,2015-02-24,9,1,268,269
36115,2015-02-24,10,4,112,116
36116,2015-02-24,11,5,116,121
36117,2015-02-24,12,5,132,137
36118,2015-02-24,13,4,127,131
36119,2015-02-24,14,4,125,129
36120,2015-02-24,15,6,131,137
36121,2015-02-24,16,5,249,254
36122,2015-02-24,17,5,447,452
36123,2015-02-24,18,9,424,433
36124,2015-02-24,19,2,276,278
36125,2015-02-24,20,1,184,185
36126,2015-02-24,21,1,149,150
36127,2015-02-24,22,1,67,68
36128,2015-02-24,23,1,41,42
36129,2015-02-25,0,0,17,17
36130,2015-02-25,1,0,8,8
36131,2015-02-25,2,0,2,2
36132,2015-02-25,3,0,1,1
36133,2015-02-25,4,0,3,3
36134,2015-02-25,5,0,35,35
36135,2015-02-25,6,1,120,121
36136,2015-02-25,7,1,362,363
36137,2015-02-25,8,8,651,659
36138,2015-02-25,9,4,340,344
36139,2015-02-25,10,3,127,130
36140,2015-02-25,11,7,142,149
36141,2015-02-25,12,14,188,202
36142,2015-02-25,13,14,157,171
36143,2015-02-25,14,5,157,162
36144,2015-02-25,15,8,181,189
36145,2015-02-25,16,16,292,308
36146,2015-02-25,17,15,606,621
36147,2015-02-25,18,10,568,578
36148,2015-02-25,19,7,331,338
36149,2015-02-25,20,2,218,220
36150,2015-02-25,21,1,129,130
36151,2015-02-25,22,2,122,124
36152,2015-02-25,23,0,75,75
36153,2015-02-26,0,9,18,27
36154,2015-02-26,1,3,15,18
36155,2015-02-26,2,0,7,7
36156,2015-02-26,3,0,2,2
36157,2015-02-26,4,0,3,3
36158,2015-02-26,5,0,20,20
36159,2015-02-26,6,0,33,33
36160,2015-02-26,7,1,85,86
36161,2015-02-26,8,1,141,142
36162,2015-02-26,9,4,150,154
36163,2015-02-26,10,4,155,159
36164,2015-02-26,11,2,114,116
36165,2015-02-26,12,8,120,128
36166,2015-02-26,13,4,130,134
36167,2015-02-26,14,7,114,121
36168,2015-02-26,15,3,164,167
36169,2015-02-26,16,13,268,281
36170,2015-02-26,17,15,503,518
36171,2015-02-26,18,7,485,492
36172,2015-02-26,19,4,305,309
36173,2015-02-26,20,5,219,224
36174,2015-02-26,21,7,146,153
36175,2015-02-26,22,2,105,107
36176,2015-02-26,23,4,70,74
36177,2015-02-27,0,4,22,26
36178,2015-02-27,1,0,9,9
36179,2015-02-27,2,0,5,5
36180,2015-02-27,3,0,4,4
36181,2015-02-27,4,0,5,5
36182,2015-02-27,5,0,33,33
36183,2015-02-27,6,0,92,92
36184,2015-02-27,7,2,314,316
36185,2015-02-27,8,9,638,647
36186,2015-02-27,9,13,353,366
36187,2015-02-27,10,12,163,175
36188,2015-02-27,11,15,145,160
36189,2015-02-27,12,7,186,193
36190,2015-02-27,13,18,190,208
36191,2015-02-27,14,9,125,134
36192,2015-02-27,15,15,222,237
36193,2015-02-27,16,10,287,297
36194,2015-02-27,17,31,532,563
36195,2015-02-27,18,10,442,452
36196,2015-02-27,19,17,283,300
36197,2015-02-27,20,2,157,159
36198,2015-02-27,21,7,81,88
36199,2015-02-27,22,0,104,104
36200,2015-02-27,23,4,62,66
36201,2015-02-28,0,0,55,55
36202,2015-02-28,1,0,29,29
36203,2015-02-28,2,0,13,13
36204,2015-02-28,3,1,4,5
36205,2015-02-28,4,0,7,7
36206,2015-02-28,5,1,1,2
36207,2015-02-28,6,1,5,6
36208,2015-02-28,7,1,38,39
36209,2015-02-28,8,11,92,103
36210,2015-02-28,9,13,157,170
36211,2015-02-28,10,18,185,203
36212,2015-02-28,11,9,216,225
36213,2015-02-28,12,21,219,240
36214,2015-02-28,13,55,247,302
36215,2015-02-28,14,66,232,298
36216,2015-02-28,15,42,261,303
36217,2015-02-28,16,70,241,311
36218,2015-02-28,17,47,219,266
36219,2015-02-28,18,24,176,200
36220,2015-02-28,19,3,119,122
36221,2015-02-28,20,5,110,115
36222,2015-02-28,21,2,83,85
36223,2015-02-28,22,5,64,69
36224,2015-02-28,23,1,53,54
36225,2015-03-01,0,2,42,44
36226,2015-03-01,1,2,34,36
36227,2015-03-01,2,2,37,39
36228,2015-03-01,3,0,10,10
36229,2015-03-01,4,0,2,2
36230,2015-03-01,5,0,3,3
36231,2015-03-01,6,0,7,7
36232,2015-03-01,7,1,42,43
36233,2015-03-01,8,2,48,50
36234,2015-03-01,9,5,78,83
36235,2015-03-01,10,2,71,73
36236,2015-03-01,11,6,57,63
36237,2015-03-01,12,3,45,48
36238,2015-03-01,13,7,27,34
36239,2015-03-01,14,4,18,22
36240,2015-03-01,15,5,28,33
36241,2015-03-01,16,3,24,27
36242,2015-03-01,17,0,28,28
36243,2015-03-01,18,0,32,32
36244,2015-03-01,19,0,16,16
36245,2015-03-01,20,2,17,19
36246,2015-03-01,21,0,22,22
36247,2015-03-01,22,0,27,27
36248,2015-03-01,23,2,5,7
36249,2015-03-02,0,0,9,9
36250,2015-03-02,3,0,1,1
36251,2015-03-02,5,0,14,14
36252,2015-03-02,6,0,38,38
36253,2015-03-02,7,2,142,144
36254,2015-03-02,8,5,303,308
36255,2015-03-02,9,8,294,302
36256,2015-03-02,10,10,232,242
36257,2015-03-02,11,16,135,151
36258,2015-03-02,12,13,149,162
36259,2015-03-02,13,11,170,181
36260,2015-03-02,14,12,145,157
36261,2015-03-02,15,26,174,200
36262,2015-03-02,16,14,278,292
36263,2015-03-02,17,24,542,566
36264,2015-03-02,18,11,485,496
36265,2015-03-02,19,7,347,354
36266,2015-03-02,20,4,203,207
36267,2015-03-02,21,2,125,127
36268,2015-03-02,22,4,80,84
36269,2015-03-02,23,0,31,31
36270,2015-03-03,0,0,18,18
36271,2015-03-03,1,0,1,1
36272,2015-03-03,2,0,2,2
36273,2015-03-03,3,0,3,3
36274,2015-03-03,4,0,5,5
36275,2015-03-03,5,0,37,37
36276,2015-03-03,6,1,121,122
36277,2015-03-03,7,3,363,366
36278,2015-03-03,8,7,749,756
36279,2015-03-03,9,6,366,372
36280,2015-03-03,10,16,151,167
36281,2015-03-03,11,16,133,149
36282,2015-03-03,12,16,133,149
36283,2015-03-03,13,17,89,106
36284,2015-03-03,14,15,77,92
36285,2015-03-03,15,10,130,140
36286,2015-03-03,16,17,147,164
36287,2015-03-03,17,9,276,285
36288,2015-03-03,18,6,252,258
36289,2015-03-03,19,4,207,211
36290,2015-03-03,20,4,159,163
36291,2015-03-03,21,0,110,110
36292,2015-03-03,22,4,101,105
36293,2015-03-03,23,4,46,50
36294,2015-03-04,0,0,16,16
36295,2015-03-04,1,0,10,10
36296,2015-03-04,2,0,1,1
36297,2015-03-04,3,0,2,2
36298,2015-03-04,4,0,3,3
36299,2015-03-04,5,0,35,35
36300,2015-03-04,6,1,112,113
36301,2015-03-04,7,2,375,377
36302,2015-03-04,8,10,701,711
36303,2015-03-04,9,7,286,293
36304,2015-03-04,10,4,139,143
36305,2015-03-04,11,8,140,148
36306,2015-03-04,12,17,207,224
36307,2015-03-04,13,12,183,195
36308,2015-03-04,14,2,147,149
36309,2015-03-04,15,8,167,175
36310,2015-03-04,16,6,230,236
36311,2015-03-04,17,10,391,401
36312,2015-03-04,18,7,358,365
36313,2015-03-04,19,6,263,269
36314,2015-03-04,20,3,103,106
36315,2015-03-04,21,7,82,89
36316,2015-03-04,22,1,45,46
36317,2015-03-04,23,1,33,34
36318,2015-03-05,0,0,9,9
36319,2015-03-05,1,0,6,6
36320,2015-03-05,2,0,4,4
36321,2015-03-05,3,0,4,4
36322,2015-03-05,4,0,4,4
36323,2015-03-05,5,0,12,12
36324,2015-03-05,6,0,20,20
36325,2015-03-05,7,1,36,37
36326,2015-03-05,8,0,63,63
36327,2015-03-05,9,7,50,57
36328,2015-03-05,10,2,29,31
36329,2015-03-05,11,4,29,33
36330,2015-03-05,12,3,25,28
36331,2015-03-05,13,1,29,30
36332,2015-03-05,14,1,11,12
36333,2015-03-05,15,1,18,19
36334,2015-03-05,16,2,18,20
36335,2015-03-05,17,3,31,34
36336,2015-03-05,18,3,22,25
36337,2015-03-05,19,0,21,21
36338,2015-03-05,20,1,15,16
36339,2015-03-05,21,0,18,18
36340,2015-03-05,22,0,18,18
36341,2015-03-05,23,0,17,17
36342,2015-03-06,0,0,6,6
36343,2015-03-06,1,0,5,5
36344,2015-03-06,2,0,3,3
36345,2015-03-06,5,0,9,9
36346,2015-03-06,6,0,10,10
36347,2015-03-06,7,2,30,32
36348,2015-03-06,8,2,101,103
36349,2015-03-06,9,6,103,109
36350,2015-03-06,10,6,95,101
36351,2015-03-06,11,1,72,73
36352,2015-03-06,12,1,66,67
36353,2015-03-06,13,1,93,94
36354,2015-03-06,14,9,77,86
36355,2015-03-06,15,7,101,108
36356,2015-03-06,16,10,159,169
36357,2015-03-06,17,12,253,265
36358,2015-03-06,18,3,233,236
36359,2015-03-06,19,4,162,166
36360,2015-03-06,20,2,94,96
36361,2015-03-06,21,2,86,88
36362,2015-03-06,22,0,47,47
36363,2015-03-06,23,5,50,55
36364,2015-03-07,0,1,22,23
36365,2015-03-07,1,1,24,25
36366,2015-03-07,2,0,16,16
36367,2015-03-07,3,0,10,10
36368,2015-03-07,4,0,2,2
36369,2015-03-07,5,0,6,6
36370,2015-03-07,6,0,8,8
36371,2015-03-07,7,1,32,33
36372,2015-03-07,8,1,71,72
36373,2015-03-07,9,7,116,123
36374,2015-03-07,10,7,166,173
36375,2015-03-07,11,19,207,226
36376,2015-03-07,12,24,240,264
36377,2015-03-07,13,44,245,289
36378,2015-03-07,14,43,259,302
36379,2015-03-07,15,43,245,288
36380,2015-03-07,16,38,217,255
36381,2015-03-07,17,53,256,309
36382,2015-03-07,18,24,191,215
36383,2015-03-07,19,13,157,170
36384,2015-03-07,20,6,109,115
36385,2015-03-07,21,8,93,101
36386,2015-03-07,22,12,68,80
36387,2015-03-07,23,6,70,76
36388,2015-03-08,0,11,76,87
36389,2015-03-08,1,2,42,44
36390,2015-03-08,3,7,58,65
36391,2015-03-08,4,4,19,23
36392,2015-03-08,5,1,6,7
36393,2015-03-08,6,1,4,5
36394,2015-03-08,7,3,15,18
36395,2015-03-08,8,6,58,64
36396,2015-03-08,9,16,100,116
36397,2015-03-08,10,48,192,240
36398,2015-03-08,11,60,239,299
36399,2015-03-08,12,103,313,416
36400,2015-03-08,13,139,352,491
36401,2015-03-08,14,173,365,538
36402,2015-03-08,15,163,458,621
36403,2015-03-08,16,152,457,609
36404,2015-03-08,17,141,388,529
36405,2015-03-08,18,90,352,442
36406,2015-03-08,19,50,237,287
36407,2015-03-08,20,26,132,158
36408,2015-03-08,21,29,95,124
36409,2015-03-08,22,36,74,110
36410,2015-03-08,23,12,42,54
36411,2015-03-09,0,3,26,29
36412,2015-03-09,1,1,9,10
36413,2015-03-09,2,0,3,3
36414,2015-03-09,3,0,1,1
36415,2015-03-09,4,0,3,3
36416,2015-03-09,5,0,48,48
36417,2015-03-09,6,1,147,148
36418,2015-03-09,7,6,427,433
36419,2015-03-09,8,25,837,862
36420,2015-03-09,9,30,420,450
36421,2015-03-09,10,61,148,209
36422,2015-03-09,11,76,157,233
36423,2015-03-09,12,95,216,311
36424,2015-03-09,13,118,248,366
36425,2015-03-09,14,108,206,314
36426,2015-03-09,15,123,245,368
36427,2015-03-09,16,153,476,629
36428,2015-03-09,17,159,895,1054
36429,2015-03-09,18,119,897,1016
36430,2015-03-09,19,71,521,592
36431,2015-03-09,20,68,308,376
36432,2015-03-09,21,40,230,270
36433,2015-03-09,22,31,114,145
36434,2015-03-09,23,13,59,72
36435,2015-03-10,0,5,17,22
36436,2015-03-10,1,3,8,11
36437,2015-03-10,4,0,4,4
36438,2015-03-10,5,0,49,49
36439,2015-03-10,6,5,155,160
36440,2015-03-10,7,23,507,530
36441,2015-03-10,8,37,941,978
36442,2015-03-10,9,27,446,473
36443,2015-03-10,10,56,147,203
36444,2015-03-10,11,43,88,131
36445,2015-03-10,12,46,94,140
36446,2015-03-10,13,10,74,84
36447,2015-03-10,14,8,60,68
36448,2015-03-10,15,17,62,79
36449,2015-03-10,16,13,124,137
36450,2015-03-10,17,23,264,287
36451,2015-03-10,18,14,187,201
36452,2015-03-10,19,2,128,130
36453,2015-03-10,20,2,95,97
36454,2015-03-10,21,11,65,76
36455,2015-03-10,22,8,26,34
36456,2015-03-10,23,9,38,47
36457,2015-03-11,0,1,12,13
36458,2015-03-11,1,1,5,6
36459,2015-03-11,2,0,2,2
36460,2015-03-11,4,1,0,1
36461,2015-03-11,5,1,47,48
36462,2015-03-11,6,1,156,157
36463,2015-03-11,7,25,448,473
36464,2015-03-11,8,33,797,830
36465,2015-03-11,9,26,308,334
36466,2015-03-11,10,26,154,180
36467,2015-03-11,11,30,159,189
36468,2015-03-11,12,41,242,283
36469,2015-03-11,13,65,238,303
36470,2015-03-11,14,91,189,280
36471,2015-03-11,15,80,271,351
36472,2015-03-11,16,71,426,497
36473,2015-03-11,17,133,877,1010
36474,2015-03-11,18,107,936,1043
36475,2015-03-11,19,88,560,648
36476,2015-03-11,20,59,346,405
36477,2015-03-11,21,55,263,318
36478,2015-03-11,22,45,182,227
36479,2015-03-11,23,14,88,102
36480,2015-03-12,0,3,20,23
36481,2015-03-12,1,3,14,17
36482,2015-03-12,2,2,5,7
36483,2015-03-12,5,0,42,42
36484,2015-03-12,6,2,169,171
36485,2015-03-12,7,19,566,585
36486,2015-03-12,8,50,1002,1052
36487,2015-03-12,9,49,404,453
36488,2015-03-12,10,80,180,260
36489,2015-03-12,11,95,179,274
36490,2015-03-12,12,116,270,386
36491,2015-03-12,13,131,266,397
36492,2015-03-12,14,157,249,406
36493,2015-03-12,15,202,269,471
36494,2015-03-12,16,157,461,618
36495,2015-03-12,17,204,954,1158
36496,2015-03-12,18,139,921,1060
36497,2015-03-12,19,97,534,631
36498,2015-03-12,20,70,314,384
36499,2015-03-12,21,66,272,338
36500,2015-03-12,22,51,137,188
36501,2015-03-12,23,16,61,77
36502,2015-03-13,0,9,33,42
36503,2015-03-13,1,3,15,18
36504,2015-03-13,2,5,11,16
36505,2015-03-13,3,0,1,1
36506,2015-03-13,4,1,6,7
36507,2015-03-13,5,1,37,38
36508,2015-03-13,6,1,146,147
36509,2015-03-13,7,16,420,436
36510,2015-03-13,8,49,849,898
36511,2015-03-13,9,70,404,474
36512,2015-03-13,10,63,216,279
36513,2015-03-13,11,105,255,360
36514,2015-03-13,12,131,307,438
36515,2015-03-13,13,190,308,498
36516,2015-03-13,14,150,244,394
36517,2015-03-13,15,115,298,413
36518,2015-03-13,16,108,458,566
36519,2015-03-13,17,139,867,1006
36520,2015-03-13,18,86,672,758
36521,2015-03-13,19,34,403,437
36522,2015-03-13,20,44,243,287
36523,2015-03-13,21,19,156,175
36524,2015-03-13,22,6,136,142
36525,2015-03-13,23,7,70,77
36526,2015-03-14,0,6,37,43
36527,2015-03-14,1,0,41,41
36528,2015-03-14,2,1,11,12
36529,2015-03-14,3,0,7,7
36530,2015-03-14,4,0,1,1
36531,2015-03-14,5,1,4,5
36532,2015-03-14,6,3,65,68
36533,2015-03-14,7,15,51,66
36534,2015-03-14,8,25,70,95
36535,2015-03-14,9,27,84,111
36536,2015-03-14,10,18,110,128
36537,2015-03-14,11,10,134,144
36538,2015-03-14,12,37,167,204
36539,2015-03-14,13,77,283,360
36540,2015-03-14,14,89,309,398
36541,2015-03-14,15,101,232,333
36542,2015-03-14,16,42,102,144
36543,2015-03-14,17,78,191,269
36544,2015-03-14,18,62,222,284
36545,2015-03-14,19,47,186,233
36546,2015-03-14,20,50,145,195
36547,2015-03-14,21,21,130,151
36548,2015-03-14,22,25,112,137
36549,2015-03-14,23,23,95,118
36550,2015-03-15,0,25,100,125
36551,2015-03-15,1,7,68,75
36552,2015-03-15,2,3,51,54
36553,2015-03-15,3,9,19,28
36554,2015-03-15,4,0,5,5
36555,2015-03-15,5,0,2,2
36556,2015-03-15,6,2,9,11
36557,2015-03-15,7,10,31,41
36558,2015-03-15,8,32,99,131
36559,2015-03-15,9,45,154,199
36560,2015-03-15,10,113,276,389
36561,2015-03-15,11,167,350,517
36562,2015-03-15,12,166,411,577
36563,2015-03-15,13,225,412,637
36564,2015-03-15,14,256,417,673
36565,2015-03-15,15,266,414,680
36566,2015-03-15,16,212,406,618
36567,2015-03-15,17,161,387,548
36568,2015-03-15,18,109,308,417
36569,2015-03-15,19,58,193,251
36570,2015-03-15,20,14,138,152
36571,2015-03-15,21,24,122,146
36572,2015-03-15,22,14,82,96
36573,2015-03-15,23,10,33,43
36574,2015-03-16,0,5,23,28
36575,2015-03-16,1,1,3,4
36576,2015-03-16,2,2,7,9
36577,2015-03-16,3,0,4,4
36578,2015-03-16,4,0,3,3
36579,2015-03-16,5,0,41,41
36580,2015-03-16,6,4,152,156
36581,2015-03-16,7,15,513,528
36582,2015-03-16,8,24,911,935
36583,2015-03-16,9,34,385,419
36584,2015-03-16,10,46,150,196
36585,2015-03-16,11,83,171,254
36586,2015-03-16,12,121,251,372
36587,2015-03-16,13,130,250,380
36588,2015-03-16,14,180,185,365
36589,2015-03-16,15,200,284,484
36590,2015-03-16,16,156,507,663
36591,2015-03-16,17,165,1021,1186
36592,2015-03-16,18,158,981,1139
36593,2015-03-16,19,91,539,630
36594,2015-03-16,20,69,355,424
36595,2015-03-16,21,44,272,316
36596,2015-03-16,22,21,136,157
36597,2015-03-16,23,25,63,88
36598,2015-03-17,0,19,33,52
36599,2015-03-17,1,8,10,18
36600,2015-03-17,2,2,5,7
36601,2015-03-17,3,1,3,4
36602,2015-03-17,4,0,5,5
36603,2015-03-17,5,0,58,58
36604,2015-03-17,6,4,201,205
36605,2015-03-17,7,13,610,623
36606,2015-03-17,8,36,1021,1057
36607,2015-03-17,9,52,430,482
36608,2015-03-17,10,93,180,273
36609,2015-03-17,11,93,206,299
36610,2015-03-17,12,104,316,420
36611,2015-03-17,13,133,260,393
36612,2015-03-17,14,119,247,366
36613,2015-03-17,15,156,286,442
36614,2015-03-17,16,180,552,732
36615,2015-03-17,17,165,1030,1195
36616,2015-03-17,18,123,911,1034
36617,2015-03-17,19,55,495,550
36618,2015-03-17,20,21,333,354
36619,2015-03-17,21,21,187,208
36620,2015-03-17,22,9,163,172
36621,2015-03-17,23,7,71,78
36622,2015-03-18,0,4,24,28
36623,2015-03-18,1,0,13,13
36624,2015-03-18,2,0,5,5
36625,2015-03-18,3,0,2,2
36626,2015-03-18,4,0,2,2
36627,2015-03-18,5,1,52,53
36628,2015-03-18,6,3,173,176
36629,2015-03-18,7,13,522,535
36630,2015-03-18,8,24,867,891
36631,2015-03-18,9,22,391,413
36632,2015-03-18,10,37,167,204
36633,2015-03-18,11,33,179,212
36634,2015-03-18,12,48,246,294
36635,2015-03-18,13,45,246,291
36636,2015-03-18,14,76,209,285
36637,2015-03-18,15,74,241,315
36638,2015-03-18,16,91,405,496
36639,2015-03-18,17,115,850,965
36640,2015-03-18,18,50,767,817
36641,2015-03-18,19,66,520,586
36642,2015-03-18,20,33,314,347
36643,2015-03-18,21,9,226,235
36644,2015-03-18,22,20,126,146
36645,2015-03-18,23,8,62,70
36646,2015-03-19,0,6,28,34
36647,2015-03-19,1,2,10,12
36648,2015-03-19,2,3,8,11
36649,2015-03-19,3,2,1,3
36650,2015-03-19,4,0,6,6
36651,2015-03-19,5,0,52,52
36652,2015-03-19,6,4,170,174
36653,2015-03-19,7,17,523,540
36654,2015-03-19,8,25,889,914
36655,2015-03-19,9,48,417,465
36656,2015-03-19,10,48,172,220
36657,2015-03-19,11,60,231,291
36658,2015-03-19,12,100,268,368
36659,2015-03-19,13,77,290,367
36660,2015-03-19,14,104,201,305
36661,2015-03-19,15,138,257,395
36662,2015-03-19,16,122,431,553
36663,2015-03-19,17,141,878,1019
36664,2015-03-19,18,93,783,876
36665,2015-03-19,19,51,482,533
36666,2015-03-19,20,34,332,366
36667,2015-03-19,21,27,237,264
36668,2015-03-19,22,24,161,185
36669,2015-03-19,23,11,80,91
36670,2015-03-20,0,6,27,33
36671,2015-03-20,1,11,21,32
36672,2015-03-20,2,0,7,7
36673,2015-03-20,3,1,0,1
36674,2015-03-20,4,0,3,3
36675,2015-03-20,5,1,16,17
36676,2015-03-20,6,1,41,42
36677,2015-03-20,7,3,86,89
36678,2015-03-20,8,4,233,237
36679,2015-03-20,9,5,126,131
36680,2015-03-20,10,4,57,61
36681,2015-03-20,11,8,53,61
36682,2015-03-20,12,8,65,73
36683,2015-03-20,13,7,70,77
36684,2015-03-20,14,2,82,84
36685,2015-03-20,15,11,96,107
36686,2015-03-20,16,13,178,191
36687,2015-03-20,17,13,437,450
36688,2015-03-20,18,15,402,417
36689,2015-03-20,19,9,266,275
36690,2015-03-20,20,7,186,193
36691,2015-03-20,21,10,127,137
36692,2015-03-20,22,5,98,103
36693,2015-03-20,23,1,82,83
36694,2015-03-21,0,2,66,68
36695,2015-03-21,1,5,41,46
36696,2015-03-21,2,1,24,25
36697,2015-03-21,3,0,12,12
36698,2015-03-21,4,0,3,3
36699,2015-03-21,5,0,7,7
36700,2015-03-21,6,1,15,16
36701,2015-03-21,7,11,42,53
36702,2015-03-21,8,29,155,184
36703,2015-03-21,9,47,245,292
36704,2015-03-21,10,64,319,383
36705,2015-03-21,11,121,352,473
36706,2015-03-21,12,205,449,654
36707,2015-03-21,13,312,452,764
36708,2015-03-21,14,377,529,906
36709,2015-03-21,15,406,550,956
36710,2015-03-21,16,458,498,956
36711,2015-03-21,17,400,506,906
36712,2015-03-21,18,273,495,768
36713,2015-03-21,19,135,350,485
36714,2015-03-21,20,134,204,338
36715,2015-03-21,21,110,190,300
36716,2015-03-21,22,69,170,239
36717,2015-03-21,23,67,142,209
36718,2015-03-22,0,28,113,141
36719,2015-03-22,1,13,71,84
36720,2015-03-22,2,12,72,84
36721,2015-03-22,3,2,28,30
36722,2015-03-22,4,1,3,4
36723,2015-03-22,5,1,3,4
36724,2015-03-22,6,1,11,12
36725,2015-03-22,7,6,39,45
36726,2015-03-22,8,29,80,109
36727,2015-03-22,9,73,197,270
36728,2015-03-22,10,136,294,430
36729,2015-03-22,11,191,428,619
36730,2015-03-22,12,225,467,692
36731,2015-03-22,13,282,512,794
36732,2015-03-22,14,335,432,767
36733,2015-03-22,15,335,538,873
36734,2015-03-22,16,256,451,707
36735,2015-03-22,17,259,469,728
36736,2015-03-22,18,187,389,576
36737,2015-03-22,19,97,252,349
36738,2015-03-22,20,74,180,254
36739,2015-03-22,21,51,143,194
36740,2015-03-22,22,33,101,134
36741,2015-03-22,23,11,41,52
36742,2015-03-23,0,14,13,27
36743,2015-03-23,1,8,8,16
36744,2015-03-23,2,0,2,2
36745,2015-03-23,3,0,1,1
36746,2015-03-23,4,1,9,10
36747,2015-03-23,5,0,49,49
36748,2015-03-23,6,2,163,165
36749,2015-03-23,7,18,463,481
36750,2015-03-23,8,24,852,876
36751,2015-03-23,9,60,370,430
36752,2015-03-23,10,69,163,232
36753,2015-03-23,11,98,138,236
36754,2015-03-23,12,102,215,317
36755,2015-03-23,13,116,238,354
36756,2015-03-23,14,134,228,362
36757,2015-03-23,15,104,242,346
36758,2015-03-23,16,143,468,611
36759,2015-03-23,17,175,912,1087
36760,2015-03-23,18,148,854,1002
36761,2015-03-23,19,84,511,595
36762,2015-03-23,20,34,312,346
36763,2015-03-23,21,31,195,226
36764,2015-03-23,22,32,116,148
36765,2015-03-23,23,6,42,48
36766,2015-03-24,0,8,19,27
36767,2015-03-24,1,0,4,4
36768,2015-03-24,2,1,7,8
36769,2015-03-24,3,0,3,3
36770,2015-03-24,4,0,6,6
36771,2015-03-24,5,1,59,60
36772,2015-03-24,6,3,185,188
36773,2015-03-24,7,7,520,527
36774,2015-03-24,8,26,899,925
36775,2015-03-24,9,35,430,465
36776,2015-03-24,10,58,188,246
36777,2015-03-24,11,77,178,255
36778,2015-03-24,12,70,237,307
36779,2015-03-24,13,78,241,319
36780,2015-03-24,14,90,176,266
36781,2015-03-24,15,81,269,350
36782,2015-03-24,16,84,450,534
36783,2015-03-24,17,111,852,963
36784,2015-03-24,18,109,814,923
36785,2015-03-24,19,55,494,549
36786,2015-03-24,20,35,339,374
36787,2015-03-24,21,9,203,212
36788,2015-03-24,22,15,131,146
36789,2015-03-24,23,3,69,72
36790,2015-03-25,0,2,20,22
36791,2015-03-25,1,0,6,6
36792,2015-03-25,2,0,5,5
36793,2015-03-25,3,0,4,4
36794,2015-03-25,4,3,1,4
36795,2015-03-25,5,0,40,40
36796,2015-03-25,6,3,183,186
36797,2015-03-25,7,11,513,524
36798,2015-03-25,8,16,850,866
36799,2015-03-25,9,20,423,443
36800,2015-03-25,10,14,118,132
36801,2015-03-25,11,38,151,189
36802,2015-03-25,12,38,210,248
36803,2015-03-25,13,63,219,282
36804,2015-03-25,14,60,219,279
36805,2015-03-25,15,68,235,303
36806,2015-03-25,16,85,415,500
36807,2015-03-25,17,65,941,1006
36808,2015-03-25,18,54,826,880
36809,2015-03-25,19,42,499,541
36810,2015-03-25,20,25,350,375
36811,2015-03-25,21,24,279,303
36812,2015-03-25,22,15,167,182
36813,2015-03-25,23,16,86,102
36814,2015-03-26,0,2,26,28
36815,2015-03-26,1,0,8,8
36816,2015-03-26,2,3,2,5
36817,2015-03-26,3,0,3,3
36818,2015-03-26,4,1,3,4
36819,2015-03-26,5,1,57,58
36820,2015-03-26,6,1,186,187
36821,2015-03-26,7,10,566,576
36822,2015-03-26,8,32,1065,1097
36823,2015-03-26,9,46,327,373
36824,2015-03-26,10,23,133,156
36825,2015-03-26,11,25,108,133
36826,2015-03-26,12,48,225,273
36827,2015-03-26,13,79,272,351
36828,2015-03-26,14,113,221,334
36829,2015-03-26,15,148,300,448
36830,2015-03-26,16,160,541,701
36831,2015-03-26,17,196,1076,1272
36832,2015-03-26,18,142,1057,1199
36833,2015-03-26,19,75,617,692
36834,2015-03-26,20,18,169,187
36835,2015-03-26,21,17,258,275
36836,2015-03-26,22,9,78,87
36837,2015-03-26,23,7,82,89
36838,2015-03-27,0,1,27,28
36839,2015-03-27,1,3,8,11
36840,2015-03-27,2,0,9,9
36841,2015-03-27,3,0,3,3
36842,2015-03-27,4,0,1,1
36843,2015-03-27,5,1,16,17
36844,2015-03-27,6,1,56,57
36845,2015-03-27,7,3,185,188
36846,2015-03-27,8,8,262,270
36847,2015-03-27,9,11,306,317
36848,2015-03-27,10,24,170,194
36849,2015-03-27,11,34,164,198
36850,2015-03-27,12,62,226,288
36851,2015-03-27,13,57,238,295
36852,2015-03-27,14,77,212,289
36853,2015-03-27,15,90,286,376
36854,2015-03-27,16,78,411,489
36855,2015-03-27,17,129,793,922
36856,2015-03-27,18,108,658,766
36857,2015-03-27,19,61,445,506
36858,2015-03-27,20,36,285,321
36859,2015-03-27,21,18,174,192
36860,2015-03-27,22,18,132,150
36861,2015-03-27,23,13,101,114
36862,2015-03-28,0,10,90,100
36863,2015-03-28,1,4,58,62
36864,2015-03-28,2,0,38,38
36865,2015-03-28,3,2,7,9
36866,2015-03-28,4,0,2,2
36867,2015-03-28,5,0,4,4
36868,2015-03-28,6,3,13,16
36869,2015-03-28,7,8,52,60
36870,2015-03-28,8,14,150,164
36871,2015-03-28,9,38,225,263
36872,2015-03-28,10,82,253,335
36873,2015-03-28,11,112,306,418
36874,2015-03-28,12,100,338,438
36875,2015-03-28,13,114,349,463
36876,2015-03-28,14,72,277,349
36877,2015-03-28,15,81,299,380
36878,2015-03-28,16,67,240,307
36879,2015-03-28,17,46,247,293
36880,2015-03-28,18,39,227,266
36881,2015-03-28,19,23,184,207
36882,2015-03-28,20,11,119,130
36883,2015-03-28,21,12,86,98
36884,2015-03-28,22,10,68,78
36885,2015-03-28,23,6,87,93
36886,2015-03-29,0,1,49,50
36887,2015-03-29,1,4,45,49
36888,2015-03-29,2,2,29,31
36889,2015-03-29,3,1,9,10
36890,2015-03-29,4,0,2,2
36891,2015-03-29,5,1,1,2
36892,2015-03-29,6,3,11,14
36893,2015-03-29,7,2,37,39
36894,2015-03-29,8,7,61,68
36895,2015-03-29,9,22,143,165
36896,2015-03-29,10,68,259,327
36897,2015-03-29,11,126,302,428
36898,2015-03-29,12,134,332,466
36899,2015-03-29,13,128,351,479
36900,2015-03-29,14,171,374,545
36901,2015-03-29,15,226,374,600
36902,2015-03-29,16,214,402,616
36903,2015-03-29,17,216,403,619
36904,2015-03-29,18,158,294,452
36905,2015-03-29,19,74,251,325
36906,2015-03-29,20,25,132,157
36907,2015-03-29,21,13,91,104
36908,2015-03-29,22,3,72,75
36909,2015-03-29,23,6,42,48
36910,2015-03-30,0,3,23,26
36911,2015-03-30,1,0,7,7
36912,2015-03-30,2,0,4,4
36913,2015-03-30,3,0,2,2
36914,2015-03-30,4,0,3,3
36915,2015-03-30,5,1,38,39
36916,2015-03-30,6,2,175,177
36917,2015-03-30,7,9,469,478
36918,2015-03-30,8,25,951,976
36919,2015-03-30,9,53,386,439
36920,2015-03-30,10,65,226,291
36921,2015-03-30,11,89,175,264
36922,2015-03-30,12,98,249,347
36923,2015-03-30,13,150,243,393
36924,2015-03-30,14,171,236,407
36925,2015-03-30,15,178,284,462
36926,2015-03-30,16,211,475,686
36927,2015-03-30,17,169,1078,1247
36928,2015-03-30,18,140,948,1088
36929,2015-03-30,19,71,616,687
36930,2015-03-30,20,50,365,415
36931,2015-03-30,21,32,252,284
36932,2015-03-30,22,24,141,165
36933,2015-03-30,23,2,63,65
36934,2015-03-31,0,4,20,24
36935,2015-03-31,1,1,11,12
36936,2015-03-31,2,1,6,7
36937,2015-03-31,3,1,2,3
36938,2015-03-31,4,0,4,4
36939,2015-03-31,5,0,56,56
36940,2015-03-31,6,2,203,205
36941,2015-03-31,7,10,648,658
36942,2015-03-31,8,40,1080,1120
36943,2015-03-31,9,53,462,515
36944,2015-03-31,10,131,238,369
36945,2015-03-31,11,130,208,338
36946,2015-03-31,12,114,304,418
36947,2015-03-31,13,143,281,424
36948,2015-03-31,14,170,302,472
36949,2015-03-31,15,142,312,454
36950,2015-03-31,16,79,345,424
36951,2015-03-31,17,55,549,604
36952,2015-03-31,18,49,655,704
36953,2015-03-31,19,40,428,468
36954,2015-03-31,20,26,271,297
36955,2015-03-31,21,27,226,253
36956,2015-03-31,22,13,111,124
36957,2015-03-31,23,1,57,58
36958,2015-04-01,0,0,31,31
36959,2015-04-01,1,1,9,10
36960,2015-04-01,2,1,2,3
36961,2015-04-01,3,0,2,2
36962,2015-04-01,4,0,3,3
36963,2015-04-01,5,1,53,54
36964,2015-04-01,6,3,211,214
36965,2015-04-01,7,20,593,613
36966,2015-04-01,8,41,1030,1071
36967,2015-04-01,9,74,421,495
36968,2015-04-01,10,57,204,261
36969,2015-04-01,11,98,238,336
36970,2015-04-01,12,148,318,466
36971,2015-04-01,13,178,226,404
36972,2015-04-01,14,153,248,401
36973,2015-04-01,15,220,314,534
36974,2015-04-01,16,191,517,708
36975,2015-04-01,17,207,1114,1321
36976,2015-04-01,18,145,1027,1172
36977,2015-04-01,19,101,605,706
36978,2015-04-01,20,65,407,472
36979,2015-04-01,21,45,273,318
36980,2015-04-01,22,22,167,189
36981,2015-04-01,23,9,84,93
36982,2015-04-02,0,1,27,28
36983,2015-04-02,1,3,18,21
36984,2015-04-02,2,0,8,8
36985,2015-04-02,4,0,2,2
36986,2015-04-02,5,0,46,46
36987,2015-04-02,6,4,207,211
36988,2015-04-02,7,16,607,623
36989,2015-04-02,8,51,1087,1138
36990,2015-04-02,9,43,466,509
36991,2015-04-02,10,153,183,336
36992,2015-04-02,11,200,232,432
36993,2015-04-02,12,221,348,569
36994,2015-04-02,13,238,304,542
36995,2015-04-02,14,266,277,543
36996,2015-04-02,15,253,319,572
36997,2015-04-02,16,287,580,867
36998,2015-04-02,17,282,1175,1457
36999,2015-04-02,18,200,1038,1238
37000,2015-04-02,19,141,641,782
37001,2015-04-02,20,100,438,538
37002,2015-04-02,21,61,321,382
37003,2015-04-02,22,57,223,280
37004,2015-04-02,23,31,119,150
37005,2015-04-03,0,18,54,72
37006,2015-04-03,1,11,29,40
37007,2015-04-03,2,9,16,25
37008,2015-04-03,3,0,2,2
37009,2015-04-03,4,0,3,3
37010,2015-04-03,5,2,65,67
37011,2015-04-03,6,5,175,180
37012,2015-04-03,7,19,458,477
37013,2015-04-03,8,36,452,488
37014,2015-04-03,9,20,164,184
37015,2015-04-03,10,27,58,85
37016,2015-04-03,11,33,111,144
37017,2015-04-03,12,43,173,216
37018,2015-04-03,13,41,118,159
37019,2015-04-03,14,50,134,184
37020,2015-04-03,15,99,255,354
37021,2015-04-03,16,167,464,631
37022,2015-04-03,17,147,663,810
37023,2015-04-03,18,132,651,783
37024,2015-04-03,19,97,402,499
37025,2015-04-03,20,85,253,338
37026,2015-04-03,21,69,228,297
37027,2015-04-03,22,35,186,221
37028,2015-04-03,23,32,137,169
37029,2015-04-04,0,16,95,111
37030,2015-04-04,1,12,71,83
37031,2015-04-04,2,9,45,54
37032,2015-04-04,3,10,17,27
37033,2015-04-04,4,2,4,6
37034,2015-04-04,5,3,9,12
37035,2015-04-04,6,11,23,34
37036,2015-04-04,7,13,64,77
37037,2015-04-04,8,53,178,231
37038,2015-04-04,9,175,273,448
37039,2015-04-04,10,279,366,645
37040,2015-04-04,11,430,368,798
37041,2015-04-04,12,430,452,882
37042,2015-04-04,13,521,434,955
37043,2015-04-04,14,521,391,912
37044,2015-04-04,15,579,467,1046
37045,2015-04-04,16,554,439,993
37046,2015-04-04,17,489,422,911
37047,2015-04-04,18,369,330,699
37048,2015-04-04,19,245,300,545
37049,2015-04-04,20,145,206,351
37050,2015-04-04,21,128,145,273
37051,2015-04-04,22,69,101,170
37052,2015-04-04,23,38,132,170
37053,2015-04-05,0,40,74,114
37054,2015-04-05,1,14,70,84
37055,2015-04-05,2,5,40,45
37056,2015-04-05,3,2,19,21
37057,2015-04-05,4,0,3,3
37058,2015-04-05,5,4,11,15
37059,2015-04-05,6,15,33,48
37060,2015-04-05,7,18,68,86
37061,2015-04-05,8,79,116,195
37062,2015-04-05,9,149,248,397
37063,2015-04-05,10,255,333,588
37064,2015-04-05,11,390,356,746
37065,2015-04-05,12,446,387,833
37066,2015-04-05,13,537,357,894
37067,2015-04-05,14,610,404,1014
37068,2015-04-05,15,611,465,1076
37069,2015-04-05,16,562,402,964
37070,2015-04-05,17,524,396,920
37071,2015-04-05,18,425,396,821
37072,2015-04-05,19,248,294,542
37073,2015-04-05,20,126,193,319
37074,2015-04-05,21,81,143,224
37075,2015-04-05,22,61,100,161
37076,2015-04-05,23,24,51,75
37077,2015-04-06,0,15,16,31
37078,2015-04-06,1,6,7,13
37079,2015-04-06,2,0,6,6
37080,2015-04-06,3,0,2,2
37081,2015-04-06,4,3,6,9
37082,2015-04-06,5,0,51,51
37083,2015-04-06,6,15,200,215
37084,2015-04-06,7,18,625,643
37085,2015-04-06,8,81,1002,1083
37086,2015-04-06,9,136,433,569
37087,2015-04-06,10,225,228,453
37088,2015-04-06,11,354,249,603
37089,2015-04-06,12,303,419,722
37090,2015-04-06,13,309,404,713
37091,2015-04-06,14,336,337,673
37092,2015-04-06,15,329,389,718
37093,2015-04-06,16,335,558,893
37094,2015-04-06,17,320,1149,1469
37095,2015-04-06,18,287,1014,1301
37096,2015-04-06,19,249,850,1099
37097,2015-04-06,20,113,479,592
37098,2015-04-06,21,85,283,368
37099,2015-04-06,22,61,142,203
37100,2015-04-06,23,37,174,211
37101,2015-04-07,0,20,53,73
37102,2015-04-07,1,15,16,31
37103,2015-04-07,2,2,3,5
37104,2015-04-07,3,1,2,3
37105,2015-04-07,4,0,5,5
37106,2015-04-07,5,1,49,50
37107,2015-04-07,6,12,196,208
37108,2015-04-07,7,17,699,716
37109,2015-04-07,8,42,1149,1191
37110,2015-04-07,9,102,491,593
37111,2015-04-07,10,179,220,399
37112,2015-04-07,11,213,237,450
37113,2015-04-07,12,220,306,526
37114,2015-04-07,13,221,396,617
37115,2015-04-07,14,244,366,610
37116,2015-04-07,15,235,357,592
37117,2015-04-07,16,222,523,745
37118,2015-04-07,17,245,1096,1341
37119,2015-04-07,18,177,956,1133
37120,2015-04-07,19,139,561,700
37121,2015-04-07,20,56,374,430
37122,2015-04-07,21,68,291,359
37123,2015-04-07,22,48,186,234
37124,2015-04-07,23,17,86,103
37125,2015-04-08,0,0,8,8
37126,2015-04-08,1,0,4,4
37127,2015-04-08,2,0,1,1
37128,2015-04-08,3,0,1,1
37129,2015-04-08,4,2,2,4
37130,2015-04-08,5,0,59,59
37131,2015-04-08,6,5,210,215
37132,2015-04-08,7,18,493,511
37133,2015-04-08,8,22,686,708
37134,2015-04-08,9,26,294,320
37135,2015-04-08,10,49,172,221
37136,2015-04-08,11,61,182,243
37137,2015-04-08,12,79,216,295
37138,2015-04-08,13,90,223,313
37139,2015-04-08,14,77,184,261
37140,2015-04-08,15,104,254,358
37141,2015-04-08,16,125,402,527
37142,2015-04-08,17,111,923,1034
37143,2015-04-08,18,85,882,967
37144,2015-04-08,19,67,481,548
37145,2015-04-08,20,18,267,285
37146,2015-04-08,21,20,234,254
37147,2015-04-08,22,24,183,207
37148,2015-04-08,23,10,87,97
37149,2015-04-09,0,6,31,37
37150,2015-04-09,1,3,13,16
37151,2015-04-09,2,1,3,4
37152,2015-04-09,3,2,1,3
37153,2015-04-09,4,0,2,2
37154,2015-04-09,5,1,31,32
37155,2015-04-09,6,5,166,171
37156,2015-04-09,7,14,503,517
37157,2015-04-09,8,27,861,888
37158,2015-04-09,9,30,484,514
37159,2015-04-09,10,68,177,245
37160,2015-04-09,11,92,209,301
37161,2015-04-09,12,87,270,357
37162,2015-04-09,13,70,235,305
37163,2015-04-09,14,101,214,315
37164,2015-04-09,15,111,306,417
37165,2015-04-09,16,126,469,595
37166,2015-04-09,17,107,870,977
37167,2015-04-09,18,84,800,884
37168,2015-04-09,19,58,455,513
37169,2015-04-09,20,23,272,295
37170,2015-04-09,21,22,205,227
37171,2015-04-09,22,12,129,141
37172,2015-04-09,23,3,69,72
37173,2015-04-10,0,4,27,31
37174,2015-04-10,1,0,15,15
37175,2015-04-10,2,2,3,5
37176,2015-04-10,4,0,4,4
37177,2015-04-10,5,2,43,45
37178,2015-04-10,6,12,170,182
37179,2015-04-10,7,18,439,457
37180,2015-04-10,8,39,785,824
37181,2015-04-10,9,61,440,501
37182,2015-04-10,10,81,202,283
37183,2015-04-10,11,164,225,389
37184,2015-04-10,12,150,323,473
37185,2015-04-10,13,213,342,555
37186,2015-04-10,14,178,295,473
37187,2015-04-10,15,211,350,561
37188,2015-04-10,16,216,529,745
37189,2015-04-10,17,208,953,1161
37190,2015-04-10,18,172,701,873
37191,2015-04-10,19,153,472,625
37192,2015-04-10,20,108,310,418
37193,2015-04-10,21,73,214,287
37194,2015-04-10,22,75,217,292
37195,2015-04-10,23,60,138,198
37196,2015-04-11,0,35,113,148
37197,2015-04-11,1,30,88,118
37198,2015-04-11,2,24,62,86
37199,2015-04-11,3,12,27,39
37200,2015-04-11,4,16,6,22
37201,2015-04-11,5,15,24,39
37202,2015-04-11,6,47,69,116
37203,2015-04-11,7,71,150,221
37204,2015-04-11,8,172,305,477
37205,2015-04-11,9,248,466,714
37206,2015-04-11,10,412,558,970
37207,2015-04-11,11,635,667,1302
37208,2015-04-11,12,786,658,1444
37209,2015-04-11,13,887,657,1544
37210,2015-04-11,14,873,604,1477
37211,2015-04-11,15,870,617,1487
37212,2015-04-11,16,965,663,1628
37213,2015-04-11,17,817,610,1427
37214,2015-04-11,18,686,542,1228
37215,2015-04-11,19,445,457,902
37216,2015-04-11,20,195,235,430
37217,2015-04-11,21,182,236,418
37218,2015-04-11,22,101,174,275
37219,2015-04-11,23,84,142,226
37220,2015-04-12,0,50,115,165
37221,2015-04-12,1,11,83,94
37222,2015-04-12,2,12,54,66
37223,2015-04-12,3,4,23,27
37224,2015-04-12,4,2,10,12
37225,2015-04-12,5,13,22,35
37226,2015-04-12,6,50,172,222
37227,2015-04-12,7,82,136,218
37228,2015-04-12,8,155,222,377
37229,2015-04-12,9,324,393,717
37230,2015-04-12,10,526,484,1010
37231,2015-04-12,11,658,625,1283
37232,2015-04-12,12,766,692,1458
37233,2015-04-12,13,883,692,1575
37234,2015-04-12,14,808,604,1412
37235,2015-04-12,15,811,631,1442
37236,2015-04-12,16,702,663,1365
37237,2015-04-12,17,646,663,1309
37238,2015-04-12,18,548,543,1091
37239,2015-04-12,19,391,446,837
37240,2015-04-12,20,210,290,500
37241,2015-04-12,21,97,154,251
37242,2015-04-12,22,58,129,187
37243,2015-04-12,23,30,67,97
37244,2015-04-13,0,15,30,45
37245,2015-04-13,1,4,10,14
37246,2015-04-13,2,0,10,10
37247,2015-04-13,3,0,4,4
37248,2015-04-13,4,1,2,3
37249,2015-04-13,5,8,62,70
37250,2015-04-13,6,26,258,284
37251,2015-04-13,7,62,676,738
37252,2015-04-13,8,80,1016,1096
37253,2015-04-13,9,108,415,523
37254,2015-04-13,10,186,243,429
37255,2015-04-13,11,215,263,478
37256,2015-04-13,12,237,388,625
37257,2015-04-13,13,247,307,554
37258,2015-04-13,14,301,325,626
37259,2015-04-13,15,273,340,613
37260,2015-04-13,16,282,649,931
37261,2015-04-13,17,317,1286,1603
37262,2015-04-13,18,287,1245,1532
37263,2015-04-13,19,266,823,1089
37264,2015-04-13,20,120,531,651
37265,2015-04-13,21,64,374,438
37266,2015-04-13,22,55,175,230
37267,2015-04-13,23,31,77,108
37268,2015-04-14,0,7,22,29
37269,2015-04-14,1,1,9,10
37270,2015-04-14,2,3,7,10
37271,2015-04-14,3,0,1,1
37272,2015-04-14,4,0,5,5
37273,2015-04-14,5,2,49,51
37274,2015-04-14,6,2,69,71
37275,2015-04-14,7,3,146,149
37276,2015-04-14,8,16,451,467
37277,2015-04-14,9,24,286,310
37278,2015-04-14,10,22,124,146
37279,2015-04-14,11,32,138,170
37280,2015-04-14,12,22,116,138
37281,2015-04-14,13,13,84,97
37282,2015-04-14,14,11,57,68
37283,2015-04-14,15,10,66,76
37284,2015-04-14,16,12,111,123
37285,2015-04-14,17,19,320,339
37286,2015-04-14,18,35,483,518
37287,2015-04-14,19,23,371,394
37288,2015-04-14,20,11,229,240
37289,2015-04-14,21,10,196,206
37290,2015-04-14,22,10,120,130
37291,2015-04-14,23,5,72,77
37292,2015-04-15,0,12,27,39
37293,2015-04-15,1,7,16,23
37294,2015-04-15,2,2,4,6
37295,2015-04-15,3,7,5,12
37296,2015-04-15,4,0,14,14
37297,2015-04-15,5,4,81,85
37298,2015-04-15,6,13,272,285
37299,2015-04-15,7,29,756,785
37300,2015-04-15,8,52,1123,1175
37301,2015-04-15,9,71,448,519
37302,2015-04-15,10,100,217,317
37303,2015-04-15,11,134,247,381
37304,2015-04-15,12,164,349,513
37305,2015-04-15,13,119,300,419
37306,2015-04-15,14,155,332,487
37307,2015-04-15,15,143,294,437
37308,2015-04-15,16,152,567,719
37309,2015-04-15,17,209,1193,1402
37310,2015-04-15,18,192,1091,1283
37311,2015-04-15,19,117,694,811
37312,2015-04-15,20,62,509,571
37313,2015-04-15,21,58,353,411
37314,2015-04-15,22,57,230,287
37315,2015-04-15,23,26,121,147
37316,2015-04-16,0,11,48,59
37317,2015-04-16,1,3,13,16
37318,2015-04-16,2,7,9,16
37319,2015-04-16,3,4,3,7
37320,2015-04-16,4,2,6,8
37321,2015-04-16,5,3,56,59
37322,2015-04-16,6,8,254,262
37323,2015-04-16,7,29,758,787
37324,2015-04-16,8,52,1132,1184
37325,2015-04-16,9,76,498,574
37326,2015-04-16,10,87,244,331
37327,2015-04-16,11,165,279,444
37328,2015-04-16,12,138,388,526
37329,2015-04-16,13,156,367,523
37330,2015-04-16,14,165,327,492
37331,2015-04-16,15,184,381,565
37332,2015-04-16,16,181,607,788
37333,2015-04-16,17,256,1187,1443
37334,2015-04-16,18,181,1196,1377
37335,2015-04-16,19,133,685,818
37336,2015-04-16,20,71,449,520
37337,2015-04-16,21,58,409,467
37338,2015-04-16,22,31,286,317
37339,2015-04-16,23,11,97,108
37340,2015-04-17,0,3,26,29
37341,2015-04-17,1,2,12,14
37342,2015-04-17,2,4,14,18
37343,2015-04-17,3,0,3,3
37344,2015-04-17,4,0,4,4
37345,2015-04-17,5,2,57,59
37346,2015-04-17,6,8,195,203
37347,2015-04-17,7,26,680,706
37348,2015-04-17,8,59,1067,1126
37349,2015-04-17,9,100,504,604
37350,2015-04-17,10,193,273,466
37351,2015-04-17,11,224,299,523
37352,2015-04-17,12,267,414,681
37353,2015-04-17,13,235,383,618
37354,2015-04-17,14,283,347,630
37355,2015-04-17,15,309,430,739
37356,2015-04-17,16,269,714,983
37357,2015-04-17,17,305,1210,1515
37358,2015-04-17,18,236,905,1141
37359,2015-04-17,19,144,570,714
37360,2015-04-17,20,148,416,564
37361,2015-04-17,21,136,363,499
37362,2015-04-17,22,98,304,402
37363,2015-04-17,23,89,216,305
37364,2015-04-18,0,58,153,211
37365,2015-04-18,1,37,68,105
37366,2015-04-18,2,19,55,74
37367,2015-04-18,3,15,27,42
37368,2015-04-18,4,4,6,10
37369,2015-04-18,5,3,13,16
37370,2015-04-18,6,7,37,44
37371,2015-04-18,7,44,122,166
37372,2015-04-18,8,103,275,378
37373,2015-04-18,9,269,419,688
37374,2015-04-18,10,413,548,961
37375,2015-04-18,11,605,585,1190
37376,2015-04-18,12,740,679,1419
37377,2015-04-18,13,685,609,1294
37378,2015-04-18,14,782,591,1373
37379,2015-04-18,15,861,591,1452
37380,2015-04-18,16,688,664,1352
37381,2015-04-18,17,694,629,1323
37382,2015-04-18,18,590,610,1200
37383,2015-04-18,19,448,474,922
37384,2015-04-18,20,257,395,652
37385,2015-04-18,21,173,318,491
37386,2015-04-18,22,138,209,347
37387,2015-04-18,23,114,183,297
37388,2015-04-19,0,76,142,218
37389,2015-04-19,1,33,107,140
37390,2015-04-19,2,39,75,114
37391,2015-04-19,3,19,35,54
37392,2015-04-19,4,2,5,7
37393,2015-04-19,5,1,13,14
37394,2015-04-19,6,14,22,36
37395,2015-04-19,7,38,64,102
37396,2015-04-19,8,97,182,279
37397,2015-04-19,9,229,279,508
37398,2015-04-19,10,351,436,787
37399,2015-04-19,11,537,557,1094
37400,2015-04-19,12,512,625,1137
37401,2015-04-19,13,533,575,1108
37402,2015-04-19,14,461,590,1051
37403,2015-04-19,15,510,543,1053
37404,2015-04-19,16,416,569,985
37405,2015-04-19,17,337,450,787
37406,2015-04-19,18,162,278,440
37407,2015-04-19,19,34,106,140
37408,2015-04-19,20,25,85,110
37409,2015-04-19,21,4,36,40
37410,2015-04-19,22,4,24,28
37411,2015-04-19,23,0,19,19
37412,2015-04-20,0,0,7,7
37413,2015-04-20,2,0,5,5
37414,2015-04-20,4,0,1,1
37415,2015-04-20,5,1,25,26
37416,2015-04-20,6,2,122,124
37417,2015-04-20,7,19,356,375
37418,2015-04-20,8,45,900,945
37419,2015-04-20,9,69,436,505
37420,2015-04-20,10,121,193,314
37421,2015-04-20,11,165,217,382
37422,2015-04-20,12,114,335,449
37423,2015-04-20,13,169,308,477
37424,2015-04-20,14,219,308,527
37425,2015-04-20,15,173,346,519
37426,2015-04-20,16,173,503,676
37427,2015-04-20,17,178,1111,1289
37428,2015-04-20,18,142,998,1140
37429,2015-04-20,19,104,660,764
37430,2015-04-20,20,24,125,149
37431,2015-04-20,21,19,167,186
37432,2015-04-20,22,17,116,133
37433,2015-04-20,23,15,59,74
37434,2015-04-21,0,4,31,35
37435,2015-04-21,1,0,6,6
37436,2015-04-21,2,2,1,3
37437,2015-04-21,3,0,2,2
37438,2015-04-21,4,0,9,9
37439,2015-04-21,5,3,64,67
37440,2015-04-21,6,4,241,245
37441,2015-04-21,7,41,786,827
37442,2015-04-21,8,78,1152,1230
37443,2015-04-21,9,74,476,550
37444,2015-04-21,10,108,225,333
37445,2015-04-21,11,149,265,414
37446,2015-04-21,12,141,362,503
37447,2015-04-21,13,171,320,491
37448,2015-04-21,14,167,264,431
37449,2015-04-21,15,184,349,533
37450,2015-04-21,16,185,635,820
37451,2015-04-21,17,215,1298,1513
37452,2015-04-21,18,193,1234,1427
37453,2015-04-21,19,119,731,850
37454,2015-04-21,20,88,474,562
37455,2015-04-21,21,47,300,347
37456,2015-04-21,22,49,253,302
37457,2015-04-21,23,28,115,143
37458,2015-04-22,0,11,36,47
37459,2015-04-22,1,3,11,14
37460,2015-04-22,2,0,8,8
37461,2015-04-22,3,0,6,6
37462,2015-04-22,4,0,7,7
37463,2015-04-22,5,7,80,87
37464,2015-04-22,6,11,279,290
37465,2015-04-22,7,39,824,863
37466,2015-04-22,8,55,1222,1277
37467,2015-04-22,9,88,487,575
37468,2015-04-22,10,124,219,343
37469,2015-04-22,11,158,239,397
37470,2015-04-22,12,166,316,482
37471,2015-04-22,13,141,343,484
37472,2015-04-22,14,99,236,335
37473,2015-04-22,15,73,282,355
37474,2015-04-22,16,84,549,633
37475,2015-04-22,17,116,1104,1220
37476,2015-04-22,18,119,1136,1255
37477,2015-04-22,19,84,623,707
37478,2015-04-22,20,54,431,485
37479,2015-04-22,21,47,280,327
37480,2015-04-22,22,31,222,253
37481,2015-04-22,23,3,92,95
37482,2015-04-23,0,5,34,39
37483,2015-04-23,1,3,11,14
37484,2015-04-23,2,1,7,8
37485,2015-04-23,3,0,3,3
37486,2015-04-23,4,0,7,7
37487,2015-04-23,5,3,53,56
37488,2015-04-23,6,8,217,225
37489,2015-04-23,7,28,701,729
37490,2015-04-23,8,43,1100,1143
37491,2015-04-23,9,70,452,522
37492,2015-04-23,10,118,227,345
37493,2015-04-23,11,122,243,365
37494,2015-04-23,12,146,323,469
37495,2015-04-23,13,121,308,429
37496,2015-04-23,14,157,276,433
37497,2015-04-23,15,149,369,518
37498,2015-04-23,16,142,513,655
37499,2015-04-23,17,178,1012,1190
37500,2015-04-23,18,130,1009,1139
37501,2015-04-23,19,72,626,698
37502,2015-04-23,20,46,352,398
37503,2015-04-23,21,43,309,352
37504,2015-04-23,22,13,233,246
37505,2015-04-23,23,13,110,123
37506,2015-04-24,0,9,48,57
37507,2015-04-24,1,3,25,28
37508,2015-04-24,2,1,10,11
37509,2015-04-24,3,0,1,1
37510,2015-04-24,4,0,6,6
37511,2015-04-24,5,2,53,55
37512,2015-04-24,6,4,202,206
37513,2015-04-24,7,25,514,539
37514,2015-04-24,8,34,986,1020
37515,2015-04-24,9,81,499,580
37516,2015-04-24,10,112,221,333
37517,2015-04-24,11,145,280,425
37518,2015-04-24,12,199,355,554
37519,2015-04-24,13,195,387,582
37520,2015-04-24,14,250,317,567
37521,2015-04-24,15,218,407,625
37522,2015-04-24,16,228,606,834
37523,2015-04-24,17,245,1043,1288
37524,2015-04-24,18,160,810,970
37525,2015-04-24,19,105,539,644
37526,2015-04-24,20,55,344,399
37527,2015-04-24,21,50,201,251
37528,2015-04-24,22,57,159,216
37529,2015-04-24,23,21,164,185
37530,2015-04-25,0,14,99,113
37531,2015-04-25,1,5,63,68
37532,2015-04-25,2,4,44,48
37533,2015-04-25,3,0,8,8
37534,2015-04-25,4,1,8,9
37535,2015-04-25,5,4,13,17
37536,2015-04-25,6,9,44,53
37537,2015-04-25,7,23,92,115
37538,2015-04-25,8,57,215,272
37539,2015-04-25,9,140,316,456
37540,2015-04-25,10,206,364,570
37541,2015-04-25,11,292,442,734
37542,2015-04-25,12,274,474,748
37543,2015-04-25,13,367,454,821
37544,2015-04-25,14,305,432,737
37545,2015-04-25,15,344,456,800
37546,2015-04-25,16,299,358,657
37547,2015-04-25,17,222,272,494
37548,2015-04-25,18,57,119,176
37549,2015-04-25,19,32,89,121
37550,2015-04-25,20,13,58,71
37551,2015-04-25,21,7,34,41
37552,2015-04-25,22,4,25,29
37553,2015-04-25,23,5,27,32
37554,2015-04-26,0,1,44,45
37555,2015-04-26,1,4,44,48
37556,2015-04-26,2,1,47,48
37557,2015-04-26,3,0,13,13
37558,2015-04-26,4,0,4,4
37559,2015-04-26,5,0,5,5
37560,2015-04-26,6,7,21,28
37561,2015-04-26,7,16,34,50
37562,2015-04-26,8,60,131,191
37563,2015-04-26,9,110,251,361
37564,2015-04-26,10,193,362,555
37565,2015-04-26,11,321,464,785
37566,2015-04-26,12,435,594,1029
37567,2015-04-26,13,463,591,1054
37568,2015-04-26,14,497,588,1085
37569,2015-04-26,15,460,537,997
37570,2015-04-26,16,436,558,994
37571,2015-04-26,17,361,525,886
37572,2015-04-26,18,257,509,766
37573,2015-04-26,19,174,367,541
37574,2015-04-26,20,96,262,358
37575,2015-04-26,21,63,182,245
37576,2015-04-26,22,37,130,167
37577,2015-04-26,23,20,59,79
37578,2015-04-27,0,6,35,41
37579,2015-04-27,1,8,15,23
37580,2015-04-27,2,6,7,13
37581,2015-04-27,3,1,6,7
37582,2015-04-27,4,0,2,2
37583,2015-04-27,5,0,50,50
37584,2015-04-27,6,6,191,197
37585,2015-04-27,7,24,669,693
37586,2015-04-27,8,40,1014,1054
37587,2015-04-27,9,64,429,493
37588,2015-04-27,10,90,159,249
37589,2015-04-27,11,116,174,290
37590,2015-04-27,12,141,271,412
37591,2015-04-27,13,62,268,330
37592,2015-04-27,14,99,249,348
37593,2015-04-27,15,106,329,435
37594,2015-04-27,16,99,522,621
37595,2015-04-27,17,116,1078,1194
37596,2015-04-27,18,82,942,1024
37597,2015-04-27,19,60,553,613
37598,2015-04-27,20,29,257,286
37599,2015-04-27,21,23,213,236
37600,2015-04-27,22,35,162,197
37601,2015-04-27,23,8,53,61
37602,2015-04-28,0,4,16,20
37603,2015-04-28,1,8,7,15
37604,2015-04-28,2,4,5,9
37605,2015-04-28,3,2,2,4
37606,2015-04-28,4,0,7,7
37607,2015-04-28,5,3,71,74
37608,2015-04-28,6,13,247,260
37609,2015-04-28,7,23,736,759
37610,2015-04-28,8,47,1098,1145
37611,2015-04-28,9,66,463,529
37612,2015-04-28,10,108,252,360
37613,2015-04-28,11,112,288,400
37614,2015-04-28,12,149,315,464
37615,2015-04-28,13,172,305,477
37616,2015-04-28,14,149,292,441
37617,2015-04-28,15,145,333,478
37618,2015-04-28,16,154,577,731
37619,2015-04-28,17,119,1229,1348
37620,2015-04-28,18,130,1196,1326
37621,2015-04-28,19,114,738,852
37622,2015-04-28,20,68,499,567
37623,2015-04-28,21,51,330,381
37624,2015-04-28,22,23,203,226
37625,2015-04-28,23,24,102,126
37626,2015-04-29,0,16,34,50
37627,2015-04-29,1,1,12,13
37628,2015-04-29,2,1,8,9
37629,2015-04-29,3,0,2,2
37630,2015-04-29,4,0,6,6
37631,2015-04-29,5,1,68,69
37632,2015-04-29,6,10,269,279
37633,2015-04-29,7,40,821,861
37634,2015-04-29,8,57,1226,1283
37635,2015-04-29,9,74,475,549
37636,2015-04-29,10,114,208,322
37637,2015-04-29,11,123,268,391
37638,2015-04-29,12,155,341,496
37639,2015-04-29,13,148,375,523
37640,2015-04-29,14,151,299,450
37641,2015-04-29,15,175,332,507
37642,2015-04-29,16,151,619,770
37643,2015-04-29,17,201,1236,1437
37644,2015-04-29,18,192,1171,1363
37645,2015-04-29,19,118,752,870
37646,2015-04-29,20,101,506,607
37647,2015-04-29,21,61,351,412
37648,2015-04-29,22,25,218,243
37649,2015-04-29,23,24,128,152
37650,2015-04-30,0,12,45,57
37651,2015-04-30,1,6,16,22
37652,2015-04-30,2,1,13,14
37653,2015-04-30,3,0,3,3
37654,2015-04-30,4,0,5,5
37655,2015-04-30,5,3,59,62
37656,2015-04-30,6,7,258,265
37657,2015-04-30,7,39,792,831
37658,2015-04-30,8,52,1156,1208
37659,2015-04-30,9,66,520,586
37660,2015-04-30,10,103,224,327
37661,2015-04-30,11,150,304,454
37662,2015-04-30,12,150,362,512
37663,2015-04-30,13,111,352,463
37664,2015-04-30,14,119,283,402
37665,2015-04-30,15,140,338,478
37666,2015-04-30,16,110,398,508
37667,2015-04-30,17,118,899,1017
37668,2015-04-30,18,106,971,1077
37669,2015-04-30,19,92,674,766
37670,2015-04-30,20,59,405,464
37671,2015-04-30,21,26,312,338
37672,2015-04-30,22,34,216,250
37673,2015-04-30,23,7,141,148
37674,2015-05-01,0,12,56,68
37675,2015-05-01,1,3,31,34
37676,2015-05-01,2,5,18,23
37677,2015-05-01,3,0,7,7
37678,2015-05-01,4,0,5,5
37679,2015-05-01,5,0,58,58
37680,2015-05-01,6,0,172,172
37681,2015-05-01,7,19,507,526
37682,2015-05-01,8,45,1004,1049
37683,2015-05-01,9,83,464,547
37684,2015-05-01,10,116,259,375
37685,2015-05-01,11,122,297,419
37686,2015-05-01,12,134,357,491
37687,2015-05-01,13,122,386,508
37688,2015-05-01,14,187,339,526
37689,2015-05-01,15,177,417,594
37690,2015-05-01,16,179,641,820
37691,2015-05-01,17,142,1031,1173
37692,2015-05-01,18,124,862,986
37693,2015-05-01,19,122,608,730
37694,2015-05-01,20,75,398,473
37695,2015-05-01,21,56,279,335
37696,2015-05-01,22,32,208,240
37697,2015-05-01,23,23,174,197
37698,2015-05-02,0,17,140,157
37699,2015-05-02,1,6,79,85
37700,2015-05-02,2,9,58,67
37701,2015-05-02,3,6,18,24
37702,2015-05-02,4,2,7,9
37703,2015-05-02,5,1,3,4
37704,2015-05-02,6,2,46,48
37705,2015-05-02,7,28,85,113
37706,2015-05-02,8,54,242,296
37707,2015-05-02,9,159,400,559
37708,2015-05-02,10,347,529,876
37709,2015-05-02,11,408,515,923
37710,2015-05-02,12,438,590,1028
37711,2015-05-02,13,468,606,1074
37712,2015-05-02,14,587,554,1141
37713,2015-05-02,15,558,600,1158
37714,2015-05-02,16,519,562,1081
37715,2015-05-02,17,441,526,967
37716,2015-05-02,18,314,484,798
37717,2015-05-02,19,234,425,659
37718,2015-05-02,20,202,346,548
37719,2015-05-02,21,149,264,413
37720,2015-05-02,22,100,228,328
37721,2015-05-02,23,60,161,221
37722,2015-05-03,0,34,115,149
37723,2015-05-03,1,39,191,230
37724,2015-05-03,2,33,57,90
37725,2015-05-03,3,20,16,36
37726,2015-05-03,4,1,6,7
37727,2015-05-03,5,6,7,13
37728,2015-05-03,6,9,22,31
37729,2015-05-03,7,31,74,105
37730,2015-05-03,8,75,178,253
37731,2015-05-03,9,195,308,503
37732,2015-05-03,10,323,489,812
37733,2015-05-03,11,445,556,1001
37734,2015-05-03,12,493,568,1061
37735,2015-05-03,13,484,578,1062
37736,2015-05-03,14,513,609,1122
37737,2015-05-03,15,507,589,1096
37738,2015-05-03,16,395,605,1000
37739,2015-05-03,17,383,513,896
37740,2015-05-03,18,300,511,811
37741,2015-05-03,19,251,430,681
37742,2015-05-03,20,182,297,479
37743,2015-05-03,21,138,189,327
37744,2015-05-03,22,83,136,219
37745,2015-05-03,23,45,76,121
37746,2015-05-04,0,18,26,44
37747,2015-05-04,1,12,15,27
37748,2015-05-04,2,3,12,15
37749,2015-05-04,3,3,10,13
37750,2015-05-04,4,1,10,11
37751,2015-05-04,5,6,68,74
37752,2015-05-04,6,15,260,275
37753,2015-05-04,7,41,750,791
37754,2015-05-04,8,86,1028,1114
37755,2015-05-04,9,109,407,516
37756,2015-05-04,10,163,185,348
37757,2015-05-04,11,195,266,461
37758,2015-05-04,12,172,314,486
37759,2015-05-04,13,161,331,492
37760,2015-05-04,14,229,332,561
37761,2015-05-04,15,202,338,540
37762,2015-05-04,16,191,554,745
37763,2015-05-04,17,257,1301,1558
37764,2015-05-04,18,243,1264,1507
37765,2015-05-04,19,158,707,865
37766,2015-05-04,20,109,483,592
37767,2015-05-04,21,115,375,490
37768,2015-05-04,22,85,251,336
37769,2015-05-04,23,35,96,131
37770,2015-05-05,0,18,40,58
37771,2015-05-05,1,11,17,28
37772,2015-05-05,2,6,10,16
37773,2015-05-05,3,4,6,10
37774,2015-05-05,4,3,9,12
37775,2015-05-05,5,8,78,86
37776,2015-05-05,6,18,333,351
37777,2015-05-05,7,39,924,963
37778,2015-05-05,8,55,1192,1247
37779,2015-05-05,9,94,458,552
37780,2015-05-05,10,133,236,369
37781,2015-05-05,11,133,322,455
37782,2015-05-05,12,142,360,502
37783,2015-05-05,13,131,346,477
37784,2015-05-05,14,154,295,449
37785,2015-05-05,15,156,351,507
37786,2015-05-05,16,154,655,809
37787,2015-05-05,17,193,1211,1404
37788,2015-05-05,18,92,743,835
37789,2015-05-05,19,70,577,647
37790,2015-05-05,20,62,428,490
37791,2015-05-05,21,52,310,362
37792,2015-05-05,22,42,263,305
37793,2015-05-05,23,15,151,166
37794,2015-05-06,0,11,43,54
37795,2015-05-06,1,3,21,24
37796,2015-05-06,2,3,8,11
37797,2015-05-06,3,0,2,2
37798,2015-05-06,4,2,9,11
37799,2015-05-06,5,1,78,79
37800,2015-05-06,6,11,325,336
37801,2015-05-06,7,33,883,916
37802,2015-05-06,8,51,1168,1219
37803,2015-05-06,9,59,483,542
37804,2015-05-06,10,104,233,337
37805,2015-05-06,11,147,273,420
37806,2015-05-06,12,123,382,505
37807,2015-05-06,13,117,364,481
37808,2015-05-06,14,154,289,443
37809,2015-05-06,15,185,387,572
37810,2015-05-06,16,132,673,805
37811,2015-05-06,17,188,1129,1317
37812,2015-05-06,18,159,1151,1310
37813,2015-05-06,19,113,603,716
37814,2015-05-06,20,87,492,579
37815,2015-05-06,21,62,291,353
37816,2015-05-06,22,57,253,310
37817,2015-05-06,23,22,124,146
37818,2015-05-07,0,13,54,67
37819,2015-05-07,1,27,21,48
37820,2015-05-07,2,13,13,26
37821,2015-05-07,3,1,7,8
37822,2015-05-07,4,2,10,12
37823,2015-05-07,5,3,67,70
37824,2015-05-07,6,7,314,321
37825,2015-05-07,7,42,855,897
37826,2015-05-07,8,63,1188,1251
37827,2015-05-07,9,74,458,532
37828,2015-05-07,10,132,225,357
37829,2015-05-07,11,144,292,436
37830,2015-05-07,12,133,387,520
37831,2015-05-07,13,154,372,526
37832,2015-05-07,14,138,317,455
37833,2015-05-07,15,173,396,569
37834,2015-05-07,16,167,657,824
37835,2015-05-07,17,188,1251,1439
37836,2015-05-07,18,192,1196,1388
37837,2015-05-07,19,157,751,908
37838,2015-05-07,20,119,563,682
37839,2015-05-07,21,67,396,463
37840,2015-05-07,22,80,264,344
37841,2015-05-07,23,42,136,178
37842,2015-05-08,0,44,73,117
37843,2015-05-08,1,23,35,58
37844,2015-05-08,2,2,25,27
37845,2015-05-08,4,1,7,8
37846,2015-05-08,5,3,77,80
37847,2015-05-08,6,14,258,272
37848,2015-05-08,7,25,762,787
37849,2015-05-08,8,78,1186,1264
37850,2015-05-08,9,104,477,581
37851,2015-05-08,10,184,301,485
37852,2015-05-08,11,267,560,827
37853,2015-05-08,12,182,507,689
37854,2015-05-08,13,231,491,722
37855,2015-05-08,14,248,398,646
37856,2015-05-08,15,221,477,698
37857,2015-05-08,16,220,670,890
37858,2015-05-08,17,280,1168,1448
37859,2015-05-08,18,236,1009,1245
37860,2015-05-08,19,183,738,921
37861,2015-05-08,20,130,426,556
37862,2015-05-08,21,105,348,453
37863,2015-05-08,22,96,283,379
37864,2015-05-08,23,47,230,277
37865,2015-05-09,0,38,131,169
37866,2015-05-09,1,36,89,125
37867,2015-05-09,2,13,48,61
37868,2015-05-09,3,6,25,31
37869,2015-05-09,4,2,12,14
37870,2015-05-09,5,3,14,17
37871,2015-05-09,6,11,35,46
37872,2015-05-09,7,31,143,174
37873,2015-05-09,8,90,256,346
37874,2015-05-09,9,165,402,567
37875,2015-05-09,10,262,634,896
37876,2015-05-09,11,369,503,872
37877,2015-05-09,12,423,590,1013
37878,2015-05-09,13,569,570,1139
37879,2015-05-09,14,520,588,1108
37880,2015-05-09,15,485,602,1087
37881,2015-05-09,16,434,527,961
37882,2015-05-09,17,418,526,944
37883,2015-05-09,18,366,453,819
37884,2015-05-09,19,303,454,757
37885,2015-05-09,20,237,400,637
37886,2015-05-09,21,139,284,423
37887,2015-05-09,22,126,242,368
37888,2015-05-09,23,87,187,274
37889,2015-05-10,0,91,169,260
37890,2015-05-10,1,28,104,132
37891,2015-05-10,2,20,76,96
37892,2015-05-10,3,7,29,36
37893,2015-05-10,4,1,11,12
37894,2015-05-10,5,5,12,17
37895,2015-05-10,6,8,27,35
37896,2015-05-10,7,42,60,102
37897,2015-05-10,8,83,137,220
37898,2015-05-10,9,165,288,453
37899,2015-05-10,10,310,405,715
37900,2015-05-10,11,349,474,823
37901,2015-05-10,12,429,541,970
37902,2015-05-10,13,484,550,1034
37903,2015-05-10,14,424,487,911
37904,2015-05-10,15,480,510,990
37905,2015-05-10,16,376,504,880
37906,2015-05-10,17,364,502,866
37907,2015-05-10,18,227,523,750
37908,2015-05-10,19,236,327,563
37909,2015-05-10,20,158,314,472
37910,2015-05-10,21,98,219,317
37911,2015-05-10,22,91,190,281
37912,2015-05-10,23,68,94,162
37913,2015-05-11,0,27,27,54
37914,2015-05-11,1,2,7,9
37915,2015-05-11,2,4,18,22
37916,2015-05-11,3,0,1,1
37917,2015-05-11,4,0,11,11
37918,2015-05-11,5,1,56,57
37919,2015-05-11,6,11,245,256
37920,2015-05-11,7,43,775,818
37921,2015-05-11,8,96,1254,1350
37922,2015-05-11,9,188,541,729
37923,2015-05-11,10,179,254,433
37924,2015-05-11,11,188,225,413
37925,2015-05-11,12,180,292,472
37926,2015-05-11,13,212,300,512
37927,2015-05-11,14,165,284,449
37928,2015-05-11,15,172,345,517
37929,2015-05-11,16,180,578,758
37930,2015-05-11,17,227,1277,1504
37931,2015-05-11,18,172,1164,1336
37932,2015-05-11,19,146,737,883
37933,2015-05-11,20,114,513,627
37934,2015-05-11,21,106,364,470
37935,2015-05-11,22,85,240,325
37936,2015-05-11,23,31,101,132
37937,2015-05-12,0,19,34,53
37938,2015-05-12,1,9,17,26
37939,2015-05-12,2,6,7,13
37940,2015-05-12,3,0,2,2
37941,2015-05-12,4,0,10,10
37942,2015-05-12,5,5,75,80
37943,2015-05-12,6,14,344,358
37944,2015-05-12,7,34,910,944
37945,2015-05-12,8,74,1184,1258
37946,2015-05-12,9,101,434,535
37947,2015-05-12,10,130,216,346
37948,2015-05-12,11,183,238,421
37949,2015-05-12,12,149,321,470
37950,2015-05-12,13,151,306,457
37951,2015-05-12,14,159,259,418
37952,2015-05-12,15,158,315,473
37953,2015-05-12,16,163,618,781
37954,2015-05-12,17,237,1245,1482
37955,2015-05-12,18,173,1169,1342
37956,2015-05-12,19,172,767,939
37957,2015-05-12,20,131,572,703
37958,2015-05-12,21,90,410,500
37959,2015-05-12,22,77,244,321
37960,2015-05-12,23,30,104,134
37961,2015-05-13,0,0,52,52
37962,2015-05-13,1,0,12,12
37963,2015-05-13,2,0,5,5
37964,2015-05-13,3,0,5,5
37965,2015-05-13,4,0,3,3
37966,2015-05-13,5,3,85,88
37967,2015-05-13,6,15,357,372
37968,2015-05-13,7,36,888,924
37969,2015-05-13,8,71,1177,1248
37970,2015-05-13,9,72,489,561
37971,2015-05-13,10,107,224,331
37972,2015-05-13,11,117,291,408
37973,2015-05-13,12,131,361,492
37974,2015-05-13,13,130,372,502
37975,2015-05-13,14,127,300,427
37976,2015-05-13,15,141,362,503
37977,2015-05-13,16,166,631,797
37978,2015-05-13,17,192,1285,1477
37979,2015-05-13,18,142,1174,1316
37980,2015-05-13,19,125,800,925
37981,2015-05-13,20,75,498,573
37982,2015-05-13,21,67,295,362
37983,2015-05-13,22,17,214,231
37984,2015-05-13,23,29,137,166
37985,2015-05-14,0,34,51,85
37986,2015-05-14,1,32,18,50
37987,2015-05-14,2,9,13,22
37988,2015-05-14,3,0,4,4
37989,2015-05-14,4,0,9,9
37990,2015-05-14,5,3,68,71
37991,2015-05-14,6,10,297,307
37992,2015-05-14,7,41,868,909
37993,2015-05-14,8,66,1203,1269
37994,2015-05-14,9,73,466,539
37995,2015-05-14,10,131,223,354
37996,2015-05-14,11,167,263,430
37997,2015-05-14,12,215,370,585
37998,2015-05-14,13,184,374,558
37999,2015-05-14,14,196,328,524
38000,2015-05-14,15,217,416,633
38001,2015-05-14,16,262,651,913
38002,2015-05-14,17,266,1309,1575
38003,2015-05-14,18,210,1176,1386
38004,2015-05-14,19,156,706,862
38005,2015-05-14,20,116,549,665
38006,2015-05-14,21,69,324,393
38007,2015-05-14,22,45,257,302
38008,2015-05-14,23,44,128,172
38009,2015-05-15,0,9,59,68
38010,2015-05-15,1,6,35,41
38011,2015-05-15,2,0,13,13
38012,2015-05-15,3,1,1,2
38013,2015-05-15,4,0,9,9
38014,2015-05-15,5,5,77,82
38015,2015-05-15,6,19,285,304
38016,2015-05-15,7,71,895,966
38017,2015-05-15,8,107,1326,1433
38018,2015-05-15,9,114,501,615
38019,2015-05-15,10,180,281,461
38020,2015-05-15,11,225,315,540
38021,2015-05-15,12,235,409,644
38022,2015-05-15,13,334,450,784
38023,2015-05-15,14,338,388,726
38024,2015-05-15,15,260,473,733
38025,2015-05-15,16,260,735,995
38026,2015-05-15,17,287,1201,1488
38027,2015-05-15,18,249,965,1214
38028,2015-05-15,19,206,623,829
38029,2015-05-15,20,140,453,593
38030,2015-05-15,21,131,341,472
38031,2015-05-15,22,120,262,382
38032,2015-05-15,23,67,188,255
38033,2015-05-16,0,28,142,170
38034,2015-05-16,1,15,88,103
38035,2015-05-16,2,8,77,85
38036,2015-05-16,3,21,29,50
38037,2015-05-16,4,3,14,17
38038,2015-05-16,5,11,20,31
38039,2015-05-16,6,23,31,54
38040,2015-05-16,7,41,121,162
38041,2015-05-16,8,97,251,348
38042,2015-05-16,9,195,438,633
38043,2015-05-16,10,321,500,821
38044,2015-05-16,11,416,553,969
38045,2015-05-16,12,512,624,1136
38046,2015-05-16,13,495,567,1062
38047,2015-05-16,14,508,580,1088
38048,2015-05-16,15,473,559,1032
38049,2015-05-16,16,462,569,1031
38050,2015-05-16,17,380,504,884
38051,2015-05-16,18,44,70,114
38052,2015-05-16,19,86,205,291
38053,2015-05-16,20,104,252,356
38054,2015-05-16,21,67,222,289
38055,2015-05-16,22,79,185,264
38056,2015-05-16,23,62,152,214
38057,2015-05-17,0,20,132,152
38058,2015-05-17,1,29,91,120
38059,2015-05-17,2,18,85,103
38060,2015-05-17,3,14,39,53
38061,2015-05-17,4,3,12,15
38062,2015-05-17,5,9,12,21
38063,2015-05-17,6,16,22,38
38064,2015-05-17,7,36,109,145
38065,2015-05-17,8,71,185,256
38066,2015-05-17,9,124,256,380
38067,2015-05-17,10,219,436,655
38068,2015-05-17,11,267,524,791
38069,2015-05-17,12,331,614,945
38070,2015-05-17,13,362,535,897
38071,2015-05-17,14,340,535,875
38072,2015-05-17,15,362,520,882
38073,2015-05-17,16,328,551,879
38074,2015-05-17,17,345,500,845
38075,2015-05-17,18,274,532,806
38076,2015-05-17,19,255,426,681
38077,2015-05-17,20,214,346,560
38078,2015-05-17,21,143,249,392
38079,2015-05-17,22,94,187,281
38080,2015-05-17,23,91,76,167
38081,2015-05-18,0,42,25,67
38082,2015-05-18,1,10,21,31
38083,2015-05-18,2,10,15,25
38084,2015-05-18,3,0,2,2
38085,2015-05-18,4,2,12,14
38086,2015-05-18,5,6,76,82
38087,2015-05-18,6,17,286,303
38088,2015-05-18,7,51,797,848
38089,2015-05-18,8,84,1053,1137
38090,2015-05-18,9,95,452,547
38091,2015-05-18,10,183,196,379
38092,2015-05-18,11,221,252,473
38093,2015-05-18,12,198,319,517
38094,2015-05-18,13,150,326,476
38095,2015-05-18,14,195,282,477
38096,2015-05-18,15,208,359,567
38097,2015-05-18,16,180,570,750
38098,2015-05-18,17,157,711,868
38099,2015-05-18,18,187,993,1180
38100,2015-05-18,19,153,653,806
38101,2015-05-18,20,101,345,446
38102,2015-05-18,21,63,181,244
38103,2015-05-18,22,38,129,167
38104,2015-05-18,23,6,32,38
38105,2015-05-19,0,8,18,26
38106,2015-05-19,1,2,13,15
38107,2015-05-19,2,5,6,11
38108,2015-05-19,3,4,7,11
38109,2015-05-19,4,2,6,8
38110,2015-05-19,5,1,84,85
38111,2015-05-19,6,11,321,332
38112,2015-05-19,7,45,864,909
38113,2015-05-19,8,67,1221,1288
38114,2015-05-19,9,92,480,572
38115,2015-05-19,10,116,210,326
38116,2015-05-19,11,133,242,375
38117,2015-05-19,12,175,330,505
38118,2015-05-19,13,158,297,455
38119,2015-05-19,14,143,279,422
38120,2015-05-19,15,173,365,538
38121,2015-05-19,16,163,594,757
38122,2015-05-19,17,198,1264,1462
38123,2015-05-19,18,213,1149,1362
38124,2015-05-19,19,141,770,911
38125,2015-05-19,20,140,520,660
38126,2015-05-19,21,86,379,465
38127,2015-05-19,22,64,330,394
38128,2015-05-19,23,42,136,178
38129,2015-05-20,0,9,68,77
38130,2015-05-20,1,8,20,28
38131,2015-05-20,2,4,11,15
38132,2015-05-20,3,4,2,6
38133,2015-05-20,4,1,6,7
38134,2015-05-20,5,7,106,113
38135,2015-05-20,6,25,355,380
38136,2015-05-20,7,35,918,953
38137,2015-05-20,8,77,1199,1276
38138,2015-05-20,9,98,478,576
38139,2015-05-20,10,166,244,410
38140,2015-05-20,11,173,298,471
38141,2015-05-20,12,211,358,569
38142,2015-05-20,13,231,376,607
38143,2015-05-20,14,195,338,533
38144,2015-05-20,15,210,394,604
38145,2015-05-20,16,185,661,846
38146,2015-05-20,17,207,1335,1542
38147,2015-05-20,18,211,1216,1427
38148,2015-05-20,19,163,770,933
38149,2015-05-20,20,111,521,632
38150,2015-05-20,21,83,373,456
38151,2015-05-20,22,68,285,353
38152,2015-05-20,23,38,133,171
38153,2015-05-21,0,12,37,49
38154,2015-05-21,1,9,21,30
38155,2015-05-21,2,5,6,11
38156,2015-05-21,3,1,6,7
38157,2015-05-21,4,0,10,10
38158,2015-05-21,5,5,65,70
38159,2015-05-21,6,10,283,293
38160,2015-05-21,7,22,797,819
38161,2015-05-21,8,22,705,727
38162,2015-05-21,9,19,224,243
38163,2015-05-21,10,19,72,91
38164,2015-05-21,11,7,47,54
38165,2015-05-21,12,4,73,77
38166,2015-05-21,13,7,60,67
38167,2015-05-21,14,12,65,77
38168,2015-05-21,15,10,141,151
38169,2015-05-21,16,40,419,459
38170,2015-05-21,17,74,933,1007
38171,2015-05-21,18,55,934,989
38172,2015-05-21,19,60,534,594
38173,2015-05-21,20,38,433,471
38174,2015-05-21,21,49,287,336
38175,2015-05-21,22,23,197,220
38176,2015-05-21,23,14,117,131
38177,2015-05-22,0,3,57,60
38178,2015-05-22,1,2,14,16
38179,2015-05-22,2,6,7,13
38180,2015-05-22,3,0,7,7
38181,2015-05-22,4,0,6,6
38182,2015-05-22,5,5,69,74
38183,2015-05-22,6,7,225,232
38184,2015-05-22,7,22,647,669
38185,2015-05-22,8,72,1050,1122
38186,2015-05-22,9,135,486,621
38187,2015-05-22,10,147,290,437
38188,2015-05-22,11,209,328,537
38189,2015-05-22,12,252,420,672
38190,2015-05-22,13,272,462,734
38191,2015-05-22,14,290,499,789
38192,2015-05-22,15,277,683,960
38193,2015-05-22,16,298,761,1059
38194,2015-05-22,17,299,1040,1339
38195,2015-05-22,18,265,762,1027
38196,2015-05-22,19,231,535,766
38197,2015-05-22,20,162,353,515
38198,2015-05-22,21,112,274,386
38199,2015-05-22,22,58,230,288
38200,2015-05-22,23,57,143,200
38201,2015-05-23,0,30,118,148
38202,2015-05-23,1,32,77,109
38203,2015-05-23,2,14,54,68
38204,2015-05-23,3,12,18,30
38205,2015-05-23,4,3,11,14
38206,2015-05-23,5,1,11,12
38207,2015-05-23,6,6,32,38
38208,2015-05-23,7,12,74,86
38209,2015-05-23,8,59,162,221
38210,2015-05-23,9,132,286,418
38211,2015-05-23,10,323,398,721
38212,2015-05-23,11,448,491,939
38213,2015-05-23,12,515,462,977
38214,2015-05-23,13,627,515,1142
38215,2015-05-23,14,719,518,1237
38216,2015-05-23,15,658,457,1115
38217,2015-05-23,16,641,415,1056
38218,2015-05-23,17,641,447,1088
38219,2015-05-23,18,535,393,928
38220,2015-05-23,19,441,373,814
38221,2015-05-23,20,319,257,576
38222,2015-05-23,21,222,227,449
38223,2015-05-23,22,151,146,297
38224,2015-05-23,23,108,125,233
38225,2015-05-24,0,63,98,161
38226,2015-05-24,1,31,89,120
38227,2015-05-24,2,20,37,57
38228,2015-05-24,3,11,24,35
38229,2015-05-24,4,4,12,16
38230,2015-05-24,5,6,14,20
38231,2015-05-24,6,11,17,28
38232,2015-05-24,7,39,69,108
38233,2015-05-24,8,102,124,226
38234,2015-05-24,9,253,259,512
38235,2015-05-24,10,429,344,773
38236,2015-05-24,11,623,401,1024
38237,2015-05-24,12,678,483,1161
38238,2015-05-24,13,658,448,1106
38239,2015-05-24,14,705,387,1092
38240,2015-05-24,15,682,435,1117
38241,2015-05-24,16,820,476,1296
38242,2015-05-24,17,607,455,1062
38243,2015-05-24,18,570,415,985
38244,2015-05-24,19,489,363,852
38245,2015-05-24,20,362,308,670
38246,2015-05-24,21,292,228,520
38247,2015-05-24,22,206,169,375
38248,2015-05-24,23,124,136,260
38249,2015-05-25,0,50,82,132
38250,2015-05-25,1,35,54,89
38251,2015-05-25,2,18,25,43
38252,2015-05-25,3,3,19,22
38253,2015-05-25,4,5,5,10
38254,2015-05-25,5,16,18,34
38255,2015-05-25,6,38,22,60
38256,2015-05-25,7,41,80,121
38257,2015-05-25,8,117,137,254
38258,2015-05-25,9,271,236,507
38259,2015-05-25,10,455,360,815
38260,2015-05-25,11,557,474,1031
38261,2015-05-25,12,557,519,1076
38262,2015-05-25,13,643,506,1149
38263,2015-05-25,14,494,499,993
38264,2015-05-25,15,574,517,1091
38265,2015-05-25,16,488,439,927
38266,2015-05-25,17,366,462,828
38267,2015-05-25,18,354,432,786
38268,2015-05-25,19,273,435,708
38269,2015-05-25,20,245,345,590
38270,2015-05-25,21,146,253,399
38271,2015-05-25,22,90,145,235
38272,2015-05-25,23,34,75,109
38273,2015-05-26,0,13,30,43
38274,2015-05-26,1,4,11,15
38275,2015-05-26,2,2,4,6
38276,2015-05-26,3,1,3,4
38277,2015-05-26,4,0,7,7
38278,2015-05-26,5,3,80,83
38279,2015-05-26,6,10,313,323
38280,2015-05-26,7,48,772,820
38281,2015-05-26,8,64,1009,1073
38282,2015-05-26,9,114,421,535
38283,2015-05-26,10,152,233,385
38284,2015-05-26,11,164,222,386
38285,2015-05-26,12,195,299,494
38286,2015-05-26,13,175,276,451
38287,2015-05-26,14,190,282,472
38288,2015-05-26,15,171,302,473
38289,2015-05-26,16,113,569,682
38290,2015-05-26,17,236,1232,1468
38291,2015-05-26,18,167,1128,1295
38292,2015-05-26,19,163,726,889
38293,2015-05-26,20,98,517,615
38294,2015-05-26,21,72,354,426
38295,2015-05-26,22,65,195,260
38296,2015-05-26,23,43,106,149
38297,2015-05-27,0,18,35,53
38298,2015-05-27,1,15,14,29
38299,2015-05-27,2,4,9,13
38300,2015-05-27,3,6,4,10
38301,2015-05-27,4,1,13,14
38302,2015-05-27,5,8,93,101
38303,2015-05-27,6,28,359,387
38304,2015-05-27,7,38,887,925
38305,2015-05-27,8,53,1214,1267
38306,2015-05-27,9,71,494,565
38307,2015-05-27,10,120,217,337
38308,2015-05-27,11,114,276,390
38309,2015-05-27,12,147,297,444
38310,2015-05-27,13,116,275,391
38311,2015-05-27,14,127,252,379
38312,2015-05-27,15,110,321,431
38313,2015-05-27,16,145,573,718
38314,2015-05-27,17,115,1256,1371
38315,2015-05-27,18,114,1187,1301
38316,2015-05-27,19,104,764,868
38317,2015-05-27,20,88,544,632
38318,2015-05-27,21,72,340,412
38319,2015-05-27,22,46,253,299
38320,2015-05-27,23,16,121,137
38321,2015-05-28,0,8,51,59
38322,2015-05-28,1,7,17,24
38323,2015-05-28,2,4,7,11
38324,2015-05-28,3,2,3,5
38325,2015-05-28,4,3,11,14
38326,2015-05-28,5,2,76,78
38327,2015-05-28,6,15,312,327
38328,2015-05-28,7,37,884,921
38329,2015-05-28,8,66,1155,1221
38330,2015-05-28,9,69,491,560
38331,2015-05-28,10,113,215,328
38332,2015-05-28,11,145,249,394
38333,2015-05-28,12,125,348,473
38334,2015-05-28,13,156,310,466
38335,2015-05-28,14,150,265,415
38336,2015-05-28,15,174,345,519
38337,2015-05-28,16,185,594,779
38338,2015-05-28,17,223,1208,1431
38339,2015-05-28,18,141,1072,1213
38340,2015-05-28,19,150,669,819
38341,2015-05-28,20,126,522,648
38342,2015-05-28,21,102,372,474
38343,2015-05-28,22,58,213,271
38344,2015-05-28,23,38,149,187
38345,2015-05-29,0,37,81,118
38346,2015-05-29,1,14,42,56
38347,2015-05-29,2,5,11,16
38348,2015-05-29,3,3,7,10
38349,2015-05-29,4,4,13,17
38350,2015-05-29,5,0,85,85
38351,2015-05-29,6,11,288,299
38352,2015-05-29,7,24,811,835
38353,2015-05-29,8,70,1062,1132
38354,2015-05-29,9,89,503,592
38355,2015-05-29,10,139,296,435
38356,2015-05-29,11,136,295,431
38357,2015-05-29,12,191,411,602
38358,2015-05-29,13,194,369,563
38359,2015-05-29,14,174,346,520
38360,2015-05-29,15,199,395,594
38361,2015-05-29,16,173,654,827
38362,2015-05-29,17,218,1113,1331
38363,2015-05-29,18,222,958,1180
38364,2015-05-29,19,141,638,779
38365,2015-05-29,20,108,433,541
38366,2015-05-29,21,104,319,423
38367,2015-05-29,22,93,282,375
38368,2015-05-29,23,68,237,305
38369,2015-05-30,0,48,170,218
38370,2015-05-30,1,16,113,129
38371,2015-05-30,2,13,71,84
38372,2015-05-30,3,4,33,37
38373,2015-05-30,4,4,9,13
38374,2015-05-30,5,1,9,10
38375,2015-05-30,6,11,50,61
38376,2015-05-30,7,34,129,163
38377,2015-05-30,8,97,247,344
38378,2015-05-30,9,154,411,565
38379,2015-05-30,10,348,550,898
38380,2015-05-30,11,425,626,1051
38381,2015-05-30,12,493,626,1119
38382,2015-05-30,13,482,605,1087
38383,2015-05-30,14,478,525,1003
38384,2015-05-30,15,435,515,950
38385,2015-05-30,16,402,478,880
38386,2015-05-30,17,389,480,869
38387,2015-05-30,18,347,462,809
38388,2015-05-30,19,229,423,652
38389,2015-05-30,20,239,344,583
38390,2015-05-30,21,167,266,433
38391,2015-05-30,22,145,263,408
38392,2015-05-30,23,98,205,303
38393,2015-05-31,0,61,169,230
38394,2015-05-31,1,37,87,124
38395,2015-05-31,2,21,79,100
38396,2015-05-31,3,21,38,59
38397,2015-05-31,4,3,6,9
38398,2015-05-31,5,5,10,15
38399,2015-05-31,6,7,26,33
38400,2015-05-31,7,28,94,122
38401,2015-05-31,8,94,177,271
38402,2015-05-31,9,195,313,508
38403,2015-05-31,10,233,460,693
38404,2015-05-31,11,279,550,829
38405,2015-05-31,12,366,557,923
38406,2015-05-31,13,329,557,886
38407,2015-05-31,14,353,478,831
38408,2015-05-31,15,338,480,818
38409,2015-05-31,16,330,554,884
38410,2015-05-31,17,298,492,790
38411,2015-05-31,18,292,502,794
38412,2015-05-31,19,234,440,674
38413,2015-05-31,20,229,348,577
38414,2015-05-31,21,161,210,371
38415,2015-05-31,22,74,160,234
38416,2015-05-31,23,56,95,151
38417,2015-06-01,0,44,41,85
38418,2015-06-01,1,6,12,18
38419,2015-06-01,2,4,9,13
38420,2015-06-01,3,0,1,1
38421,2015-06-01,4,1,5,6
38422,2015-06-01,5,2,79,81
38423,2015-06-01,6,15,278,293
38424,2015-06-01,7,41,792,833
38425,2015-06-01,8,43,957,1000
38426,2015-06-01,9,92,389,481
38427,2015-06-01,10,90,176,266
38428,2015-06-01,11,176,207,383
38429,2015-06-01,12,178,340,518
38430,2015-06-01,13,136,295,431
38431,2015-06-01,14,135,240,375
38432,2015-06-01,15,164,312,476
38433,2015-06-01,16,60,343,403
38434,2015-06-01,17,118,736,854
38435,2015-06-01,18,65,489,554
38436,2015-06-01,19,56,380,436
38437,2015-06-01,20,28,193,221
38438,2015-06-01,21,15,179,194
38439,2015-06-01,22,28,119,147
38440,2015-06-01,23,1,36,37
38441,2015-06-02,0,0,11,11
38442,2015-06-02,1,0,4,4
38443,2015-06-02,2,0,2,2
38444,2015-06-02,3,0,3,3
38445,2015-06-02,4,0,6,6
38446,2015-06-02,5,3,76,79
38447,2015-06-02,6,13,296,309
38448,2015-06-02,7,13,780,793
38449,2015-06-02,8,35,779,814
38450,2015-06-02,9,22,257,279
38451,2015-06-02,10,48,151,199
38452,2015-06-02,11,73,183,256
38453,2015-06-02,12,44,141,185
38454,2015-06-02,13,52,189,241
38455,2015-06-02,14,52,192,244
38456,2015-06-02,15,92,310,402
38457,2015-06-02,16,65,519,584
38458,2015-06-02,17,94,1056,1150
38459,2015-06-02,18,78,709,787
38460,2015-06-02,19,51,541,592
38461,2015-06-02,20,70,360,430
38462,2015-06-02,21,40,299,339
38463,2015-06-02,22,34,203,237
38464,2015-06-02,23,21,87,108
38465,2015-06-03,0,3,20,23
38466,2015-06-03,1,5,8,13
38467,2015-06-03,2,0,4,4
38468,2015-06-03,3,1,2,3
38469,2015-06-03,4,0,8,8
38470,2015-06-03,5,2,84,86
38471,2015-06-03,6,11,300,311
38472,2015-06-03,7,29,787,816
38473,2015-06-03,8,40,965,1005
38474,2015-06-03,9,35,429,464
38475,2015-06-03,10,45,205,250
38476,2015-06-03,11,59,205,264
38477,2015-06-03,12,59,330,389
38478,2015-06-03,13,91,300,391
38479,2015-06-03,14,90,251,341
38480,2015-06-03,15,87,291,378
38481,2015-06-03,16,110,559,669
38482,2015-06-03,17,95,1179,1274
38483,2015-06-03,18,92,1086,1178
38484,2015-06-03,19,100,645,745
38485,2015-06-03,20,46,452,498
38486,2015-06-03,21,54,353,407
38487,2015-06-03,22,55,190,245
38488,2015-06-03,23,12,108,120
38489,2015-06-04,0,11,51,62
38490,2015-06-04,1,5,12,17
38491,2015-06-04,2,0,6,6
38492,2015-06-04,3,0,4,4
38493,2015-06-04,4,0,7,7
38494,2015-06-04,5,4,78,82
38495,2015-06-04,6,9,164,173
38496,2015-06-04,7,26,548,574
38497,2015-06-04,8,35,1084,1119
38498,2015-06-04,9,24,400,424
38499,2015-06-04,10,65,209,274
38500,2015-06-04,11,74,248,322
38501,2015-06-04,12,84,308,392
38502,2015-06-04,13,100,301,401
38503,2015-06-04,14,125,222,347
38504,2015-06-04,15,73,255,328
38505,2015-06-04,16,64,364,428
38506,2015-06-04,17,47,256,303
38507,2015-06-04,18,13,162,175
38508,2015-06-04,19,19,199,218
38509,2015-06-04,20,21,201,222
38510,2015-06-04,21,21,201,222
38511,2015-06-04,22,22,138,160
38512,2015-06-04,23,5,94,99
38513,2015-06-05,0,13,54,67
38514,2015-06-05,1,2,24,26
38515,2015-06-05,2,1,12,13
38516,2015-06-05,3,2,3,5
38517,2015-06-05,4,0,9,9
38518,2015-06-05,5,2,57,59
38519,2015-06-05,6,5,158,163
38520,2015-06-05,7,16,577,593
38521,2015-06-05,8,42,867,909
38522,2015-06-05,9,43,474,517
38523,2015-06-05,10,121,229,350
38524,2015-06-05,11,111,268,379
38525,2015-06-05,12,155,384,539
38526,2015-06-05,13,156,366,522
38527,2015-06-05,14,213,371,584
38528,2015-06-05,15,193,455,648
38529,2015-06-05,16,192,653,845
38530,2015-06-05,17,207,1235,1442
38531,2015-06-05,18,149,1011,1160
38532,2015-06-05,19,111,585,696
38533,2015-06-05,20,93,388,481
38534,2015-06-05,21,103,321,424
38535,2015-06-05,22,74,310,384
38536,2015-06-05,23,69,197,266
38537,2015-06-06,0,39,145,184
38538,2015-06-06,1,9,97,106
38539,2015-06-06,2,9,64,73
38540,2015-06-06,3,3,21,24
38541,2015-06-06,4,1,4,5
38542,2015-06-06,5,2,7,9
38543,2015-06-06,6,8,27,35
38544,2015-06-06,7,22,128,150
38545,2015-06-06,8,65,279,344
38546,2015-06-06,9,125,433,558
38547,2015-06-06,10,211,505,716
38548,2015-06-06,11,389,610,999
38549,2015-06-06,12,407,604,1011
38550,2015-06-06,13,408,589,997
38551,2015-06-06,14,402,562,964
38552,2015-06-06,15,459,592,1051
38553,2015-06-06,16,450,569,1019
38554,2015-06-06,17,354,623,977
38555,2015-06-06,18,333,504,837
38556,2015-06-06,19,285,469,754
38557,2015-06-06,20,229,388,617
38558,2015-06-06,21,171,337,508
38559,2015-06-06,22,184,239,423
38560,2015-06-06,23,107,215,322
38561,2015-06-07,0,53,189,242
38562,2015-06-07,1,33,123,156
38563,2015-06-07,2,23,79,102
38564,2015-06-07,3,21,35,56
38565,2015-06-07,4,14,9,23
38566,2015-06-07,5,6,13,19
38567,2015-06-07,6,5,23,28
38568,2015-06-07,7,38,82,120
38569,2015-06-07,8,93,168,261
38570,2015-06-07,9,126,295,421
38571,2015-06-07,10,262,409,671
38572,2015-06-07,11,348,487,835
38573,2015-06-07,12,414,534,948
38574,2015-06-07,13,449,600,1049
38575,2015-06-07,14,433,602,1035
38576,2015-06-07,15,422,642,1064
38577,2015-06-07,16,417,582,999
38578,2015-06-07,17,355,511,866
38579,2015-06-07,18,327,471,798
38580,2015-06-07,19,229,486,715
38581,2015-06-07,20,225,365,590
38582,2015-06-07,21,122,196,318
38583,2015-06-07,22,70,142,212
38584,2015-06-07,23,55,88,143
38585,2015-06-08,0,23,26,49
38586,2015-06-08,1,2,8,10
38587,2015-06-08,2,1,16,17
38588,2015-06-08,3,0,6,6
38589,2015-06-08,4,0,5,5
38590,2015-06-08,5,3,83,86
38591,2015-06-08,6,21,301,322
38592,2015-06-08,7,33,839,872
38593,2015-06-08,8,68,1108,1176
38594,2015-06-08,9,81,433,514
38595,2015-06-08,10,161,268,429
38596,2015-06-08,11,178,258,436
38597,2015-06-08,12,150,293,443
38598,2015-06-08,13,172,319,491
38599,2015-06-08,14,190,232,422
38600,2015-06-08,15,159,302,461
38601,2015-06-08,16,163,632,795
38602,2015-06-08,17,104,801,905
38603,2015-06-08,18,131,939,1070
38604,2015-06-08,19,115,720,835
38605,2015-06-08,20,27,211,238
38606,2015-06-08,21,37,190,227
38607,2015-06-08,22,12,90,102
38608,2015-06-08,23,7,49,56
38609,2015-06-09,0,12,32,44
38610,2015-06-09,1,7,8,15
38611,2015-06-09,2,0,2,2
38612,2015-06-09,3,1,2,3
38613,2015-06-09,4,0,8,8
38614,2015-06-09,5,3,105,108
38615,2015-06-09,6,11,301,312
38616,2015-06-09,7,22,891,913
38617,2015-06-09,8,52,1193,1245
38618,2015-06-09,9,50,433,483
38619,2015-06-09,10,110,223,333
38620,2015-06-09,11,129,240,369
38621,2015-06-09,12,118,314,432
38622,2015-06-09,13,131,322,453
38623,2015-06-09,14,154,255,409
38624,2015-06-09,15,155,373,528
38625,2015-06-09,16,147,606,753
38626,2015-06-09,17,190,1249,1439
38627,2015-06-09,18,168,1237,1405
38628,2015-06-09,19,130,789,919
38629,2015-06-09,20,110,594,704
38630,2015-06-09,21,65,395,460
38631,2015-06-09,22,63,228,291
38632,2015-06-09,23,28,115,143
38633,2015-06-10,0,11,59,70
38634,2015-06-10,1,4,12,16
38635,2015-06-10,2,4,2,6
38636,2015-06-10,3,0,4,4
38637,2015-06-10,4,1,7,8
38638,2015-06-10,5,2,93,95
38639,2015-06-10,6,14,372,386
38640,2015-06-10,7,28,901,929
38641,2015-06-10,8,61,1174,1235
38642,2015-06-10,9,75,462,537
38643,2015-06-10,10,58,199,257
38644,2015-06-10,11,40,283,323
38645,2015-06-10,12,56,358,414
38646,2015-06-10,13,92,320,412
38647,2015-06-10,14,97,302,399
38648,2015-06-10,15,114,349,463
38649,2015-06-10,16,118,551,669
38650,2015-06-10,17,185,1239,1424
38651,2015-06-10,18,154,1128,1282
38652,2015-06-10,19,172,786,958
38653,2015-06-10,20,123,594,717
38654,2015-06-10,21,89,413,502
38655,2015-06-10,22,57,268,325
38656,2015-06-10,23,17,142,159
38657,2015-06-11,0,26,56,82
38658,2015-06-11,1,23,18,41
38659,2015-06-11,2,9,13,22
38660,2015-06-11,3,4,5,9
38661,2015-06-11,4,3,5,8
38662,2015-06-11,5,4,93,97
38663,2015-06-11,6,18,314,332
38664,2015-06-11,7,37,855,892
38665,2015-06-11,8,77,1161,1238
38666,2015-06-11,9,78,480,558
38667,2015-06-11,10,89,214,303
38668,2015-06-11,11,112,255,367
38669,2015-06-11,12,158,306,464
38670,2015-06-11,13,142,309,451
38671,2015-06-11,14,145,243,388
38672,2015-06-11,15,136,335,471
38673,2015-06-11,16,140,585,725
38674,2015-06-11,17,136,1107,1243
38675,2015-06-11,18,154,1178,1332
38676,2015-06-11,19,184,742,926
38677,2015-06-11,20,138,620,758
38678,2015-06-11,21,137,455,592
38679,2015-06-11,22,57,294,351
38680,2015-06-11,23,25,178,203
38681,2015-06-12,0,21,81,102
38682,2015-06-12,1,10,41,51
38683,2015-06-12,2,6,20,26
38684,2015-06-12,3,2,5,7
38685,2015-06-12,4,0,7,7
38686,2015-06-12,5,3,82,85
38687,2015-06-12,6,16,260,276
38688,2015-06-12,7,37,738,775
38689,2015-06-12,8,69,1018,1087
38690,2015-06-12,9,106,510,616
38691,2015-06-12,10,128,236,364
38692,2015-06-12,11,141,296,437
38693,2015-06-12,12,158,354,512
38694,2015-06-12,13,149,365,514
38695,2015-06-12,14,133,304,437
38696,2015-06-12,15,154,391,545
38697,2015-06-12,16,171,604,775
38698,2015-06-12,17,163,980,1143
38699,2015-06-12,18,159,720,879
38700,2015-06-12,19,103,553,656
38701,2015-06-12,20,120,416,536
38702,2015-06-12,21,98,300,398
38703,2015-06-12,22,88,293,381
38704,2015-06-12,23,74,188,262
38705,2015-06-13,0,59,175,234
38706,2015-06-13,1,25,112,137
38707,2015-06-13,2,14,66,80
38708,2015-06-13,3,7,33,40
38709,2015-06-13,4,8,12,20
38710,2015-06-13,5,3,16,19
38711,2015-06-13,6,14,85,99
38712,2015-06-13,7,29,130,159
38713,2015-06-13,8,86,273,359
38714,2015-06-13,9,162,444,606
38715,2015-06-13,10,240,512,752
38716,2015-06-13,11,368,520,888
38717,2015-06-13,12,298,606,904
38718,2015-06-13,13,364,565,929
38719,2015-06-13,14,371,474,845
38720,2015-06-13,15,456,530,986
38721,2015-06-13,16,353,404,757
38722,2015-06-13,17,346,403,749
38723,2015-06-13,18,321,432,753
38724,2015-06-13,19,317,419,736
38725,2015-06-13,20,207,403,610
38726,2015-06-13,21,153,297,450
38727,2015-06-13,22,127,217,344
38728,2015-06-13,23,107,203,310
38729,2015-06-14,0,52,185,237
38730,2015-06-14,1,24,122,146
38731,2015-06-14,2,29,79,108
38732,2015-06-14,3,14,51,65
38733,2015-06-14,4,3,16,19
38734,2015-06-14,5,3,13,16
38735,2015-06-14,6,11,24,35
38736,2015-06-14,7,30,73,103
38737,2015-06-14,8,76,168,244
38738,2015-06-14,9,197,307,504
38739,2015-06-14,10,287,435,722
38740,2015-06-14,11,289,556,845
38741,2015-06-14,12,360,595,955
38742,2015-06-14,13,333,526,859
38743,2015-06-14,14,301,548,849
38744,2015-06-14,15,327,519,846
38745,2015-06-14,16,249,459,708
38746,2015-06-14,17,90,158,248
38747,2015-06-14,18,126,275,401
38748,2015-06-14,19,161,343,504
38749,2015-06-14,20,144,329,473
38750,2015-06-14,21,81,182,263
38751,2015-06-14,22,55,181,236
38752,2015-06-14,23,23,105,128
38753,2015-06-15,0,24,34,58
38754,2015-06-15,1,2,13,15
38755,2015-06-15,2,2,9,11
38756,2015-06-15,3,2,4,6
38757,2015-06-15,4,1,10,11
38758,2015-06-15,5,5,78,83
38759,2015-06-15,6,9,261,270
38760,2015-06-15,7,25,749,774
38761,2015-06-15,8,53,894,947
38762,2015-06-15,9,70,440,510
38763,2015-06-15,10,135,174,309
38764,2015-06-15,11,159,214,373
38765,2015-06-15,12,187,318,505
38766,2015-06-15,13,157,320,477
38767,2015-06-15,14,175,207,382
38768,2015-06-15,15,169,324,493
38769,2015-06-15,16,196,548,744
38770,2015-06-15,17,147,1058,1205
38771,2015-06-15,18,85,698,783
38772,2015-06-15,19,90,634,724
38773,2015-06-15,20,84,486,570
38774,2015-06-15,21,71,306,377
38775,2015-06-15,22,35,184,219
38776,2015-06-15,23,35,105,140
38777,2015-06-16,0,10,32,42
38778,2015-06-16,1,2,14,16
38779,2015-06-16,2,2,9,11
38780,2015-06-16,3,0,5,5
38781,2015-06-16,4,1,8,9
38782,2015-06-16,5,6,102,108
38783,2015-06-16,6,8,317,325
38784,2015-06-16,7,42,898,940
38785,2015-06-16,8,55,1149,1204
38786,2015-06-16,9,72,430,502
38787,2015-06-16,10,90,204,294
38788,2015-06-16,11,115,241,356
38789,2015-06-16,12,134,296,430
38790,2015-06-16,13,109,311,420
38791,2015-06-16,14,162,253,415
38792,2015-06-16,15,144,325,469
38793,2015-06-16,16,175,604,779
38794,2015-06-16,17,148,1204,1352
38795,2015-06-16,18,162,1137,1299
38796,2015-06-16,19,134,785,919
38797,2015-06-16,20,118,571,689
38798,2015-06-16,21,84,369,453
38799,2015-06-16,22,51,263,314
38800,2015-06-16,23,42,107,149
38801,2015-06-17,0,23,68,91
38802,2015-06-17,1,2,15,17
38803,2015-06-17,2,5,6,11
38804,2015-06-17,3,1,0,1
38805,2015-06-17,4,1,10,11
38806,2015-06-17,5,6,101,107
38807,2015-06-17,6,26,344,370
38808,2015-06-17,7,40,845,885
38809,2015-06-17,8,70,1138,1208
38810,2015-06-17,9,77,457,534
38811,2015-06-17,10,113,186,299
38812,2015-06-17,11,143,251,394
38813,2015-06-17,12,124,369,493
38814,2015-06-17,13,132,316,448
38815,2015-06-17,14,122,256,378
38816,2015-06-17,15,127,290,417
38817,2015-06-17,16,136,605,741
38818,2015-06-17,17,173,1166,1339
38819,2015-06-17,18,161,1171,1332
38820,2015-06-17,19,157,678,835
38821,2015-06-17,20,92,490,582
38822,2015-06-17,21,46,191,237
38823,2015-06-17,22,44,289,333
38824,2015-06-17,23,16,96,112
38825,2015-06-18,0,4,18,22
38826,2015-06-18,1,0,21,21
38827,2015-06-18,2,0,7,7
38828,2015-06-18,3,1,4,5
38829,2015-06-18,4,0,14,14
38830,2015-06-18,5,7,81,88
38831,2015-06-18,6,19,282,301
38832,2015-06-18,7,29,822,851
38833,2015-06-18,8,42,1214,1256
38834,2015-06-18,9,72,510,582
38835,2015-06-18,10,85,203,288
38836,2015-06-18,11,132,250,382
38837,2015-06-18,12,133,297,430
38838,2015-06-18,13,137,351,488
38839,2015-06-18,14,125,254,379
38840,2015-06-18,15,136,347,483
38841,2015-06-18,16,109,403,512
38842,2015-06-18,17,62,484,546
38843,2015-06-18,18,114,984,1098
38844,2015-06-18,19,121,716,837
38845,2015-06-18,20,79,408,487
38846,2015-06-18,21,56,337,393
38847,2015-06-18,22,42,306,348
38848,2015-06-18,23,25,152,177
38849,2015-06-19,0,17,68,85
38850,2015-06-19,1,7,17,24
38851,2015-06-19,2,4,7,11
38852,2015-06-19,3,1,1,2
38853,2015-06-19,4,2,6,8
38854,2015-06-19,5,7,70,77
38855,2015-06-19,6,16,250,266
38856,2015-06-19,7,41,732,773
38857,2015-06-19,8,64,1071,1135
38858,2015-06-19,9,100,491,591
38859,2015-06-19,10,141,260,401
38860,2015-06-19,11,135,283,418
38861,2015-06-19,12,187,408,595
38862,2015-06-19,13,178,360,538
38863,2015-06-19,14,143,364,507
38864,2015-06-19,15,211,426,637
38865,2015-06-19,16,181,686,867
38866,2015-06-19,17,205,1128,1333
38867,2015-06-19,18,209,1004,1213
38868,2015-06-19,19,202,723,925
38869,2015-06-19,20,156,439,595
38870,2015-06-19,21,86,276,362
38871,2015-06-19,22,102,295,397
38872,2015-06-19,23,67,195,262
38873,2015-06-20,0,77,168,245
38874,2015-06-20,1,23,105,128
38875,2015-06-20,2,15,77,92
38876,2015-06-20,3,16,25,41
38877,2015-06-20,4,6,9,15
38878,2015-06-20,5,4,12,16
38879,2015-06-20,6,13,37,50
38880,2015-06-20,7,30,127,157
38881,2015-06-20,8,79,226,305
38882,2015-06-20,9,168,349,517
38883,2015-06-20,10,213,454,667
38884,2015-06-20,11,280,547,827
38885,2015-06-20,12,372,514,886
38886,2015-06-20,13,365,582,947
38887,2015-06-20,14,378,528,906
38888,2015-06-20,15,314,495,809
38889,2015-06-20,16,334,479,813
38890,2015-06-20,17,342,449,791
38891,2015-06-20,18,248,415,663
38892,2015-06-20,19,120,139,259
38893,2015-06-20,20,35,41,76
38894,2015-06-20,21,1,22,23
38895,2015-06-20,22,6,14,20
38896,2015-06-20,23,7,53,60
38897,2015-06-21,0,15,84,99
38898,2015-06-21,1,34,56,90
38899,2015-06-21,2,4,55,59
38900,2015-06-21,3,7,15,22
38901,2015-06-21,4,7,7,14
38902,2015-06-21,5,7,12,19
38903,2015-06-21,6,8,16,24
38904,2015-06-21,7,21,53,74
38905,2015-06-21,8,64,186,250
38906,2015-06-21,9,167,310,477
38907,2015-06-21,10,213,472,685
38908,2015-06-21,11,307,537,844
38909,2015-06-21,12,345,568,913
38910,2015-06-21,13,330,548,878
38911,2015-06-21,14,317,489,806
38912,2015-06-21,15,72,480,552
38913,2015-06-21,16,26,524,550
38914,2015-06-21,17,15,479,494
38915,2015-06-21,18,8,436,444
38916,2015-06-21,19,12,388,400
38917,2015-06-21,20,83,312,395
38918,2015-06-21,21,78,244,322
38919,2015-06-21,22,72,162,234
38920,2015-06-21,23,51,87,138
38921,2015-06-22,0,28,33,61
38922,2015-06-22,1,9,8,17
38923,2015-06-22,2,10,6,16
38924,2015-06-22,3,5,8,13
38925,2015-06-22,4,4,8,12
38926,2015-06-22,5,4,85,89
38927,2015-06-22,6,12,277,289
38928,2015-06-22,7,25,795,820
38929,2015-06-22,8,72,972,1044
38930,2015-06-22,9,83,449,532
38931,2015-06-22,10,118,199,317
38932,2015-06-22,11,176,242,418
38933,2015-06-22,12,202,311,513
38934,2015-06-22,13,113,252,365
38935,2015-06-22,14,129,222,351
38936,2015-06-22,15,162,296,458
38937,2015-06-22,16,145,518,663
38938,2015-06-22,17,164,1224,1388
38939,2015-06-22,18,168,1107,1275
38940,2015-06-22,19,194,767,961
38941,2015-06-22,20,133,563,696
38942,2015-06-22,21,106,380,486
38943,2015-06-22,22,77,250,327
38944,2015-06-22,23,49,99,148
38945,2015-06-23,0,13,29,42
38946,2015-06-23,1,13,16,29
38947,2015-06-23,2,4,5,9
38948,2015-06-23,3,0,4,4
38949,2015-06-23,4,2,11,13
38950,2015-06-23,5,9,91,100
38951,2015-06-23,6,17,346,363
38952,2015-06-23,7,39,843,882
38953,2015-06-23,8,65,1072,1137
38954,2015-06-23,9,101,461,562
38955,2015-06-23,10,101,175,276
38956,2015-06-23,11,86,215,301
38957,2015-06-23,12,93,267,360
38958,2015-06-23,13,76,259,335
38959,2015-06-23,14,80,239,319
38960,2015-06-23,15,85,300,385
38961,2015-06-23,16,111,543,654
38962,2015-06-23,17,130,1137,1267
38963,2015-06-23,18,86,960,1046
38964,2015-06-23,19,6,88,94
38965,2015-06-23,20,48,302,350
38966,2015-06-23,21,42,234,276
38967,2015-06-23,22,44,193,237
38968,2015-06-23,23,34,114,148
38969,2015-06-24,0,10,50,60
38970,2015-06-24,1,5,16,21
38971,2015-06-24,2,8,10,18
38972,2015-06-24,3,1,4,5
38973,2015-06-24,4,0,12,12
38974,2015-06-24,5,8,95,103
38975,2015-06-24,6,18,348,366
38976,2015-06-24,7,35,903,938
38977,2015-06-24,8,44,1102,1146
38978,2015-06-24,9,59,429,488
38979,2015-06-24,10,100,226,326
38980,2015-06-24,11,138,274,412
38981,2015-06-24,12,169,351,520
38982,2015-06-24,13,150,326,476
38983,2015-06-24,14,145,318,463
38984,2015-06-24,15,163,329,492
38985,2015-06-24,16,178,594,772
38986,2015-06-24,17,172,1386,1558
38987,2015-06-24,18,183,1245,1428
38988,2015-06-24,19,204,814,1018
38989,2015-06-24,20,154,638,792
38990,2015-06-24,21,129,396,525
38991,2015-06-24,22,81,354,435
38992,2015-06-24,23,55,158,213
38993,2015-06-25,0,19,66,85
38994,2015-06-25,1,13,25,38
38995,2015-06-25,2,6,6,12
38996,2015-06-25,3,4,2,6
38997,2015-06-25,4,5,9,14
38998,2015-06-25,5,11,75,86
38999,2015-06-25,6,16,339,355
39000,2015-06-25,7,29,868,897
39001,2015-06-25,8,89,1093,1182
39002,2015-06-25,9,90,444,534
39003,2015-06-25,10,127,220,347
39004,2015-06-25,11,183,236,419
39005,2015-06-25,12,171,346,517
39006,2015-06-25,13,166,330,496
39007,2015-06-25,14,154,294,448
39008,2015-06-25,15,181,384,565
39009,2015-06-25,16,143,599,742
39010,2015-06-25,17,169,1137,1306
39011,2015-06-25,18,163,1006,1169
39012,2015-06-25,19,136,675,811
39013,2015-06-25,20,105,436,541
39014,2015-06-25,21,73,187,260
39015,2015-06-25,22,37,143,180
39016,2015-06-25,23,8,111,119
39017,2015-06-26,0,4,57,61
39018,2015-06-26,1,0,23,23
39019,2015-06-26,2,1,10,11
39020,2015-06-26,3,5,6,11
39021,2015-06-26,4,0,2,2
39022,2015-06-26,5,15,71,86
39023,2015-06-26,6,15,277,292
39024,2015-06-26,7,38,679,717
39025,2015-06-26,8,72,1119,1191
39026,2015-06-26,9,118,468,586
39027,2015-06-26,10,154,305,459
39028,2015-06-26,11,217,319,536
39029,2015-06-26,12,200,390,590
39030,2015-06-26,13,227,397,624
39031,2015-06-26,14,281,348,629
39032,2015-06-26,15,227,497,724
39033,2015-06-26,16,262,715,977
39034,2015-06-26,17,238,1163,1401
39035,2015-06-26,18,254,954,1208
39036,2015-06-26,19,153,702,855
39037,2015-06-26,20,136,464,600
39038,2015-06-26,21,129,445,574
39039,2015-06-26,22,122,373,495
39040,2015-06-26,23,94,293,387
39041,2015-06-27,0,57,269,326
39042,2015-06-27,1,37,136,173
39043,2015-06-27,2,25,103,128
39044,2015-06-27,3,10,17,27
39045,2015-06-27,4,2,9,11
39046,2015-06-27,5,0,9,9
39047,2015-06-27,6,0,10,10
39048,2015-06-27,7,6,29,35
39049,2015-06-27,8,4,36,40
39050,2015-06-27,9,5,83,88
39051,2015-06-27,10,22,148,170
39052,2015-06-27,11,48,214,262
39053,2015-06-27,12,75,215,290
39054,2015-06-27,13,47,134,181
39055,2015-06-27,14,35,60,95
39056,2015-06-27,15,11,43,54
39057,2015-06-27,16,24,85,109
39058,2015-06-27,17,66,192,258
39059,2015-06-27,18,84,232,316
39060,2015-06-27,19,51,241,292
39061,2015-06-27,20,28,119,147
39062,2015-06-27,21,5,44,49
39063,2015-06-27,22,16,91,107
39064,2015-06-27,23,24,103,127
39065,2015-06-28,0,16,87,103
39066,2015-06-28,1,14,69,83
39067,2015-06-28,2,3,36,39
39068,2015-06-28,3,10,28,38
39069,2015-06-28,4,3,6,9
39070,2015-06-28,5,0,11,11
39071,2015-06-28,6,21,15,36
39072,2015-06-28,7,21,67,88
39073,2015-06-28,8,36,168,204
39074,2015-06-28,9,126,305,431
39075,2015-06-28,10,269,459,728
39076,2015-06-28,11,357,592,949
39077,2015-06-28,12,413,616,1029
39078,2015-06-28,13,445,616,1061
39079,2015-06-28,14,448,587,1035
39080,2015-06-28,15,423,655,1078
39081,2015-06-28,16,420,636,1056
39082,2015-06-28,17,323,551,874
39083,2015-06-28,18,273,519,792
39084,2015-06-28,19,221,478,699
39085,2015-06-28,20,166,352,518
39086,2015-06-28,21,134,265,399
39087,2015-06-28,22,87,148,235
39088,2015-06-28,23,42,80,122
39089,2015-06-29,0,17,48,65
39090,2015-06-29,1,8,14,22
39091,2015-06-29,2,3,7,10
39092,2015-06-29,3,0,8,8
39093,2015-06-29,4,2,12,14
39094,2015-06-29,5,7,81,88
39095,2015-06-29,6,11,308,319
39096,2015-06-29,7,35,780,815
39097,2015-06-29,8,66,962,1028
39098,2015-06-29,9,96,387,483
39099,2015-06-29,10,166,190,356
39100,2015-06-29,11,164,253,417
39101,2015-06-29,12,194,365,559
39102,2015-06-29,13,229,323,552
39103,2015-06-29,14,240,296,536
39104,2015-06-29,15,229,331,560
39105,2015-06-29,16,219,549,768
39106,2015-06-29,17,262,1356,1618
39107,2015-06-29,18,222,1167,1389
39108,2015-06-29,19,193,816,1009
39109,2015-06-29,20,139,557,696
39110,2015-06-29,21,100,334,434
39111,2015-06-29,22,72,254,326
39112,2015-06-29,23,39,93,132
39113,2015-06-30,0,18,34,52
39114,2015-06-30,1,4,12,16
39115,2015-06-30,2,8,9,17
39116,2015-06-30,3,0,6,6
39117,2015-06-30,4,1,9,10
39118,2015-06-30,5,1,102,103
39119,2015-06-30,6,11,334,345
39120,2015-06-30,7,40,852,892
39121,2015-06-30,8,59,1161,1220
39122,2015-06-30,9,66,406,472
39123,2015-06-30,10,79,196,275
39124,2015-06-30,11,108,247,355
39125,2015-06-30,12,161,336,497
39126,2015-06-30,13,152,316,468
39127,2015-06-30,14,161,295,456
39128,2015-06-30,15,158,327,485
39129,2015-06-30,16,196,586,782
39130,2015-06-30,17,228,1304,1532
39131,2015-06-30,18,185,1188,1373
39132,2015-06-30,19,173,728,901
39133,2015-06-30,20,126,514,640
39134,2015-06-30,21,96,481,577
39135,2015-06-30,22,74,285,359
39136,2015-06-30,23,31,116,147
39137,2015-07-01,0,16,44,60
39138,2015-07-01,1,2,1,3
39139,2015-07-01,2,3,5,8
39140,2015-07-01,3,1,2,3
39141,2015-07-01,4,1,8,9
39142,2015-07-01,5,2,70,72
39143,2015-07-01,6,11,287,298
39144,2015-07-01,7,41,784,825
39145,2015-07-01,8,54,1103,1157
39146,2015-07-01,9,92,490,582
39147,2015-07-01,10,109,201,310
39148,2015-07-01,11,185,255,440
39149,2015-07-01,12,169,342,511
39150,2015-07-01,13,185,330,515
39151,2015-07-01,14,229,254,483
39152,2015-07-01,15,241,311,552
39153,2015-07-01,16,214,580,794
39154,2015-07-01,17,215,1126,1341
39155,2015-07-01,18,87,836,923
39156,2015-07-01,19,146,677,823
39157,2015-07-01,20,157,476,633
39158,2015-07-01,21,67,364,431
39159,2015-07-01,22,44,234,278
39160,2015-07-01,23,36,135,171
39161,2015-07-02,0,22,56,78
39162,2015-07-02,1,9,17,26
39163,2015-07-02,2,1,6,7
39164,2015-07-02,3,0,5,5
39165,2015-07-02,4,0,6,6
39166,2015-07-02,5,3,74,77
39167,2015-07-02,6,5,108,113
39168,2015-07-02,7,25,382,407
39169,2015-07-02,8,43,916,959
39170,2015-07-02,9,71,477,548
39171,2015-07-02,10,76,229,305
39172,2015-07-02,11,128,275,403
39173,2015-07-02,12,138,384,522
39174,2015-07-02,13,214,410,624
39175,2015-07-02,14,205,484,689
39176,2015-07-02,15,224,640,864
39177,2015-07-02,16,198,750,948
39178,2015-07-02,17,222,862,1084
39179,2015-07-02,18,199,845,1044
39180,2015-07-02,19,199,540,739
39181,2015-07-02,20,168,452,620
39182,2015-07-02,21,135,337,472
39183,2015-07-02,22,107,282,389
39184,2015-07-02,23,94,232,326
39185,2015-07-03,0,49,123,172
39186,2015-07-03,1,25,92,117
39187,2015-07-03,2,26,72,98
39188,2015-07-03,3,8,20,28
39189,2015-07-03,4,2,9,11
39190,2015-07-03,5,9,30,39
39191,2015-07-03,6,10,55,65
39192,2015-07-03,7,20,107,127
39193,2015-07-03,8,64,210,274
39194,2015-07-03,9,164,316,480
39195,2015-07-03,10,349,417,766
39196,2015-07-03,11,435,510,945
39197,2015-07-03,12,580,511,1091
39198,2015-07-03,13,654,536,1190
39199,2015-07-03,14,767,494,1261
39200,2015-07-03,15,665,511,1176
39201,2015-07-03,16,686,535,1221
39202,2015-07-03,17,604,477,1081
39203,2015-07-03,18,426,402,828
39204,2015-07-03,19,289,212,501
39205,2015-07-03,20,229,229,458
39206,2015-07-03,21,147,213,360
39207,2015-07-03,22,138,124,262
39208,2015-07-03,23,79,155,234
39209,2015-07-04,0,94,94,188
39210,2015-07-04,1,33,93,126
39211,2015-07-04,2,22,64,86
39212,2015-07-04,3,19,34,53
39213,2015-07-04,4,22,4,26
39214,2015-07-04,5,7,15,22
39215,2015-07-04,6,17,28,45
39216,2015-07-04,7,25,61,86
39217,2015-07-04,8,77,157,234
39218,2015-07-04,9,41,71,112
39219,2015-07-04,10,86,144,230
39220,2015-07-04,11,308,286,594
39221,2015-07-04,12,413,349,762
39222,2015-07-04,13,596,361,957
39223,2015-07-04,14,690,425,1115
39224,2015-07-04,15,779,423,1202
39225,2015-07-04,16,186,126,312
39226,2015-07-04,17,284,187,471
39227,2015-07-04,18,446,246,692
39228,2015-07-04,19,435,280,715
39229,2015-07-04,20,376,291,667
39230,2015-07-04,21,366,342,708
39231,2015-07-04,22,304,257,561
39232,2015-07-04,23,128,192,320
39233,2015-07-05,0,145,173,318
39234,2015-07-05,1,50,84,134
39235,2015-07-05,2,46,60,106
39236,2015-07-05,3,27,32,59
39237,2015-07-05,4,26,14,40
39238,2015-07-05,5,16,14,30
39239,2015-07-05,6,13,23,36
39240,2015-07-05,7,24,52,76
39241,2015-07-05,8,110,127,237
39242,2015-07-05,9,198,225,423
39243,2015-07-05,10,364,352,716
39244,2015-07-05,11,525,453,978
39245,2015-07-05,12,587,454,1041
39246,2015-07-05,13,580,502,1082
39247,2015-07-05,14,586,390,976
39248,2015-07-05,15,491,450,941
39249,2015-07-05,16,558,502,1060
39250,2015-07-05,17,494,454,948
39251,2015-07-05,18,366,502,868
39252,2015-07-05,19,272,336,608
39253,2015-07-05,20,229,244,473
39254,2015-07-05,21,202,302,504
39255,2015-07-05,22,178,148,326
39256,2015-07-05,23,124,94,218
39257,2015-07-06,0,48,30,78
39258,2015-07-06,1,23,20,43
39259,2015-07-06,2,6,5,11
39260,2015-07-06,3,10,4,14
39261,2015-07-06,4,5,7,12
39262,2015-07-06,5,2,69,71
39263,2015-07-06,6,10,216,226
39264,2015-07-06,7,31,639,670
39265,2015-07-06,8,51,926,977
39266,2015-07-06,9,100,426,526
39267,2015-07-06,10,171,177,348
39268,2015-07-06,11,189,253,442
39269,2015-07-06,12,177,298,475
39270,2015-07-06,13,235,327,562
39271,2015-07-06,14,248,266,514
39272,2015-07-06,15,190,364,554
39273,2015-07-06,16,215,548,763
39274,2015-07-06,17,215,1046,1261
39275,2015-07-06,18,157,1003,1160
39276,2015-07-06,19,129,646,775
39277,2015-07-06,20,139,445,584
39278,2015-07-06,21,152,295,447
39279,2015-07-06,22,65,187,252
39280,2015-07-06,23,44,91,135
39281,2015-07-07,0,23,37,60
39282,2015-07-07,1,10,19,29
39283,2015-07-07,2,1,8,9
39284,2015-07-07,3,1,4,5
39285,2015-07-07,4,0,10,10
39286,2015-07-07,5,5,92,97
39287,2015-07-07,6,10,333,343
39288,2015-07-07,7,33,864,897
39289,2015-07-07,8,62,1138,1200
39290,2015-07-07,9,99,462,561
39291,2015-07-07,10,143,226,369
39292,2015-07-07,11,129,240,369
39293,2015-07-07,12,179,337,516
39294,2015-07-07,13,118,306,424
39295,2015-07-07,14,175,233,408
39296,2015-07-07,15,211,340,551
39297,2015-07-07,16,168,578,746
39298,2015-07-07,17,244,1288,1532
39299,2015-07-07,18,208,1120,1328
39300,2015-07-07,19,164,758,922
39301,2015-07-07,20,162,585,747
39302,2015-07-07,21,118,455,573
39303,2015-07-07,22,94,273,367
39304,2015-07-07,23,36,124,160
39305,2015-07-08,0,7,50,57
39306,2015-07-08,1,5,22,27
39307,2015-07-08,2,2,14,16
39308,2015-07-08,3,0,4,4
39309,2015-07-08,4,0,16,16
39310,2015-07-08,5,1,102,103
39311,2015-07-08,6,11,330,341
39312,2015-07-08,7,30,863,893
39313,2015-07-08,8,51,1164,1215
39314,2015-07-08,9,101,483,584
39315,2015-07-08,10,146,227,373
39316,2015-07-08,11,149,249,398
39317,2015-07-08,12,134,303,437
39318,2015-07-08,13,152,333,485
39319,2015-07-08,14,165,242,407
39320,2015-07-08,15,140,232,372
39321,2015-07-08,16,122,433,555
39322,2015-07-08,17,93,655,748
39323,2015-07-08,18,68,468,536
39324,2015-07-08,19,98,617,715
39325,2015-07-08,20,78,443,521
39326,2015-07-08,21,57,272,329
39327,2015-07-08,22,50,174,224
39328,2015-07-08,23,22,115,137
39329,2015-07-09,0,6,48,54
39330,2015-07-09,1,23,18,41
39331,2015-07-09,2,4,5,9
39332,2015-07-09,3,0,5,5
39333,2015-07-09,4,0,6,6
39334,2015-07-09,5,6,88,94
39335,2015-07-09,6,13,312,325
39336,2015-07-09,7,25,885,910
39337,2015-07-09,8,47,1109,1156
39338,2015-07-09,9,96,460,556
39339,2015-07-09,10,110,211,321
39340,2015-07-09,11,163,222,385
39341,2015-07-09,12,155,296,451
39342,2015-07-09,13,152,319,471
39343,2015-07-09,14,156,262,418
39344,2015-07-09,15,166,290,456
39345,2015-07-09,16,131,588,719
39346,2015-07-09,17,146,1187,1333
39347,2015-07-09,18,126,916,1042
39348,2015-07-09,19,117,607,724
39349,2015-07-09,20,103,548,651
39350,2015-07-09,21,78,390,468
39351,2015-07-09,22,60,240,300
39352,2015-07-09,23,33,117,150
39353,2015-07-10,0,29,72,101
39354,2015-07-10,1,17,30,47
39355,2015-07-10,2,6,22,28
39356,2015-07-10,3,1,10,11
39357,2015-07-10,4,0,7,7
39358,2015-07-10,5,6,91,97
39359,2015-07-10,6,23,292,315
39360,2015-07-10,7,50,720,770
39361,2015-07-10,8,71,1103,1174
39362,2015-07-10,9,112,493,605
39363,2015-07-10,10,131,249,380
39364,2015-07-10,11,177,270,447
39365,2015-07-10,12,194,407,601
39366,2015-07-10,13,210,415,625
39367,2015-07-10,14,231,334,565
39368,2015-07-10,15,272,426,698
39369,2015-07-10,16,232,673,905
39370,2015-07-10,17,243,1137,1380
39371,2015-07-10,18,218,1063,1281
39372,2015-07-10,19,255,726,981
39373,2015-07-10,20,210,479,689
39374,2015-07-10,21,159,399,558
39375,2015-07-10,22,129,303,432
39376,2015-07-10,23,95,219,314
39377,2015-07-11,0,56,173,229
39378,2015-07-11,1,34,111,145
39379,2015-07-11,2,12,65,77
39380,2015-07-11,3,2,20,22
39381,2015-07-11,4,2,5,7
39382,2015-07-11,5,1,8,9
39383,2015-07-11,6,4,45,49
39384,2015-07-11,7,3,60,63
39385,2015-07-11,8,28,174,202
39386,2015-07-11,9,101,329,430
39387,2015-07-11,10,194,420,614
39388,2015-07-11,11,279,549,828
39389,2015-07-11,12,420,616,1036
39390,2015-07-11,13,471,570,1041
39391,2015-07-11,14,478,597,1075
39392,2015-07-11,15,487,596,1083
39393,2015-07-11,16,468,511,979
39394,2015-07-11,17,390,541,931
39395,2015-07-11,18,398,564,962
39396,2015-07-11,19,362,439,801
39397,2015-07-11,20,251,422,673
39398,2015-07-11,21,158,292,450
39399,2015-07-11,22,164,257,421
39400,2015-07-11,23,82,207,289
39401,2015-07-12,0,43,179,222
39402,2015-07-12,1,48,129,177
39403,2015-07-12,2,24,104,128
39404,2015-07-12,3,9,31,40
39405,2015-07-12,4,3,17,20
39406,2015-07-12,5,5,10,15
39407,2015-07-12,6,9,24,33
39408,2015-07-12,7,11,86,97
39409,2015-07-12,8,51,167,218
39410,2015-07-12,9,149,286,435
39411,2015-07-12,10,265,458,723
39412,2015-07-12,11,326,544,870
39413,2015-07-12,12,424,570,994
39414,2015-07-12,13,405,579,984
39415,2015-07-12,14,386,574,960
39416,2015-07-12,15,363,549,912
39417,2015-07-12,16,395,594,989
39418,2015-07-12,17,316,567,883
39419,2015-07-12,18,276,570,846
39420,2015-07-12,19,216,461,677
39421,2015-07-12,20,223,349,572
39422,2015-07-12,21,185,274,459
39423,2015-07-12,22,111,186,297
39424,2015-07-12,23,69,88,157
39425,2015-07-13,0,35,35,70
39426,2015-07-13,1,8,21,29
39427,2015-07-13,2,1,7,8
39428,2015-07-13,3,1,2,3
39429,2015-07-13,4,0,7,7
39430,2015-07-13,5,2,87,89
39431,2015-07-13,6,14,290,304
39432,2015-07-13,7,38,767,805
39433,2015-07-13,8,29,597,626
39434,2015-07-13,9,66,368,434
39435,2015-07-13,10,107,211,318
39436,2015-07-13,11,90,155,245
39437,2015-07-13,12,78,236,314
39438,2015-07-13,13,129,309,438
39439,2015-07-13,14,169,248,417
39440,2015-07-13,15,208,332,540
39441,2015-07-13,16,182,592,774
39442,2015-07-13,17,182,1221,1403
39443,2015-07-13,18,141,1046,1187
39444,2015-07-13,19,126,700,826
39445,2015-07-13,20,117,513,630
39446,2015-07-13,21,87,336,423
39447,2015-07-13,22,41,185,226
39448,2015-07-13,23,12,95,107
39449,2015-07-14,0,31,71,102
39450,2015-07-14,1,11,18,29
39451,2015-07-14,2,1,9,10
39452,2015-07-14,3,3,8,11
39453,2015-07-14,4,4,11,15
39454,2015-07-14,5,2,97,99
39455,2015-07-14,6,16,333,349
39456,2015-07-14,7,19,864,883
39457,2015-07-14,8,56,1092,1148
39458,2015-07-14,9,41,422,463
39459,2015-07-14,10,133,225,358
39460,2015-07-14,11,120,236,356
39461,2015-07-14,12,145,345,490
39462,2015-07-14,13,168,304,472
39463,2015-07-14,14,134,267,401
39464,2015-07-14,15,145,300,445
39465,2015-07-14,16,137,564,701
39466,2015-07-14,17,183,1250,1433
39467,2015-07-14,18,177,1146,1323
39468,2015-07-14,19,146,791,937
39469,2015-07-14,20,98,542,640
39470,2015-07-14,21,85,340,425
39471,2015-07-14,22,60,246,306
39472,2015-07-14,23,60,135,195
39473,2015-07-15,0,21,52,73
39474,2015-07-15,1,1,10,11
39475,2015-07-15,2,2,4,6
39476,2015-07-15,3,0,1,1
39477,2015-07-15,4,0,18,18
39478,2015-07-15,5,4,108,112
39479,2015-07-15,6,17,323,340
39480,2015-07-15,7,57,892,949
39481,2015-07-15,8,61,1268,1329
39482,2015-07-15,9,76,501,577
39483,2015-07-15,10,105,243,348
39484,2015-07-15,11,96,229,325
39485,2015-07-15,12,137,299,436
39486,2015-07-15,13,123,298,421
39487,2015-07-15,14,104,261,365
39488,2015-07-15,15,155,345,500
39489,2015-07-15,16,155,586,741
39490,2015-07-15,17,167,1196,1363
39491,2015-07-15,18,206,1200,1406
39492,2015-07-15,19,216,778,994
39493,2015-07-15,20,153,626,779
39494,2015-07-15,21,80,417,497
39495,2015-07-15,22,62,260,322
39496,2015-07-15,23,41,134,175
39497,2015-07-16,0,31,62,93
39498,2015-07-16,1,3,14,17
39499,2015-07-16,2,6,8,14
39500,2015-07-16,3,2,1,3
39501,2015-07-16,4,0,11,11
39502,2015-07-16,5,5,89,94
39503,2015-07-16,6,17,311,328
39504,2015-07-16,7,24,884,908
39505,2015-07-16,8,58,1228,1286
39506,2015-07-16,9,82,516,598
39507,2015-07-16,10,141,238,379
39508,2015-07-16,11,142,281,423
39509,2015-07-16,12,175,421,596
39510,2015-07-16,13,146,365,511
39511,2015-07-16,14,172,300,472
39512,2015-07-16,15,208,375,583
39513,2015-07-16,16,188,686,874
39514,2015-07-16,17,175,1339,1514
39515,2015-07-16,18,194,1248,1442
39516,2015-07-16,19,193,877,1070
39517,2015-07-16,20,177,614,791
39518,2015-07-16,21,135,391,526
39519,2015-07-16,22,144,322,466
39520,2015-07-16,23,96,160,256
39521,2015-07-17,0,37,76,113
39522,2015-07-17,1,23,42,65
39523,2015-07-17,2,15,18,33
39524,2015-07-17,3,1,4,5
39525,2015-07-17,4,5,8,13
39526,2015-07-17,5,11,91,102
39527,2015-07-17,6,11,265,276
39528,2015-07-17,7,39,733,772
39529,2015-07-17,8,70,1111,1181
39530,2015-07-17,9,98,503,601
39531,2015-07-17,10,146,246,392
39532,2015-07-17,11,207,268,475
39533,2015-07-17,12,262,388,650
39534,2015-07-17,13,215,359,574
39535,2015-07-17,14,277,352,629
39536,2015-07-17,15,258,466,724
39537,2015-07-17,16,233,702,935
39538,2015-07-17,17,243,1194,1437
39539,2015-07-17,18,214,918,1132
39540,2015-07-17,19,181,642,823
39541,2015-07-17,20,158,424,582
39542,2015-07-17,21,123,324,447
39543,2015-07-17,22,96,304,400
39544,2015-07-17,23,53,211,264
39545,2015-07-18,0,38,159,197
39546,2015-07-18,1,35,127,162
39547,2015-07-18,2,9,88,97
39548,2015-07-18,3,14,25,39
39549,2015-07-18,4,5,9,14
39550,2015-07-18,5,3,9,12
39551,2015-07-18,6,11,48,59
39552,2015-07-18,7,37,121,158
39553,2015-07-18,8,79,260,339
39554,2015-07-18,9,106,290,396
39555,2015-07-18,10,89,226,315
39556,2015-07-18,11,207,423,630
39557,2015-07-18,12,323,493,816
39558,2015-07-18,13,418,498,916
39559,2015-07-18,14,406,518,924
39560,2015-07-18,15,458,515,973
39561,2015-07-18,16,361,450,811
39562,2015-07-18,17,338,406,744
39563,2015-07-18,18,350,474,824
39564,2015-07-18,19,347,454,801
39565,2015-07-18,20,292,381,673
39566,2015-07-18,21,204,263,467
39567,2015-07-18,22,182,235,417
39568,2015-07-18,23,113,197,310
39569,2015-07-19,0,89,149,238
39570,2015-07-19,1,40,131,171
39571,2015-07-19,2,24,82,106
39572,2015-07-19,3,21,36,57
39573,2015-07-19,4,7,11,18
39574,2015-07-19,5,3,14,17
39575,2015-07-19,6,21,27,48
39576,2015-07-19,7,27,64,91
39577,2015-07-19,8,108,160,268
39578,2015-07-19,9,175,286,461
39579,2015-07-19,10,362,446,808
39580,2015-07-19,11,386,476,862
39581,2015-07-19,12,381,466,847
39582,2015-07-19,13,306,417,723
39583,2015-07-19,14,357,425,782
39584,2015-07-19,15,305,415,720
39585,2015-07-19,16,302,421,723
39586,2015-07-19,17,310,424,734
39587,2015-07-19,18,246,394,640
39588,2015-07-19,19,222,382,604
39589,2015-07-19,20,204,316,520
39590,2015-07-19,21,165,218,383
39591,2015-07-19,22,71,158,229
39592,2015-07-19,23,23,72,95
39593,2015-07-20,0,24,35,59
39594,2015-07-20,1,9,9,18
39595,2015-07-20,2,4,7,11
39596,2015-07-20,3,0,4,4
39597,2015-07-20,4,1,10,11
39598,2015-07-20,5,3,88,91
39599,2015-07-20,6,13,276,289
39600,2015-07-20,7,26,724,750
39601,2015-07-20,8,64,913,977
39602,2015-07-20,9,87,381,468
39603,2015-07-20,10,140,174,314
39604,2015-07-20,11,168,215,383
39605,2015-07-20,12,153,312,465
39606,2015-07-20,13,174,250,424
39607,2015-07-20,14,150,195,345
39608,2015-07-20,15,178,241,419
39609,2015-07-20,16,191,515,706
39610,2015-07-20,17,188,1137,1325
39611,2015-07-20,18,159,1096,1255
39612,2015-07-20,19,172,707,879
39613,2015-07-20,20,156,565,721
39614,2015-07-20,21,107,358,465
39615,2015-07-20,22,88,221,309
39616,2015-07-20,23,62,105,167
39617,2015-07-21,0,5,36,41
39618,2015-07-21,1,3,10,13
39619,2015-07-21,2,1,8,9
39620,2015-07-21,3,2,3,5
39621,2015-07-21,4,0,13,13
39622,2015-07-21,5,3,84,87
39623,2015-07-21,6,15,304,319
39624,2015-07-21,7,49,816,865
39625,2015-07-21,8,64,1070,1134
39626,2015-07-21,9,70,463,533
39627,2015-07-21,10,122,197,319
39628,2015-07-21,11,171,229,400
39629,2015-07-21,12,161,291,452
39630,2015-07-21,13,163,329,492
39631,2015-07-21,14,155,266,421
39632,2015-07-21,15,192,324,516
39633,2015-07-21,16,165,555,720
39634,2015-07-21,17,202,1244,1446
39635,2015-07-21,18,185,1164,1349
39636,2015-07-21,19,134,744,878
39637,2015-07-21,20,146,565,711
39638,2015-07-21,21,104,429,533
39639,2015-07-21,22,82,299,381
39640,2015-07-21,23,52,122,174
39641,2015-07-22,0,22,42,64
39642,2015-07-22,1,13,22,35
39643,2015-07-22,2,9,8,17
39644,2015-07-22,3,5,2,7
39645,2015-07-22,4,4,11,15
39646,2015-07-22,5,12,100,112
39647,2015-07-22,6,27,372,399
39648,2015-07-22,7,41,931,972
39649,2015-07-22,8,67,1161,1228
39650,2015-07-22,9,84,501,585
39651,2015-07-22,10,115,289,404
39652,2015-07-22,11,168,327,495
39653,2015-07-22,12,163,379,542
39654,2015-07-22,13,169,312,481
39655,2015-07-22,14,158,277,435
39656,2015-07-22,15,202,346,548
39657,2015-07-22,16,208,628,836
39658,2015-07-22,17,240,1336,1576
39659,2015-07-22,18,188,1164,1352
39660,2015-07-22,19,192,806,998
39661,2015-07-22,20,164,611,775
39662,2015-07-22,21,112,435,547
39663,2015-07-22,22,75,273,348
39664,2015-07-22,23,30,132,162
39665,2015-07-23,0,31,66,97
39666,2015-07-23,1,9,27,36
39667,2015-07-23,2,4,14,18
39668,2015-07-23,3,1,6,7
39669,2015-07-23,4,0,14,14
39670,2015-07-23,5,3,79,82
39671,2015-07-23,6,9,316,325
39672,2015-07-23,7,47,916,963
39673,2015-07-23,8,62,1158,1220
39674,2015-07-23,9,72,482,554
39675,2015-07-23,10,155,217,372
39676,2015-07-23,11,149,261,410
39677,2015-07-23,12,148,425,573
39678,2015-07-23,13,193,375,568
39679,2015-07-23,14,191,298,489
39680,2015-07-23,15,185,351,536
39681,2015-07-23,16,192,649,841
39682,2015-07-23,17,257,1307,1564
39683,2015-07-23,18,239,1180,1419
39684,2015-07-23,19,194,811,1005
39685,2015-07-23,20,189,625,814
39686,2015-07-23,21,136,384,520
39687,2015-07-23,22,83,291,374
39688,2015-07-23,23,25,165,190
39689,2015-07-24,0,18,77,95
39690,2015-07-24,1,27,41,68
39691,2015-07-24,2,11,18,29
39692,2015-07-24,3,2,6,8
39693,2015-07-24,4,0,11,11
39694,2015-07-24,5,8,84,92
39695,2015-07-24,6,20,272,292
39696,2015-07-24,7,39,758,797
39697,2015-07-24,8,59,1142,1201
39698,2015-07-24,9,119,525,644
39699,2015-07-24,10,185,287,472
39700,2015-07-24,11,202,331,533
39701,2015-07-24,12,214,401,615
39702,2015-07-24,13,220,413,633
39703,2015-07-24,14,210,386,596
39704,2015-07-24,15,239,469,708
39705,2015-07-24,16,279,738,1017
39706,2015-07-24,17,282,1247,1529
39707,2015-07-24,18,280,970,1250
39708,2015-07-24,19,254,593,847
39709,2015-07-24,20,258,463,721
39710,2015-07-24,21,138,327,465
39711,2015-07-24,22,126,289,415
39712,2015-07-24,23,88,209,297
39713,2015-07-25,0,49,122,171
39714,2015-07-25,1,20,89,109
39715,2015-07-25,2,27,57,84
39716,2015-07-25,3,12,31,43
39717,2015-07-25,4,8,14,22
39718,2015-07-25,5,9,13,22
39719,2015-07-25,6,19,40,59
39720,2015-07-25,7,50,119,169
39721,2015-07-25,8,89,270,359
39722,2015-07-25,9,209,377,586
39723,2015-07-25,10,317,417,734
39724,2015-07-25,11,384,552,936
39725,2015-07-25,12,477,525,1002
39726,2015-07-25,13,507,540,1047
39727,2015-07-25,14,484,542,1026
39728,2015-07-25,15,525,520,1045
39729,2015-07-25,16,512,447,959
39730,2015-07-25,17,481,490,971
39731,2015-07-25,18,415,474,889
39732,2015-07-25,19,344,422,766
39733,2015-07-25,20,286,347,633
39734,2015-07-25,21,256,255,511
39735,2015-07-25,22,190,247,437
39736,2015-07-25,23,136,183,319
39737,2015-07-26,0,76,157,233
39738,2015-07-26,1,26,104,130
39739,2015-07-26,2,22,66,88
39740,2015-07-26,3,14,34,48
39741,2015-07-26,4,0,8,8
39742,2015-07-26,5,5,12,17
39743,2015-07-26,6,11,24,35
39744,2015-07-26,7,42,62,104
39745,2015-07-26,8,62,153,215
39746,2015-07-26,9,223,350,573
39747,2015-07-26,10,300,415,715
39748,2015-07-26,11,302,486,788
39749,2015-07-26,12,441,462,903
39750,2015-07-26,13,372,493,865
39751,2015-07-26,14,432,500,932
39752,2015-07-26,15,423,516,939
39753,2015-07-26,16,408,528,936
39754,2015-07-26,17,368,518,886
39755,2015-07-26,18,328,478,806
39756,2015-07-26,19,289,447,736
39757,2015-07-26,20,229,334,563
39758,2015-07-26,21,142,217,359
39759,2015-07-26,22,86,185,271
39760,2015-07-26,23,79,81,160
39761,2015-07-27,0,40,29,69
39762,2015-07-27,1,26,12,38
39763,2015-07-27,2,7,11,18
39764,2015-07-27,3,1,4,5
39765,2015-07-27,4,2,4,6
39766,2015-07-27,5,0,37,37
39767,2015-07-27,6,11,239,250
39768,2015-07-27,7,28,693,721
39769,2015-07-27,8,71,955,1026
39770,2015-07-27,9,80,434,514
39771,2015-07-27,10,181,203,384
39772,2015-07-27,11,177,225,402
39773,2015-07-27,12,216,311,527
39774,2015-07-27,13,223,299,522
39775,2015-07-27,14,201,262,463
39776,2015-07-27,15,47,101,148
39777,2015-07-27,16,129,425,554
39778,2015-07-27,17,228,1174,1402
39779,2015-07-27,18,193,1129,1322
39780,2015-07-27,19,212,713,925
39781,2015-07-27,20,155,555,710
39782,2015-07-27,21,135,359,494
39783,2015-07-27,22,78,160,238
39784,2015-07-27,23,40,103,143
39785,2015-07-28,0,24,44,68
39786,2015-07-28,1,15,20,35
39787,2015-07-28,2,0,17,17
39788,2015-07-28,3,2,0,2
39789,2015-07-28,4,1,10,11
39790,2015-07-28,5,4,81,85
39791,2015-07-28,6,15,361,376
39792,2015-07-28,7,26,908,934
39793,2015-07-28,8,66,1185,1251
39794,2015-07-28,9,130,486,616
39795,2015-07-28,10,202,190,392
39796,2015-07-28,11,244,263,507
39797,2015-07-28,12,204,329,533
39798,2015-07-28,13,204,319,523
39799,2015-07-28,14,221,243,464
39800,2015-07-28,15,213,334,547
39801,2015-07-28,16,195,612,807
39802,2015-07-28,17,203,1249,1452
39803,2015-07-28,18,170,1140,1310
39804,2015-07-28,19,94,452,546
39805,2015-07-28,20,119,501,620
39806,2015-07-28,21,85,342,427
39807,2015-07-28,22,46,227,273
39808,2015-07-28,23,45,135,180
39809,2015-07-29,0,17,43,60
39810,2015-07-29,1,16,14,30
39811,2015-07-29,2,14,10,24
39812,2015-07-29,3,6,7,13
39813,2015-07-29,4,1,9,10
39814,2015-07-29,5,4,109,113
39815,2015-07-29,6,16,341,357
39816,2015-07-29,7,27,861,888
39817,2015-07-29,8,66,1191,1257
39818,2015-07-29,9,74,471,545
39819,2015-07-29,10,141,216,357
39820,2015-07-29,11,160,271,431
39821,2015-07-29,12,158,307,465
39822,2015-07-29,13,206,306,512
39823,2015-07-29,14,201,258,459
39824,2015-07-29,15,184,276,460
39825,2015-07-29,16,163,585,748
39826,2015-07-29,17,206,1186,1392
39827,2015-07-29,18,218,1101,1319
39828,2015-07-29,19,184,778,962
39829,2015-07-29,20,137,606,743
39830,2015-07-29,21,109,391,500
39831,2015-07-29,22,83,261,344
39832,2015-07-29,23,34,143,177
39833,2015-07-30,0,39,62,101
39834,2015-07-30,1,14,29,43
39835,2015-07-30,2,4,4,8
39836,2015-07-30,3,4,8,12
39837,2015-07-30,4,0,7,7
39838,2015-07-30,5,4,91,95
39839,2015-07-30,6,18,320,338
39840,2015-07-30,7,34,789,823
39841,2015-07-30,8,51,1105,1156
39842,2015-07-30,9,86,464,550
39843,2015-07-30,10,101,210,311
39844,2015-07-30,11,139,238,377
39845,2015-07-30,12,143,315,458
39846,2015-07-30,13,152,304,456
39847,2015-07-30,14,31,49,80
39848,2015-07-30,15,105,252,357
39849,2015-07-30,16,156,585,741
39850,2015-07-30,17,171,1097,1268
39851,2015-07-30,18,145,1037,1182
39852,2015-07-30,19,138,774,912
39853,2015-07-30,20,120,513,633
39854,2015-07-30,21,61,359,420
39855,2015-07-30,22,56,249,305
39856,2015-07-30,23,29,144,173
39857,2015-07-31,0,17,64,81
39858,2015-07-31,1,11,38,49
39859,2015-07-31,2,2,20,22
39860,2015-07-31,3,2,5,7
39861,2015-07-31,4,3,13,16
39862,2015-07-31,5,4,81,85
39863,2015-07-31,6,23,284,307
39864,2015-07-31,7,26,728,754
39865,2015-07-31,8,71,1061,1132
39866,2015-07-31,9,80,506,586
39867,2015-07-31,10,140,229,369
39868,2015-07-31,11,163,326,489
39869,2015-07-31,12,172,421,593
39870,2015-07-31,13,193,409,602
39871,2015-07-31,14,180,354,534
39872,2015-07-31,15,213,445,658
39873,2015-07-31,16,203,726,929
39874,2015-07-31,17,217,1072,1289
39875,2015-07-31,18,224,902,1126
39876,2015-07-31,19,246,619,865
39877,2015-07-31,20,186,509,695
39878,2015-07-31,21,137,336,473
39879,2015-07-31,22,139,250,389
39880,2015-07-31,23,98,247,345
39881,2015-08-01,0,29,151,180
39882,2015-08-01,1,22,101,123
39883,2015-08-01,2,14,73,87
39884,2015-08-01,3,12,18,30
39885,2015-08-01,4,2,7,9
39886,2015-08-01,5,6,11,17
39887,2015-08-01,6,21,54,75
39888,2015-08-01,7,25,107,132
39889,2015-08-01,8,71,218,289
39890,2015-08-01,9,143,413,556
39891,2015-08-01,10,270,485,755
39892,2015-08-01,11,283,477,760
39893,2015-08-01,12,413,532,945
39894,2015-08-01,13,461,561,1022
39895,2015-08-01,14,467,495,962
39896,2015-08-01,15,439,529,968
39897,2015-08-01,16,448,439,887
39898,2015-08-01,17,433,473,906
39899,2015-08-01,18,332,485,817
39900,2015-08-01,19,332,397,729
39901,2015-08-01,20,239,319,558
39902,2015-08-01,21,200,336,536
39903,2015-08-01,22,167,222,389
39904,2015-08-01,23,108,200,308
39905,2015-08-02,0,79,168,247
39906,2015-08-02,1,43,124,167
39907,2015-08-02,2,18,91,109
39908,2015-08-02,3,24,40,64
39909,2015-08-02,4,13,11,24
39910,2015-08-02,5,7,13,20
39911,2015-08-02,6,10,20,30
39912,2015-08-02,7,33,76,109
39913,2015-08-02,8,88,157,245
39914,2015-08-02,9,174,301,475
39915,2015-08-02,10,284,445,729
39916,2015-08-02,11,385,456,841
39917,2015-08-02,12,398,573,971
39918,2015-08-02,13,381,547,928
39919,2015-08-02,14,435,493,928
39920,2015-08-02,15,349,522,871
39921,2015-08-02,16,435,574,1009
39922,2015-08-02,17,321,479,800
39923,2015-08-02,18,314,529,843
39924,2015-08-02,19,236,443,679
39925,2015-08-02,20,189,343,532
39926,2015-08-02,21,139,239,378
39927,2015-08-02,22,121,159,280
39928,2015-08-02,23,72,94,166
39929,2015-08-03,0,33,29,62
39930,2015-08-03,1,12,12,24
39931,2015-08-03,2,5,6,11
39932,2015-08-03,3,0,3,3
39933,2015-08-03,4,3,8,11
39934,2015-08-03,5,1,82,83
39935,2015-08-03,6,8,310,318
39936,2015-08-03,7,17,785,802
39937,2015-08-03,8,55,994,1049
39938,2015-08-03,9,125,484,609
39939,2015-08-03,10,172,233,405
39940,2015-08-03,11,235,265,500
39941,2015-08-03,12,181,309,490
39942,2015-08-03,13,169,308,477
39943,2015-08-03,14,225,293,518
39944,2015-08-03,15,235,336,571
39945,2015-08-03,16,173,576,749
39946,2015-08-03,17,202,1201,1403
39947,2015-08-03,18,220,1121,1341
39948,2015-08-03,19,216,783,999
39949,2015-08-03,20,192,489,681
39950,2015-08-03,21,114,411,525
39951,2015-08-03,22,70,223,293
39952,2015-08-03,23,50,108,158
39953,2015-08-04,0,25,42,67
39954,2015-08-04,1,8,18,26
39955,2015-08-04,2,3,9,12
39956,2015-08-04,3,1,1,2
39957,2015-08-04,4,3,11,14
39958,2015-08-04,5,5,97,102
39959,2015-08-04,6,16,347,363
39960,2015-08-04,7,49,852,901
39961,2015-08-04,8,58,1146,1204
39962,2015-08-04,9,94,454,548
39963,2015-08-04,10,159,190,349
39964,2015-08-04,11,142,240,382
39965,2015-08-04,12,134,313,447
39966,2015-08-04,13,153,323,476
39967,2015-08-04,14,155,278,433
39968,2015-08-04,15,154,321,475
39969,2015-08-04,16,161,585,746
39970,2015-08-04,17,208,1203,1411
39971,2015-08-04,18,186,1097,1283
39972,2015-08-04,19,161,728,889
39973,2015-08-04,20,129,481,610
39974,2015-08-04,21,101,304,405
39975,2015-08-04,22,69,233,302
39976,2015-08-04,23,37,141,178
39977,2015-08-05,0,13,40,53
39978,2015-08-05,1,5,10,15
39979,2015-08-05,2,1,8,9
39980,2015-08-05,3,2,3,5
39981,2015-08-05,4,1,8,9
39982,2015-08-05,5,3,104,107
39983,2015-08-05,6,13,316,329
39984,2015-08-05,7,45,859,904
39985,2015-08-05,8,60,1150,1210
39986,2015-08-05,9,89,535,624
39987,2015-08-05,10,116,247,363
39988,2015-08-05,11,122,290,412
39989,2015-08-05,12,179,345,524
39990,2015-08-05,13,189,336,525
39991,2015-08-05,14,193,252,445
39992,2015-08-05,15,195,339,534
39993,2015-08-05,16,214,636,850
39994,2015-08-05,17,205,1251,1456
39995,2015-08-05,18,182,1189,1371
39996,2015-08-05,19,201,771,972
39997,2015-08-05,20,138,578,716
39998,2015-08-05,21,114,365,479
39999,2015-08-05,22,83,300,383
40000,2015-08-05,23,45,160,205
40001,2015-08-06,0,34,57,91
40002,2015-08-06,1,2,28,30
40003,2015-08-06,2,6,7,13
40004,2015-08-06,3,1,3,4
40005,2015-08-06,4,0,5,5
40006,2015-08-06,5,4,79,83
40007,2015-08-06,6,12,311,323
40008,2015-08-06,7,46,886,932
40009,2015-08-06,8,73,1209,1282
40010,2015-08-06,9,97,570,667
40011,2015-08-06,10,146,279,425
40012,2015-08-06,11,199,263,462
40013,2015-08-06,12,191,357,548
40014,2015-08-06,13,186,295,481
40015,2015-08-06,14,216,278,494
40016,2015-08-06,15,216,367,583
40017,2015-08-06,16,208,607,815
40018,2015-08-06,17,216,1286,1502
40019,2015-08-06,18,211,1166,1377
40020,2015-08-06,19,155,725,880
40021,2015-08-06,20,116,535,651
40022,2015-08-06,21,114,280,394
40023,2015-08-06,22,65,247,312
40024,2015-08-06,23,51,210,261
40025,2015-08-07,0,27,92,119
40026,2015-08-07,1,12,41,53
40027,2015-08-07,2,2,21,23
40028,2015-08-07,3,0,4,4
40029,2015-08-07,4,4,8,12
40030,2015-08-07,5,6,74,80
40031,2015-08-07,6,11,223,234
40032,2015-08-07,7,31,628,659
40033,2015-08-07,8,48,1032,1080
40034,2015-08-07,9,86,543,629
40035,2015-08-07,10,122,263,385
40036,2015-08-07,11,155,293,448
40037,2015-08-07,12,208,392,600
40038,2015-08-07,13,202,439,641
40039,2015-08-07,14,228,337,565
40040,2015-08-07,15,204,459,663
40041,2015-08-07,16,242,685,927
40042,2015-08-07,17,281,1092,1373
40043,2015-08-07,18,247,935,1182
40044,2015-08-07,19,235,563,798
40045,2015-08-07,20,161,419,580
40046,2015-08-07,21,130,298,428
40047,2015-08-07,22,111,283,394
40048,2015-08-07,23,74,228,302
40049,2015-08-08,0,41,135,176
40050,2015-08-08,1,33,106,139
40051,2015-08-08,2,22,72,94
40052,2015-08-08,3,10,30,40
40053,2015-08-08,4,4,12,16
40054,2015-08-08,5,4,22,26
40055,2015-08-08,6,23,52,75
40056,2015-08-08,7,45,109,154
40057,2015-08-08,8,77,222,299
40058,2015-08-08,9,160,380,540
40059,2015-08-08,10,269,471,740
40060,2015-08-08,11,358,506,864
40061,2015-08-08,12,485,584,1069
40062,2015-08-08,13,512,568,1080
40063,2015-08-08,14,616,571,1187
40064,2015-08-08,15,553,499,1052
40065,2015-08-08,16,459,451,910
40066,2015-08-08,17,549,511,1060
40067,2015-08-08,18,360,507,867
40068,2015-08-08,19,396,358,754
40069,2015-08-08,20,260,328,588
40070,2015-08-08,21,243,249,492
40071,2015-08-08,22,206,212,418
40072,2015-08-08,23,158,168,326
40073,2015-08-09,0,103,172,275
40074,2015-08-09,1,69,118,187
40075,2015-08-09,2,41,68,109
40076,2015-08-09,3,7,29,36
40077,2015-08-09,4,0,12,12
40078,2015-08-09,5,7,8,15
40079,2015-08-09,6,18,28,46
40080,2015-08-09,7,28,70,98
40081,2015-08-09,8,46,175,221
40082,2015-08-09,9,191,260,451
40083,2015-08-09,10,338,464,802
40084,2015-08-09,11,355,492,847
40085,2015-08-09,12,356,582,938
40086,2015-08-09,13,480,549,1029
40087,2015-08-09,14,478,525,1003
40088,2015-08-09,15,378,507,885
40089,2015-08-09,16,418,500,918
40090,2015-08-09,17,387,512,899
40091,2015-08-09,18,329,487,816
40092,2015-08-09,19,279,400,679
40093,2015-08-09,20,190,304,494
40094,2015-08-09,21,208,233,441
40095,2015-08-09,22,134,149,283
40096,2015-08-09,23,80,83,163
40097,2015-08-10,0,44,28,72
40098,2015-08-10,1,8,20,28
40099,2015-08-10,2,6,3,9
40100,2015-08-10,3,6,2,8
40101,2015-08-10,4,0,2,2
40102,2015-08-10,5,2,39,41
40103,2015-08-10,6,11,213,224
40104,2015-08-10,7,27,627,654
40105,2015-08-10,8,46,850,896
40106,2015-08-10,9,89,478,567
40107,2015-08-10,10,158,189,347
40108,2015-08-10,11,144,243,387
40109,2015-08-10,12,180,265,445
40110,2015-08-10,13,190,290,480
40111,2015-08-10,14,208,250,458
40112,2015-08-10,15,243,302,545
40113,2015-08-10,16,167,541,708
40114,2015-08-10,17,240,1227,1467
40115,2015-08-10,18,183,1053,1236
40116,2015-08-10,19,141,651,792
40117,2015-08-10,20,131,468,599
40118,2015-08-10,21,88,181,269
40119,2015-08-10,22,36,145,181
40120,2015-08-10,23,13,64,77
40121,2015-08-11,0,2,22,24
40122,2015-08-11,1,1,14,15
40123,2015-08-11,2,2,1,3
40124,2015-08-11,3,1,4,5
40125,2015-08-11,4,1,8,9
40126,2015-08-11,5,2,84,86
40127,2015-08-11,6,4,200,204
40128,2015-08-11,7,20,648,668
40129,2015-08-11,8,48,1041,1089
40130,2015-08-11,9,67,545,612
40131,2015-08-11,10,106,210,316
40132,2015-08-11,11,149,243,392
40133,2015-08-11,12,143,339,482
40134,2015-08-11,13,181,329,510
40135,2015-08-11,14,165,283,448
40136,2015-08-11,15,157,316,473
40137,2015-08-11,16,143,558,701
40138,2015-08-11,17,172,1309,1481
40139,2015-08-11,18,194,1157,1351
40140,2015-08-11,19,178,719,897
40141,2015-08-11,20,139,547,686
40142,2015-08-11,21,98,346,444
40143,2015-08-11,22,79,236,315
40144,2015-08-11,23,13,118,131
40145,2015-08-12,0,33,40,73
40146,2015-08-12,1,5,15,20
40147,2015-08-12,2,2,11,13
40148,2015-08-12,3,2,2,4
40149,2015-08-12,4,2,9,11
40150,2015-08-12,5,4,114,118
40151,2015-08-12,6,5,361,366
40152,2015-08-12,7,44,847,891
40153,2015-08-12,8,50,1136,1186
40154,2015-08-12,9,107,513,620
40155,2015-08-12,10,123,226,349
40156,2015-08-12,11,158,237,395
40157,2015-08-12,12,190,358,548
40158,2015-08-12,13,156,340,496
40159,2015-08-12,14,194,237,431
40160,2015-08-12,15,181,371,552
40161,2015-08-12,16,200,628,828
40162,2015-08-12,17,159,1334,1493
40163,2015-08-12,18,228,1190,1418
40164,2015-08-12,19,163,815,978
40165,2015-08-12,20,136,618,754
40166,2015-08-12,21,93,405,498
40167,2015-08-12,22,42,251,293
40168,2015-08-12,23,27,123,150
40169,2015-08-13,0,6,45,51
40170,2015-08-13,1,14,24,38
40171,2015-08-13,2,7,17,24
40172,2015-08-13,3,3,9,12
40173,2015-08-13,4,2,6,8
40174,2015-08-13,5,6,86,92
40175,2015-08-13,6,14,341,355
40176,2015-08-13,7,29,842,871
40177,2015-08-13,8,61,1060,1121
40178,2015-08-13,9,86,493,579
40179,2015-08-13,10,129,230,359
40180,2015-08-13,11,143,280,423
40181,2015-08-13,12,164,357,521
40182,2015-08-13,13,162,367,529
40183,2015-08-13,14,154,309,463
40184,2015-08-13,15,182,442,624
40185,2015-08-13,16,207,609,816
40186,2015-08-13,17,212,1329,1541
40187,2015-08-13,18,239,1175,1414
40188,2015-08-13,19,157,793,950
40189,2015-08-13,20,123,504,627
40190,2015-08-13,21,124,404,528
40191,2015-08-13,22,80,225,305
40192,2015-08-13,23,39,144,183
40193,2015-08-14,0,41,76,117
40194,2015-08-14,1,7,38,45
40195,2015-08-14,2,2,18,20
40196,2015-08-14,3,3,4,7
40197,2015-08-14,4,3,7,10
40198,2015-08-14,5,5,73,78
40199,2015-08-14,6,8,283,291
40200,2015-08-14,7,34,695,729
40201,2015-08-14,8,54,1084,1138
40202,2015-08-14,9,93,556,649
40203,2015-08-14,10,164,247,411
40204,2015-08-14,11,208,287,495
40205,2015-08-14,12,243,439,682
40206,2015-08-14,13,252,407,659
40207,2015-08-14,14,273,333,606
40208,2015-08-14,15,235,465,700
40209,2015-08-14,16,255,734,989
40210,2015-08-14,17,254,1190,1444
40211,2015-08-14,18,198,887,1085
40212,2015-08-14,19,215,521,736
40213,2015-08-14,20,150,409,559
40214,2015-08-14,21,116,341,457
40215,2015-08-14,22,94,240,334
40216,2015-08-14,23,65,243,308
40217,2015-08-15,0,41,134,175
40218,2015-08-15,1,19,93,112
40219,2015-08-15,2,28,71,99
40220,2015-08-15,3,8,33,41
40221,2015-08-15,4,2,8,10
40222,2015-08-15,5,3,19,22
40223,2015-08-15,6,6,48,54
40224,2015-08-15,7,31,115,146
40225,2015-08-15,8,62,242,304
40226,2015-08-15,9,128,357,485
40227,2015-08-15,10,305,455,760
40228,2015-08-15,11,407,535,942
40229,2015-08-15,12,493,583,1076
40230,2015-08-15,13,494,522,1016
40231,2015-08-15,14,479,422,901
40232,2015-08-15,15,449,501,950
40233,2015-08-15,16,446,470,916
40234,2015-08-15,17,420,428,848
40235,2015-08-15,18,363,445,808
40236,2015-08-15,19,333,416,749
40237,2015-08-15,20,243,314,557
40238,2015-08-15,21,217,249,466
40239,2015-08-15,22,160,190,350
40240,2015-08-15,23,123,170,293
40241,2015-08-16,0,74,118,192
40242,2015-08-16,1,37,98,135
40243,2015-08-16,2,24,68,92
40244,2015-08-16,3,22,33,55
40245,2015-08-16,4,2,7,9
40246,2015-08-16,5,6,12,18
40247,2015-08-16,6,7,30,37
40248,2015-08-16,7,27,62,89
40249,2015-08-16,8,54,182,236
40250,2015-08-16,9,167,311,478
40251,2015-08-16,10,285,429,714
40252,2015-08-16,11,375,506,881
40253,2015-08-16,12,377,532,909
40254,2015-08-16,13,374,471,845
40255,2015-08-16,14,311,494,805
40256,2015-08-16,15,338,434,772
40257,2015-08-16,16,285,469,754
40258,2015-08-16,17,251,476,727
40259,2015-08-16,18,219,449,668
40260,2015-08-16,19,237,432,669
40261,2015-08-16,20,179,308,487
40262,2015-08-16,21,97,193,290
40263,2015-08-16,22,79,139,218
40264,2015-08-16,23,45,67,112
40265,2015-08-17,0,25,27,52
40266,2015-08-17,1,20,8,28
40267,2015-08-17,2,2,6,8
40268,2015-08-17,3,1,9,10
40269,2015-08-17,4,5,7,12
40270,2015-08-17,5,2,73,75
40271,2015-08-17,6,14,298,312
40272,2015-08-17,7,28,773,801
40273,2015-08-17,8,48,1022,1070
40274,2015-08-17,9,124,416,540
40275,2015-08-17,10,144,215,359
40276,2015-08-17,11,158,196,354
40277,2015-08-17,12,185,316,501
40278,2015-08-17,13,128,301,429
40279,2015-08-17,14,127,245,372
40280,2015-08-17,15,172,316,488
40281,2015-08-17,16,165,535,700
40282,2015-08-17,17,139,1169,1308
40283,2015-08-17,18,163,1085,1248
40284,2015-08-17,19,150,732,882
40285,2015-08-17,20,120,490,610
40286,2015-08-17,21,124,320,444
40287,2015-08-17,22,63,181,244
40288,2015-08-17,23,28,96,124
40289,2015-08-18,0,9,23,32
40290,2015-08-18,1,2,9,11
40291,2015-08-18,2,5,1,6
40292,2015-08-18,3,0,2,2
40293,2015-08-18,4,2,5,7
40294,2015-08-18,5,4,93,97
40295,2015-08-18,6,11,308,319
40296,2015-08-18,7,23,891,914
40297,2015-08-18,8,59,1144,1203
40298,2015-08-18,9,56,465,521
40299,2015-08-18,10,136,193,329
40300,2015-08-18,11,167,262,429
40301,2015-08-18,12,110,323,433
40302,2015-08-18,13,131,316,447
40303,2015-08-18,14,164,281,445
40304,2015-08-18,15,169,361,530
40305,2015-08-18,16,219,601,820
40306,2015-08-18,17,218,1237,1455
40307,2015-08-18,18,176,1130,1306
40308,2015-08-18,19,158,708,866
40309,2015-08-18,20,98,497,595
40310,2015-08-18,21,83,299,382
40311,2015-08-18,22,52,223,275
40312,2015-08-18,23,46,125,171
40313,2015-08-19,0,19,52,71
40314,2015-08-19,1,8,18,26
40315,2015-08-19,2,4,5,9
40316,2015-08-19,3,4,4,8
40317,2015-08-19,4,4,8,12
40318,2015-08-19,5,0,131,131
40319,2015-08-19,6,6,319,325
40320,2015-08-19,7,41,885,926
40321,2015-08-19,8,39,1167,1206
40322,2015-08-19,9,70,520,590
40323,2015-08-19,10,146,236,382
40324,2015-08-19,11,158,257,415
40325,2015-08-19,12,171,335,506
40326,2015-08-19,13,173,351,524
40327,2015-08-19,14,169,268,437
40328,2015-08-19,15,141,363,504
40329,2015-08-19,16,146,565,711
40330,2015-08-19,17,156,1237,1393
40331,2015-08-19,18,165,1136,1301
40332,2015-08-19,19,117,832,949
40333,2015-08-19,20,100,567,667
40334,2015-08-19,21,60,332,392
40335,2015-08-19,22,52,264,316
40336,2015-08-19,23,35,127,162
40337,2015-08-20,0,19,55,74
40338,2015-08-20,1,17,37,54
40339,2015-08-20,2,2,8,10
40340,2015-08-20,3,3,1,4
40341,2015-08-20,4,0,8,8
40342,2015-08-20,5,0,78,78
40343,2015-08-20,6,6,266,272
40344,2015-08-20,7,28,705,733
40345,2015-08-20,8,48,1061,1109
40346,2015-08-20,9,59,471,530
40347,2015-08-20,10,98,214,312
40348,2015-08-20,11,144,254,398
40349,2015-08-20,12,139,316,455
40350,2015-08-20,13,136,288,424
40351,2015-08-20,14,153,224,377
40352,2015-08-20,15,186,331,517
40353,2015-08-20,16,182,536,718
40354,2015-08-20,17,202,1188,1390
40355,2015-08-20,18,167,1087,1254
40356,2015-08-20,19,95,516,611
40357,2015-08-20,20,63,243,306
40358,2015-08-20,21,36,207,243
40359,2015-08-20,22,20,159,179
40360,2015-08-20,23,19,116,135
40361,2015-08-21,0,19,64,83
40362,2015-08-21,1,7,25,32
40363,2015-08-21,2,2,16,18
40364,2015-08-21,3,1,1,2
40365,2015-08-21,4,1,6,7
40366,2015-08-21,5,11,88,99
40367,2015-08-21,6,8,268,276
40368,2015-08-21,7,23,694,717
40369,2015-08-21,8,72,1059,1131
40370,2015-08-21,9,97,549,646
40371,2015-08-21,10,150,265,415
40372,2015-08-21,11,205,325,530
40373,2015-08-21,12,224,444,668
40374,2015-08-21,13,218,434,652
40375,2015-08-21,14,292,436,728
40376,2015-08-21,15,235,506,741
40377,2015-08-21,16,236,796,1032
40378,2015-08-21,17,281,1145,1426
40379,2015-08-21,18,256,914,1170
40380,2015-08-21,19,197,627,824
40381,2015-08-21,20,178,382,560
40382,2015-08-21,21,139,314,453
40383,2015-08-21,22,117,278,395
40384,2015-08-21,23,92,202,294
40385,2015-08-22,0,62,137,199
40386,2015-08-22,1,14,100,114
40387,2015-08-22,2,17,59,76
40388,2015-08-22,3,18,16,34
40389,2015-08-22,4,7,12,19
40390,2015-08-22,5,1,12,13
40391,2015-08-22,6,13,39,52
40392,2015-08-22,7,33,122,155
40393,2015-08-22,8,61,230,291
40394,2015-08-22,9,159,384,543
40395,2015-08-22,10,242,452,694
40396,2015-08-22,11,347,585,932
40397,2015-08-22,12,384,545,929
40398,2015-08-22,13,431,550,981
40399,2015-08-22,14,461,548,1009
40400,2015-08-22,15,521,517,1038
40401,2015-08-22,16,431,526,957
40402,2015-08-22,17,445,548,993
40403,2015-08-22,18,372,475,847
40404,2015-08-22,19,283,431,714
40405,2015-08-22,20,249,342,591
40406,2015-08-22,21,197,306,503
40407,2015-08-22,22,163,235,398
40408,2015-08-22,23,83,173,256
40409,2015-08-23,0,47,136,183
40410,2015-08-23,1,30,99,129
40411,2015-08-23,2,21,76,97
40412,2015-08-23,3,14,38,52
40413,2015-08-23,4,0,6,6
40414,2015-08-23,5,2,17,19
40415,2015-08-23,6,17,32,49
40416,2015-08-23,7,41,82,123
40417,2015-08-23,8,70,191,261
40418,2015-08-23,9,161,346,507
40419,2015-08-23,10,326,464,790
40420,2015-08-23,11,314,539,853
40421,2015-08-23,12,376,529,905
40422,2015-08-23,13,323,487,810
40423,2015-08-23,14,395,492,887
40424,2015-08-23,15,411,531,942
40425,2015-08-23,16,326,575,901
40426,2015-08-23,17,370,539,909
40427,2015-08-23,18,288,534,822
40428,2015-08-23,19,235,419,654
40429,2015-08-23,20,151,319,470
40430,2015-08-23,21,109,208,317
40431,2015-08-23,22,68,137,205
40432,2015-08-23,23,22,64,86
40433,2015-08-24,0,8,24,32
40434,2015-08-24,1,2,11,13
40435,2015-08-24,2,1,7,8
40436,2015-08-24,3,2,3,5
40437,2015-08-24,4,1,6,7
40438,2015-08-24,5,4,91,95
40439,2015-08-24,6,8,275,283
40440,2015-08-24,7,25,822,847
40441,2015-08-24,8,59,1032,1091
40442,2015-08-24,9,96,460,556
40443,2015-08-24,10,156,202,358
40444,2015-08-24,11,177,212,389
40445,2015-08-24,12,127,312,439
40446,2015-08-24,13,157,321,478
40447,2015-08-24,14,175,244,419
40448,2015-08-24,15,168,299,467
40449,2015-08-24,16,182,596,778
40450,2015-08-24,17,227,1272,1499
40451,2015-08-24,18,145,1079,1224
40452,2015-08-24,19,96,461,557
40453,2015-08-24,20,37,162,199
40454,2015-08-24,21,53,214,267
40455,2015-08-24,22,28,139,167
40456,2015-08-24,23,29,75,104
40457,2015-08-25,0,8,25,33
40458,2015-08-25,1,5,5,10
40459,2015-08-25,2,2,6,8
40460,2015-08-25,3,3,1,4
40461,2015-08-25,4,2,8,10
40462,2015-08-25,5,3,89,92
40463,2015-08-25,6,16,363,379
40464,2015-08-25,7,32,953,985
40465,2015-08-25,8,58,1261,1319
40466,2015-08-25,9,94,448,542
40467,2015-08-25,10,102,223,325
40468,2015-08-25,11,135,285,420
40469,2015-08-25,12,122,399,521
40470,2015-08-25,13,128,330,458
40471,2015-08-25,14,155,266,421
40472,2015-08-25,15,157,360,517
40473,2015-08-25,16,198,614,812
40474,2015-08-25,17,215,1387,1602
40475,2015-08-25,18,244,1275,1519
40476,2015-08-25,19,170,819,989
40477,2015-08-25,20,133,531,664
40478,2015-08-25,21,110,398,508
40479,2015-08-25,22,88,303,391
40480,2015-08-25,23,39,103,142
40481,2015-08-26,0,19,48,67
40482,2015-08-26,1,6,20,26
40483,2015-08-26,2,9,6,15
40484,2015-08-26,3,4,6,10
40485,2015-08-26,4,0,14,14
40486,2015-08-26,5,2,109,111
40487,2015-08-26,6,12,393,405
40488,2015-08-26,7,38,927,965
40489,2015-08-26,8,50,1234,1284
40490,2015-08-26,9,69,472,541
40491,2015-08-26,10,97,219,316
40492,2015-08-26,11,136,283,419
40493,2015-08-26,12,135,401,536
40494,2015-08-26,13,142,335,477
40495,2015-08-26,14,146,303,449
40496,2015-08-26,15,159,376,535
40497,2015-08-26,16,157,641,798
40498,2015-08-26,17,185,1340,1525
40499,2015-08-26,18,185,1256,1441
40500,2015-08-26,19,149,778,927
40501,2015-08-26,20,87,491,578
40502,2015-08-26,21,68,318,386
40503,2015-08-26,22,40,302,342
40504,2015-08-26,23,37,124,161
40505,2015-08-27,0,35,39,74
40506,2015-08-27,1,11,17,28
40507,2015-08-27,2,7,9,16
40508,2015-08-27,3,2,10,12
40509,2015-08-27,4,1,14,15
40510,2015-08-27,5,0,72,72
40511,2015-08-27,6,3,343,346
40512,2015-08-27,7,37,886,923
40513,2015-08-27,8,64,1167,1231
40514,2015-08-27,9,55,533,588
40515,2015-08-27,10,78,231,309
40516,2015-08-27,11,111,277,388
40517,2015-08-27,12,129,418,547
40518,2015-08-27,13,147,363,510
40519,2015-08-27,14,153,265,418
40520,2015-08-27,15,176,354,530
40521,2015-08-27,16,137,674,811
40522,2015-08-27,17,183,1367,1550
40523,2015-08-27,18,190,1219,1409
40524,2015-08-27,19,167,798,965
40525,2015-08-27,20,97,511,608
40526,2015-08-27,21,138,344,482
40527,2015-08-27,22,56,315,371
40528,2015-08-27,23,43,158,201
40529,2015-08-28,0,24,62,86
40530,2015-08-28,1,9,27,36
40531,2015-08-28,2,7,24,31
40532,2015-08-28,3,0,4,4
40533,2015-08-28,4,1,9,10
40534,2015-08-28,5,1,75,76
40535,2015-08-28,6,13,276,289
40536,2015-08-28,7,26,751,777
40537,2015-08-28,8,59,1099,1158
40538,2015-08-28,9,67,511,578
40539,2015-08-28,10,113,257,370
40540,2015-08-28,11,166,306,472
40541,2015-08-28,12,227,404,631
40542,2015-08-28,13,202,395,597
40543,2015-08-28,14,243,401,644
40544,2015-08-28,15,191,489,680
40545,2015-08-28,16,170,725,895
40546,2015-08-28,17,227,1181,1408
40547,2015-08-28,18,194,949,1143
40548,2015-08-28,19,170,608,778
40549,2015-08-28,20,86,404,490
40550,2015-08-28,21,90,309,399
40551,2015-08-28,22,78,308,386
40552,2015-08-28,23,75,195,270
40553,2015-08-29,0,36,133,169
40554,2015-08-29,1,19,101,120
40555,2015-08-29,2,20,71,91
40556,2015-08-29,3,9,20,29
40557,2015-08-29,4,3,9,12
40558,2015-08-29,5,8,7,15
40559,2015-08-29,6,8,43,51
40560,2015-08-29,7,16,136,152
40561,2015-08-29,8,68,223,291
40562,2015-08-29,9,166,401,567
40563,2015-08-29,10,237,504,741
40564,2015-08-29,11,321,532,853
40565,2015-08-29,12,361,576,937
40566,2015-08-29,13,371,546,917
40567,2015-08-29,14,422,507,929
40568,2015-08-29,15,438,498,936
40569,2015-08-29,16,404,497,901
40570,2015-08-29,17,373,481,854
40571,2015-08-29,18,342,493,835
40572,2015-08-29,19,288,418,706
40573,2015-08-29,20,172,269,441
40574,2015-08-29,21,151,265,416
40575,2015-08-29,22,113,191,304
40576,2015-08-29,23,80,178,258
40577,2015-08-30,0,34,153,187
40578,2015-08-30,1,22,103,125
40579,2015-08-30,2,14,63,77
40580,2015-08-30,3,7,27,34
40581,2015-08-30,4,5,9,14
40582,2015-08-30,5,1,5,6
40583,2015-08-30,6,13,31,44
40584,2015-08-30,7,33,78,111
40585,2015-08-30,8,66,194,260
40586,2015-08-30,9,143,293,436
40587,2015-08-30,10,221,474,695
40588,2015-08-30,11,270,525,795
40589,2015-08-30,12,354,600,954
40590,2015-08-30,13,310,511,821
40591,2015-08-30,14,354,494,848
40592,2015-08-30,15,381,462,843
40593,2015-08-30,16,320,545,865
40594,2015-08-30,17,244,525,769
40595,2015-08-30,18,253,496,749
40596,2015-08-30,19,157,369,526
40597,2015-08-30,20,131,299,430
40598,2015-08-30,21,88,205,293
40599,2015-08-30,22,58,129,187
40600,2015-08-30,23,31,84,115
40601,2015-08-31,0,22,30,52
40602,2015-08-31,1,13,15,28
40603,2015-08-31,2,11,7,18
40604,2015-08-31,3,7,5,12
40605,2015-08-31,4,1,4,5
40606,2015-08-31,5,2,90,92
40607,2015-08-31,6,8,298,306
40608,2015-08-31,7,29,813,842
40609,2015-08-31,8,52,1026,1078
40610,2015-08-31,9,54,408,462
40611,2015-08-31,10,139,200,339
40612,2015-08-31,11,147,244,391
40613,2015-08-31,12,136,376,512
40614,2015-08-31,13,112,309,421
40615,2015-08-31,14,140,242,382
40616,2015-08-31,15,128,364,492
40617,2015-08-31,16,140,557,697
40618,2015-08-31,17,151,1306,1457
40619,2015-08-31,18,115,1175,1290
40620,2015-08-31,19,119,771,890
40621,2015-08-31,20,85,507,592
40622,2015-08-31,21,64,311,375
40623,2015-08-31,22,29,192,221
40624,2015-08-31,23,12,86,98
40625,2015-09-01,0,11,33,44
40626,2015-09-01,1,2,12,14
40627,2015-09-01,2,5,11,16
40628,2015-09-01,3,2,7,9
40629,2015-09-01,4,1,10,11
40630,2015-09-01,5,4,99,103
40631,2015-09-01,6,13,348,361
40632,2015-09-01,7,27,894,921
40633,2015-09-01,8,43,1202,1245
40634,2015-09-01,9,79,485,564
40635,2015-09-01,10,115,247,362
40636,2015-09-01,11,104,298,402
40637,2015-09-01,12,121,346,467
40638,2015-09-01,13,97,344,441
40639,2015-09-01,14,70,274,344
40640,2015-09-01,15,91,326,417
40641,2015-09-01,16,120,660,780
40642,2015-09-01,17,163,1259,1422
40643,2015-09-01,18,138,1181,1319
40644,2015-09-01,19,94,831,925
40645,2015-09-01,20,84,486,570
40646,2015-09-01,21,56,317,373
40647,2015-09-01,22,37,225,262
40648,2015-09-01,23,26,123,149
40649,2015-09-02,0,29,42,71
40650,2015-09-02,1,7,9,16
40651,2015-09-02,2,2,10,12
40652,2015-09-02,3,0,2,2
40653,2015-09-02,4,3,12,15
40654,2015-09-02,5,2,111,113
40655,2015-09-02,6,6,357,363
40656,2015-09-02,7,19,860,879
40657,2015-09-02,8,61,1192,1253
40658,2015-09-02,9,63,479,542
40659,2015-09-02,10,92,204,296
40660,2015-09-02,11,141,295,436
40661,2015-09-02,12,120,350,470
40662,2015-09-02,13,99,332,431
40663,2015-09-02,14,124,275,399
40664,2015-09-02,15,103,319,422
40665,2015-09-02,16,106,601,707
40666,2015-09-02,17,134,1235,1369
40667,2015-09-02,18,134,1189,1323
40668,2015-09-02,19,117,751,868
40669,2015-09-02,20,64,518,582
40670,2015-09-02,21,53,335,388
40671,2015-09-02,22,35,223,258
40672,2015-09-02,23,31,132,163
40673,2015-09-03,0,15,44,59
40674,2015-09-03,1,4,14,18
40675,2015-09-03,2,0,8,8
40676,2015-09-03,3,1,2,3
40677,2015-09-03,4,1,15,16
40678,2015-09-03,5,3,84,87
40679,2015-09-03,6,9,333,342
40680,2015-09-03,7,19,817,836
40681,2015-09-03,8,37,1170,1207
40682,2015-09-03,9,79,479,558
40683,2015-09-03,10,103,249,352
40684,2015-09-03,11,135,273,408
40685,2015-09-03,12,136,346,482
40686,2015-09-03,13,120,289,409
40687,2015-09-03,14,128,269,397
40688,2015-09-03,15,136,394,530
40689,2015-09-03,16,144,579,723
40690,2015-09-03,17,142,1196,1338
40691,2015-09-03,18,126,1008,1134
40692,2015-09-03,19,111,728,839
40693,2015-09-03,20,67,471,538
40694,2015-09-03,21,86,314,400
40695,2015-09-03,22,46,237,283
40696,2015-09-03,23,22,142,164
40697,2015-09-04,0,8,58,66
40698,2015-09-04,1,12,32,44
40699,2015-09-04,2,1,16,17
40700,2015-09-04,3,2,8,10
40701,2015-09-04,4,1,8,9
40702,2015-09-04,5,2,68,70
40703,2015-09-04,6,8,244,252
40704,2015-09-04,7,33,675,708
40705,2015-09-04,8,40,1015,1055
40706,2015-09-04,9,84,494,578
40707,2015-09-04,10,142,290,432
40708,2015-09-04,11,156,300,456
40709,2015-09-04,12,168,394,562
40710,2015-09-04,13,175,408,583
40711,2015-09-04,14,182,487,669
40712,2015-09-04,15,210,662,872
40713,2015-09-04,16,216,796,1012
40714,2015-09-04,17,158,834,992
40715,2015-09-04,18,161,695,856
40716,2015-09-04,19,111,439,550
40717,2015-09-04,20,76,301,377
40718,2015-09-04,21,112,251,363
40719,2015-09-04,22,70,230,300
40720,2015-09-04,23,57,158,215
40721,2015-09-05,0,27,120,147
40722,2015-09-05,1,17,85,102
40723,2015-09-05,2,17,54,71
40724,2015-09-05,3,3,27,30
40725,2015-09-05,4,2,11,13
40726,2015-09-05,5,3,14,17
40727,2015-09-05,6,7,42,49
40728,2015-09-05,7,19,105,124
40729,2015-09-05,8,51,182,233
40730,2015-09-05,9,144,281,425
40731,2015-09-05,10,237,368,605
40732,2015-09-05,11,319,448,767
40733,2015-09-05,12,409,398,807
40734,2015-09-05,13,459,468,927
40735,2015-09-05,14,552,381,933
40736,2015-09-05,15,504,391,895
40737,2015-09-05,16,492,329,821
40738,2015-09-05,17,453,384,837
40739,2015-09-05,18,462,420,882
40740,2015-09-05,19,344,359,703
40741,2015-09-05,20,244,259,503
40742,2015-09-05,21,201,194,395
40743,2015-09-05,22,142,154,296
40744,2015-09-05,23,151,133,284
40745,2015-09-06,0,83,89,172
40746,2015-09-06,1,48,80,128
40747,2015-09-06,2,26,41,67
40748,2015-09-06,3,8,20,28
40749,2015-09-06,4,9,7,16
40750,2015-09-06,5,1,16,17
40751,2015-09-06,6,15,20,35
40752,2015-09-06,7,40,51,91
40753,2015-09-06,8,69,155,224
40754,2015-09-06,9,256,292,548
40755,2015-09-06,10,446,379,825
40756,2015-09-06,11,518,420,938
40757,2015-09-06,12,560,455,1015
40758,2015-09-06,13,596,396,992
40759,2015-09-06,14,614,382,996
40760,2015-09-06,15,596,352,948
40761,2015-09-06,16,634,416,1050
40762,2015-09-06,17,564,422,986
40763,2015-09-06,18,530,382,912
40764,2015-09-06,19,420,339,759
40765,2015-09-06,20,329,226,555
40766,2015-09-06,21,279,186,465
40767,2015-09-06,22,209,174,383
40768,2015-09-06,23,115,129,244
40769,2015-09-07,0,79,71,150
40770,2015-09-07,1,42,67,109
40771,2015-09-07,2,14,47,61
40772,2015-09-07,3,6,16,22
40773,2015-09-07,4,1,10,11
40774,2015-09-07,5,3,15,18
40775,2015-09-07,6,14,31,45
40776,2015-09-07,7,40,92,132
40777,2015-09-07,8,127,171,298
40778,2015-09-07,9,197,313,510
40779,2015-09-07,10,381,394,775
40780,2015-09-07,11,442,497,939
40781,2015-09-07,12,457,495,952
40782,2015-09-07,13,391,454,845
40783,2015-09-07,14,319,443,762
40784,2015-09-07,15,352,444,796
40785,2015-09-07,16,348,514,862
40786,2015-09-07,17,296,446,742
40787,2015-09-07,18,267,447,714
40788,2015-09-07,19,203,384,587
40789,2015-09-07,20,134,250,384
40790,2015-09-07,21,93,210,303
40791,2015-09-07,22,72,142,214
40792,2015-09-07,23,16,102,118
40793,2015-09-08,0,5,33,38
40794,2015-09-08,1,6,7,13
40795,2015-09-08,2,0,6,6
40796,2015-09-08,3,1,0,1
40797,2015-09-08,4,2,10,12
40798,2015-09-08,5,2,87,89
40799,2015-09-08,6,8,328,336
40800,2015-09-08,7,23,895,918
40801,2015-09-08,8,51,1073,1124
40802,2015-09-08,9,69,420,489
40803,2015-09-08,10,92,200,292
40804,2015-09-08,11,116,208,324
40805,2015-09-08,12,100,332,432
40806,2015-09-08,13,129,290,419
40807,2015-09-08,14,96,292,388
40808,2015-09-08,15,95,338,433
40809,2015-09-08,16,113,622,735
40810,2015-09-08,17,121,1298,1419
40811,2015-09-08,18,104,1182,1286
40812,2015-09-08,19,76,761,837
40813,2015-09-08,20,55,487,542
40814,2015-09-08,21,42,326,368
40815,2015-09-08,22,49,264,313
40816,2015-09-08,23,26,124,150
40817,2015-09-09,0,12,36,48
40818,2015-09-09,1,6,14,20
40819,2015-09-09,2,2,6,8
40820,2015-09-09,3,3,2,5
40821,2015-09-09,4,0,14,14
40822,2015-09-09,5,3,112,115
40823,2015-09-09,6,8,383,391
40824,2015-09-09,7,25,945,970
40825,2015-09-09,8,47,1145,1192
40826,2015-09-09,9,79,524,603
40827,2015-09-09,10,82,204,286
40828,2015-09-09,11,68,217,285
40829,2015-09-09,12,82,302,384
40830,2015-09-09,13,101,292,393
40831,2015-09-09,14,107,267,374
40832,2015-09-09,15,89,324,413
40833,2015-09-09,16,135,582,717
40834,2015-09-09,17,137,1249,1386
40835,2015-09-09,18,122,1163,1285
40836,2015-09-09,19,81,738,819
40837,2015-09-09,20,40,451,491
40838,2015-09-09,21,48,351,399
40839,2015-09-09,22,51,276,327
40840,2015-09-09,23,23,116,139
40841,2015-09-10,0,3,48,51
40842,2015-09-10,1,2,13,15
40843,2015-09-10,2,1,4,5
40844,2015-09-10,3,1,1,2
40845,2015-09-10,4,1,1,2
40846,2015-09-10,5,2,64,66
40847,2015-09-10,6,10,303,313
40848,2015-09-10,7,26,864,890
40849,2015-09-10,8,40,1114,1154
40850,2015-09-10,9,50,458,508
40851,2015-09-10,10,59,232,291
40852,2015-09-10,11,66,248,314
40853,2015-09-10,12,85,293,378
40854,2015-09-10,13,85,297,382
40855,2015-09-10,14,76,210,286
40856,2015-09-10,15,70,296,366
40857,2015-09-10,16,84,579,663
40858,2015-09-10,17,118,1172,1290
40859,2015-09-10,18,94,1135,1229
40860,2015-09-10,19,72,703,775
40861,2015-09-10,20,48,495,543
40862,2015-09-10,21,51,342,393
40863,2015-09-10,22,16,233,249
40864,2015-09-10,23,18,173,191
40865,2015-09-11,0,10,56,66
40866,2015-09-11,1,11,25,36
40867,2015-09-11,2,2,12,14
40868,2015-09-11,3,0,4,4
40869,2015-09-11,4,1,10,11
40870,2015-09-11,5,0,83,83
40871,2015-09-11,6,6,294,300
40872,2015-09-11,7,17,853,870
40873,2015-09-11,8,58,1136,1194
40874,2015-09-11,9,65,504,569
40875,2015-09-11,10,118,284,402
40876,2015-09-11,11,156,323,479
40877,2015-09-11,12,161,444,605
40878,2015-09-11,13,172,385,557
40879,2015-09-11,14,179,321,500
40880,2015-09-11,15,171,450,621
40881,2015-09-11,16,175,703,878
40882,2015-09-11,17,169,1270,1439
40883,2015-09-11,18,155,1066,1221
40884,2015-09-11,19,164,720,884
40885,2015-09-11,20,97,434,531
40886,2015-09-11,21,69,284,353
40887,2015-09-11,22,75,241,316
40888,2015-09-11,23,53,179,232
40889,2015-09-12,0,37,117,154
40890,2015-09-12,1,32,85,117
40891,2015-09-12,2,14,61,75
40892,2015-09-12,3,5,32,37
40893,2015-09-12,4,2,6,8
40894,2015-09-12,5,4,8,12
40895,2015-09-12,6,13,45,58
40896,2015-09-12,7,15,111,126
40897,2015-09-12,8,8,146,154
40898,2015-09-12,9,31,178,209
40899,2015-09-12,10,32,232,264
40900,2015-09-12,11,74,333,407
40901,2015-09-12,12,80,347,427
40902,2015-09-12,13,48,186,234
40903,2015-09-12,14,85,337,422
40904,2015-09-12,15,110,389,499
40905,2015-09-12,16,122,375,497
40906,2015-09-12,17,148,502,650
40907,2015-09-12,18,135,449,584
40908,2015-09-12,19,130,388,518
40909,2015-09-12,20,104,305,409
40910,2015-09-12,21,69,244,313
40911,2015-09-12,22,75,211,286
40912,2015-09-12,23,43,161,204
40913,2015-09-13,0,31,138,169
40914,2015-09-13,1,28,92,120
40915,2015-09-13,2,36,68,104
40916,2015-09-13,3,13,35,48
40917,2015-09-13,4,5,15,20
40918,2015-09-13,5,15,31,46
40919,2015-09-13,6,9,42,51
40920,2015-09-13,7,15,93,108
40921,2015-09-13,8,38,185,223
40922,2015-09-13,9,124,318,442
40923,2015-09-13,10,164,481,645
40924,2015-09-13,11,252,535,787
40925,2015-09-13,12,265,669,934
40926,2015-09-13,13,275,602,877
40927,2015-09-13,14,296,565,861
40928,2015-09-13,15,338,519,857
40929,2015-09-13,16,339,639,978
40930,2015-09-13,17,260,572,832
40931,2015-09-13,18,265,559,824
40932,2015-09-13,19,142,430,572
40933,2015-09-13,20,97,314,411
40934,2015-09-13,21,54,181,235
40935,2015-09-13,22,40,131,171
40936,2015-09-13,23,23,56,79
40937,2015-09-14,0,10,36,46
40938,2015-09-14,1,2,15,17
40939,2015-09-14,2,1,7,8
40940,2015-09-14,3,2,3,5
40941,2015-09-14,4,1,11,12
40942,2015-09-14,5,2,82,84
40943,2015-09-14,6,12,303,315
40944,2015-09-14,7,9,858,867
40945,2015-09-14,8,38,1036,1074
40946,2015-09-14,9,60,448,508
40947,2015-09-14,10,79,206,285
40948,2015-09-14,11,117,249,366
40949,2015-09-14,12,108,328,436
40950,2015-09-14,13,151,310,461
40951,2015-09-14,14,143,332,475
40952,2015-09-14,15,136,362,498
40953,2015-09-14,16,131,656,787
40954,2015-09-14,17,172,1341,1513
40955,2015-09-14,18,161,1250,1411
40956,2015-09-14,19,98,761,859
40957,2015-09-14,20,47,408,455
40958,2015-09-14,21,62,294,356
40959,2015-09-14,22,33,175,208
40960,2015-09-14,23,16,93,109
40961,2015-09-15,0,5,33,38
40962,2015-09-15,1,9,6,15
40963,2015-09-15,2,3,2,5
40964,2015-09-15,3,4,1,5
40965,2015-09-15,4,0,15,15
40966,2015-09-15,5,1,83,84
40967,2015-09-15,6,9,362,371
40968,2015-09-15,7,29,961,990
40969,2015-09-15,8,40,1239,1279
40970,2015-09-15,9,58,455,513
40971,2015-09-15,10,45,240,285
40972,2015-09-15,11,120,256,376
40973,2015-09-15,12,97,374,471
40974,2015-09-15,13,103,354,457
40975,2015-09-15,14,92,302,394
40976,2015-09-15,15,94,367,461
40977,2015-09-15,16,150,676,826
40978,2015-09-15,17,178,1324,1502
40979,2015-09-15,18,150,1318,1468
40980,2015-09-15,19,120,812,932
40981,2015-09-15,20,99,504,603
40982,2015-09-15,21,67,372,439
40983,2015-09-15,22,41,224,265
40984,2015-09-15,23,25,123,148
40985,2015-09-16,0,9,56,65
40986,2015-09-16,1,7,15,22
40987,2015-09-16,2,0,4,4
40988,2015-09-16,3,2,4,6
40989,2015-09-16,4,3,10,13
40990,2015-09-16,5,4,111,115
40991,2015-09-16,6,17,385,402
40992,2015-09-16,7,26,954,980
40993,2015-09-16,8,42,1222,1264
40994,2015-09-16,9,42,486,528
40995,2015-09-16,10,78,243,321
40996,2015-09-16,11,114,293,407
40997,2015-09-16,12,126,343,469
40998,2015-09-16,13,103,341,444
40999,2015-09-16,14,112,296,408
41000,2015-09-16,15,106,394,500
41001,2015-09-16,16,132,683,815
41002,2015-09-16,17,183,1318,1501
41003,2015-09-16,18,122,1266,1388
41004,2015-09-16,19,116,836,952
41005,2015-09-16,20,60,484,544
41006,2015-09-16,21,34,340,374
41007,2015-09-16,22,28,211,239
41008,2015-09-16,23,19,158,177
41009,2015-09-17,0,9,55,64
41010,2015-09-17,1,7,25,32
41011,2015-09-17,2,5,10,15
41012,2015-09-17,3,1,3,4
41013,2015-09-17,4,0,9,9
41014,2015-09-17,5,3,88,91
41015,2015-09-17,6,8,327,335
41016,2015-09-17,7,30,881,911
41017,2015-09-17,8,47,1228,1275
41018,2015-09-17,9,50,499,549
41019,2015-09-17,10,85,251,336
41020,2015-09-17,11,102,270,372
41021,2015-09-17,12,102,369,471
41022,2015-09-17,13,123,363,486
41023,2015-09-17,14,116,305,421
41024,2015-09-17,15,139,389,528
41025,2015-09-17,16,164,643,807
41026,2015-09-17,17,139,1341,1480
41027,2015-09-17,18,152,1224,1376
41028,2015-09-17,19,84,793,877
41029,2015-09-17,20,75,510,585
41030,2015-09-17,21,53,363,416
41031,2015-09-17,22,44,288,332
41032,2015-09-17,23,23,154,177
41033,2015-09-18,0,11,52,63
41034,2015-09-18,1,6,34,40
41035,2015-09-18,2,3,17,20
41036,2015-09-18,3,2,5,7
41037,2015-09-18,4,0,8,8
41038,2015-09-18,5,2,88,90
41039,2015-09-18,6,6,289,295
41040,2015-09-18,7,21,756,777
41041,2015-09-18,8,50,1214,1264
41042,2015-09-18,9,56,492,548
41043,2015-09-18,10,113,298,411
41044,2015-09-18,11,114,326,440
41045,2015-09-18,12,153,415,568
41046,2015-09-18,13,130,413,543
41047,2015-09-18,14,157,399,556
41048,2015-09-18,15,141,469,610
41049,2015-09-18,16,148,759,907
41050,2015-09-18,17,171,1249,1420
41051,2015-09-18,18,126,1025,1151
41052,2015-09-18,19,130,641,771
41053,2015-09-18,20,88,407,495
41054,2015-09-18,21,57,320,377
41055,2015-09-18,22,76,300,376
41056,2015-09-18,23,46,171,217
41057,2015-09-19,0,48,161,209
41058,2015-09-19,1,11,119,130
41059,2015-09-19,2,13,75,88
41060,2015-09-19,3,6,18,24
41061,2015-09-19,4,4,14,18
41062,2015-09-19,5,6,16,22
41063,2015-09-19,6,11,27,38
41064,2015-09-19,7,25,123,148
41065,2015-09-19,8,54,259,313
41066,2015-09-19,9,145,403,548
41067,2015-09-19,10,237,495,732
41068,2015-09-19,11,267,560,827
41069,2015-09-19,12,339,572,911
41070,2015-09-19,13,304,572,876
41071,2015-09-19,14,331,523,854
41072,2015-09-19,15,369,558,927
41073,2015-09-19,16,310,524,834
41074,2015-09-19,17,372,496,868
41075,2015-09-19,18,332,562,894
41076,2015-09-19,19,276,500,776
41077,2015-09-19,20,164,300,464
41078,2015-09-19,21,143,301,444
41079,2015-09-19,22,104,234,338
41080,2015-09-19,23,98,196,294
41081,2015-09-20,0,54,150,204
41082,2015-09-20,1,30,97,127
41083,2015-09-20,2,14,86,100
41084,2015-09-20,3,11,47,58
41085,2015-09-20,4,3,19,22
41086,2015-09-20,5,6,19,25
41087,2015-09-20,6,19,88,107
41088,2015-09-20,7,39,109,148
41089,2015-09-20,8,91,227,318
41090,2015-09-20,9,164,330,494
41091,2015-09-20,10,225,473,698
41092,2015-09-20,11,292,528,820
41093,2015-09-20,12,327,690,1017
41094,2015-09-20,13,342,543,885
41095,2015-09-20,14,335,541,876
41096,2015-09-20,15,333,566,899
41097,2015-09-20,16,334,663,997
41098,2015-09-20,17,274,516,790
41099,2015-09-20,18,235,524,759
41100,2015-09-20,19,176,470,646
41101,2015-09-20,20,143,298,441
41102,2015-09-20,21,71,193,264
41103,2015-09-20,22,57,139,196
41104,2015-09-20,23,27,75,102
41105,2015-09-21,0,22,35,57
41106,2015-09-21,1,1,10,11
41107,2015-09-21,2,1,12,13
41108,2015-09-21,3,0,2,2
41109,2015-09-21,4,2,8,10
41110,2015-09-21,5,4,89,93
41111,2015-09-21,6,14,308,322
41112,2015-09-21,7,20,914,934
41113,2015-09-21,8,62,1060,1122
41114,2015-09-21,9,100,459,559
41115,2015-09-21,10,97,205,302
41116,2015-09-21,11,137,221,358
41117,2015-09-21,12,160,310,470
41118,2015-09-21,13,133,288,421
41119,2015-09-21,14,150,227,377
41120,2015-09-21,15,139,359,498
41121,2015-09-21,16,128,466,594
41122,2015-09-21,17,60,446,506
41123,2015-09-21,18,20,351,371
41124,2015-09-21,19,14,255,269
41125,2015-09-21,20,18,155,173
41126,2015-09-21,21,13,189,202
41127,2015-09-21,22,10,89,99
41128,2015-09-21,23,9,44,53
41129,2015-09-22,0,4,30,34
41130,2015-09-22,1,4,15,19
41131,2015-09-22,2,2,9,11
41132,2015-09-22,3,1,2,3
41133,2015-09-22,4,1,6,7
41134,2015-09-22,5,4,81,85
41135,2015-09-22,6,8,316,324
41136,2015-09-22,7,30,904,934
41137,2015-09-22,8,51,1089,1140
41138,2015-09-22,9,52,407,459
41139,2015-09-22,10,96,224,320
41140,2015-09-22,11,94,253,347
41141,2015-09-22,12,137,341,478
41142,2015-09-22,13,109,352,461
41143,2015-09-22,14,115,312,427
41144,2015-09-22,15,143,393,536
41145,2015-09-22,16,190,688,878
41146,2015-09-22,17,214,1325,1539
41147,2015-09-22,18,177,1272,1449
41148,2015-09-22,19,149,861,1010
41149,2015-09-22,20,75,489,564
41150,2015-09-22,21,65,419,484
41151,2015-09-22,22,35,266,301
41152,2015-09-22,23,27,114,141
41153,2015-09-23,0,25,56,81
41154,2015-09-23,1,4,14,18
41155,2015-09-23,2,2,10,12
41156,2015-09-23,3,12,14,26
41157,2015-09-23,4,7,31,38
41158,2015-09-23,5,15,147,162
41159,2015-09-23,6,30,340,370
41160,2015-09-23,7,58,767,825
41161,2015-09-23,8,74,900,974
41162,2015-09-23,9,75,519,594
41163,2015-09-23,10,130,337,467
41164,2015-09-23,11,140,399,539
41165,2015-09-23,12,220,495,715
41166,2015-09-23,13,188,454,642
41167,2015-09-23,14,195,386,581
41168,2015-09-23,15,185,456,641
41169,2015-09-23,16,186,715,901
41170,2015-09-23,17,238,1127,1365
41171,2015-09-23,18,199,1128,1327
41172,2015-09-23,19,130,807,937
41173,2015-09-23,20,87,501,588
41174,2015-09-23,21,61,386,447
41175,2015-09-23,22,60,294,354
41176,2015-09-23,23,17,151,168
41177,2015-09-24,0,5,52,57
41178,2015-09-24,1,8,17,25
41179,2015-09-24,2,1,5,6
41180,2015-09-24,3,6,11,17
41181,2015-09-24,4,13,20,33
41182,2015-09-24,5,11,105,116
41183,2015-09-24,6,29,316,345
41184,2015-09-24,7,43,799,842
41185,2015-09-24,8,65,957,1022
41186,2015-09-24,9,99,441,540
41187,2015-09-24,10,164,277,441
41188,2015-09-24,11,182,378,560
41189,2015-09-24,12,231,441,672
41190,2015-09-24,13,190,436,626
41191,2015-09-24,14,176,379,555
41192,2015-09-24,15,196,439,635
41193,2015-09-24,16,201,605,806
41194,2015-09-24,17,188,1166,1354
41195,2015-09-24,18,185,1193,1378
41196,2015-09-24,19,127,835,962
41197,2015-09-24,20,57,509,566
41198,2015-09-24,21,79,360,439
41199,2015-09-24,22,50,258,308
41200,2015-09-24,23,13,193,206
41201,2015-09-25,0,15,75,90
41202,2015-09-25,1,2,35,37
41203,2015-09-25,2,5,17,22
41204,2015-09-25,3,0,7,7
41205,2015-09-25,4,3,6,9
41206,2015-09-25,5,2,81,83
41207,2015-09-25,6,10,302,312
41208,2015-09-25,7,26,798,824
41209,2015-09-25,8,63,1190,1253
41210,2015-09-25,9,72,527,599
41211,2015-09-25,10,111,267,378
41212,2015-09-25,11,129,337,466
41213,2015-09-25,12,164,418,582
41214,2015-09-25,13,151,389,540
41215,2015-09-25,14,188,384,572
41216,2015-09-25,15,163,456,619
41217,2015-09-25,16,145,574,719
41218,2015-09-25,17,165,1167,1332
41219,2015-09-25,18,144,890,1034
41220,2015-09-25,19,73,581,654
41221,2015-09-25,20,64,387,451
41222,2015-09-25,21,69,304,373
41223,2015-09-25,22,33,210,243
41224,2015-09-25,23,17,187,204
41225,2015-09-26,0,17,141,158
41226,2015-09-26,1,17,100,117
41227,2015-09-26,2,4,62,66
41228,2015-09-26,3,1,21,22
41229,2015-09-26,4,5,9,14
41230,2015-09-26,5,1,9,10
41231,2015-09-26,6,6,46,52
41232,2015-09-26,7,15,123,138
41233,2015-09-26,8,50,281,331
41234,2015-09-26,9,105,446,551
41235,2015-09-26,10,189,505,694
41236,2015-09-26,11,291,632,923
41237,2015-09-26,12,293,614,907
41238,2015-09-26,13,416,591,1007
41239,2015-09-26,14,422,629,1051
41240,2015-09-26,15,357,627,984
41241,2015-09-26,16,324,508,832
41242,2015-09-26,17,355,548,903
41243,2015-09-26,18,223,414,637
41244,2015-09-26,19,150,336,486
41245,2015-09-26,20,94,217,311
41246,2015-09-26,21,53,211,264
41247,2015-09-26,22,64,259,323
41248,2015-09-26,23,55,198,253
41249,2015-09-27,0,39,150,189
41250,2015-09-27,1,23,108,131
41251,2015-09-27,2,15,71,86
41252,2015-09-27,3,8,42,50
41253,2015-09-27,4,2,8,10
41254,2015-09-27,5,7,11,18
41255,2015-09-27,6,7,18,25
41256,2015-09-27,7,10,61,71
41257,2015-09-27,8,42,166,208
41258,2015-09-27,9,119,304,423
41259,2015-09-27,10,198,434,632
41260,2015-09-27,11,255,553,808
41261,2015-09-27,12,342,633,975
41262,2015-09-27,13,340,625,965
41263,2015-09-27,14,256,548,804
41264,2015-09-27,15,303,550,853
41265,2015-09-27,16,207,566,773
41266,2015-09-27,17,200,484,684
41267,2015-09-27,18,165,517,682
41268,2015-09-27,19,115,387,502
41269,2015-09-27,20,76,287,363
41270,2015-09-27,21,79,228,307
41271,2015-09-27,22,58,242,300
41272,2015-09-27,23,25,94,119
41273,2015-09-28,0,8,31,39
41274,2015-09-28,1,3,10,13
41275,2015-09-28,2,0,8,8
41276,2015-09-28,3,4,2,6
41277,2015-09-28,4,3,4,7
41278,2015-09-28,5,2,84,86
41279,2015-09-28,6,5,288,293
41280,2015-09-28,7,23,811,834
41281,2015-09-28,8,39,1184,1223
41282,2015-09-28,9,67,474,541
41283,2015-09-28,10,107,194,301
41284,2015-09-28,11,100,282,382
41285,2015-09-28,12,101,362,463
41286,2015-09-28,13,150,325,475
41287,2015-09-28,14,127,334,461
41288,2015-09-28,15,127,370,497
41289,2015-09-28,16,155,644,799
41290,2015-09-28,17,178,1329,1507
41291,2015-09-28,18,138,1174,1312
41292,2015-09-28,19,96,736,832
41293,2015-09-28,20,34,428,462
41294,2015-09-28,21,53,349,402
41295,2015-09-28,22,34,212,246
41296,2015-09-28,23,15,101,116
41297,2015-09-29,0,10,32,42
41298,2015-09-29,1,5,11,16
41299,2015-09-29,2,1,7,8
41300,2015-09-29,3,0,8,8
41301,2015-09-29,4,2,6,8
41302,2015-09-29,5,3,99,102
41303,2015-09-29,6,4,341,345
41304,2015-09-29,7,29,974,1003
41305,2015-09-29,8,43,1233,1276
41306,2015-09-29,9,60,498,558
41307,2015-09-29,10,78,219,297
41308,2015-09-29,11,123,244,367
41309,2015-09-29,12,113,333,446
41310,2015-09-29,13,110,291,401
41311,2015-09-29,14,108,277,385
41312,2015-09-29,15,92,282,374
41313,2015-09-29,16,61,485,546
41314,2015-09-29,17,46,394,440
41315,2015-09-29,18,20,218,238
41316,2015-09-29,19,10,129,139
41317,2015-09-29,20,6,62,68
41318,2015-09-29,21,1,47,48
41319,2015-09-29,22,2,50,52
41320,2015-09-29,23,2,70,72
41321,2015-09-30,0,5,23,28
41322,2015-09-30,1,2,15,17
41323,2015-09-30,2,0,7,7
41324,2015-09-30,3,0,5,5
41325,2015-09-30,4,0,9,9
41326,2015-09-30,5,2,91,93
41327,2015-09-30,6,16,290,306
41328,2015-09-30,7,16,695,711
41329,2015-09-30,8,29,1099,1128
41330,2015-09-30,9,52,431,483
41331,2015-09-30,10,38,189,227
41332,2015-09-30,11,61,175,236
41333,2015-09-30,12,85,285,370
41334,2015-09-30,13,58,269,327
41335,2015-09-30,14,66,243,309
41336,2015-09-30,15,103,367,470
41337,2015-09-30,16,92,579,671
41338,2015-09-30,17,124,1177,1301
41339,2015-09-30,18,106,1174,1280
41340,2015-09-30,19,69,746,815
41341,2015-09-30,20,51,517,568
41342,2015-09-30,21,36,389,425
41343,2015-09-30,22,19,233,252
41344,2015-09-30,23,17,129,146
41345,2015-10-01,0,7,49,56
41346,2015-10-01,1,1,17,18
41347,2015-10-01,2,1,4,5
41348,2015-10-01,3,0,1,1
41349,2015-10-01,4,1,8,9
41350,2015-10-01,5,0,71,71
41351,2015-10-01,6,7,236,243
41352,2015-10-01,7,8,351,359
41353,2015-10-01,8,8,468,476
41354,2015-10-01,9,17,211,228
41355,2015-10-01,10,5,52,57
41356,2015-10-01,11,8,58,66
41357,2015-10-01,12,2,70,72
41358,2015-10-01,13,3,56,59
41359,2015-10-01,14,7,67,74
41360,2015-10-01,15,13,107,120
41361,2015-10-01,16,13,202,215
41362,2015-10-01,17,18,602,620
41363,2015-10-01,18,21,695,716
41364,2015-10-01,19,18,438,456
41365,2015-10-01,20,28,324,352
41366,2015-10-01,21,15,243,258
41367,2015-10-01,22,19,159,178
41368,2015-10-01,23,4,86,90
41369,2015-10-02,0,4,41,45
41370,2015-10-02,1,4,26,30
41371,2015-10-02,2,0,4,4
41372,2015-10-02,3,0,7,7
41373,2015-10-02,4,0,2,2
41374,2015-10-02,5,0,24,24
41375,2015-10-02,6,0,67,67
41376,2015-10-02,7,1,120,121
41377,2015-10-02,8,8,236,244
41378,2015-10-02,9,1,162,163
41379,2015-10-02,10,3,78,81
41380,2015-10-02,11,10,63,73
41381,2015-10-02,12,3,52,55
41382,2015-10-02,13,9,59,68
41383,2015-10-02,14,3,43,46
41384,2015-10-02,15,3,82,85
41385,2015-10-02,16,8,110,118
41386,2015-10-02,17,10,234,244
41387,2015-10-02,18,10,187,197
41388,2015-10-02,19,11,144,155
41389,2015-10-02,20,8,57,65
41390,2015-10-02,21,4,68,72
41391,2015-10-02,22,3,57,60
41392,2015-10-02,23,1,52,53
41393,2015-10-03,0,1,29,30
41394,2015-10-03,1,0,33,33
41395,2015-10-03,2,2,16,18
41396,2015-10-03,3,0,5,5
41397,2015-10-03,4,0,6,6
41398,2015-10-03,5,2,4,6
41399,2015-10-03,6,3,12,15
41400,2015-10-03,7,4,35,39
41401,2015-10-03,8,11,76,87
41402,2015-10-03,9,23,175,198
41403,2015-10-03,10,35,242,277
41404,2015-10-03,11,27,284,311
41405,2015-10-03,12,55,288,343
41406,2015-10-03,13,72,303,375
41407,2015-10-03,14,80,315,395
41408,2015-10-03,15,83,359,442
41409,2015-10-03,16,74,304,378
41410,2015-10-03,17,51,252,303
41411,2015-10-03,18,28,170,198
41412,2015-10-03,19,15,164,179
41413,2015-10-03,20,13,96,109
41414,2015-10-03,21,7,104,111
41415,2015-10-03,22,11,99,110
41416,2015-10-03,23,1,81,82
41417,2015-10-04,0,7,105,112
41418,2015-10-04,1,7,65,72
41419,2015-10-04,2,7,44,51
41420,2015-10-04,3,1,30,31
41421,2015-10-04,4,1,9,10
41422,2015-10-04,5,1,8,9
41423,2015-10-04,6,3,12,15
41424,2015-10-04,7,19,56,75
41425,2015-10-04,8,34,117,151
41426,2015-10-04,9,23,194,217
41427,2015-10-04,10,53,319,372
41428,2015-10-04,11,92,389,481
41429,2015-10-04,12,117,449,566
41430,2015-10-04,13,130,463,593
41431,2015-10-04,14,153,462,615
41432,2015-10-04,15,144,454,598
41433,2015-10-04,16,156,464,620
41434,2015-10-04,17,113,389,502
41435,2015-10-04,18,101,417,518
41436,2015-10-04,19,49,333,382
41437,2015-10-04,20,42,213,255
41438,2015-10-04,21,22,144,166
41439,2015-10-04,22,24,109,133
41440,2015-10-04,23,12,68,80
41441,2015-10-05,0,3,17,20
41442,2015-10-05,1,5,9,14
41443,2015-10-05,2,4,8,12
41444,2015-10-05,3,0,2,2
41445,2015-10-05,4,1,10,11
41446,2015-10-05,5,1,83,84
41447,2015-10-05,6,6,243,249
41448,2015-10-05,7,14,780,794
41449,2015-10-05,8,34,1147,1181
41450,2015-10-05,9,42,443,485
41451,2015-10-05,10,84,210,294
41452,2015-10-05,11,118,249,367
41453,2015-10-05,12,98,327,425
41454,2015-10-05,13,115,347,462
41455,2015-10-05,14,128,263,391
41456,2015-10-05,15,110,341,451
41457,2015-10-05,16,133,642,775
41458,2015-10-05,17,137,1304,1441
41459,2015-10-05,18,81,1180,1261
41460,2015-10-05,19,47,703,750
41461,2015-10-05,20,31,407,438
41462,2015-10-05,21,16,260,276
41463,2015-10-05,22,15,152,167
41464,2015-10-05,23,11,84,95
41465,2015-10-06,0,3,40,43
41466,2015-10-06,1,1,10,11
41467,2015-10-06,2,0,6,6
41468,2015-10-06,3,0,2,2
41469,2015-10-06,4,2,7,9
41470,2015-10-06,5,1,86,87
41471,2015-10-06,6,11,307,318
41472,2015-10-06,7,20,825,845
41473,2015-10-06,8,43,1256,1299
41474,2015-10-06,9,43,509,552
41475,2015-10-06,10,61,261,322
41476,2015-10-06,11,72,281,353
41477,2015-10-06,12,97,357,454
41478,2015-10-06,13,91,364,455
41479,2015-10-06,14,100,312,412
41480,2015-10-06,15,99,381,480
41481,2015-10-06,16,112,717,829
41482,2015-10-06,17,187,1401,1588
41483,2015-10-06,18,130,1269,1399
41484,2015-10-06,19,69,770,839
41485,2015-10-06,20,20,506,526
41486,2015-10-06,21,13,339,352
41487,2015-10-06,22,15,228,243
41488,2015-10-06,23,13,113,126
41489,2015-10-07,0,15,50,65
41490,2015-10-07,1,2,19,21
41491,2015-10-07,2,0,10,10
41492,2015-10-07,3,0,4,4
41493,2015-10-07,4,0,12,12
41494,2015-10-07,5,2,101,103
41495,2015-10-07,6,3,370,373
41496,2015-10-07,7,27,914,941
41497,2015-10-07,8,34,1252,1286
41498,2015-10-07,9,30,516,546
41499,2015-10-07,10,61,255,316
41500,2015-10-07,11,74,284,358
41501,2015-10-07,12,92,377,469
41502,2015-10-07,13,93,388,481
41503,2015-10-07,14,83,286,369
41504,2015-10-07,15,87,379,466
41505,2015-10-07,16,104,727,831
41506,2015-10-07,17,131,1375,1506
41507,2015-10-07,18,113,1235,1348
41508,2015-10-07,19,104,763,867
41509,2015-10-07,20,60,512,572
41510,2015-10-07,21,40,338,378
41511,2015-10-07,22,12,247,259
41512,2015-10-07,23,14,139,153
41513,2015-10-08,0,4,45,49
41514,2015-10-08,1,2,17,19
41515,2015-10-08,2,4,9,13
41516,2015-10-08,3,0,6,6
41517,2015-10-08,4,0,4,4
41518,2015-10-08,5,4,77,81
41519,2015-10-08,6,6,274,280
41520,2015-10-08,7,20,852,872
41521,2015-10-08,8,48,1223,1271
41522,2015-10-08,9,45,500,545
41523,2015-10-08,10,94,249,343
41524,2015-10-08,11,125,289,414
41525,2015-10-08,12,115,400,515
41526,2015-10-08,13,129,361,490
41527,2015-10-08,14,133,303,436
41528,2015-10-08,15,112,382,494
41529,2015-10-08,16,132,619,751
41530,2015-10-08,17,173,1282,1455
41531,2015-10-08,18,94,1340,1434
41532,2015-10-08,19,77,698,775
41533,2015-10-08,20,47,521,568
41534,2015-10-08,21,61,363,424
41535,2015-10-08,22,27,254,281
41536,2015-10-08,23,22,169,191
41537,2015-10-09,0,18,97,115
41538,2015-10-09,1,9,44,53
41539,2015-10-09,2,0,17,17
41540,2015-10-09,3,0,10,10
41541,2015-10-09,4,3,1,4
41542,2015-10-09,5,1,73,74
41543,2015-10-09,6,8,223,231
41544,2015-10-09,7,16,712,728
41545,2015-10-09,8,37,1095,1132
41546,2015-10-09,9,63,549,612
41547,2015-10-09,10,110,305,415
41548,2015-10-09,11,130,322,452
41549,2015-10-09,12,185,461,646
41550,2015-10-09,13,150,380,530
41551,2015-10-09,14,149,380,529
41552,2015-10-09,15,200,494,694
41553,2015-10-09,16,222,693,915
41554,2015-10-09,17,210,1112,1322
41555,2015-10-09,18,92,575,667
41556,2015-10-09,19,68,294,362
41557,2015-10-09,20,43,263,306
41558,2015-10-09,21,55,222,277
41559,2015-10-09,22,22,202,224
41560,2015-10-09,23,38,148,186
41561,2015-10-10,0,17,96,113
41562,2015-10-10,1,13,79,92
41563,2015-10-10,2,15,69,84
41564,2015-10-10,3,11,20,31
41565,2015-10-10,4,2,7,9
41566,2015-10-10,5,1,15,16
41567,2015-10-10,6,6,39,45
41568,2015-10-10,7,26,83,109
41569,2015-10-10,8,62,195,257
41570,2015-10-10,9,119,336,455
41571,2015-10-10,10,203,435,638
41572,2015-10-10,11,281,514,795
41573,2015-10-10,12,324,539,863
41574,2015-10-10,13,350,490,840
41575,2015-10-10,14,404,506,910
41576,2015-10-10,15,417,510,927
41577,2015-10-10,16,465,519,984
41578,2015-10-10,17,384,497,881
41579,2015-10-10,18,267,454,721
41580,2015-10-10,19,163,349,512
41581,2015-10-10,20,108,219,327
41582,2015-10-10,21,82,179,261
41583,2015-10-10,22,57,182,239
41584,2015-10-10,23,22,136,158
41585,2015-10-11,0,28,129,157
41586,2015-10-11,1,11,87,98
41587,2015-10-11,2,12,56,68
41588,2015-10-11,3,5,37,42
41589,2015-10-11,4,1,10,11
41590,2015-10-11,5,5,16,21
41591,2015-10-11,6,3,53,56
41592,2015-10-11,7,14,63,77
41593,2015-10-11,8,53,140,193
41594,2015-10-11,9,124,226,350
41595,2015-10-11,10,251,404,655
41596,2015-10-11,11,321,473,794
41597,2015-10-11,12,395,484,879
41598,2015-10-11,13,446,467,913
41599,2015-10-11,14,540,494,1034
41600,2015-10-11,15,518,482,1000
41601,2015-10-11,16,424,524,948
41602,2015-10-11,17,466,503,969
41603,2015-10-11,18,308,441,749
41604,2015-10-11,19,177,347,524
41605,2015-10-11,20,108,247,355
41606,2015-10-11,21,74,200,274
41607,2015-10-11,22,61,143,204
41608,2015-10-11,23,34,85,119
41609,2015-10-12,0,14,58,72
41610,2015-10-12,1,3,32,35
41611,2015-10-12,2,5,19,24
41612,2015-10-12,3,2,9,11
41613,2015-10-12,4,1,2,3
41614,2015-10-12,5,2,46,48
41615,2015-10-12,6,0,98,98
41616,2015-10-12,7,16,304,320
41617,2015-10-12,8,41,541,582
41618,2015-10-12,9,88,348,436
41619,2015-10-12,10,171,332,503
41620,2015-10-12,11,237,359,596
41621,2015-10-12,12,267,492,759
41622,2015-10-12,13,315,475,790
41623,2015-10-12,14,298,442,740
41624,2015-10-12,15,347,413,760
41625,2015-10-12,16,303,564,867
41626,2015-10-12,17,263,830,1093
41627,2015-10-12,18,200,858,1058
41628,2015-10-12,19,121,554,675
41629,2015-10-12,20,81,332,413
41630,2015-10-12,21,57,265,322
41631,2015-10-12,22,30,150,180
41632,2015-10-12,23,26,83,109
41633,2015-10-13,0,16,45,61
41634,2015-10-13,1,4,17,21
41635,2015-10-13,2,0,10,10
41636,2015-10-13,3,0,2,2
41637,2015-10-13,4,0,4,4
41638,2015-10-13,5,1,80,81
41639,2015-10-13,6,6,315,321
41640,2015-10-13,7,22,838,860
41641,2015-10-13,8,53,1139,1192
41642,2015-10-13,9,52,407,459
41643,2015-10-13,10,64,232,296
41644,2015-10-13,11,91,258,349
41645,2015-10-13,12,91,370,461
41646,2015-10-13,13,112,337,449
41647,2015-10-13,14,97,287,384
41648,2015-10-13,15,125,363,488
41649,2015-10-13,16,120,614,734
41650,2015-10-13,17,158,1354,1512
41651,2015-10-13,18,102,974,1076
41652,2015-10-13,19,47,657,704
41653,2015-10-13,20,38,477,515
41654,2015-10-13,21,36,335,371
41655,2015-10-13,22,26,212,238
41656,2015-10-13,23,33,182,215
41657,2015-10-14,0,15,58,73
41658,2015-10-14,1,6,16,22
41659,2015-10-14,2,6,11,17
41660,2015-10-14,3,12,5,17
41661,2015-10-14,4,1,11,12
41662,2015-10-14,5,1,101,102
41663,2015-10-14,6,7,344,351
41664,2015-10-14,7,17,884,901
41665,2015-10-14,8,40,1281,1321
41666,2015-10-14,9,53,493,546
41667,2015-10-14,10,76,224,300
41668,2015-10-14,11,68,279,347
41669,2015-10-14,12,75,378,453
41670,2015-10-14,13,78,334,412
41671,2015-10-14,14,72,291,363
41672,2015-10-14,15,104,412,516
41673,2015-10-14,16,125,685,810
41674,2015-10-14,17,154,1346,1500
41675,2015-10-14,18,137,1185,1322
41676,2015-10-14,19,70,729,799
41677,2015-10-14,20,39,460,499
41678,2015-10-14,21,22,327,349
41679,2015-10-14,22,20,234,254
41680,2015-10-14,23,16,104,120
41681,2015-10-15,0,7,57,64
41682,2015-10-15,1,1,16,17
41683,2015-10-15,2,4,7,11
41684,2015-10-15,3,2,7,9
41685,2015-10-15,4,1,6,7
41686,2015-10-15,5,2,76,78
41687,2015-10-15,6,8,276,284
41688,2015-10-15,7,14,813,827
41689,2015-10-15,8,55,1237,1292
41690,2015-10-15,9,92,538,630
41691,2015-10-15,10,86,235,321
41692,2015-10-15,11,119,283,402
41693,2015-10-15,12,125,387,512
41694,2015-10-15,13,130,351,481
41695,2015-10-15,14,118,299,417
41696,2015-10-15,15,145,405,550
41697,2015-10-15,16,162,661,823
41698,2015-10-15,17,141,1264,1405
41699,2015-10-15,18,124,1140,1264
41700,2015-10-15,19,104,643,747
41701,2015-10-15,20,80,460,540
41702,2015-10-15,21,59,350,409
41703,2015-10-15,22,51,192,243
41704,2015-10-15,23,24,148,172
41705,2015-10-16,0,6,70,76
41706,2015-10-16,1,6,46,52
41707,2015-10-16,2,4,15,19
41708,2015-10-16,3,0,5,5
41709,2015-10-16,4,0,6,6
41710,2015-10-16,5,1,74,75
41711,2015-10-16,6,2,231,233
41712,2015-10-16,7,22,690,712
41713,2015-10-16,8,42,1211,1253
41714,2015-10-16,9,77,510,587
41715,2015-10-16,10,126,273,399
41716,2015-10-16,11,166,300,466
41717,2015-10-16,12,129,415,544
41718,2015-10-16,13,173,405,578
41719,2015-10-16,14,163,384,547
41720,2015-10-16,15,175,409,584
41721,2015-10-16,16,168,699,867
41722,2015-10-16,17,203,1217,1420
41723,2015-10-16,18,151,933,1084
41724,2015-10-16,19,76,526,602
41725,2015-10-16,20,75,347,422
41726,2015-10-16,21,61,247,308
41727,2015-10-16,22,29,203,232
41728,2015-10-16,23,19,173,192
41729,2015-10-17,0,28,115,143
41730,2015-10-17,1,23,85,108
41731,2015-10-17,2,8,50,58
41732,2015-10-17,3,2,32,34
41733,2015-10-17,4,0,4,4
41734,2015-10-17,5,2,7,9
41735,2015-10-17,6,6,35,41
41736,2015-10-17,7,20,103,123
41737,2015-10-17,8,49,244,293
41738,2015-10-17,9,103,351,454
41739,2015-10-17,10,167,452,619
41740,2015-10-17,11,237,472,709
41741,2015-10-17,12,304,530,834
41742,2015-10-17,13,331,480,811
41743,2015-10-17,14,308,413,721
41744,2015-10-17,15,381,472,853
41745,2015-10-17,16,308,416,724
41746,2015-10-17,17,269,364,633
41747,2015-10-17,18,139,366,505
41748,2015-10-17,19,56,289,345
41749,2015-10-17,20,33,232,265
41750,2015-10-17,21,34,154,188
41751,2015-10-17,22,24,139,163
41752,2015-10-17,23,26,115,141
41753,2015-10-18,0,14,86,100
41754,2015-10-18,1,9,58,67
41755,2015-10-18,2,2,51,53
41756,2015-10-18,3,0,20,20
41757,2015-10-18,4,2,5,7
41758,2015-10-18,5,2,8,10
41759,2015-10-18,6,1,16,17
41760,2015-10-18,7,10,52,62
41761,2015-10-18,8,23,137,160
41762,2015-10-18,9,68,251,319
41763,2015-10-18,10,166,345,511
41764,2015-10-18,11,194,445,639
41765,2015-10-18,12,237,436,673
41766,2015-10-18,13,170,464,634
41767,2015-10-18,14,179,391,570
41768,2015-10-18,15,164,453,617
41769,2015-10-18,16,176,455,631
41770,2015-10-18,17,116,391,507
41771,2015-10-18,18,85,386,471
41772,2015-10-18,19,53,268,321
41773,2015-10-18,20,35,170,205
41774,2015-10-18,21,36,150,186
41775,2015-10-18,22,32,106,138
41776,2015-10-18,23,12,46,58
41777,2015-10-19,0,0,26,26
41778,2015-10-19,1,5,8,13
41779,2015-10-19,2,2,10,12
41780,2015-10-19,3,1,3,4
41781,2015-10-19,4,1,6,7
41782,2015-10-19,5,0,52,52
41783,2015-10-19,6,0,200,200
41784,2015-10-19,7,20,634,654
41785,2015-10-19,8,25,1048,1073
41786,2015-10-19,9,53,455,508
41787,2015-10-19,10,49,195,244
41788,2015-10-19,11,80,216,296
41789,2015-10-19,12,87,304,391
41790,2015-10-19,13,74,280,354
41791,2015-10-19,14,98,238,336
41792,2015-10-19,15,90,317,407
41793,2015-10-19,16,84,569,653
41794,2015-10-19,17,88,1169,1257
41795,2015-10-19,18,70,1024,1094
41796,2015-10-19,19,34,549,583
41797,2015-10-19,20,12,372,384
41798,2015-10-19,21,6,247,253
41799,2015-10-19,22,20,163,183
41800,2015-10-19,23,14,74,88
41801,2015-10-20,0,0,32,32
41802,2015-10-20,1,1,13,14
41803,2015-10-20,2,0,8,8
41804,2015-10-20,3,0,3,3
41805,2015-10-20,4,2,7,9
41806,2015-10-20,5,0,73,73
41807,2015-10-20,6,1,261,262
41808,2015-10-20,7,14,753,767
41809,2015-10-20,8,28,1169,1197
41810,2015-10-20,9,34,468,502
41811,2015-10-20,10,45,215,260
41812,2015-10-20,11,72,206,278
41813,2015-10-20,12,76,299,375
41814,2015-10-20,13,77,290,367
41815,2015-10-20,14,75,278,353
41816,2015-10-20,15,95,345,440
41817,2015-10-20,16,109,625,734
41818,2015-10-20,17,115,1333,1448
41819,2015-10-20,18,64,1109,1173
41820,2015-10-20,19,37,649,686
41821,2015-10-20,20,31,397,428
41822,2015-10-20,21,20,287,307
41823,2015-10-20,22,17,187,204
41824,2015-10-20,23,19,96,115
41825,2015-10-21,0,11,42,53
41826,2015-10-21,1,6,15,21
41827,2015-10-21,2,0,5,5
41828,2015-10-21,3,4,8,12
41829,2015-10-21,4,1,5,6
41830,2015-10-21,5,2,104,106
41831,2015-10-21,6,6,275,281
41832,2015-10-21,7,17,772,789
41833,2015-10-21,8,32,1213,1245
41834,2015-10-21,9,39,478,517
41835,2015-10-21,10,45,244,289
41836,2015-10-21,11,68,236,304
41837,2015-10-21,12,84,335,419
41838,2015-10-21,13,73,322,395
41839,2015-10-21,14,103,272,375
41840,2015-10-21,15,84,359,443
41841,2015-10-21,16,111,680,791
41842,2015-10-21,17,150,1294,1444
41843,2015-10-21,18,83,1133,1216
41844,2015-10-21,19,41,696,737
41845,2015-10-21,20,43,493,536
41846,2015-10-21,21,27,340,367
41847,2015-10-21,22,11,205,216
41848,2015-10-21,23,15,96,111
41849,2015-10-22,0,8,51,59
41850,2015-10-22,1,6,13,19
41851,2015-10-22,2,1,11,12
41852,2015-10-22,3,3,2,5
41853,2015-10-22,4,3,5,8
41854,2015-10-22,5,0,71,71
41855,2015-10-22,6,0,272,272
41856,2015-10-22,7,12,769,781
41857,2015-10-22,8,28,1190,1218
41858,2015-10-22,9,40,543,583
41859,2015-10-22,10,98,225,323
41860,2015-10-22,11,116,291,407
41861,2015-10-22,12,122,380,502
41862,2015-10-22,13,147,338,485
41863,2015-10-22,14,176,302,478
41864,2015-10-22,15,140,369,509
41865,2015-10-22,16,176,644,820
41866,2015-10-22,17,190,1255,1445
41867,2015-10-22,18,149,1120,1269
41868,2015-10-22,19,78,661,739
41869,2015-10-22,20,68,455,523
41870,2015-10-22,21,39,323,362
41871,2015-10-22,22,27,234,261
41872,2015-10-22,23,16,120,136
41873,2015-10-23,0,13,73,86
41874,2015-10-23,1,11,31,42
41875,2015-10-23,2,2,19,21
41876,2015-10-23,3,1,8,9
41877,2015-10-23,4,0,6,6
41878,2015-10-23,5,1,50,51
41879,2015-10-23,6,2,224,226
41880,2015-10-23,7,22,710,732
41881,2015-10-23,8,39,1113,1152
41882,2015-10-23,9,57,528,585
41883,2015-10-23,10,108,271,379
41884,2015-10-23,11,130,306,436
41885,2015-10-23,12,183,420,603
41886,2015-10-23,13,223,394,617
41887,2015-10-23,14,214,395,609
41888,2015-10-23,15,241,457,698
41889,2015-10-23,16,207,722,929
41890,2015-10-23,17,261,1137,1398
41891,2015-10-23,18,123,941,1064
41892,2015-10-23,19,85,533,618
41893,2015-10-23,20,61,359,420
41894,2015-10-23,21,52,258,310
41895,2015-10-23,22,63,221,284
41896,2015-10-23,23,36,157,193
41897,2015-10-24,0,14,103,117
41898,2015-10-24,1,10,83,93
41899,2015-10-24,2,4,59,63
41900,2015-10-24,3,3,25,28
41901,2015-10-24,4,0,7,7
41902,2015-10-24,5,0,11,11
41903,2015-10-24,6,3,37,40
41904,2015-10-24,7,17,93,110
41905,2015-10-24,8,38,267,305
41906,2015-10-24,9,82,346,428
41907,2015-10-24,10,196,425,621
41908,2015-10-24,11,272,483,755
41909,2015-10-24,12,341,543,884
41910,2015-10-24,13,347,486,833
41911,2015-10-24,14,425,441,866
41912,2015-10-24,15,391,476,867
41913,2015-10-24,16,407,441,848
41914,2015-10-24,17,308,465,773
41915,2015-10-24,18,206,413,619
41916,2015-10-24,19,84,356,440
41917,2015-10-24,20,82,211,293
41918,2015-10-24,21,87,176,263
41919,2015-10-24,22,72,196,268
41920,2015-10-24,23,43,152,195
41921,2015-10-25,0,20,106,126
41922,2015-10-25,1,21,87,108
41923,2015-10-25,2,6,55,61
41924,2015-10-25,3,6,23,29
41925,2015-10-25,4,0,5,5
41926,2015-10-25,5,4,23,27
41927,2015-10-25,6,15,37,52
41928,2015-10-25,7,23,60,83
41929,2015-10-25,8,65,119,184
41930,2015-10-25,9,99,193,292
41931,2015-10-25,10,153,345,498
41932,2015-10-25,11,197,412,609
41933,2015-10-25,12,255,518,773
41934,2015-10-25,13,238,524,762
41935,2015-10-25,14,294,553,847
41936,2015-10-25,15,256,505,761
41937,2015-10-25,16,286,535,821
41938,2015-10-25,17,240,507,747
41939,2015-10-25,18,173,448,621
41940,2015-10-25,19,113,295,408
41941,2015-10-25,20,88,213,301
41942,2015-10-25,21,54,179,233
41943,2015-10-25,22,30,121,151
41944,2015-10-25,23,18,70,88
41945,2015-10-26,0,7,36,43
41946,2015-10-26,1,2,7,9
41947,2015-10-26,2,1,6,7
41948,2015-10-26,3,0,5,5
41949,2015-10-26,4,0,6,6
41950,2015-10-26,5,2,64,66
41951,2015-10-26,6,4,240,244
41952,2015-10-26,7,14,695,709
41953,2015-10-26,8,42,1045,1087
41954,2015-10-26,9,65,487,552
41955,2015-10-26,10,80,195,275
41956,2015-10-26,11,137,234,371
41957,2015-10-26,12,146,301,447
41958,2015-10-26,13,160,312,472
41959,2015-10-26,14,131,236,367
41960,2015-10-26,15,139,362,501
41961,2015-10-26,16,168,618,786
41962,2015-10-26,17,128,1300,1428
41963,2015-10-26,18,85,995,1080
41964,2015-10-26,19,52,598,650
41965,2015-10-26,20,32,327,359
41966,2015-10-26,21,18,246,264
41967,2015-10-26,22,17,158,175
41968,2015-10-26,23,4,65,69
41969,2015-10-27,0,2,27,29
41970,2015-10-27,1,4,15,19
41971,2015-10-27,2,1,3,4
41972,2015-10-27,4,0,8,8
41973,2015-10-27,5,1,72,73
41974,2015-10-27,6,4,283,287
41975,2015-10-27,7,17,779,796
41976,2015-10-27,8,33,1188,1221
41977,2015-10-27,9,50,477,527
41978,2015-10-27,10,77,205,282
41979,2015-10-27,11,82,222,304
41980,2015-10-27,12,97,299,396
41981,2015-10-27,13,67,306,373
41982,2015-10-27,14,96,267,363
41983,2015-10-27,15,68,343,411
41984,2015-10-27,16,99,563,662
41985,2015-10-27,17,87,1228,1315
41986,2015-10-27,18,39,965,1004
41987,2015-10-27,19,34,604,638
41988,2015-10-27,20,34,413,447
41989,2015-10-27,21,26,308,334
41990,2015-10-27,22,16,175,191
41991,2015-10-27,23,5,108,113
41992,2015-10-28,0,1,30,31
41993,2015-10-28,1,3,18,21
41994,2015-10-28,2,1,4,5
41995,2015-10-28,3,0,3,3
41996,2015-10-28,4,0,5,5
41997,2015-10-28,5,1,70,71
41998,2015-10-28,6,5,202,207
41999,2015-10-28,7,9,568,577
42000,2015-10-28,8,15,693,708
42001,2015-10-28,9,15,361,376
42002,2015-10-28,10,8,141,149
42003,2015-10-28,11,11,46,57
42004,2015-10-28,12,6,93,99
42005,2015-10-28,13,4,86,90
42006,2015-10-28,14,25,113,138
42007,2015-10-28,15,10,129,139
42008,2015-10-28,16,9,274,283
42009,2015-10-28,17,19,417,436
42010,2015-10-28,18,12,585,597
42011,2015-10-28,19,10,279,289
42012,2015-10-28,20,9,286,295
42013,2015-10-28,21,9,238,247
42014,2015-10-28,22,9,229,238
42015,2015-10-28,23,10,108,118
42016,2015-10-29,0,2,36,38
42017,2015-10-29,1,2,9,11
42018,2015-10-29,2,0,6,6
42019,2015-10-29,3,0,6,6
42020,2015-10-29,4,0,5,5
42021,2015-10-29,5,1,59,60
42022,2015-10-29,6,3,252,255
42023,2015-10-29,7,17,776,793
42024,2015-10-29,8,16,1130,1146
42025,2015-10-29,9,26,471,497
42026,2015-10-29,10,61,216,277
42027,2015-10-29,11,84,273,357
42028,2015-10-29,12,110,349,459
42029,2015-10-29,13,83,333,416
42030,2015-10-29,14,108,281,389
42031,2015-10-29,15,110,382,492
42032,2015-10-29,16,92,627,719
42033,2015-10-29,17,127,1318,1445
42034,2015-10-29,18,76,1085,1161
42035,2015-10-29,19,55,690,745
42036,2015-10-29,20,62,470,532
42037,2015-10-29,21,51,307,358
42038,2015-10-29,22,29,243,272
42039,2015-10-29,23,27,166,193
42040,2015-10-30,0,14,51,65
42041,2015-10-30,1,1,29,30
42042,2015-10-30,2,3,17,20
42043,2015-10-30,3,0,3,3
42044,2015-10-30,4,1,8,9
42045,2015-10-30,5,0,70,70
42046,2015-10-30,6,1,201,202
42047,2015-10-30,7,15,623,638
42048,2015-10-30,8,30,1097,1127
42049,2015-10-30,9,51,524,575
42050,2015-10-30,10,49,226,275
42051,2015-10-30,11,94,289,383
42052,2015-10-30,12,74,373,447
42053,2015-10-30,13,131,359,490
42054,2015-10-30,14,107,384,491
42055,2015-10-30,15,108,407,515
42056,2015-10-30,16,115,691,806
42057,2015-10-30,17,117,1098,1215
42058,2015-10-30,18,70,779,849
42059,2015-10-30,19,40,500,540
42060,2015-10-30,20,35,324,359
42061,2015-10-30,21,34,203,237
42062,2015-10-30,22,22,179,201
42063,2015-10-30,23,11,140,151
42064,2015-10-31,0,17,103,120
42065,2015-10-31,1,9,91,100
42066,2015-10-31,2,5,52,57
42067,2015-10-31,3,5,22,27
42068,2015-10-31,4,0,10,10
42069,2015-10-31,5,0,10,10
42070,2015-10-31,6,1,22,23
42071,2015-10-31,7,8,73,81
42072,2015-10-31,8,27,183,210
42073,2015-10-31,9,55,318,373
42074,2015-10-31,10,125,436,561
42075,2015-10-31,11,182,460,642
42076,2015-10-31,12,230,549,779
42077,2015-10-31,13,258,504,762
42078,2015-10-31,14,314,552,866
42079,2015-10-31,15,300,549,849
42080,2015-10-31,16,279,587,866
42081,2015-10-31,17,216,423,639
42082,2015-10-31,18,124,413,537
42083,2015-10-31,19,90,273,363
42084,2015-10-31,20,67,217,284
42085,2015-10-31,21,33,161,194
42086,2015-10-31,22,51,165,216
42087,2015-10-31,23,29,122,151
42088,2015-11-01,0,10,141,151
42089,2015-11-01,1,41,237,278
42090,2015-11-01,2,20,37,57
42091,2015-11-01,3,6,25,31
42092,2015-11-01,4,1,5,6
42093,2015-11-01,5,3,4,7
42094,2015-11-01,6,2,18,20
42095,2015-11-01,7,4,43,47
42096,2015-11-01,8,10,75,85
42097,2015-11-01,9,45,166,211
42098,2015-11-01,10,93,306,399
42099,2015-11-01,11,129,382,511
42100,2015-11-01,12,174,505,679
42101,2015-11-01,13,227,482,709
42102,2015-11-01,14,235,499,734
42103,2015-11-01,15,246,467,713
42104,2015-11-01,16,207,476,683
42105,2015-11-01,17,164,448,612
42106,2015-11-01,18,80,295,375
42107,2015-11-01,19,61,251,312
42108,2015-11-01,20,58,174,232
42109,2015-11-01,21,47,98,145
42110,2015-11-01,22,29,124,153
42111,2015-11-01,23,5,55,60
42112,2015-11-02,0,6,23,29
42113,2015-11-02,1,6,10,16
42114,2015-11-02,2,7,6,13
42115,2015-11-02,3,0,3,3
42116,2015-11-02,4,1,4,5
42117,2015-11-02,5,5,79,84
42118,2015-11-02,6,5,282,287
42119,2015-11-02,7,27,855,882
42120,2015-11-02,8,36,1070,1106
42121,2015-11-02,9,52,409,461
42122,2015-11-02,10,76,186,262
42123,2015-11-02,11,82,199,281
42124,2015-11-02,12,86,312,398
42125,2015-11-02,13,87,276,363
42126,2015-11-02,14,104,226,330
42127,2015-11-02,15,105,305,410
42128,2015-11-02,16,82,603,685
42129,2015-11-02,17,97,1174,1271
42130,2015-11-02,18,53,900,953
42131,2015-11-02,19,43,633,676
42132,2015-11-02,20,37,398,435
42133,2015-11-02,21,32,242,274
42134,2015-11-02,22,17,142,159
42135,2015-11-02,23,5,58,63
42136,2015-11-03,0,7,27,34
42137,2015-11-03,1,0,15,15
42138,2015-11-03,2,2,1,3
42139,2015-11-03,3,0,2,2
42140,2015-11-03,4,0,6,6
42141,2015-11-03,5,2,87,89
42142,2015-11-03,6,2,327,329
42143,2015-11-03,7,19,924,943
42144,2015-11-03,8,42,1239,1281
42145,2015-11-03,9,43,418,461
42146,2015-11-03,10,57,220,277
42147,2015-11-03,11,86,237,323
42148,2015-11-03,12,86,341,427
42149,2015-11-03,13,111,332,443
42150,2015-11-03,14,101,285,386
42151,2015-11-03,15,100,379,479
42152,2015-11-03,16,106,697,803
42153,2015-11-03,17,104,1316,1420
42154,2015-11-03,18,40,1007,1047
42155,2015-11-03,19,24,638,662
42156,2015-11-03,20,18,463,481
42157,2015-11-03,21,15,309,324
42158,2015-11-03,22,15,169,184
42159,2015-11-03,23,5,84,89
42160,2015-11-04,0,2,25,27
42161,2015-11-04,1,0,9,9
42162,2015-11-04,2,4,4,8
42163,2015-11-04,3,0,5,5
42164,2015-11-04,4,0,9,9
42165,2015-11-04,5,4,97,101
42166,2015-11-04,6,2,381,383
42167,2015-11-04,7,18,927,945
42168,2015-11-04,8,32,1171,1203
42169,2015-11-04,9,64,491,555
42170,2015-11-04,10,43,241,284
42171,2015-11-04,11,107,289,396
42172,2015-11-04,12,101,386,487
42173,2015-11-04,13,107,388,495
42174,2015-11-04,14,120,365,485
42175,2015-11-04,15,103,415,518
42176,2015-11-04,16,86,685,771
42177,2015-11-04,17,116,1269,1385
42178,2015-11-04,18,54,1067,1121
42179,2015-11-04,19,52,588,640
42180,2015-11-04,20,21,382,403
42181,2015-11-04,21,28,247,275
42182,2015-11-04,22,25,176,201
42183,2015-11-04,23,2,113,115
42184,2015-11-05,0,3,37,40
42185,2015-11-05,1,1,11,12
42186,2015-11-05,2,2,6,8
42187,2015-11-05,3,0,1,1
42188,2015-11-05,4,0,13,13
42189,2015-11-05,5,0,71,71
42190,2015-11-05,6,2,279,281
42191,2015-11-05,7,17,794,811
42192,2015-11-05,8,51,1166,1217
42193,2015-11-05,9,42,484,526
42194,2015-11-05,10,61,220,281
42195,2015-11-05,11,84,251,335
42196,2015-11-05,12,90,350,440
42197,2015-11-05,13,92,348,440
42198,2015-11-05,14,86,316,402
42199,2015-11-05,15,92,364,456
42200,2015-11-05,16,136,673,809
42201,2015-11-05,17,109,1209,1318
42202,2015-11-05,18,59,1055,1114
42203,2015-11-05,19,53,642,695
42204,2015-11-05,20,35,428,463
42205,2015-11-05,21,20,367,387
42206,2015-11-05,22,16,243,259
42207,2015-11-05,23,22,152,174
42208,2015-11-06,0,21,66,87
42209,2015-11-06,1,5,35,40
42210,2015-11-06,2,6,13,19
42211,2015-11-06,3,1,5,6
42212,2015-11-06,4,0,7,7
42213,2015-11-06,5,0,73,73
42214,2015-11-06,6,6,268,274
42215,2015-11-06,7,17,789,806
42216,2015-11-06,8,52,1159,1211
42217,2015-11-06,9,62,516,578
42218,2015-11-06,10,135,301,436
42219,2015-11-06,11,186,310,496
42220,2015-11-06,12,171,422,593
42221,2015-11-06,13,220,440,660
42222,2015-11-06,14,222,390,612
42223,2015-11-06,15,259,501,760
42224,2015-11-06,16,267,859,1126
42225,2015-11-06,17,170,1182,1352
42226,2015-11-06,18,102,889,991
42227,2015-11-06,19,93,499,592
42228,2015-11-06,20,54,196,250
42229,2015-11-06,21,42,169,211
42230,2015-11-06,22,34,199,233
42231,2015-11-06,23,29,166,195
42232,2015-11-07,0,26,139,165
42233,2015-11-07,1,16,106,122
42234,2015-11-07,2,16,53,69
42235,2015-11-07,3,13,21,34
42236,2015-11-07,4,2,5,7
42237,2015-11-07,5,6,8,14
42238,2015-11-07,6,7,19,26
42239,2015-11-07,7,9,99,108
42240,2015-11-07,8,44,239,283
42241,2015-11-07,9,72,280,352
42242,2015-11-07,10,72,232,304
42243,2015-11-07,11,41,185,226
42244,2015-11-07,12,17,156,173
42245,2015-11-07,13,45,189,234
42246,2015-11-07,14,98,276,374
42247,2015-11-07,15,130,349,479
42248,2015-11-07,16,128,364,492
42249,2015-11-07,17,130,385,515
42250,2015-11-07,18,61,328,389
42251,2015-11-07,19,55,266,321
42252,2015-11-07,20,44,218,262
42253,2015-11-07,21,41,216,257
42254,2015-11-07,22,40,175,215
42255,2015-11-07,23,35,152,187
42256,2015-11-08,0,12,88,100
42257,2015-11-08,1,2,94,96
42258,2015-11-08,2,3,71,74
42259,2015-11-08,3,12,33,45
42260,2015-11-08,4,0,11,11
42261,2015-11-08,5,1,12,13
42262,2015-11-08,6,4,24,28
42263,2015-11-08,7,16,87,103
42264,2015-11-08,8,43,145,188
42265,2015-11-08,9,122,310,432
42266,2015-11-08,10,232,466,698
42267,2015-11-08,11,363,493,856
42268,2015-11-08,12,304,570,874
42269,2015-11-08,13,305,587,892
42270,2015-11-08,14,360,555,915
42271,2015-11-08,15,360,528,888
42272,2015-11-08,16,299,558,857
42273,2015-11-08,17,148,466,614
42274,2015-11-08,18,74,343,417
42275,2015-11-08,19,53,266,319
42276,2015-11-08,20,31,204,235
42277,2015-11-08,21,26,145,171
42278,2015-11-08,22,12,98,110
42279,2015-11-08,23,7,49,56
42280,2015-11-09,0,0,31,31
42281,2015-11-09,1,0,9,9
42282,2015-11-09,2,2,3,5
42283,2015-11-09,3,2,4,6
42284,2015-11-09,4,0,9,9
42285,2015-11-09,5,0,73,73
42286,2015-11-09,6,2,252,254
42287,2015-11-09,7,16,729,745
42288,2015-11-09,8,26,1013,1039
42289,2015-11-09,9,42,459,501
42290,2015-11-09,10,49,135,184
42291,2015-11-09,11,50,187,237
42292,2015-11-09,12,72,262,334
42293,2015-11-09,13,59,267,326
42294,2015-11-09,14,56,256,312
42295,2015-11-09,15,51,261,312
42296,2015-11-09,16,40,489,529
42297,2015-11-09,17,40,663,703
42298,2015-11-09,18,20,521,541
42299,2015-11-09,19,19,275,294
42300,2015-11-09,20,8,155,163
42301,2015-11-09,21,5,63,68
42302,2015-11-09,22,2,26,28
42303,2015-11-09,23,3,9,12
42304,2015-11-10,0,0,6,6
42305,2015-11-10,1,0,2,2
42306,2015-11-10,2,1,3,4
42307,2015-11-10,3,0,1,1
42308,2015-11-10,4,0,1,1
42309,2015-11-10,5,1,55,56
42310,2015-11-10,6,1,208,209
42311,2015-11-10,7,7,418,425
42312,2015-11-10,8,15,779,794
42313,2015-11-10,9,17,292,309
42314,2015-11-10,10,16,97,113
42315,2015-11-10,11,19,128,147
42316,2015-11-10,12,31,194,225
42317,2015-11-10,13,16,133,149
42318,2015-11-10,14,15,92,107
42319,2015-11-10,15,17,200,217
42320,2015-11-10,16,16,325,341
42321,2015-11-10,17,20,627,647
42322,2015-11-10,18,18,678,696
42323,2015-11-10,19,12,434,446
42324,2015-11-10,20,9,337,346
42325,2015-11-10,21,5,256,261
42326,2015-11-10,22,10,137,147
42327,2015-11-10,23,2,122,124
42328,2015-11-11,0,3,41,44
42329,2015-11-11,1,0,24,24
42330,2015-11-11,2,1,13,14
42331,2015-11-11,3,0,6,6
42332,2015-11-11,4,1,4,5
42333,2015-11-11,5,0,50,50
42334,2015-11-11,6,1,146,147
42335,2015-11-11,7,10,497,507
42336,2015-11-11,8,23,853,876
42337,2015-11-11,9,41,513,554
42338,2015-11-11,10,44,285,329
42339,2015-11-11,11,76,387,463
42340,2015-11-11,12,102,434,536
42341,2015-11-11,13,113,453,566
42342,2015-11-11,14,113,426,539
42343,2015-11-11,15,103,439,542
42344,2015-11-11,16,114,539,653
42345,2015-11-11,17,73,812,885
42346,2015-11-11,18,36,680,716
42347,2015-11-11,19,30,495,525
42348,2015-11-11,20,22,349,371
42349,2015-11-11,21,16,251,267
42350,2015-11-11,22,18,187,205
42351,2015-11-11,23,4,72,76
42352,2015-11-12,0,3,43,46
42353,2015-11-12,1,1,14,15
42354,2015-11-12,2,6,11,17
42355,2015-11-12,3,0,4,4
42356,2015-11-12,4,0,6,6
42357,2015-11-12,5,0,74,74
42358,2015-11-12,6,0,269,269
42359,2015-11-12,7,11,740,751
42360,2015-11-12,8,15,862,877
42361,2015-11-12,9,22,341,363
42362,2015-11-12,10,24,146,170
42363,2015-11-12,11,10,127,137
42364,2015-11-12,12,31,215,246
42365,2015-11-12,13,46,252,298
42366,2015-11-12,14,70,218,288
42367,2015-11-12,15,61,320,381
42368,2015-11-12,16,47,636,683
42369,2015-11-12,17,63,1081,1144
42370,2015-11-12,18,50,955,1005
42371,2015-11-12,19,22,577,599
42372,2015-11-12,20,28,409,437
42373,2015-11-12,21,12,350,362
42374,2015-11-12,22,15,174,189
42375,2015-11-12,23,6,109,115
42376,2015-11-13,0,7,52,59
42377,2015-11-13,1,4,21,25
42378,2015-11-13,2,0,8,8
42379,2015-11-13,3,0,2,2
42380,2015-11-13,4,0,5,5
42381,2015-11-13,5,2,74,76
42382,2015-11-13,6,3,255,258
42383,2015-11-13,7,13,708,721
42384,2015-11-13,8,28,1150,1178
42385,2015-11-13,9,44,521,565
42386,2015-11-13,10,78,226,304
42387,2015-11-13,11,91,304,395
42388,2015-11-13,12,108,395,503
42389,2015-11-13,13,87,363,450
42390,2015-11-13,14,110,341,451
42391,2015-11-13,15,95,380,475
42392,2015-11-13,16,76,675,751
42393,2015-11-13,17,51,992,1043
42394,2015-11-13,18,32,720,752
42395,2015-11-13,19,28,423,451
42396,2015-11-13,20,23,267,290
42397,2015-11-13,21,26,200,226
42398,2015-11-13,22,12,147,159
42399,2015-11-13,23,10,105,115
42400,2015-11-14,0,10,96,106
42401,2015-11-14,1,3,48,51
42402,2015-11-14,2,5,34,39
42403,2015-11-14,3,5,19,24
42404,2015-11-14,4,0,4,4
42405,2015-11-14,5,0,8,8
42406,2015-11-14,6,1,25,26
42407,2015-11-14,7,6,86,92
42408,2015-11-14,8,17,195,212
42409,2015-11-14,9,54,327,381
42410,2015-11-14,10,97,396,493
42411,2015-11-14,11,155,438,593
42412,2015-11-14,12,189,434,623
42413,2015-11-14,13,222,445,667
42414,2015-11-14,14,279,416,695
42415,2015-11-14,15,279,436,715
42416,2015-11-14,16,196,423,619
42417,2015-11-14,17,121,350,471
42418,2015-11-14,18,53,331,384
42419,2015-11-14,19,35,262,297
42420,2015-11-14,20,23,175,198
42421,2015-11-14,21,39,158,197
42422,2015-11-14,22,18,127,145
42423,2015-11-14,23,16,115,131
42424,2015-11-15,0,14,112,126
42425,2015-11-15,1,13,85,98
42426,2015-11-15,2,5,59,64
42427,2015-11-15,3,2,22,24
42428,2015-11-15,4,1,6,7
42429,2015-11-15,5,0,7,7
42430,2015-11-15,6,3,8,11
42431,2015-11-15,7,2,47,49
42432,2015-11-15,8,17,137,154
42433,2015-11-15,9,84,235,319
42434,2015-11-15,10,130,400,530
42435,2015-11-15,11,220,459,679
42436,2015-11-15,12,226,494,720
42437,2015-11-15,13,239,490,729
42438,2015-11-15,14,252,499,751
42439,2015-11-15,15,227,531,758
42440,2015-11-15,16,189,538,727
42441,2015-11-15,17,144,395,539
42442,2015-11-15,18,52,304,356
42443,2015-11-15,19,38,202,240
42444,2015-11-15,20,28,195,223
42445,2015-11-15,21,23,129,152
42446,2015-11-15,22,15,97,112
42447,2015-11-15,23,8,57,65
42448,2015-11-16,0,2,26,28
42449,2015-11-16,1,0,13,13
42450,2015-11-16,2,0,9,9
42451,2015-11-16,3,0,5,5
42452,2015-11-16,4,1,6,7
42453,2015-11-16,5,1,64,65
42454,2015-11-16,6,4,220,224
42455,2015-11-16,7,17,739,756
42456,2015-11-16,8,17,1138,1155
42457,2015-11-16,9,46,432,478
42458,2015-11-16,10,47,225,272
42459,2015-11-16,11,77,235,312
42460,2015-11-16,12,69,277,346
42461,2015-11-16,13,82,271,353
42462,2015-11-16,14,66,227,293
42463,2015-11-16,15,70,357,427
42464,2015-11-16,16,89,608,697
42465,2015-11-16,17,50,1164,1214
42466,2015-11-16,18,42,971,1013
42467,2015-11-16,19,26,552,578
42468,2015-11-16,20,23,360,383
42469,2015-11-16,21,12,284,296
42470,2015-11-16,22,13,144,157
42471,2015-11-16,23,3,72,75
42472,2015-11-17,0,1,29,30
42473,2015-11-17,1,0,11,11
42474,2015-11-17,2,0,6,6
42475,2015-11-17,3,0,4,4
42476,2015-11-17,4,0,3,3
42477,2015-11-17,5,0,79,79
42478,2015-11-17,6,4,275,279
42479,2015-11-17,7,20,860,880
42480,2015-11-17,8,32,1226,1258
42481,2015-11-17,9,26,463,489
42482,2015-11-17,10,47,183,230
42483,2015-11-17,11,56,206,262
42484,2015-11-17,12,72,290,362
42485,2015-11-17,13,52,286,338
42486,2015-11-17,14,52,267,319
42487,2015-11-17,15,60,320,380
42488,2015-11-17,16,65,549,614
42489,2015-11-17,17,58,1083,1141
42490,2015-11-17,18,30,960,990
42491,2015-11-17,19,24,563,587
42492,2015-11-17,20,16,395,411
42493,2015-11-17,21,23,289,312
42494,2015-11-17,22,8,149,157
42495,2015-11-17,23,5,78,83
42496,2015-11-18,0,2,30,32
42497,2015-11-18,1,0,14,14
42498,2015-11-18,2,3,5,8
42499,2015-11-18,3,0,3,3
42500,2015-11-18,4,0,4,4
42501,2015-11-18,5,2,101,103
42502,2015-11-18,6,7,309,316
42503,2015-11-18,7,25,837,862
42504,2015-11-18,8,32,1170,1202
42505,2015-11-18,9,34,477,511
42506,2015-11-18,10,51,227,278
42507,2015-11-18,11,43,252,295
42508,2015-11-18,12,40,312,352
42509,2015-11-18,13,61,304,365
42510,2015-11-18,14,74,275,349
42511,2015-11-18,15,60,316,376
42512,2015-11-18,16,66,583,649
42513,2015-11-18,17,57,1137,1194
42514,2015-11-18,18,53,969,1022
42515,2015-11-18,19,51,576,627
42516,2015-11-18,20,27,442,469
42517,2015-11-18,21,29,316,345
42518,2015-11-18,22,26,212,238
42519,2015-11-18,23,8,145,153
42520,2015-11-19,0,3,66,69
42521,2015-11-19,1,1,24,25
42522,2015-11-19,2,0,17,17
42523,2015-11-19,3,0,8,8
42524,2015-11-19,4,0,8,8
42525,2015-11-19,5,1,32,33
42526,2015-11-19,6,4,186,190
42527,2015-11-19,7,17,527,544
42528,2015-11-19,8,23,1037,1060
42529,2015-11-19,9,19,431,450
42530,2015-11-19,10,31,127,158
42531,2015-11-19,11,17,113,130
42532,2015-11-19,12,13,123,136
42533,2015-11-19,13,1,49,50
42534,2015-11-19,14,4,43,47
42535,2015-11-19,15,8,112,120
42536,2015-11-19,16,10,250,260
42537,2015-11-19,17,18,740,758
42538,2015-11-19,18,18,726,744
42539,2015-11-19,19,12,429,441
42540,2015-11-19,20,12,335,347
42541,2015-11-19,21,22,295,317
42542,2015-11-19,22,15,200,215
42543,2015-11-19,23,9,119,128
42544,2015-11-20,0,4,53,57
42545,2015-11-20,1,1,17,18
42546,2015-11-20,2,0,11,11
42547,2015-11-20,3,0,4,4
42548,2015-11-20,4,0,9,9
42549,2015-11-20,5,2,69,71
42550,2015-11-20,6,5,213,218
42551,2015-11-20,7,17,673,690
42552,2015-11-20,8,29,1097,1126
42553,2015-11-20,9,49,498,547
42554,2015-11-20,10,45,225,270
42555,2015-11-20,11,75,265,340
42556,2015-11-20,12,85,390,475
42557,2015-11-20,13,83,360,443
42558,2015-11-20,14,132,313,445
42559,2015-11-20,15,113,418,531
42560,2015-11-20,16,103,671,774
42561,2015-11-20,17,51,973,1024
42562,2015-11-20,18,44,700,744
42563,2015-11-20,19,41,448,489
42564,2015-11-20,20,20,277,297
42565,2015-11-20,21,22,174,196
42566,2015-11-20,22,7,173,180
42567,2015-11-20,23,19,119,138
42568,2015-11-21,0,13,82,95
42569,2015-11-21,1,6,68,74
42570,2015-11-21,2,0,27,27
42571,2015-11-21,3,0,12,12
42572,2015-11-21,4,0,10,10
42573,2015-11-21,5,0,6,6
42574,2015-11-21,6,2,33,35
42575,2015-11-21,7,5,96,101
42576,2015-11-21,8,28,170,198
42577,2015-11-21,9,64,292,356
42578,2015-11-21,10,123,374,497
42579,2015-11-21,11,139,485,624
42580,2015-11-21,12,222,502,724
42581,2015-11-21,13,195,436,631
42582,2015-11-21,14,228,459,687
42583,2015-11-21,15,240,461,701
42584,2015-11-21,16,194,394,588
42585,2015-11-21,17,134,337,471
42586,2015-11-21,18,60,262,322
42587,2015-11-21,19,75,255,330
42588,2015-11-21,20,40,204,244
42589,2015-11-21,21,45,177,222
42590,2015-11-21,22,27,150,177
42591,2015-11-21,23,27,140,167
42592,2015-11-22,0,7,116,123
42593,2015-11-22,1,9,90,99
42594,2015-11-22,2,2,71,73
42595,2015-11-22,3,0,15,15
42596,2015-11-22,4,1,4,5
42597,2015-11-22,5,2,6,8
42598,2015-11-22,6,6,19,25
42599,2015-11-22,7,5,43,48
42600,2015-11-22,8,31,114,145
42601,2015-11-22,9,50,234,284
42602,2015-11-22,10,88,297,385
42603,2015-11-22,11,117,379,496
42604,2015-11-22,12,86,404,490
42605,2015-11-22,13,96,374,470
42606,2015-11-22,14,84,321,405
42607,2015-11-22,15,51,357,408
42608,2015-11-22,16,69,329,398
42609,2015-11-22,17,52,247,299
42610,2015-11-22,18,26,229,255
42611,2015-11-22,19,20,181,201
42612,2015-11-22,20,6,134,140
42613,2015-11-22,21,8,75,83
42614,2015-11-22,22,1,54,55
42615,2015-11-22,23,1,35,36
42616,2015-11-23,0,0,16,16
42617,2015-11-23,1,1,8,9
42618,2015-11-23,2,2,5,7
42619,2015-11-23,3,0,4,4
42620,2015-11-23,4,0,4,4
42621,2015-11-23,5,1,71,72
42622,2015-11-23,6,0,210,210
42623,2015-11-23,7,4,549,553
42624,2015-11-23,8,13,905,918
42625,2015-11-23,9,34,411,445
42626,2015-11-23,10,43,163,206
42627,2015-11-23,11,25,158,183
42628,2015-11-23,12,17,224,241
42629,2015-11-23,13,25,197,222
42630,2015-11-23,14,33,170,203
42631,2015-11-23,15,29,244,273
42632,2015-11-23,16,25,431,456
42633,2015-11-23,17,20,844,864
42634,2015-11-23,18,12,676,688
42635,2015-11-23,19,10,418,428
42636,2015-11-23,20,13,258,271
42637,2015-11-23,21,3,178,181
42638,2015-11-23,22,2,97,99
42639,2015-11-23,23,1,47,48
42640,2015-11-24,0,0,36,36
42641,2015-11-24,1,1,4,5
42642,2015-11-24,2,0,5,5
42643,2015-11-24,4,0,7,7
42644,2015-11-24,5,0,56,56
42645,2015-11-24,6,0,226,226
42646,2015-11-24,7,8,575,583
42647,2015-11-24,8,15,944,959
42648,2015-11-24,9,16,405,421
42649,2015-11-24,10,31,191,222
42650,2015-11-24,11,39,223,262
42651,2015-11-24,12,55,321,376
42652,2015-11-24,13,62,306,368
42653,2015-11-24,14,52,263,315
42654,2015-11-24,15,65,321,386
42655,2015-11-24,16,54,501,555
42656,2015-11-24,17,47,902,949
42657,2015-11-24,18,19,703,722
42658,2015-11-24,19,3,419,422
42659,2015-11-24,20,11,255,266
42660,2015-11-24,21,15,163,178
42661,2015-11-24,22,8,111,119
42662,2015-11-24,23,5,57,62
42663,2015-11-25,0,7,28,35
42664,2015-11-25,1,6,12,18
42665,2015-11-25,2,3,12,15
42666,2015-11-25,3,1,1,2
42667,2015-11-25,4,0,5,5
42668,2015-11-25,5,1,58,59
42669,2015-11-25,6,0,151,151
42670,2015-11-25,7,6,466,472
42671,2015-11-25,8,10,722,732
42672,2015-11-25,9,21,384,405
42673,2015-11-25,10,61,203,264
42674,2015-11-25,11,69,236,305
42675,2015-11-25,12,69,344,413
42676,2015-11-25,13,69,366,435
42677,2015-11-25,14,91,480,571
42678,2015-11-25,15,85,647,732
42679,2015-11-25,16,67,609,676
42680,2015-11-25,17,40,485,525
42681,2015-11-25,18,20,344,364
42682,2015-11-25,19,22,214,236
42683,2015-11-25,20,16,158,174
42684,2015-11-25,21,8,112,120
42685,2015-11-25,22,6,72,78
42686,2015-11-25,23,18,59,77
42687,2015-11-26,0,14,52,66
42688,2015-11-26,1,13,29,42
42689,2015-11-26,2,2,22,24
42690,2015-11-26,3,0,6,6
42691,2015-11-26,4,0,4,4
42692,2015-11-26,5,0,7,7
42693,2015-11-26,6,1,13,14
42694,2015-11-26,7,5,68,73
42695,2015-11-26,8,17,128,145
42696,2015-11-26,9,30,106,136
42697,2015-11-26,10,65,165,230
42698,2015-11-26,11,120,205,325
42699,2015-11-26,12,193,218,411
42700,2015-11-26,13,174,183,357
42701,2015-11-26,14,195,179,374
42702,2015-11-26,15,157,176,333
42703,2015-11-26,16,127,106,233
42704,2015-11-26,17,89,68,157
42705,2015-11-26,18,35,60,95
42706,2015-11-26,19,33,61,94
42707,2015-11-26,20,14,40,54
42708,2015-11-26,21,30,46,76
42709,2015-11-26,22,38,44,82
42710,2015-11-26,23,14,41,55
42711,2015-11-27,0,21,22,43
42712,2015-11-27,1,2,9,11
42713,2015-11-27,2,5,10,15
42714,2015-11-27,3,0,2,2
42715,2015-11-27,4,0,2,2
42716,2015-11-27,5,0,13,13
42717,2015-11-27,6,0,40,40
42718,2015-11-27,7,16,93,109
42719,2015-11-27,8,32,148,180
42720,2015-11-27,9,95,162,257
42721,2015-11-27,10,162,184,346
42722,2015-11-27,11,247,180,427
42723,2015-11-27,12,373,266,639
42724,2015-11-27,13,423,250,673
42725,2015-11-27,14,355,303,658
42726,2015-11-27,15,380,343,723
42727,2015-11-27,16,324,342,666
42728,2015-11-27,17,185,270,455
42729,2015-11-27,18,73,209,282
42730,2015-11-27,19,55,149,204
42731,2015-11-27,20,30,125,155
42732,2015-11-27,21,32,102,134
42733,2015-11-27,22,27,103,130
42734,2015-11-27,23,18,56,74
42735,2015-11-28,0,24,49,73
42736,2015-11-28,1,6,27,33
42737,2015-11-28,2,8,22,30
42738,2015-11-28,3,8,21,29
42739,2015-11-28,4,3,8,11
42740,2015-11-28,5,1,14,15
42741,2015-11-28,6,1,12,13
42742,2015-11-28,7,8,48,56
42743,2015-11-28,8,34,103,137
42744,2015-11-28,9,101,145,246
42745,2015-11-28,10,200,230,430
42746,2015-11-28,11,237,288,525
42747,2015-11-28,12,292,291,583
42748,2015-11-28,13,307,254,561
42749,2015-11-28,14,358,310,668
42750,2015-11-28,15,337,358,695
42751,2015-11-28,16,312,298,610
42752,2015-11-28,17,193,289,482
42753,2015-11-28,18,112,223,335
42754,2015-11-28,19,116,176,292
42755,2015-11-28,20,53,128,181
42756,2015-11-28,21,61,121,182
42757,2015-11-28,22,44,112,156
42758,2015-11-28,23,8,65,73
42759,2015-11-29,0,9,50,59
42760,2015-11-29,1,1,37,38
42761,2015-11-29,2,4,21,25
42762,2015-11-29,3,2,9,11
42763,2015-11-29,4,0,2,2
42764,2015-11-29,5,0,4,4
42765,2015-11-29,6,0,6,6
42766,2015-11-29,7,8,14,22
42767,2015-11-29,8,7,29,36
42768,2015-11-29,9,8,53,61
42769,2015-11-29,10,9,123,132
42770,2015-11-29,11,22,187,209
42771,2015-11-29,12,31,202,233
42772,2015-11-29,13,34,242,276
42773,2015-11-29,14,45,211,256
42774,2015-11-29,15,34,256,290
42775,2015-11-29,16,25,267,292
42776,2015-11-29,17,32,212,244
42777,2015-11-29,18,34,194,228
42778,2015-11-29,19,10,144,154
42779,2015-11-29,20,13,114,127
42780,2015-11-29,21,9,68,77
42781,2015-11-29,22,3,51,54
42782,2015-11-29,23,3,38,41
42783,2015-11-30,0,5,19,24
42784,2015-11-30,1,0,9,9
42785,2015-11-30,2,2,4,6
42786,2015-11-30,3,3,0,3
42787,2015-11-30,4,0,4,4
42788,2015-11-30,5,0,72,72
42789,2015-11-30,6,3,222,225
42790,2015-11-30,7,5,526,531
42791,2015-11-30,8,7,665,672
42792,2015-11-30,9,11,279,290
42793,2015-11-30,10,19,91,110
42794,2015-11-30,11,7,116,123
42795,2015-11-30,12,12,145,157
42796,2015-11-30,13,12,105,117
42797,2015-11-30,14,5,55,60
42798,2015-11-30,15,3,96,99
42799,2015-11-30,16,1,191,192
42800,2015-11-30,17,4,403,407
42801,2015-11-30,18,4,395,399
42802,2015-11-30,19,6,301,307
42803,2015-11-30,20,1,177,178
42804,2015-11-30,21,1,88,89
42805,2015-11-30,22,2,51,53
42806,2015-11-30,23,1,32,33
42807,2015-12-01,0,1,8,9
42808,2015-12-01,1,0,5,5
42809,2015-12-01,2,0,2,2
42810,2015-12-01,3,0,3,3
42811,2015-12-01,4,0,5,5
42812,2015-12-01,5,0,46,46
42813,2015-12-01,6,0,105,105
42814,2015-12-01,7,0,170,170
42815,2015-12-01,8,1,294,295
42816,2015-12-01,9,1,160,161
42817,2015-12-01,10,1,37,38
42818,2015-12-01,11,2,51,53
42819,2015-12-01,12,2,60,62
42820,2015-12-01,13,0,51,51
42821,2015-12-01,14,3,67,70
42822,2015-12-01,15,3,168,171
42823,2015-12-01,16,8,288,296
42824,2015-12-01,17,12,657,669
42825,2015-12-01,18,7,646,653
42826,2015-12-01,19,8,408,416
42827,2015-12-01,20,5,291,296
42828,2015-12-01,21,5,191,196
42829,2015-12-01,22,6,108,114
42830,2015-12-01,23,8,60,68
42831,2015-12-02,0,4,41,45
42832,2015-12-02,1,3,8,11
42833,2015-12-02,2,0,2,2
42834,2015-12-02,3,0,1,1
42835,2015-12-02,4,0,4,4
42836,2015-12-02,5,0,54,54
42837,2015-12-02,6,4,194,198
42838,2015-12-02,7,3,269,272
42839,2015-12-02,8,5,786,791
42840,2015-12-02,9,7,438,445
42841,2015-12-02,10,7,142,149
42842,2015-12-02,11,4,103,107
42843,2015-12-02,12,3,97,100
42844,2015-12-02,13,5,91,96
42845,2015-12-02,14,8,135,143
42846,2015-12-02,15,19,169,188
42847,2015-12-02,16,19,351,370
42848,2015-12-02,17,15,683,698
42849,2015-12-02,18,8,708,716
42850,2015-12-02,19,7,459,466
42851,2015-12-02,20,10,328,338
42852,2015-12-02,21,14,281,295
42853,2015-12-02,22,11,153,164
42854,2015-12-02,23,4,83,87
42855,2015-12-03,0,2,41,43
42856,2015-12-03,1,0,20,20
42857,2015-12-03,2,1,10,11
42858,2015-12-03,4,0,11,11
42859,2015-12-03,5,1,57,58
42860,2015-12-03,6,3,231,234
42861,2015-12-03,7,8,648,656
42862,2015-12-03,8,7,1107,1114
42863,2015-12-03,9,7,451,458
42864,2015-12-03,10,16,222,238
42865,2015-12-03,11,31,206,237
42866,2015-12-03,12,28,300,328
42867,2015-12-03,13,25,275,300
42868,2015-12-03,14,22,207,229
42869,2015-12-03,15,22,304,326
42870,2015-12-03,16,35,502,537
42871,2015-12-03,17,19,865,884
42872,2015-12-03,18,29,834,863
42873,2015-12-03,19,22,522,544
42874,2015-12-03,20,11,363,374
42875,2015-12-03,21,6,214,220
42876,2015-12-03,22,7,175,182
42877,2015-12-03,23,6,96,102
42878,2015-12-04,0,1,37,38
42879,2015-12-04,1,0,39,39
42880,2015-12-04,2,6,15,21
42881,2015-12-04,3,8,3,11
42882,2015-12-04,4,10,8,18
42883,2015-12-04,5,5,52,57
42884,2015-12-04,6,5,191,196
42885,2015-12-04,7,7,534,541
42886,2015-12-04,8,21,991,1012
42887,2015-12-04,9,19,480,499
42888,2015-12-04,10,20,219,239
42889,2015-12-04,11,24,238,262
42890,2015-12-04,12,37,316,353
42891,2015-12-04,13,37,328,365
42892,2015-12-04,14,57,313,370
42893,2015-12-04,15,37,336,373
42894,2015-12-04,16,39,560,599
42895,2015-12-04,17,38,875,913
42896,2015-12-04,18,19,723,742
42897,2015-12-04,19,28,447,475
42898,2015-12-04,20,15,260,275
42899,2015-12-04,21,13,187,200
42900,2015-12-04,22,26,187,213
42901,2015-12-04,23,6,123,129
42902,2015-12-05,0,6,91,97
42903,2015-12-05,1,8,76,84
42904,2015-12-05,2,10,73,83
42905,2015-12-05,3,3,22,25
42906,2015-12-05,4,0,2,2
42907,2015-12-05,5,1,9,10
42908,2015-12-05,6,3,20,23
42909,2015-12-05,7,5,71,76
42910,2015-12-05,8,15,159,174
42911,2015-12-05,9,30,275,305
42912,2015-12-05,10,74,388,462
42913,2015-12-05,11,108,452,560
42914,2015-12-05,12,159,509,668
42915,2015-12-05,13,193,516,709
42916,2015-12-05,14,199,436,635
42917,2015-12-05,15,206,491,697
42918,2015-12-05,16,155,439,594
42919,2015-12-05,17,108,426,534
42920,2015-12-05,18,53,347,400
42921,2015-12-05,19,40,235,275
42922,2015-12-05,20,28,207,235
42923,2015-12-05,21,28,156,184
42924,2015-12-05,22,15,120,135
42925,2015-12-05,23,14,105,119
42926,2015-12-06,0,8,110,118
42927,2015-12-06,1,4,66,70
42928,2015-12-06,2,6,57,63
42929,2015-12-06,3,5,28,33
42930,2015-12-06,4,2,10,12
42931,2015-12-06,5,0,5,5
42932,2015-12-06,6,2,13,15
42933,2015-12-06,7,7,49,56
42934,2015-12-06,8,17,132,149
42935,2015-12-06,9,38,219,257
42936,2015-12-06,10,94,328,422
42937,2015-12-06,11,117,385,502
42938,2015-12-06,12,146,461,607
42939,2015-12-06,13,140,515,655
42940,2015-12-06,14,140,441,581
42941,2015-12-06,15,131,464,595
42942,2015-12-06,16,79,407,486
42943,2015-12-06,17,61,324,385
42944,2015-12-06,18,25,262,287
42945,2015-12-06,19,35,208,243
42946,2015-12-06,20,11,157,168
42947,2015-12-06,21,19,120,139
42948,2015-12-06,22,12,79,91
42949,2015-12-06,23,5,36,41
42950,2015-12-07,0,4,21,25
42951,2015-12-07,1,0,5,5
42952,2015-12-07,2,1,8,9
42953,2015-12-07,3,0,1,1
42954,2015-12-07,4,1,6,7
42955,2015-12-07,5,0,57,57
42956,2015-12-07,6,5,224,229
42957,2015-12-07,7,8,592,600
42958,2015-12-07,8,14,948,962
42959,2015-12-07,9,21,405,426
42960,2015-12-07,10,33,150,183
42961,2015-12-07,11,51,173,224
42962,2015-12-07,12,61,270,331
42963,2015-12-07,13,63,253,316
42964,2015-12-07,14,61,209,270
42965,2015-12-07,15,57,297,354
42966,2015-12-07,16,58,517,575
42967,2015-12-07,17,43,978,1021
42968,2015-12-07,18,29,873,902
42969,2015-12-07,19,14,576,590
42970,2015-12-07,20,16,374,390
42971,2015-12-07,21,9,236,245
42972,2015-12-07,22,8,115,123
42973,2015-12-07,23,2,81,83
42974,2015-12-08,0,1,56,57
42975,2015-12-08,1,2,12,14
42976,2015-12-08,2,0,4,4
42977,2015-12-08,3,2,2,4
42978,2015-12-08,4,1,5,6
42979,2015-12-08,5,0,73,73
42980,2015-12-08,6,3,234,237
42981,2015-12-08,7,9,696,705
42982,2015-12-08,8,21,1136,1157
42983,2015-12-08,9,17,478,495
42984,2015-12-08,10,19,192,211
42985,2015-12-08,11,55,195,250
42986,2015-12-08,12,49,304,353
42987,2015-12-08,13,51,302,353
42988,2015-12-08,14,56,222,278
42989,2015-12-08,15,46,285,331
42990,2015-12-08,16,37,512,549
42991,2015-12-08,17,40,997,1037
42992,2015-12-08,18,19,877,896
42993,2015-12-08,19,20,531,551
42994,2015-12-08,20,13,363,376
42995,2015-12-08,21,8,255,263
42996,2015-12-08,22,11,166,177
42997,2015-12-08,23,3,78,81
42998,2015-12-09,0,3,30,33
42999,2015-12-09,1,2,11,13
43000,2015-12-09,2,1,6,7
43001,2015-12-09,3,0,1,1
43002,2015-12-09,4,2,6,8
43003,2015-12-09,5,0,79,79
43004,2015-12-09,6,8,252,260
43005,2015-12-09,7,5,653,658
43006,2015-12-09,8,15,1106,1121
43007,2015-12-09,9,11,493,504
43008,2015-12-09,10,20,189,209
43009,2015-12-09,11,23,226,249
43010,2015-12-09,12,16,279,295
43011,2015-12-09,13,26,247,273
43012,2015-12-09,14,22,214,236
43013,2015-12-09,15,34,238,272
43014,2015-12-09,16,32,472,504
43015,2015-12-09,17,23,921,944
43016,2015-12-09,18,18,868,886
43017,2015-12-09,19,13,514,527
43018,2015-12-09,20,11,350,361
43019,2015-12-09,21,9,290,299
43020,2015-12-09,22,5,150,155
43021,2015-12-09,23,2,86,88
43022,2015-12-10,0,1,30,31
43023,2015-12-10,1,1,6,7
43024,2015-12-10,2,1,5,6
43025,2015-12-10,3,3,4,7
43026,2015-12-10,4,0,7,7
43027,2015-12-10,5,0,60,60
43028,2015-12-10,6,2,225,227
43029,2015-12-10,7,7,639,646
43030,2015-12-10,8,22,1079,1101
43031,2015-12-10,9,20,486,506
43032,2015-12-10,10,19,214,233
43033,2015-12-10,11,48,254,302
43034,2015-12-10,12,48,310,358
43035,2015-12-10,13,46,335,381
43036,2015-12-10,14,54,291,345
43037,2015-12-10,15,55,358,413
43038,2015-12-10,16,56,586,642
43039,2015-12-10,17,62,940,1002
43040,2015-12-10,18,33,861,894
43041,2015-12-10,19,22,499,521
43042,2015-12-10,20,19,361,380
43043,2015-12-10,21,22,277,299
43044,2015-12-10,22,12,194,206
43045,2015-12-10,23,8,103,111
43046,2015-12-11,0,7,50,57
43047,2015-12-11,1,2,34,36
43048,2015-12-11,2,0,18,18
43049,2015-12-11,3,0,3,3
43050,2015-12-11,4,0,6,6
43051,2015-12-11,5,1,65,66
43052,2015-12-11,6,4,193,197
43053,2015-12-11,7,14,608,622
43054,2015-12-11,8,28,1050,1078
43055,2015-12-11,9,37,474,511
43056,2015-12-11,10,52,219,271
43057,2015-12-11,11,61,252,313
43058,2015-12-11,12,63,343,406
43059,2015-12-11,13,69,346,415
43060,2015-12-11,14,70,312,382
43061,2015-12-11,15,86,405,491
43062,2015-12-11,16,88,624,712
43063,2015-12-11,17,63,924,987
43064,2015-12-11,18,43,691,734
43065,2015-12-11,19,30,461,491
43066,2015-12-11,20,16,303,319
43067,2015-12-11,21,27,236,263
43068,2015-12-11,22,19,186,205
43069,2015-12-11,23,17,122,139
43070,2015-12-12,0,8,127,135
43071,2015-12-12,1,4,88,92
43072,2015-12-12,2,5,63,68
43073,2015-12-12,3,1,24,25
43074,2015-12-12,4,2,10,12
43075,2015-12-12,5,0,10,10
43076,2015-12-12,6,4,18,22
43077,2015-12-12,7,2,82,84
43078,2015-12-12,8,41,199,240
43079,2015-12-12,9,69,302,371
43080,2015-12-12,10,81,414,495
43081,2015-12-12,11,196,478,674
43082,2015-12-12,12,194,572,766
43083,2015-12-12,13,286,526,812
43084,2015-12-12,14,305,547,852
43085,2015-12-12,15,344,561,905
43086,2015-12-12,16,291,555,846
43087,2015-12-12,17,181,409,590
43088,2015-12-12,18,75,360,435
43089,2015-12-12,19,73,330,403
43090,2015-12-12,20,43,235,278
43091,2015-12-12,21,40,199,239
43092,2015-12-12,22,34,181,215
43093,2015-12-12,23,20,130,150
43094,2015-12-13,0,23,126,149
43095,2015-12-13,1,31,118,149
43096,2015-12-13,2,9,81,90
43097,2015-12-13,3,1,29,30
43098,2015-12-13,4,0,7,7
43099,2015-12-13,5,1,9,10
43100,2015-12-13,6,6,14,20
43101,2015-12-13,7,6,49,55
43102,2015-12-13,8,19,156,175
43103,2015-12-13,9,53,245,298
43104,2015-12-13,10,102,355,457
43105,2015-12-13,11,186,457,643
43106,2015-12-13,12,173,537,710
43107,2015-12-13,13,228,577,805
43108,2015-12-13,14,274,532,806
43109,2015-12-13,15,268,573,841
43110,2015-12-13,16,201,580,781
43111,2015-12-13,17,126,437,563
43112,2015-12-13,18,70,377,447
43113,2015-12-13,19,49,285,334
43114,2015-12-13,20,56,193,249
43115,2015-12-13,21,26,169,195
43116,2015-12-13,22,19,127,146
43117,2015-12-13,23,4,67,71
43118,2015-12-14,0,13,28,41
43119,2015-12-14,1,5,14,19
43120,2015-12-14,2,7,3,10
43121,2015-12-14,3,1,1,2
43122,2015-12-14,4,1,4,5
43123,2015-12-14,5,1,70,71
43124,2015-12-14,6,0,257,257
43125,2015-12-14,7,7,662,669
43126,2015-12-14,8,21,1000,1021
43127,2015-12-14,9,35,439,474
43128,2015-12-14,10,21,178,199
43129,2015-12-14,11,41,192,233
43130,2015-12-14,12,51,301,352
43131,2015-12-14,13,69,243,312
43132,2015-12-14,14,65,239,304
43133,2015-12-14,15,75,284,359
43134,2015-12-14,16,49,449,498
43135,2015-12-14,17,13,269,282
43136,2015-12-14,18,7,481,488
43137,2015-12-14,19,13,341,354
43138,2015-12-14,20,11,227,238
43139,2015-12-14,21,11,229,240
43140,2015-12-14,22,19,114,133
43141,2015-12-14,23,9,75,84
43142,2015-12-15,0,7,28,35
43143,2015-12-15,1,8,26,34
43144,2015-12-15,2,3,6,9
43145,2015-12-15,3,0,2,2
43146,2015-12-15,4,0,6,6
43147,2015-12-15,5,2,80,82
43148,2015-12-15,6,2,272,274
43149,2015-12-15,7,8,779,787
43150,2015-12-15,8,18,1122,1140
43151,2015-12-15,9,23,446,469
43152,2015-12-15,10,33,179,212
43153,2015-12-15,11,53,256,309
43154,2015-12-15,12,62,338,400
43155,2015-12-15,13,47,297,344
43156,2015-12-15,14,46,292,338
43157,2015-12-15,15,46,357,403
43158,2015-12-15,16,36,540,576
43159,2015-12-15,17,50,971,1021
43160,2015-12-15,18,30,862,892
43161,2015-12-15,19,19,553,572
43162,2015-12-15,20,7,380,387
43163,2015-12-15,21,12,237,249
43164,2015-12-15,22,10,170,180
43165,2015-12-15,23,4,78,82
43166,2015-12-16,0,3,33,36
43167,2015-12-16,1,4,15,19
43168,2015-12-16,2,0,4,4
43169,2015-12-16,3,0,4,4
43170,2015-12-16,4,0,8,8
43171,2015-12-16,5,2,73,75
43172,2015-12-16,6,5,263,268
43173,2015-12-16,7,11,688,699
43174,2015-12-16,8,15,1066,1081
43175,2015-12-16,9,18,507,525
43176,2015-12-16,10,55,199,254
43177,2015-12-16,11,47,226,273
43178,2015-12-16,12,41,302,343
43179,2015-12-16,13,47,293,340
43180,2015-12-16,14,69,237,306
43181,2015-12-16,15,75,288,363
43182,2015-12-16,16,64,542,606
43183,2015-12-16,17,53,931,984
43184,2015-12-16,18,30,896,926
43185,2015-12-16,19,20,534,554
43186,2015-12-16,20,13,352,365
43187,2015-12-16,21,13,273,286
43188,2015-12-16,22,8,185,193
43189,2015-12-16,23,2,111,113
43190,2015-12-17,0,4,44,48
43191,2015-12-17,1,0,10,10
43192,2015-12-17,2,1,5,6
43193,2015-12-17,3,1,1,2
43194,2015-12-17,4,0,4,4
43195,2015-12-17,5,1,62,63
43196,2015-12-17,6,2,230,232
43197,2015-12-17,7,4,298,302
43198,2015-12-17,8,4,296,300
43199,2015-12-17,9,9,188,197
43200,2015-12-17,10,6,80,86
43201,2015-12-17,11,6,60,66
43202,2015-12-17,12,4,89,93
43203,2015-12-17,13,5,63,68
43204,2015-12-17,14,1,79,80
43205,2015-12-17,15,1,96,97
43206,2015-12-17,16,6,292,298
43207,2015-12-17,17,12,673,685
43208,2015-12-17,18,16,652,668
43209,2015-12-17,19,6,412,418
43210,2015-12-17,20,14,275,289
43211,2015-12-17,21,10,225,235
43212,2015-12-17,22,13,184,197
43213,2015-12-17,23,9,100,109
43214,2015-12-18,0,13,63,76
43215,2015-12-18,1,0,47,47
43216,2015-12-18,2,2,10,12
43217,2015-12-18,3,0,2,2
43218,2015-12-18,4,1,9,10
43219,2015-12-18,5,0,55,55
43220,2015-12-18,6,0,182,182
43221,2015-12-18,7,5,504,509
43222,2015-12-18,8,20,943,963
43223,2015-12-18,9,15,435,450
43224,2015-12-18,10,27,214,241
43225,2015-12-18,11,47,244,291
43226,2015-12-18,12,30,265,295
43227,2015-12-18,13,29,270,299
43228,2015-12-18,14,28,298,326
43229,2015-12-18,15,37,339,376
43230,2015-12-18,16,33,454,487
43231,2015-12-18,17,18,652,670
43232,2015-12-18,18,17,545,562
43233,2015-12-18,19,7,321,328
43234,2015-12-18,20,2,191,193
43235,2015-12-18,21,6,139,145
43236,2015-12-18,22,7,96,103
43237,2015-12-18,23,0,76,76
43238,2015-12-19,0,2,61,63
43239,2015-12-19,1,2,62,64
43240,2015-12-19,2,1,27,28
43241,2015-12-19,3,0,15,15
43242,2015-12-19,4,0,5,5
43243,2015-12-19,5,0,3,3
43244,2015-12-19,6,0,12,12
43245,2015-12-19,7,3,52,55
43246,2015-12-19,8,5,115,120
43247,2015-12-19,9,20,164,184
43248,2015-12-19,10,32,287,319
43249,2015-12-19,11,67,343,410
43250,2015-12-19,12,56,311,367
43251,2015-12-19,13,72,344,416
43252,2015-12-19,14,68,290,358
43253,2015-12-19,15,54,325,379
43254,2015-12-19,16,57,285,342
43255,2015-12-19,17,39,263,302
43256,2015-12-19,18,23,216,239
43257,2015-12-19,19,7,142,149
43258,2015-12-19,20,10,140,150
43259,2015-12-19,21,9,118,127
43260,2015-12-19,22,2,89,91
43261,2015-12-19,23,2,78,80
43262,2015-12-20,0,4,76,80
43263,2015-12-20,1,3,49,52
43264,2015-12-20,2,1,42,43
43265,2015-12-20,3,2,18,20
43266,2015-12-20,4,2,5,7
43267,2015-12-20,5,3,8,11
43268,2015-12-20,6,2,13,15
43269,2015-12-20,7,2,28,30
43270,2015-12-20,8,2,86,88
43271,2015-12-20,9,8,147,155
43272,2015-12-20,10,45,244,289
43273,2015-12-20,11,61,316,377
43274,2015-12-20,12,51,353,404
43275,2015-12-20,13,82,327,409
43276,2015-12-20,14,82,338,420
43277,2015-12-20,15,78,327,405
43278,2015-12-20,16,60,342,402
43279,2015-12-20,17,36,246,282
43280,2015-12-20,18,13,206,219
43281,2015-12-20,19,15,153,168
43282,2015-12-20,20,12,119,131
43283,2015-12-20,21,5,91,96
43284,2015-12-20,22,5,70,75
43285,2015-12-20,23,0,41,41
43286,2015-12-21,0,3,23,26
43287,2015-12-21,1,1,14,15
43288,2015-12-21,2,0,3,3
43289,2015-12-21,3,0,2,2
43290,2015-12-21,4,0,4,4
43291,2015-12-21,5,0,56,56
43292,2015-12-21,6,1,143,144
43293,2015-12-21,7,7,433,440
43294,2015-12-21,8,14,809,823
43295,2015-12-21,9,26,390,416
43296,2015-12-21,10,38,149,187
43297,2015-12-21,11,54,199,253
43298,2015-12-21,12,48,230,278
43299,2015-12-21,13,67,264,331
43300,2015-12-21,14,53,227,280
43301,2015-12-21,15,38,290,328
43302,2015-12-21,16,52,472,524
43303,2015-12-21,17,62,780,842
43304,2015-12-21,18,41,659,700
43305,2015-12-21,19,40,364,404
43306,2015-12-21,20,15,230,245
43307,2015-12-21,21,12,185,197
43308,2015-12-21,22,14,107,121
43309,2015-12-21,23,5,51,56
43310,2015-12-22,0,2,29,31
43311,2015-12-22,1,4,11,15
43312,2015-12-22,2,2,5,7
43313,2015-12-22,4,1,3,4
43314,2015-12-22,5,1,28,29
43315,2015-12-22,6,0,55,55
43316,2015-12-22,7,2,152,154
43317,2015-12-22,8,4,263,267
43318,2015-12-22,9,7,263,270
43319,2015-12-22,10,13,143,156
43320,2015-12-22,11,33,169,202
43321,2015-12-22,12,35,243,278
43322,2015-12-22,13,34,242,276
43323,2015-12-22,14,55,219,274
43324,2015-12-22,15,38,258,296
43325,2015-12-22,16,66,416,482
43326,2015-12-22,17,26,668,694
43327,2015-12-22,18,11,505,516
43328,2015-12-22,19,11,324,335
43329,2015-12-22,20,22,222,244
43330,2015-12-22,21,19,152,171
43331,2015-12-22,22,4,106,110
43332,2015-12-22,23,6,62,68
43333,2015-12-23,0,11,27,38
43334,2015-12-23,1,5,27,32
43335,2015-12-23,2,0,7,7
43336,2015-12-23,3,0,2,2
43337,2015-12-23,4,1,6,7
43338,2015-12-23,5,0,46,46
43339,2015-12-23,6,1,143,144
43340,2015-12-23,7,0,295,295
43341,2015-12-23,8,2,323,325
43342,2015-12-23,9,4,118,122
43343,2015-12-23,10,4,73,77
43344,2015-12-23,11,6,71,77
43345,2015-12-23,12,11,83,94
43346,2015-12-23,13,5,67,72
43347,2015-12-23,14,6,74,80
43348,2015-12-23,15,8,87,95
43349,2015-12-23,16,2,53,55
43350,2015-12-23,17,3,128,131
43351,2015-12-23,18,6,177,183
43352,2015-12-23,19,5,84,89
43353,2015-12-23,20,3,83,86
43354,2015-12-23,21,3,82,85
43355,2015-12-23,22,7,65,72
43356,2015-12-23,23,8,41,49
43357,2015-12-24,0,3,19,22
43358,2015-12-24,1,5,14,19
43359,2015-12-24,2,7,15,22
43360,2015-12-24,3,2,4,6
43361,2015-12-24,4,0,3,3
43362,2015-12-24,5,0,14,14
43363,2015-12-24,6,0,32,32
43364,2015-12-24,7,0,60,60
43365,2015-12-24,8,2,103,105
43366,2015-12-24,9,15,132,147
43367,2015-12-24,10,24,114,138
43368,2015-12-24,11,33,174,207
43369,2015-12-24,12,62,231,293
43370,2015-12-24,13,36,261,297
43371,2015-12-24,14,29,229,258
43372,2015-12-24,15,74,224,298
43373,2015-12-24,16,72,179,251
43374,2015-12-24,17,26,132,158
43375,2015-12-24,18,10,115,125
43376,2015-12-24,19,7,85,92
43377,2015-12-24,20,15,64,79
43378,2015-12-24,21,24,38,62
43379,2015-12-24,22,11,48,59
43380,2015-12-24,23,8,41,49
43381,2015-12-25,0,2,36,38
43382,2015-12-25,1,0,31,31
43383,2015-12-25,2,3,11,14
43384,2015-12-25,3,1,1,2
43385,2015-12-25,4,1,2,3
43386,2015-12-25,5,0,9,9
43387,2015-12-25,6,1,7,8
43388,2015-12-25,7,2,19,21
43389,2015-12-25,8,8,23,31
43390,2015-12-25,9,25,37,62
43391,2015-12-25,10,45,60,105
43392,2015-12-25,11,122,104,226
43393,2015-12-25,12,112,62,174
43394,2015-12-25,13,126,93,219
43395,2015-12-25,14,101,40,141
43396,2015-12-25,15,28,28,56
43397,2015-12-25,16,27,26,53
43398,2015-12-25,17,21,15,36
43399,2015-12-25,18,9,17,26
43400,2015-12-25,19,13,32,45
43401,2015-12-25,20,20,21,41
43402,2015-12-25,21,24,47,71
43403,2015-12-25,22,27,34,61
43404,2015-12-25,23,12,17,29
43405,2015-12-26,0,5,16,21
43406,2015-12-26,1,5,18,23
43407,2015-12-26,2,1,2,3
43408,2015-12-26,3,0,1,1
43409,2015-12-26,4,1,1,2
43410,2015-12-26,5,0,2,2
43411,2015-12-26,6,0,18,18
43412,2015-12-26,7,5,20,25
43413,2015-12-26,8,11,40,51
43414,2015-12-26,9,45,72,117
43415,2015-12-26,10,73,100,173
43416,2015-12-26,11,133,137,270
43417,2015-12-26,12,131,141,272
43418,2015-12-26,13,133,156,289
43419,2015-12-26,14,105,162,267
43420,2015-12-26,15,105,140,245
43421,2015-12-26,16,93,144,237
43422,2015-12-26,17,45,137,182
43423,2015-12-26,18,27,101,128
43424,2015-12-26,19,39,71,110
43425,2015-12-26,20,27,50,77
43426,2015-12-26,21,22,65,87
43427,2015-12-26,22,12,50,62
43428,2015-12-26,23,11,29,40
43429,2015-12-27,0,3,39,42
43430,2015-12-27,1,1,26,27
43431,2015-12-27,2,3,21,24
43432,2015-12-27,3,2,8,10
43433,2015-12-27,4,1,3,4
43434,2015-12-27,5,0,4,4
43435,2015-12-27,6,0,12,12
43436,2015-12-27,7,5,23,28
43437,2015-12-27,8,25,54,79
43438,2015-12-27,9,71,72,143
43439,2015-12-27,10,143,119,262
43440,2015-12-27,11,160,141,301
43441,2015-12-27,12,209,207,416
43442,2015-12-27,13,245,220,465
43443,2015-12-27,14,286,221,507
43444,2015-12-27,15,327,244,571
43445,2015-12-27,16,275,267,542
43446,2015-12-27,17,187,218,405
43447,2015-12-27,18,113,164,277
43448,2015-12-27,19,60,84,144
43449,2015-12-27,20,51,66,117
43450,2015-12-27,21,27,60,87
43451,2015-12-27,22,34,63,97
43452,2015-12-27,23,21,37,58
43453,2015-12-28,0,3,17,20
43454,2015-12-28,1,11,13,24
43455,2015-12-28,2,0,7,7
43456,2015-12-28,3,0,1,1
43457,2015-12-28,4,0,2,2
43458,2015-12-28,5,0,36,36
43459,2015-12-28,6,0,110,110
43460,2015-12-28,7,5,258,263
43461,2015-12-28,8,27,459,486
43462,2015-12-28,9,44,269,313
43463,2015-12-28,10,61,147,208
43464,2015-12-28,11,108,157,265
43465,2015-12-28,12,121,167,288
43466,2015-12-28,13,110,158,268
43467,2015-12-28,14,79,178,257
43468,2015-12-28,15,72,198,270
43469,2015-12-28,16,69,314,383
43470,2015-12-28,17,52,480,532
43471,2015-12-28,18,28,266,294
43472,2015-12-28,19,28,186,214
43473,2015-12-28,20,8,99,107
43474,2015-12-28,21,5,51,56
43475,2015-12-28,22,5,39,44
43476,2015-12-28,23,1,9,10
43477,2015-12-29,0,1,5,6
43478,2015-12-29,1,1,2,3
43479,2015-12-29,2,1,0,1
43480,2015-12-29,3,1,0,1
43481,2015-12-29,4,0,3,3
43482,2015-12-29,5,0,18,18
43483,2015-12-29,6,0,96,96
43484,2015-12-29,7,0,164,164
43485,2015-12-29,8,15,298,313
43486,2015-12-29,9,26,240,266
43487,2015-12-29,10,43,134,177
43488,2015-12-29,11,64,161,225
43489,2015-12-29,12,78,205,283
43490,2015-12-29,13,103,216,319
43491,2015-12-29,14,119,234,353
43492,2015-12-29,15,118,260,378
43493,2015-12-29,16,139,396,535
43494,2015-12-29,17,85,613,698
43495,2015-12-29,18,71,471,542
43496,2015-12-29,19,42,300,342
43497,2015-12-29,20,26,169,195
43498,2015-12-29,21,39,122,161
43499,2015-12-29,22,18,72,90
43500,2015-12-29,23,14,70,84
43501,2015-12-30,0,3,36,39
43502,2015-12-30,1,7,10,17
43503,2015-12-30,2,0,7,7
43504,2015-12-30,3,0,1,1
43505,2015-12-30,4,0,4,4
43506,2015-12-30,5,1,39,40
43507,2015-12-30,6,1,131,132
43508,2015-12-30,7,15,305,320
43509,2015-12-30,8,30,594,624
43510,2015-12-30,9,66,356,422
43511,2015-12-30,10,92,205,297
43512,2015-12-30,11,126,228,354
43513,2015-12-30,12,136,281,417
43514,2015-12-30,13,131,256,387
43515,2015-12-30,14,97,186,283
43516,2015-12-30,15,90,187,277
43517,2015-12-30,16,68,251,319
43518,2015-12-30,17,54,316,370
43519,2015-12-30,18,37,321,358
43520,2015-12-30,19,32,177,209
43521,2015-12-30,20,19,124,143
43522,2015-12-30,21,19,110,129
43523,2015-12-30,22,10,62,72
43524,2015-12-30,23,4,50,54
43525,2015-12-31,0,6,35,41
43526,2015-12-31,1,3,28,31
43527,2015-12-31,2,1,8,9
43528,2015-12-31,3,1,5,6
43529,2015-12-31,4,0,3,3
43530,2015-12-31,5,0,32,32
43531,2015-12-31,6,0,90,90
43532,2015-12-31,7,7,260,267
43533,2015-12-31,8,15,409,424
43534,2015-12-31,9,37,309,346
43535,2015-12-31,10,86,216,302
43536,2015-12-31,11,139,298,437
43537,2015-12-31,12,176,339,515
43538,2015-12-31,13,179,368,547
43539,2015-12-31,14,182,426,608
43540,2015-12-31,15,132,472,604
43541,2015-12-31,16,113,421,534
43542,2015-12-31,17,64,270,334
43543,2015-12-31,18,51,159,210
43544,2015-12-31,19,25,113,138
43545,2015-12-31,20,19,118,137
43546,2015-12-31,21,9,93,102
43547,2015-12-31,22,30,54,84
43548,2015-12-31,23,16,37,53
43549,2016-01-01,0,9,47,56
43550,2016-01-01,1,12,93,105
43551,2016-01-01,2,15,59,74
43552,2016-01-01,3,5,27,32
43553,2016-01-01,4,5,8,13
43554,2016-01-01,5,2,3,5
43555,2016-01-01,6,1,9,10
43556,2016-01-01,7,3,11,14
43557,2016-01-01,8,9,45,54
43558,2016-01-01,9,31,70,101
43559,2016-01-01,10,40,80,120
43560,2016-01-01,11,95,144,239
43561,2016-01-01,12,89,143,232
43562,2016-01-01,13,106,189,295
43563,2016-01-01,14,125,199,324
43564,2016-01-01,15,124,214,338
43565,2016-01-01,16,125,216,341
43566,2016-01-01,17,77,170,247
43567,2016-01-01,18,36,147,183
43568,2016-01-01,19,34,126,160
43569,2016-01-01,20,18,72,90
43570,2016-01-01,21,20,55,75
43571,2016-01-01,22,10,60,70
43572,2016-01-01,23,7,31,38
43573,2016-01-02,0,7,30,37
43574,2016-01-02,1,12,19,31
43575,2016-01-02,2,1,16,17
43576,2016-01-02,3,4,19,23
43577,2016-01-02,4,3,1,4
43578,2016-01-02,5,0,7,7
43579,2016-01-02,6,0,10,10
43580,2016-01-02,7,7,27,34
43581,2016-01-02,8,14,66,80
43582,2016-01-02,9,41,162,203
43583,2016-01-02,10,75,199,274
43584,2016-01-02,11,131,269,400
43585,2016-01-02,12,178,322,500
43586,2016-01-02,13,187,303,490
43587,2016-01-02,14,197,298,495
43588,2016-01-02,15,198,327,525
43589,2016-01-02,16,201,328,529
43590,2016-01-02,17,129,263,392
43591,2016-01-02,18,39,193,232
43592,2016-01-02,19,25,163,188
43593,2016-01-02,20,30,120,150
43594,2016-01-02,21,17,96,113
43595,2016-01-02,22,8,84,92
43596,2016-01-02,23,18,77,95
43597,2016-01-03,0,14,46,60
43598,2016-01-03,1,6,36,42
43599,2016-01-03,2,7,32,39
43600,2016-01-03,3,6,9,15
43601,2016-01-03,4,1,5,6
43602,2016-01-03,5,1,8,9
43603,2016-01-03,6,0,5,5
43604,2016-01-03,7,1,32,33
43605,2016-01-03,8,12,75,87
43606,2016-01-03,9,31,137,168
43607,2016-01-03,10,78,230,308
43608,2016-01-03,11,109,304,413
43609,2016-01-03,12,124,379,503
43610,2016-01-03,13,176,342,518
43611,2016-01-03,14,189,335,524
43612,2016-01-03,15,170,375,545
43613,2016-01-03,16,147,432,579
43614,2016-01-03,17,91,307,398
43615,2016-01-03,18,23,214,237
43616,2016-01-03,19,25,147,172
43617,2016-01-03,20,10,105,115
43618,2016-01-03,21,10,86,96
43619,2016-01-03,22,7,57,64
43620,2016-01-03,23,3,25,28
43621,2016-01-04,0,2,18,20
43622,2016-01-04,1,2,4,6
43623,2016-01-04,2,0,2,2
43624,2016-01-04,3,0,1,1
43625,2016-01-04,4,0,3,3
43626,2016-01-04,5,1,57,58
43627,2016-01-04,6,2,190,192
43628,2016-01-04,7,3,465,468
43629,2016-01-04,8,7,752,759
43630,2016-01-04,9,11,310,321
43631,2016-01-04,10,39,106,145
43632,2016-01-04,11,30,122,152
43633,2016-01-04,12,32,167,199
43634,2016-01-04,13,27,176,203
43635,2016-01-04,14,19,126,145
43636,2016-01-04,15,31,175,206
43637,2016-01-04,16,24,341,365
43638,2016-01-04,17,18,682,700
43639,2016-01-04,18,7,540,547
43640,2016-01-04,19,9,284,293
43641,2016-01-04,20,1,145,146
43642,2016-01-04,21,3,93,96
43643,2016-01-04,22,4,58,62
43644,2016-01-04,23,2,42,44
43645,2016-01-05,0,0,5,5
43646,2016-01-05,1,2,3,5
43647,2016-01-05,2,2,1,3
43648,2016-01-05,3,0,1,1
43649,2016-01-05,4,0,2,2
43650,2016-01-05,5,0,42,42
43651,2016-01-05,6,0,131,131
43652,2016-01-05,7,2,361,363
43653,2016-01-05,8,12,671,683
43654,2016-01-05,9,14,315,329
43655,2016-01-05,10,19,127,146
43656,2016-01-05,11,18,125,143
43657,2016-01-05,12,18,133,151
43658,2016-01-05,13,30,163,193
43659,2016-01-05,14,25,149,174
43660,2016-01-05,15,28,181,209
43661,2016-01-05,16,23,342,365
43662,2016-01-05,17,23,653,676
43663,2016-01-05,18,6,513,519
43664,2016-01-05,19,1,278,279
43665,2016-01-05,20,3,175,178
43666,2016-01-05,21,2,120,122
43667,2016-01-05,22,9,76,85
43668,2016-01-05,23,12,34,46
43669,2016-01-06,0,0,10,10
43670,2016-01-06,1,0,1,1
43671,2016-01-06,2,0,2,2
43672,2016-01-06,4,0,1,1
43673,2016-01-06,5,0,57,57
43674,2016-01-06,6,1,173,174
43675,2016-01-06,7,1,418,419
43676,2016-01-06,8,4,795,799
43677,2016-01-06,9,7,384,391
43678,2016-01-06,10,17,139,156
43679,2016-01-06,11,13,136,149
43680,2016-01-06,12,17,188,205
43681,2016-01-06,13,29,188,217
43682,2016-01-06,14,38,140,178
43683,2016-01-06,15,30,191,221
43684,2016-01-06,16,27,365,392
43685,2016-01-06,17,24,746,770
43686,2016-01-06,18,6,639,645
43687,2016-01-06,19,6,369,375
43688,2016-01-06,20,9,226,235
43689,2016-01-06,21,8,159,167
43690,2016-01-06,22,11,89,100
43691,2016-01-06,23,5,43,48
43692,2016-01-07,0,6,15,21
43693,2016-01-07,1,0,9,9
43694,2016-01-07,2,0,4,4
43695,2016-01-07,4,0,2,2
43696,2016-01-07,5,0,51,51
43697,2016-01-07,6,0,184,184
43698,2016-01-07,7,3,508,511
43699,2016-01-07,8,17,925,942
43700,2016-01-07,9,8,420,428
43701,2016-01-07,10,27,157,184
43702,2016-01-07,11,25,172,197
43703,2016-01-07,12,33,225,258
43704,2016-01-07,13,32,221,253
43705,2016-01-07,14,36,170,206
43706,2016-01-07,15,31,252,283
43707,2016-01-07,16,36,393,429
43708,2016-01-07,17,29,796,825
43709,2016-01-07,18,31,701,732
43710,2016-01-07,19,18,413,431
43711,2016-01-07,20,12,255,267
43712,2016-01-07,21,17,194,211
43713,2016-01-07,22,8,92,100
43714,2016-01-07,23,2,62,64
43715,2016-01-08,0,0,17,17
43716,2016-01-08,1,1,13,14
43717,2016-01-08,2,0,6,6
43718,2016-01-08,3,1,4,5
43719,2016-01-08,4,0,2,2
43720,2016-01-08,5,1,46,47
43721,2016-01-08,6,0,169,169
43722,2016-01-08,7,3,470,473
43723,2016-01-08,8,9,894,903
43724,2016-01-08,9,19,424,443
43725,2016-01-08,10,12,154,166
43726,2016-01-08,11,15,179,194
43727,2016-01-08,12,48,216,264
43728,2016-01-08,13,22,236,258
43729,2016-01-08,14,27,226,253
43730,2016-01-08,15,43,230,273
43731,2016-01-08,16,30,369,399
43732,2016-01-08,17,33,657,690
43733,2016-01-08,18,24,583,607
43734,2016-01-08,19,18,314,332
43735,2016-01-08,20,9,211,220
43736,2016-01-08,21,17,161,178
43737,2016-01-08,22,13,124,137
43738,2016-01-08,23,2,100,102
43739,2016-01-09,0,3,93,96
43740,2016-01-09,1,1,53,54
43741,2016-01-09,2,0,37,37
43742,2016-01-09,3,1,19,20
43743,2016-01-09,4,1,7,8
43744,2016-01-09,5,0,5,5
43745,2016-01-09,6,0,10,10
43746,2016-01-09,7,2,81,83
43747,2016-01-09,8,7,134,141
43748,2016-01-09,9,11,217,228
43749,2016-01-09,10,39,294,333
43750,2016-01-09,11,41,357,398
43751,2016-01-09,12,70,413,483
43752,2016-01-09,13,89,387,476
43753,2016-01-09,14,87,355,442
43754,2016-01-09,15,99,408,507
43755,2016-01-09,16,90,395,485
43756,2016-01-09,17,88,349,437
43757,2016-01-09,18,60,292,352
43758,2016-01-09,19,27,255,282
43759,2016-01-09,20,29,191,220
43760,2016-01-09,21,16,121,137
43761,2016-01-09,22,1,34,35
43762,2016-01-09,23,3,41,44
43763,2016-01-10,0,0,36,36
43764,2016-01-10,1,0,24,24
43765,2016-01-10,2,2,24,26
43766,2016-01-10,3,2,6,8
43767,2016-01-10,4,0,2,2
43768,2016-01-10,5,0,4,4
43769,2016-01-10,6,2,13,15
43770,2016-01-10,7,5,28,33
43771,2016-01-10,8,15,91,106
43772,2016-01-10,9,20,187,207
43773,2016-01-10,10,47,295,342
43774,2016-01-10,11,76,395,471
43775,2016-01-10,12,129,526,655
43776,2016-01-10,13,140,526,666
43777,2016-01-10,14,141,525,666
43778,2016-01-10,15,128,501,629
43779,2016-01-10,16,95,409,504
43780,2016-01-10,17,63,316,379
43781,2016-01-10,18,26,257,283
43782,2016-01-10,19,25,161,186
43783,2016-01-10,20,18,173,191
43784,2016-01-10,21,9,108,117
43785,2016-01-10,22,11,69,80
43786,2016-01-10,23,2,30,32
43787,2016-01-11,0,5,15,20
43788,2016-01-11,1,0,4,4
43789,2016-01-11,2,0,4,4
43790,2016-01-11,3,0,3,3
43791,2016-01-11,4,0,5,5
43792,2016-01-11,5,0,49,49
43793,2016-01-11,6,4,192,196
43794,2016-01-11,7,13,463,476
43795,2016-01-11,8,16,814,830
43796,2016-01-11,9,15,378,393
43797,2016-01-11,10,22,143,165
43798,2016-01-11,11,25,153,178
43799,2016-01-11,12,44,213,257
43800,2016-01-11,13,41,192,233
43801,2016-01-11,14,30,199,229
43802,2016-01-11,15,50,208,258
43803,2016-01-11,16,39,398,437
43804,2016-01-11,17,46,780,826
43805,2016-01-11,18,21,659,680
43806,2016-01-11,19,19,433,452
43807,2016-01-11,20,12,263,275
43808,2016-01-11,21,12,150,162
43809,2016-01-11,22,5,100,105
43810,2016-01-11,23,9,48,57
43811,2016-01-12,0,5,29,34
43812,2016-01-12,1,1,8,9
43813,2016-01-12,2,0,4,4
43814,2016-01-12,3,0,1,1
43815,2016-01-12,4,0,4,4
43816,2016-01-12,5,0,55,55
43817,2016-01-12,6,3,212,215
43818,2016-01-12,7,17,535,552
43819,2016-01-12,8,20,925,945
43820,2016-01-12,9,14,397,411
43821,2016-01-12,10,20,136,156
43822,2016-01-12,11,26,167,193
43823,2016-01-12,12,37,219,256
43824,2016-01-12,13,28,192,220
43825,2016-01-12,14,30,166,196
43826,2016-01-12,15,41,230,271
43827,2016-01-12,16,29,420,449
43828,2016-01-12,17,39,815,854
43829,2016-01-12,18,39,739,778
43830,2016-01-12,19,17,332,349
43831,2016-01-12,20,6,226,232
43832,2016-01-12,21,8,132,140
43833,2016-01-12,22,4,92,96
43834,2016-01-12,23,3,67,70
43835,2016-01-13,0,3,11,14
43836,2016-01-13,1,1,6,7
43837,2016-01-13,2,0,3,3
43838,2016-01-13,4,0,6,6
43839,2016-01-13,5,1,52,53
43840,2016-01-13,6,2,177,179
43841,2016-01-13,7,17,438,455
43842,2016-01-13,8,12,797,809
43843,2016-01-13,9,18,380,398
43844,2016-01-13,10,23,151,174
43845,2016-01-13,11,19,153,172
43846,2016-01-13,12,23,181,204
43847,2016-01-13,13,28,163,191
43848,2016-01-13,14,28,142,170
43849,2016-01-13,15,23,193,216
43850,2016-01-13,16,18,345,363
43851,2016-01-13,17,20,675,695
43852,2016-01-13,18,10,603,613
43853,2016-01-13,19,9,344,353
43854,2016-01-13,20,6,212,218
43855,2016-01-13,21,6,187,193
43856,2016-01-13,22,2,80,82
43857,2016-01-13,23,1,49,50
43858,2016-01-14,0,5,20,25
43859,2016-01-14,1,2,7,9
43860,2016-01-14,2,0,4,4
43861,2016-01-14,3,0,1,1
43862,2016-01-14,4,1,2,3
43863,2016-01-14,5,0,49,49
43864,2016-01-14,6,1,186,187
43865,2016-01-14,7,4,510,514
43866,2016-01-14,8,20,863,883
43867,2016-01-14,9,24,402,426
43868,2016-01-14,10,17,138,155
43869,2016-01-14,11,19,175,194
43870,2016-01-14,12,50,234,284
43871,2016-01-14,13,52,213,265
43872,2016-01-14,14,51,190,241
43873,2016-01-14,15,41,292,333
43874,2016-01-14,16,45,438,483
43875,2016-01-14,17,56,881,937
43876,2016-01-14,18,20,777,797
43877,2016-01-14,19,15,478,493
43878,2016-01-14,20,20,362,382
43879,2016-01-14,21,19,229,248
43880,2016-01-14,22,6,146,152
43881,2016-01-14,23,10,88,98
43882,2016-01-15,0,6,30,36
43883,2016-01-15,1,3,18,21
43884,2016-01-15,2,6,10,16
43885,2016-01-15,3,1,3,4
43886,2016-01-15,4,0,3,3
43887,2016-01-15,5,0,52,52
43888,2016-01-15,6,1,165,166
43889,2016-01-15,7,5,486,491
43890,2016-01-15,8,13,964,977
43891,2016-01-15,9,19,427,446
43892,2016-01-15,10,27,205,232
43893,2016-01-15,11,35,237,272
43894,2016-01-15,12,44,303,347
43895,2016-01-15,13,56,269,325
43896,2016-01-15,14,62,272,334
43897,2016-01-15,15,67,338,405
43898,2016-01-15,16,87,528,615
43899,2016-01-15,17,41,634,675
43900,2016-01-15,18,13,252,265
43901,2016-01-15,19,2,108,110
43902,2016-01-15,20,3,72,75
43903,2016-01-15,21,4,50,54
43904,2016-01-15,22,9,35,44
43905,2016-01-15,23,2,16,18
43906,2016-01-16,0,0,29,29
43907,2016-01-16,1,3,36,39
43908,2016-01-16,2,4,24,28
43909,2016-01-16,3,2,5,7
43910,2016-01-16,4,2,8,10
43911,2016-01-16,5,2,5,7
43912,2016-01-16,6,5,15,20
43913,2016-01-16,7,1,52,53
43914,2016-01-16,8,5,144,149
43915,2016-01-16,9,27,234,261
43916,2016-01-16,10,60,297,357
43917,2016-01-16,11,128,379,507
43918,2016-01-16,12,165,489,654
43919,2016-01-16,13,207,426,633
43920,2016-01-16,14,220,408,628
43921,2016-01-16,15,189,409,598
43922,2016-01-16,16,145,376,521
43923,2016-01-16,17,96,279,375
43924,2016-01-16,18,64,229,293
43925,2016-01-16,19,45,177,222
43926,2016-01-16,20,27,155,182
43927,2016-01-16,21,14,102,116
43928,2016-01-16,22,17,109,126
43929,2016-01-16,23,8,84,92
43930,2016-01-17,0,16,57,73
43931,2016-01-17,1,5,44,49
43932,2016-01-17,2,3,52,55
43933,2016-01-17,3,12,25,37
43934,2016-01-17,4,0,7,7
43935,2016-01-17,5,0,6,6
43936,2016-01-17,6,5,11,16
43937,2016-01-17,7,5,30,35
43938,2016-01-17,8,8,73,81
43939,2016-01-17,9,24,168,192
43940,2016-01-17,10,81,241,322
43941,2016-01-17,11,82,254,336
43942,2016-01-17,12,62,249,311
43943,2016-01-17,13,44,151,195
43944,2016-01-17,14,27,130,157
43945,2016-01-17,15,35,219,254
43946,2016-01-17,16,64,263,327
43947,2016-01-17,17,56,186,242
43948,2016-01-17,18,27,160,187
43949,2016-01-17,19,14,133,147
43950,2016-01-17,20,9,124,133
43951,2016-01-17,21,19,83,102
43952,2016-01-17,22,8,82,90
43953,2016-01-17,23,0,46,46
43954,2016-01-18,0,2,34,36
43955,2016-01-18,1,2,20,22
43956,2016-01-18,2,0,9,9
43957,2016-01-18,3,0,5,5
43958,2016-01-18,4,1,1,2
43959,2016-01-18,5,0,20,20
43960,2016-01-18,6,5,30,35
43961,2016-01-18,7,2,66,68
43962,2016-01-18,8,7,121,128
43963,2016-01-18,9,10,118,128
43964,2016-01-18,10,20,130,150
43965,2016-01-18,11,15,186,201
43966,2016-01-18,12,17,180,197
43967,2016-01-18,13,15,216,231
43968,2016-01-18,14,13,173,186
43969,2016-01-18,15,7,192,199
43970,2016-01-18,16,11,181,192
43971,2016-01-18,17,5,216,221
43972,2016-01-18,18,4,146,150
43973,2016-01-18,19,4,120,124
43974,2016-01-18,20,0,79,79
43975,2016-01-18,21,0,51,51
43976,2016-01-18,22,0,46,46
43977,2016-01-18,23,2,17,19
43978,2016-01-19,0,0,5,5
43979,2016-01-19,1,0,3,3
43980,2016-01-19,2,0,1,1
43981,2016-01-19,4,0,3,3
43982,2016-01-19,5,0,41,41
43983,2016-01-19,6,2,114,116
43984,2016-01-19,7,4,316,320
43985,2016-01-19,8,5,583,588
43986,2016-01-19,9,0,310,310
43987,2016-01-19,10,2,108,110
43988,2016-01-19,11,5,84,89
43989,2016-01-19,12,2,126,128
43990,2016-01-19,13,4,114,118
43991,2016-01-19,14,6,109,115
43992,2016-01-19,15,1,140,141
43993,2016-01-19,16,6,227,233
43994,2016-01-19,17,8,508,516
43995,2016-01-19,18,3,446,449
43996,2016-01-19,19,3,283,286
43997,2016-01-19,20,3,129,132
43998,2016-01-19,21,0,126,126
43999,2016-01-19,22,1,51,52
44000,2016-01-19,23,2,28,30
44001,2016-01-20,0,0,12,12
44002,2016-01-20,1,0,2,2
44003,2016-01-20,2,0,1,1
44004,2016-01-20,3,0,1,1
44005,2016-01-20,4,1,8,9
44006,2016-01-20,5,0,42,42
44007,2016-01-20,6,2,154,156
44008,2016-01-20,7,2,370,372
44009,2016-01-20,8,3,694,697
44010,2016-01-20,9,8,324,332
44011,2016-01-20,10,2,136,138
44012,2016-01-20,11,0,159,159
44013,2016-01-20,12,8,167,175
44014,2016-01-20,13,5,166,171
44015,2016-01-20,14,5,152,157
44016,2016-01-20,15,3,185,188
44017,2016-01-20,16,6,326,332
44018,2016-01-20,17,8,573,581
44019,2016-01-20,18,2,422,424
44020,2016-01-20,19,1,129,130
44021,2016-01-20,20,2,101,103
44022,2016-01-20,21,1,64,65
44023,2016-01-20,22,3,41,44
44024,2016-01-20,23,2,28,30
44025,2016-01-21,0,1,9,10
44026,2016-01-21,1,1,2,3
44027,2016-01-21,4,0,1,1
44028,2016-01-21,5,0,29,29
44029,2016-01-21,6,0,83,83
44030,2016-01-21,7,0,181,181
44031,2016-01-21,8,1,404,405
44032,2016-01-21,9,1,259,260
44033,2016-01-21,10,1,124,125
44034,2016-01-21,11,1,129,130
44035,2016-01-21,12,8,154,162
44036,2016-01-21,13,3,171,174
44037,2016-01-21,14,5,166,171
44038,2016-01-21,15,3,207,210
44039,2016-01-21,16,22,313,335
44040,2016-01-21,17,3,560,563
44041,2016-01-21,18,2,494,496
44042,2016-01-21,19,2,282,284
44043,2016-01-21,20,3,267,270
44044,2016-01-21,21,7,154,161
44045,2016-01-21,22,2,115,117
44046,2016-01-21,23,5,53,58
44047,2016-01-22,0,3,28,31
44048,2016-01-22,1,0,10,10
44049,2016-01-22,2,0,17,17
44050,2016-01-22,3,1,2,3
44051,2016-01-22,4,0,3,3
44052,2016-01-22,5,1,41,42
44053,2016-01-22,6,1,114,115
44054,2016-01-22,7,0,247,247
44055,2016-01-22,8,4,530,534
44056,2016-01-22,9,4,299,303
44057,2016-01-22,10,5,197,202
44058,2016-01-22,11,13,334,347
44059,2016-01-22,12,14,487,501
44060,2016-01-22,13,5,363,368
44061,2016-01-22,14,5,121,126
44062,2016-01-22,15,2,51,53
44063,2016-01-22,16,4,33,37
44064,2016-01-22,17,0,30,30
44065,2016-01-22,18,0,16,16
44066,2016-01-27,15,0,3,3
44067,2016-01-27,16,1,37,38
44068,2016-01-27,17,0,149,149
44069,2016-01-27,18,1,125,126
44070,2016-01-27,19,0,76,76
44071,2016-01-27,20,0,41,41
44072,2016-01-27,21,1,52,53
44073,2016-01-27,22,0,29,29
44074,2016-01-27,23,0,13,13
44075,2016-01-28,1,0,1,1
44076,2016-01-28,5,0,13,13
44077,2016-01-28,6,0,29,29
44078,2016-01-28,7,0,78,78
44079,2016-01-28,8,0,173,173
44080,2016-01-28,9,3,130,133
44081,2016-01-28,10,4,64,68
44082,2016-01-28,11,0,70,70
44083,2016-01-28,12,2,62,64
44084,2016-01-28,13,3,69,72
44085,2016-01-28,14,3,69,72
44086,2016-01-28,15,3,74,77
44087,2016-01-28,16,5,158,163
44088,2016-01-28,17,4,305,309
44089,2016-01-28,18,4,266,270
44090,2016-01-28,19,1,145,146
44091,2016-01-28,20,2,101,103
44092,2016-01-28,21,1,82,83
44093,2016-01-28,22,2,63,65
44094,2016-01-28,23,1,32,33
44095,2016-01-29,0,0,13,13
44096,2016-01-29,1,1,5,6
44097,2016-01-29,2,0,5,5
44098,2016-01-29,3,0,1,1
44099,2016-01-29,4,0,1,1
44100,2016-01-29,5,0,21,21
44101,2016-01-29,6,0,60,60
44102,2016-01-29,7,0,176,176
44103,2016-01-29,8,2,356,358
44104,2016-01-29,9,4,238,242
44105,2016-01-29,10,8,91,99
44106,2016-01-29,11,10,105,115
44107,2016-01-29,12,8,122,130
44108,2016-01-29,13,4,107,111
44109,2016-01-29,14,7,94,101
44110,2016-01-29,15,10,132,142
44111,2016-01-29,16,10,232,242
44112,2016-01-29,17,11,355,366
44113,2016-01-29,18,4,277,281
44114,2016-01-29,19,3,184,187
44115,2016-01-29,20,4,111,115
44116,2016-01-29,21,2,65,67
44117,2016-01-29,22,1,51,52
44118,2016-01-29,23,5,46,51
44119,2016-01-30,0,1,27,28
44120,2016-01-30,1,0,36,36
44121,2016-01-30,2,0,15,15
44122,2016-01-30,3,0,5,5
44123,2016-01-30,4,0,3,3
44124,2016-01-30,5,0,3,3
44125,2016-01-30,6,0,7,7
44126,2016-01-30,7,1,35,36
44127,2016-01-30,8,1,80,81
44128,2016-01-30,9,4,104,108
44129,2016-01-30,10,23,147,170
44130,2016-01-30,11,21,175,196
44131,2016-01-30,12,30,189,219
44132,2016-01-30,13,28,215,243
44133,2016-01-30,14,39,204,243
44134,2016-01-30,15,45,240,285
44135,2016-01-30,16,40,212,252
44136,2016-01-30,17,35,191,226
44137,2016-01-30,18,13,181,194
44138,2016-01-30,19,7,130,137
44139,2016-01-30,20,20,91,111
44140,2016-01-30,21,2,77,79
44141,2016-01-30,22,5,70,75
44142,2016-01-30,23,6,64,70
44143,2016-01-31,0,2,52,54
44144,2016-01-31,1,1,33,34
44145,2016-01-31,2,1,25,26
44146,2016-01-31,3,3,18,21
44147,2016-01-31,4,0,5,5
44148,2016-01-31,5,0,2,2
44149,2016-01-31,6,0,6,6
44150,2016-01-31,7,1,22,23
44151,2016-01-31,8,5,67,72
44152,2016-01-31,9,13,115,128
44153,2016-01-31,10,38,160,198
44154,2016-01-31,11,43,225,268
44155,2016-01-31,12,51,260,311
44156,2016-01-31,13,71,283,354
44157,2016-01-31,14,57,321,378
44158,2016-01-31,15,91,347,438
44159,2016-01-31,16,46,281,327
44160,2016-01-31,17,25,259,284
44161,2016-01-31,18,8,207,215
44162,2016-01-31,19,3,148,151
44163,2016-01-31,20,3,124,127
44164,2016-01-31,21,8,78,86
44165,2016-01-31,22,2,72,74
44166,2016-01-31,23,5,24,29
44167,2016-02-01,0,8,11,19
44168,2016-02-01,1,4,5,9
44169,2016-02-01,2,1,3,4
44170,2016-02-01,3,1,1,2
44171,2016-02-01,4,1,2,3
44172,2016-02-01,5,0,57,57
44173,2016-02-01,6,0,149,149
44174,2016-02-01,7,5,434,439
44175,2016-02-01,8,2,665,667
44176,2016-02-01,9,7,310,317
44177,2016-02-01,10,27,124,151
44178,2016-02-01,11,17,150,167
44179,2016-02-01,12,19,186,205
44180,2016-02-01,13,28,166,194
44181,2016-02-01,14,12,93,105
44182,2016-02-01,15,2,67,69
44183,2016-02-01,16,6,201,207
44184,2016-02-01,17,18,506,524
44185,2016-02-01,18,5,428,433
44186,2016-02-01,19,3,331,334
44187,2016-02-01,20,7,217,224
44188,2016-02-01,21,7,160,167
44189,2016-02-01,22,6,85,91
44190,2016-02-01,23,4,63,67
44191,2016-02-02,0,0,17,17
44192,2016-02-02,1,0,5,5
44193,2016-02-02,2,0,6,6
44194,2016-02-02,4,0,4,4
44195,2016-02-02,5,2,64,66
44196,2016-02-02,6,1,216,217
44197,2016-02-02,7,5,539,544
44198,2016-02-02,8,7,909,916
44199,2016-02-02,9,7,364,371
44200,2016-02-02,10,5,167,172
44201,2016-02-02,11,16,162,178
44202,2016-02-02,12,24,242,266
44203,2016-02-02,13,24,197,221
44204,2016-02-02,14,27,195,222
44205,2016-02-02,15,26,245,271
44206,2016-02-02,16,23,410,433
44207,2016-02-02,17,27,824,851
44208,2016-02-02,18,7,698,705
44209,2016-02-02,19,13,438,451
44210,2016-02-02,20,1,261,262
44211,2016-02-02,21,5,213,218
44212,2016-02-02,22,3,128,131
44213,2016-02-02,23,4,53,57
44214,2016-02-03,0,1,22,23
44215,2016-02-03,1,1,5,6
44216,2016-02-03,2,0,1,1
44217,2016-02-03,4,0,6,6
44218,2016-02-03,5,0,62,62
44219,2016-02-03,6,1,199,200
44220,2016-02-03,7,2,478,480
44221,2016-02-03,8,5,697,702
44222,2016-02-03,9,2,222,224
44223,2016-02-03,10,5,128,133
44224,2016-02-03,11,3,130,133
44225,2016-02-03,12,2,84,86
44226,2016-02-03,13,0,27,27
44227,2016-02-03,14,2,44,46
44228,2016-02-03,15,3,64,67
44229,2016-02-03,16,6,159,165
44230,2016-02-03,17,3,363,366
44231,2016-02-03,18,11,490,501
44232,2016-02-03,19,10,357,367
44233,2016-02-03,20,5,248,253
44234,2016-02-03,21,2,173,175
44235,2016-02-03,22,6,152,158
44236,2016-02-03,23,2,60,62
44237,2016-02-04,0,5,15,20
44238,2016-02-04,1,0,8,8
44239,2016-02-04,3,0,1,1
44240,2016-02-04,4,0,2,2
44241,2016-02-04,5,0,60,60
44242,2016-02-04,6,2,199,201
44243,2016-02-04,7,3,554,557
44244,2016-02-04,8,10,924,934
44245,2016-02-04,9,16,366,382
44246,2016-02-04,10,12,160,172
44247,2016-02-04,11,11,188,199
44248,2016-02-04,12,20,206,226
44249,2016-02-04,13,20,211,231
44250,2016-02-04,14,37,172,209
44251,2016-02-04,15,31,235,266
44252,2016-02-04,16,42,409,451
44253,2016-02-04,17,24,778,802
44254,2016-02-04,18,18,765,783
44255,2016-02-04,19,9,444,453
44256,2016-02-04,20,15,287,302
44257,2016-02-04,21,11,193,204
44258,2016-02-04,22,9,150,159
44259,2016-02-04,23,6,63,69
44260,2016-02-05,0,6,22,28
44261,2016-02-05,1,1,10,11
44262,2016-02-05,2,0,6,6
44263,2016-02-05,4,1,3,4
44264,2016-02-05,5,0,40,40
44265,2016-02-05,6,4,141,145
44266,2016-02-05,7,2,307,309
44267,2016-02-05,8,19,742,761
44268,2016-02-05,9,8,385,393
44269,2016-02-05,10,22,173,195
44270,2016-02-05,11,26,173,199
44271,2016-02-05,12,38,217,255
44272,2016-02-05,13,37,235,272
44273,2016-02-05,14,44,226,270
44274,2016-02-05,15,48,234,282
44275,2016-02-05,16,28,428,456
44276,2016-02-05,17,37,696,733
44277,2016-02-05,18,18,574,592
44278,2016-02-05,19,8,304,312
44279,2016-02-05,20,12,187,199
44280,2016-02-05,21,6,148,154
44281,2016-02-05,22,9,100,109
44282,2016-02-05,23,8,89,97
44283,2016-02-06,0,6,68,74
44284,2016-02-06,1,5,47,52
44285,2016-02-06,2,2,26,28
44286,2016-02-06,3,5,11,16
44287,2016-02-06,4,3,5,8
44288,2016-02-06,5,0,1,1
44289,2016-02-06,6,0,14,14
44290,2016-02-06,7,8,67,75
44291,2016-02-06,8,11,151,162
44292,2016-02-06,9,31,224,255
44293,2016-02-06,10,36,284,320
44294,2016-02-06,11,63,351,414
44295,2016-02-06,12,84,383,467
44296,2016-02-06,13,92,349,441
44297,2016-02-06,14,90,391,481
44298,2016-02-06,15,85,366,451
44299,2016-02-06,16,80,327,407
44300,2016-02-06,17,92,270,362
44301,2016-02-06,18,50,242,292
44302,2016-02-06,19,16,194,210
44303,2016-02-06,20,5,151,156
44304,2016-02-06,21,6,130,136
44305,2016-02-06,22,11,114,125
44306,2016-02-06,23,6,88,94
44307,2016-02-07,0,6,65,71
44308,2016-02-07,1,7,65,72
44309,2016-02-07,2,4,43,47
44310,2016-02-07,3,2,28,30
44311,2016-02-07,4,1,5,6
44312,2016-02-07,5,0,5,5
44313,2016-02-07,6,2,14,16
44314,2016-02-07,7,6,31,37
44315,2016-02-07,8,9,96,105
44316,2016-02-07,9,32,155,187
44317,2016-02-07,10,63,245,308
44318,2016-02-07,11,80,313,393
44319,2016-02-07,12,63,337,400
44320,2016-02-07,13,69,372,441
44321,2016-02-07,14,61,349,410
44322,2016-02-07,15,57,317,374
44323,2016-02-07,16,75,363,438
44324,2016-02-07,17,36,363,399
44325,2016-02-07,18,27,262,289
44326,2016-02-07,19,6,90,96
44327,2016-02-07,20,16,95,111
44328,2016-02-07,21,26,81,107
44329,2016-02-07,22,10,207,217
44330,2016-02-07,23,13,91,104
44331,2016-02-08,0,2,16,18
44332,2016-02-08,1,0,3,3
44333,2016-02-08,2,2,3,5
44334,2016-02-08,4,0,4,4
44335,2016-02-08,5,1,46,47
44336,2016-02-08,6,1,154,155
44337,2016-02-08,7,5,498,503
44338,2016-02-08,8,8,896,904
44339,2016-02-08,9,24,347,371
44340,2016-02-08,10,13,138,151
44341,2016-02-08,11,26,169,195
44342,2016-02-08,12,30,215,245
44343,2016-02-08,13,19,214,233
44344,2016-02-08,14,33,181,214
44345,2016-02-08,15,27,212,239
44346,2016-02-08,16,25,403,428
44347,2016-02-08,17,20,807,827
44348,2016-02-08,18,7,686,693
44349,2016-02-08,19,8,323,331
44350,2016-02-08,20,6,184,190
44351,2016-02-08,21,6,147,153
44352,2016-02-08,22,3,48,51
44353,2016-02-08,23,0,34,34
44354,2016-02-09,0,0,15,15
44355,2016-02-09,1,0,4,4
44356,2016-02-09,3,0,2,2
44357,2016-02-09,4,0,2,2
44358,2016-02-09,5,0,31,31
44359,2016-02-09,6,1,69,70
44360,2016-02-09,7,1,184,185
44361,2016-02-09,8,3,454,457
44362,2016-02-09,9,2,199,201
44363,2016-02-09,10,4,90,94
44364,2016-02-09,11,10,64,74
44365,2016-02-09,12,6,91,97
44366,2016-02-09,13,4,94,98
44367,2016-02-09,14,15,107,122
44368,2016-02-09,15,1,167,168
44369,2016-02-09,16,15,293,308
44370,2016-02-09,17,15,677,692
44371,2016-02-09,18,10,560,570
44372,2016-02-09,19,5,335,340
44373,2016-02-09,20,3,222,225
44374,2016-02-09,21,5,159,164
44375,2016-02-09,22,7,82,89
44376,2016-02-09,23,4,41,45
44377,2016-02-10,0,1,16,17
44378,2016-02-10,1,0,7,7
44379,2016-02-10,2,0,2,2
44380,2016-02-10,4,0,3,3
44381,2016-02-10,5,0,41,41
44382,2016-02-10,6,0,163,163
44383,2016-02-10,7,0,464,464
44384,2016-02-10,8,6,806,812
44385,2016-02-10,9,12,397,409
44386,2016-02-10,10,10,144,154
44387,2016-02-10,11,19,156,175
44388,2016-02-10,12,20,197,217
44389,2016-02-10,13,15,201,216
44390,2016-02-10,14,27,181,208
44391,2016-02-10,15,14,185,199
44392,2016-02-10,16,24,366,390
44393,2016-02-10,17,21,662,683
44394,2016-02-10,18,6,561,567
44395,2016-02-10,19,4,320,324
44396,2016-02-10,20,3,205,208
44397,2016-02-10,21,1,124,125
44398,2016-02-10,22,1,69,70
44399,2016-02-10,23,0,39,39
44400,2016-02-11,0,0,10,10
44401,2016-02-11,1,0,2,2
44402,2016-02-11,2,0,2,2
44403,2016-02-11,3,0,1,1
44404,2016-02-11,4,0,4,4
44405,2016-02-11,5,0,39,39
44406,2016-02-11,6,1,114,115
44407,2016-02-11,7,2,347,349
44408,2016-02-11,8,7,625,632
44409,2016-02-11,9,3,323,326
44410,2016-02-11,10,6,114,120
44411,2016-02-11,11,6,131,137
44412,2016-02-11,12,13,143,156
44413,2016-02-11,13,13,150,163
44414,2016-02-11,14,4,102,106
44415,2016-02-11,15,7,130,137
44416,2016-02-11,16,9,277,286
44417,2016-02-11,17,9,524,533
44418,2016-02-11,18,5,440,445
44419,2016-02-11,19,1,281,282
44420,2016-02-11,20,3,169,172
44421,2016-02-11,21,2,113,115
44422,2016-02-11,22,0,77,77
44423,2016-02-11,23,0,37,37
44424,2016-02-12,0,0,22,22
44425,2016-02-12,1,1,7,8
44426,2016-02-12,2,0,1,1
44427,2016-02-12,4,0,3,3
44428,2016-02-12,5,0,40,40
44429,2016-02-12,6,1,96,97
44430,2016-02-12,7,1,282,283
44431,2016-02-12,8,5,605,610
44432,2016-02-12,9,5,333,338
44433,2016-02-12,10,11,137,148
44434,2016-02-12,11,12,151,163
44435,2016-02-12,12,24,187,211
44436,2016-02-12,13,13,195,208
44437,2016-02-12,14,10,159,169
44438,2016-02-12,15,23,227,250
44439,2016-02-12,16,20,306,326
44440,2016-02-12,17,15,507,522
44441,2016-02-12,18,15,386,401
44442,2016-02-12,19,10,213,223
44443,2016-02-12,20,2,126,128
44444,2016-02-12,21,0,106,106
44445,2016-02-12,22,2,58,60
44446,2016-02-12,23,2,44,46
44447,2016-02-13,0,7,38,45
44448,2016-02-13,1,0,15,15
44449,2016-02-13,2,0,17,17
44450,2016-02-13,3,1,3,4
44451,2016-02-13,4,0,3,3
44452,2016-02-13,5,0,3,3
44453,2016-02-13,6,1,3,4
44454,2016-02-13,7,0,25,25
44455,2016-02-13,8,4,38,42
44456,2016-02-13,9,2,56,58
44457,2016-02-13,10,22,107,129
44458,2016-02-13,11,3,103,106
44459,2016-02-13,12,11,130,141
44460,2016-02-13,13,12,117,129
44461,2016-02-13,14,2,117,119
44462,2016-02-13,15,12,124,136
44463,2016-02-13,16,14,121,135
44464,2016-02-13,17,10,111,121
44465,2016-02-13,18,6,91,97
44466,2016-02-13,19,4,71,75
44467,2016-02-13,20,3,53,56
44468,2016-02-13,21,1,31,32
44469,2016-02-13,22,3,24,27
44470,2016-02-13,23,0,16,16
44471,2016-02-14,0,1,22,23
44472,2016-02-14,1,1,15,16
44473,2016-02-14,2,0,9,9
44474,2016-02-14,3,0,4,4
44475,2016-02-14,4,0,1,1
44476,2016-02-14,5,0,3,3
44477,2016-02-14,6,0,3,3
44478,2016-02-14,7,0,17,17
44479,2016-02-14,8,3,35,38
44480,2016-02-14,9,4,69,73
44481,2016-02-14,10,12,104,116
44482,2016-02-14,11,22,105,127
44483,2016-02-14,12,29,135,164
44484,2016-02-14,13,18,174,192
44485,2016-02-14,14,16,146,162
44486,2016-02-14,15,26,140,166
44487,2016-02-14,16,22,152,174
44488,2016-02-14,17,27,147,174
44489,2016-02-14,18,17,111,128
44490,2016-02-14,19,11,84,95
44491,2016-02-14,20,8,60,68
44492,2016-02-14,21,5,42,47
44493,2016-02-14,22,3,29,32
44494,2016-02-14,23,0,19,19
44495,2016-02-15,0,0,9,9
44496,2016-02-15,1,0,1,1
44497,2016-02-15,2,0,3,3
44498,2016-02-15,3,0,1,1
44499,2016-02-15,4,0,2,2
44500,2016-02-15,5,0,8,8
44501,2016-02-15,6,0,9,9
44502,2016-02-15,7,0,24,24
44503,2016-02-15,8,0,34,34
44504,2016-02-15,9,2,29,31
44505,2016-02-15,10,2,13,15
44506,2016-02-15,11,0,30,30
44507,2016-02-15,12,0,25,25
44508,2016-02-15,13,3,29,32
44509,2016-02-15,14,1,36,37
44510,2016-02-15,15,4,37,41
44511,2016-02-15,16,10,44,54
44512,2016-02-15,17,1,35,36
44513,2016-02-15,18,0,34,34
44514,2016-02-15,19,0,26,26
44515,2016-02-15,20,0,14,14
44516,2016-02-15,21,0,14,14
44517,2016-02-15,22,0,13,13
44518,2016-02-15,23,1,7,8
44519,2016-02-16,0,0,2,2
44520,2016-02-16,1,0,1,1
44521,2016-02-16,2,0,2,2
44522,2016-02-16,4,0,3,3
44523,2016-02-16,5,0,13,13
44524,2016-02-16,6,0,25,25
44525,2016-02-16,7,1,48,49
44526,2016-02-16,8,0,65,65
44527,2016-02-16,9,0,49,49
44528,2016-02-16,10,0,42,42
44529,2016-02-16,11,3,50,53
44530,2016-02-16,12,4,76,80
44531,2016-02-16,13,2,111,113
44532,2016-02-16,14,11,109,120
44533,2016-02-16,15,13,159,172
44534,2016-02-16,16,12,285,297
44535,2016-02-16,17,16,679,695
44536,2016-02-16,18,0,545,545
44537,2016-02-16,19,9,329,338
44538,2016-02-16,20,5,219,224
44539,2016-02-16,21,2,188,190
44540,2016-02-16,22,4,106,110
44541,2016-02-16,23,1,48,49
44542,2016-02-17,0,1,14,15
44543,2016-02-17,1,0,7,7
44544,2016-02-17,2,0,2,2
44545,2016-02-17,3,0,2,2
44546,2016-02-17,4,0,5,5
44547,2016-02-17,5,0,54,54
44548,2016-02-17,6,0,181,181
44549,2016-02-17,7,7,496,503
44550,2016-02-17,8,5,864,869
44551,2016-02-17,9,7,373,380
44552,2016-02-17,10,7,151,158
44553,2016-02-17,11,14,181,195
44554,2016-02-17,12,19,227,246
44555,2016-02-17,13,25,187,212
44556,2016-02-17,14,33,157,190
44557,2016-02-17,15,33,201,234
44558,2016-02-17,16,30,410,440
44559,2016-02-17,17,27,746,773
44560,2016-02-17,18,6,627,633
44561,2016-02-17,19,4,361,365
44562,2016-02-17,20,8,265,273
44563,2016-02-17,21,8,178,186
44564,2016-02-17,22,5,109,114
44565,2016-02-17,23,2,58,60
44566,2016-02-18,0,7,18,25
44567,2016-02-18,1,2,3,5
44568,2016-02-18,2,0,5,5
44569,2016-02-18,3,0,3,3
44570,2016-02-18,4,0,4,4
44571,2016-02-18,5,0,54,54
44572,2016-02-18,6,1,168,169
44573,2016-02-18,7,3,458,461
44574,2016-02-18,8,5,843,848
44575,2016-02-18,9,10,376,386
44576,2016-02-18,10,14,146,160
44577,2016-02-18,11,26,164,190
44578,2016-02-18,12,17,196,213
44579,2016-02-18,13,11,194,205
44580,2016-02-18,14,30,143,173
44581,2016-02-18,15,21,203,224
44582,2016-02-18,16,18,319,337
44583,2016-02-18,17,26,732,758
44584,2016-02-18,18,1,639,640
44585,2016-02-18,19,8,367,375
44586,2016-02-18,20,6,247,253
44587,2016-02-18,21,5,168,173
44588,2016-02-18,22,3,102,105
44589,2016-02-18,23,3,53,56
44590,2016-02-19,0,0,20,20
44591,2016-02-19,1,0,9,9
44592,2016-02-19,2,0,2,2
44593,2016-02-19,3,0,3,3
44594,2016-02-19,4,0,3,3
44595,2016-02-19,5,0,58,58
44596,2016-02-19,6,1,142,143
44597,2016-02-19,7,4,394,398
44598,2016-02-19,8,8,736,744
44599,2016-02-19,9,14,379,393
44600,2016-02-19,10,12,145,157
44601,2016-02-19,11,25,167,192
44602,2016-02-19,12,26,202,228
44603,2016-02-19,13,34,198,232
44604,2016-02-19,14,19,198,217
44605,2016-02-19,15,36,264,300
44606,2016-02-19,16,30,403,433
44607,2016-02-19,17,28,673,701
44608,2016-02-19,18,16,520,536
44609,2016-02-19,19,11,311,322
44610,2016-02-19,20,6,202,208
44611,2016-02-19,21,4,120,124
44612,2016-02-19,22,9,118,127
44613,2016-02-19,23,6,77,83
44614,2016-02-20,0,10,57,67
44615,2016-02-20,1,4,51,55
44616,2016-02-20,2,3,34,37
44617,2016-02-20,3,3,17,20
44618,2016-02-20,4,1,8,9
44619,2016-02-20,5,0,7,7
44620,2016-02-20,6,0,21,21
44621,2016-02-20,7,6,57,63
44622,2016-02-20,8,13,182,195
44623,2016-02-20,9,35,244,279
44624,2016-02-20,10,80,284,364
44625,2016-02-20,11,147,399,546
44626,2016-02-20,12,206,495,701
44627,2016-02-20,13,297,511,808
44628,2016-02-20,14,400,542,942
44629,2016-02-20,15,364,535,899
44630,2016-02-20,16,391,533,924
44631,2016-02-20,17,276,423,699
44632,2016-02-20,18,128,361,489
44633,2016-02-20,19,98,226,324
44634,2016-02-20,20,60,179,239
44635,2016-02-20,21,41,171,212
44636,2016-02-20,22,55,143,198
44637,2016-02-20,23,33,113,146
44638,2016-02-21,0,30,104,134
44639,2016-02-21,1,12,80,92
44640,2016-02-21,2,7,61,68
44641,2016-02-21,3,7,28,35
44642,2016-02-21,4,2,6,8
44643,2016-02-21,5,0,5,5
44644,2016-02-21,6,4,14,18
44645,2016-02-21,7,7,49,56
44646,2016-02-21,8,24,122,146
44647,2016-02-21,9,62,218,280
44648,2016-02-21,10,90,332,422
44649,2016-02-21,11,69,271,340
44650,2016-02-21,12,44,193,237
44651,2016-02-21,13,68,243,311
44652,2016-02-21,14,66,290,356
44653,2016-02-21,15,77,285,362
44654,2016-02-21,16,44,257,301
44655,2016-02-21,17,42,254,296
44656,2016-02-21,18,20,233,253
44657,2016-02-21,19,10,183,193
44658,2016-02-21,20,13,117,130
44659,2016-02-21,21,11,79,90
44660,2016-02-21,22,14,61,75
44661,2016-02-21,23,10,36,46
44662,2016-02-22,0,1,17,18
44663,2016-02-22,1,1,5,6
44664,2016-02-22,2,0,4,4
44665,2016-02-22,3,1,3,4
44666,2016-02-22,4,0,3,3
44667,2016-02-22,5,1,50,51
44668,2016-02-22,6,3,178,181
44669,2016-02-22,7,4,545,549
44670,2016-02-22,8,25,924,949
44671,2016-02-22,9,20,390,410
44672,2016-02-22,10,26,165,191
44673,2016-02-22,11,45,158,203
44674,2016-02-22,12,39,210,249
44675,2016-02-22,13,35,224,259
44676,2016-02-22,14,63,190,253
44677,2016-02-22,15,49,264,313
44678,2016-02-22,16,52,429,481
44679,2016-02-22,17,56,931,987
44680,2016-02-22,18,36,799,835
44681,2016-02-22,19,15,473,488
44682,2016-02-22,20,15,306,321
44683,2016-02-22,21,21,200,221
44684,2016-02-22,22,10,106,116
44685,2016-02-22,23,3,52,55
44686,2016-02-23,0,2,17,19
44687,2016-02-23,1,4,5,9
44688,2016-02-23,2,6,7,13
44689,2016-02-23,3,0,4,4
44690,2016-02-23,4,1,4,5
44691,2016-02-23,5,1,49,50
44692,2016-02-23,6,0,78,78
44693,2016-02-23,7,4,142,146
44694,2016-02-23,8,4,193,197
44695,2016-02-23,9,4,104,108
44696,2016-02-23,10,2,71,73
44697,2016-02-23,11,5,57,62
44698,2016-02-23,12,1,64,65
44699,2016-02-23,13,1,66,67
44700,2016-02-23,14,1,47,48
44701,2016-02-23,15,4,72,76
44702,2016-02-23,16,2,161,163
44703,2016-02-23,17,3,360,363
44704,2016-02-23,18,5,313,318
44705,2016-02-23,19,1,256,257
44706,2016-02-23,20,0,181,181
44707,2016-02-23,21,2,162,164
44708,2016-02-23,22,3,89,92
44709,2016-02-23,23,1,26,27
44710,2016-02-24,0,0,21,21
44711,2016-02-24,1,0,7,7
44712,2016-02-24,2,0,4,4
44713,2016-02-24,3,0,1,1
44714,2016-02-24,4,0,4,4
44715,2016-02-24,5,0,51,51
44716,2016-02-24,6,0,108,108
44717,2016-02-24,7,3,281,284
44718,2016-02-24,8,4,346,350
44719,2016-02-24,9,2,250,252
44720,2016-02-24,10,4,111,115
44721,2016-02-24,11,3,96,99
44722,2016-02-24,12,7,137,144
44723,2016-02-24,13,8,115,123
44724,2016-02-24,14,12,92,104
44725,2016-02-24,15,3,68,71
44726,2016-02-24,16,1,186,187
44727,2016-02-24,17,9,518,527
44728,2016-02-24,18,0,49,49
44729,2016-02-24,19,2,196,198
44730,2016-02-24,20,1,199,200
44731,2016-02-24,21,2,187,189
44732,2016-02-24,22,4,136,140
44733,2016-02-24,23,2,49,51
44734,2016-02-25,0,5,20,25
44735,2016-02-25,1,2,12,14
44736,2016-02-25,2,0,1,1
44737,2016-02-25,3,0,2,2
44738,2016-02-25,4,0,3,3
44739,2016-02-25,5,0,51,51
44740,2016-02-25,6,4,198,202
44741,2016-02-25,7,10,518,528
44742,2016-02-25,8,10,969,979
44743,2016-02-25,9,8,417,425
44744,2016-02-25,10,12,172,184
44745,2016-02-25,11,18,193,211
44746,2016-02-25,12,5,190,195
44747,2016-02-25,13,18,222,240
44748,2016-02-25,14,24,179,203
44749,2016-02-25,15,10,226,236
44750,2016-02-25,16,7,344,351
44751,2016-02-25,17,6,788,794
44752,2016-02-25,18,6,647,653
44753,2016-02-25,19,3,375,378
44754,2016-02-25,20,10,257,267
44755,2016-02-25,21,5,183,188
44756,2016-02-25,22,2,130,132
44757,2016-02-25,23,4,64,68
44758,2016-02-26,0,3,23,26
44759,2016-02-26,1,0,9,9
44760,2016-02-26,2,0,7,7
44761,2016-02-26,4,0,4,4
44762,2016-02-26,5,0,56,56
44763,2016-02-26,6,0,148,148
44764,2016-02-26,7,3,425,428
44765,2016-02-26,8,6,785,791
44766,2016-02-26,9,2,353,355
44767,2016-02-26,10,9,155,164
44768,2016-02-26,11,18,176,194
44769,2016-02-26,12,10,206,216
44770,2016-02-26,13,11,215,226
44771,2016-02-26,14,18,181,199
44772,2016-02-26,15,14,234,248
44773,2016-02-26,16,13,382,395
44774,2016-02-26,17,9,599,608
44775,2016-02-26,18,4,506,510
44776,2016-02-26,19,2,284,286
44777,2016-02-26,20,1,158,159
44778,2016-02-26,21,9,123,132
44779,2016-02-26,22,9,85,94
44780,2016-02-26,23,5,85,90
44781,2016-02-27,0,0,68,68
44782,2016-02-27,1,0,35,35
44783,2016-02-27,2,2,29,31
44784,2016-02-27,3,1,14,15
44785,2016-02-27,4,0,4,4
44786,2016-02-27,5,1,4,5
44787,2016-02-27,6,0,18,18
44788,2016-02-27,7,0,58,58
44789,2016-02-27,8,13,144,157
44790,2016-02-27,9,20,270,290
44791,2016-02-27,10,43,274,317
44792,2016-02-27,11,57,353,410
44793,2016-02-27,12,109,381,490
44794,2016-02-27,13,101,375,476
44795,2016-02-27,14,133,341,474
44796,2016-02-27,15,155,379,534
44797,2016-02-27,16,134,347,481
44798,2016-02-27,17,102,323,425
44799,2016-02-27,18,40,312,352
44800,2016-02-27,19,28,214,242
44801,2016-02-27,20,13,153,166
44802,2016-02-27,21,13,152,165
44803,2016-02-27,22,11,108,119
44804,2016-02-27,23,6,93,99
44805,2016-02-28,0,7,70,77
44806,2016-02-28,1,5,60,65
44807,2016-02-28,2,7,32,39
44808,2016-02-28,3,2,11,13
44809,2016-02-28,4,0,5,5
44810,2016-02-28,5,0,4,4
44811,2016-02-28,6,0,8,8
44812,2016-02-28,7,6,47,53
44813,2016-02-28,8,11,117,128
44814,2016-02-28,9,46,193,239
44815,2016-02-28,10,111,354,465
44816,2016-02-28,11,182,512,694
44817,2016-02-28,12,319,583,902
44818,2016-02-28,13,361,556,917
44819,2016-02-28,14,425,579,1004
44820,2016-02-28,15,405,650,1055
44821,2016-02-28,16,366,626,992
44822,2016-02-28,17,261,504,765
44823,2016-02-28,18,124,398,522
44824,2016-02-28,19,61,247,308
44825,2016-02-28,20,49,147,196
44826,2016-02-28,21,21,109,130
44827,2016-02-28,22,17,92,109
44828,2016-02-28,23,6,36,42
44829,2016-02-29,0,3,51,54
44830,2016-02-29,1,4,8,12
44831,2016-02-29,2,0,2,2
44832,2016-02-29,3,0,3,3
44833,2016-02-29,4,0,6,6
44834,2016-02-29,5,3,54,57
44835,2016-02-29,6,4,187,191
44836,2016-02-29,7,10,605,615
44837,2016-02-29,8,15,890,905
44838,2016-02-29,9,32,359,391
44839,2016-02-29,10,52,175,227
44840,2016-02-29,11,64,196,260
44841,2016-02-29,12,56,256,312
44842,2016-02-29,13,78,272,350
44843,2016-02-29,14,48,202,250
44844,2016-02-29,15,52,292,344
44845,2016-02-29,16,53,486,539
44846,2016-02-29,17,64,1070,1134
44847,2016-02-29,18,31,854,885
44848,2016-02-29,19,29,471,500
44849,2016-02-29,20,26,308,334
44850,2016-02-29,21,7,257,264
44851,2016-02-29,22,5,126,131
44852,2016-02-29,23,10,51,61
44853,2016-03-01,0,1,14,15
44854,2016-03-01,1,5,7,12
44855,2016-03-01,2,1,6,7
44856,2016-03-01,3,0,5,5
44857,2016-03-01,4,1,10,11
44858,2016-03-01,5,0,59,59
44859,2016-03-01,6,4,237,241
44860,2016-03-01,7,13,719,732
44861,2016-03-01,8,19,1103,1122
44862,2016-03-01,9,26,417,443
44863,2016-03-01,10,31,189,220
44864,2016-03-01,11,43,206,249
44865,2016-03-01,12,48,305,353
44866,2016-03-01,13,58,276,334
44867,2016-03-01,14,78,230,308
44868,2016-03-01,15,74,293,367
44869,2016-03-01,16,65,491,556
44870,2016-03-01,17,84,1085,1169
44871,2016-03-01,18,42,895,937
44872,2016-03-01,19,30,536,566
44873,2016-03-01,20,33,325,358
44874,2016-03-01,21,14,247,261
44875,2016-03-01,22,10,182,192
44876,2016-03-01,23,6,65,71
44877,2016-03-02,0,1,14,15
44878,2016-03-02,1,0,7,7
44879,2016-03-02,2,0,1,1
44880,2016-03-02,3,0,3,3
44881,2016-03-02,4,0,3,3
44882,2016-03-02,5,1,60,61
44883,2016-03-02,6,2,184,186
44884,2016-03-02,7,10,526,536
44885,2016-03-02,8,14,892,906
44886,2016-03-02,9,16,381,397
44887,2016-03-02,10,10,159,169
44888,2016-03-02,11,13,166,179
44889,2016-03-02,12,20,220,240
44890,2016-03-02,13,7,176,183
44891,2016-03-02,14,29,158,187
44892,2016-03-02,15,12,200,212
44893,2016-03-02,16,22,348,370
44894,2016-03-02,17,23,759,782
44895,2016-03-02,18,8,565,573
44896,2016-03-02,19,11,335,346
44897,2016-03-02,20,4,238,242
44898,2016-03-02,21,6,175,181
44899,2016-03-02,22,1,97,98
44900,2016-03-02,23,0,41,41
44901,2016-03-03,0,1,12,13
44902,2016-03-03,1,0,8,8
44903,2016-03-03,2,0,2,2
44904,2016-03-03,4,0,6,6
44905,2016-03-03,5,0,51,51
44906,2016-03-03,6,3,189,192
44907,2016-03-03,7,3,503,506
44908,2016-03-03,8,16,867,883
44909,2016-03-03,9,21,378,399
44910,2016-03-03,10,13,139,152
44911,2016-03-03,11,21,158,179
44912,2016-03-03,12,22,185,207
44913,2016-03-03,13,30,197,227
44914,2016-03-03,14,35,169,204
44915,2016-03-03,15,15,218,233
44916,2016-03-03,16,24,372,396
44917,2016-03-03,17,20,741,761
44918,2016-03-03,18,13,631,644
44919,2016-03-03,19,8,377,385
44920,2016-03-03,20,5,219,224
44921,2016-03-03,21,0,137,137
44922,2016-03-03,22,1,53,54
44923,2016-03-03,23,0,38,38
44924,2016-03-04,0,1,12,13
44925,2016-03-04,1,0,6,6
44926,2016-03-04,2,0,5,5
44927,2016-03-04,4,0,3,3
44928,2016-03-04,5,0,47,47
44929,2016-03-04,6,0,103,103
44930,2016-03-04,7,3,294,297
44931,2016-03-04,8,6,612,618
44932,2016-03-04,9,9,343,352
44933,2016-03-04,10,11,168,179
44934,2016-03-04,11,17,173,190
44935,2016-03-04,12,20,237,257
44936,2016-03-04,13,9,236,245
44937,2016-03-04,14,27,181,208
44938,2016-03-04,15,28,226,254
44939,2016-03-04,16,31,389,420
44940,2016-03-04,17,49,707,756
44941,2016-03-04,18,15,506,521
44942,2016-03-04,19,20,296,316
44943,2016-03-04,20,8,191,199
44944,2016-03-04,21,6,144,150
44945,2016-03-04,22,7,107,114
44946,2016-03-04,23,6,86,92
44947,2016-03-05,0,5,61,66
44948,2016-03-05,1,1,34,35
44949,2016-03-05,2,3,40,43
44950,2016-03-05,3,1,14,15
44951,2016-03-05,4,0,3,3
44952,2016-03-05,5,1,8,9
44953,2016-03-05,6,2,17,19
44954,2016-03-05,7,8,60,68
44955,2016-03-05,8,14,141,155
44956,2016-03-05,9,35,255,290
44957,2016-03-05,10,75,290,365
44958,2016-03-05,11,68,344,412
44959,2016-03-05,12,101,370,471
44960,2016-03-05,13,122,337,459
44961,2016-03-05,14,138,291,429
44962,2016-03-05,15,129,355,484
44963,2016-03-05,16,108,366,474
44964,2016-03-05,17,133,323,456
44965,2016-03-05,18,49,275,324
44966,2016-03-05,19,41,197,238
44967,2016-03-05,20,27,147,174
44968,2016-03-05,21,17,120,137
44969,2016-03-05,22,7,87,94
44970,2016-03-05,23,24,90,114
44971,2016-03-06,0,13,64,77
44972,2016-03-06,1,9,51,60
44973,2016-03-06,2,15,45,60
44974,2016-03-06,3,3,13,16
44975,2016-03-06,4,0,2,2
44976,2016-03-06,5,0,6,6
44977,2016-03-06,6,2,14,16
44978,2016-03-06,7,5,52,57
44979,2016-03-06,8,22,133,155
44980,2016-03-06,9,76,175,251
44981,2016-03-06,10,108,265,373
44982,2016-03-06,11,111,310,421
44983,2016-03-06,12,144,424,568
44984,2016-03-06,13,164,404,568
44985,2016-03-06,14,170,395,565
44986,2016-03-06,15,184,403,587
44987,2016-03-06,16,190,425,615
44988,2016-03-06,17,133,393,526
44989,2016-03-06,18,86,279,365
44990,2016-03-06,19,34,186,220
44991,2016-03-06,20,15,137,152
44992,2016-03-06,21,31,99,130
44993,2016-03-06,22,19,53,72
44994,2016-03-06,23,5,32,37
44995,2016-03-07,0,4,12,16
44996,2016-03-07,1,0,5,5
44997,2016-03-07,2,0,4,4
44998,2016-03-07,3,1,4,5
44999,2016-03-07,5,2,56,58
45000,2016-03-07,6,6,177,183
45001,2016-03-07,7,15,566,581
45002,2016-03-07,8,24,1022,1046
45003,2016-03-07,9,57,425,482
45004,2016-03-07,10,110,162,272
45005,2016-03-07,11,117,202,319
45006,2016-03-07,12,123,260,383
45007,2016-03-07,13,127,249,376
45008,2016-03-07,14,132,212,344
45009,2016-03-07,15,150,322,472
45010,2016-03-07,16,157,512,669
45011,2016-03-07,17,168,1167,1335
45012,2016-03-07,18,100,937,1037
45013,2016-03-07,19,71,503,574
45014,2016-03-07,20,30,339,369
45015,2016-03-07,21,41,229,270
45016,2016-03-07,22,16,120,136
45017,2016-03-07,23,28,39,67
45018,2016-03-08,0,4,22,26
45019,2016-03-08,1,1,5,6
45020,2016-03-08,2,3,3,6
45021,2016-03-08,3,0,1,1
45022,2016-03-08,4,0,2,2
45023,2016-03-08,5,0,69,69
45024,2016-03-08,6,4,273,277
45025,2016-03-08,7,26,790,816
45026,2016-03-08,8,58,1152,1210
45027,2016-03-08,9,85,448,533
45028,2016-03-08,10,75,220,295
45029,2016-03-08,11,136,235,371
45030,2016-03-08,12,148,334,482
45031,2016-03-08,13,125,304,429
45032,2016-03-08,14,183,274,457
45033,2016-03-08,15,182,326,508
45034,2016-03-08,16,133,636,769
45035,2016-03-08,17,153,1195,1348
45036,2016-03-08,18,109,1028,1137
45037,2016-03-08,19,79,626,705
45038,2016-03-08,20,64,405,469
45039,2016-03-08,21,60,273,333
45040,2016-03-08,22,22,179,201
45041,2016-03-08,23,19,88,107
45042,2016-03-09,0,19,24,43
45043,2016-03-09,1,3,8,11
45044,2016-03-09,2,3,8,11
45045,2016-03-09,3,1,1,2
45046,2016-03-09,4,1,7,8
45047,2016-03-09,5,2,61,63
45048,2016-03-09,6,4,288,292
45049,2016-03-09,7,28,815,843
45050,2016-03-09,8,65,1199,1264
45051,2016-03-09,9,52,439,491
45052,2016-03-09,10,100,223,323
45053,2016-03-09,11,129,249,378
45054,2016-03-09,12,108,354,462
45055,2016-03-09,13,161,297,458
45056,2016-03-09,14,181,278,459
45057,2016-03-09,15,184,344,528
45058,2016-03-09,16,189,675,864
45059,2016-03-09,17,219,1288,1507
45060,2016-03-09,18,188,1026,1214
45061,2016-03-09,19,98,613,711
45062,2016-03-09,20,56,448,504
45063,2016-03-09,21,57,327,384
45064,2016-03-09,22,57,201,258
45065,2016-03-09,23,19,116,135
45066,2016-03-10,0,19,61,80
45067,2016-03-10,1,2,17,19
45068,2016-03-10,2,2,2,4
45069,2016-03-10,3,2,2,4
45070,2016-03-10,4,1,4,5
45071,2016-03-10,5,1,83,84
45072,2016-03-10,6,13,280,293
45073,2016-03-10,7,30,795,825
45074,2016-03-10,8,55,1140,1195
45075,2016-03-10,9,70,455,525
45076,2016-03-10,10,118,220,338
45077,2016-03-10,11,127,253,380
45078,2016-03-10,12,123,349,472
45079,2016-03-10,13,125,322,447
45080,2016-03-10,14,164,281,445
45081,2016-03-10,15,193,324,517
45082,2016-03-10,16,220,611,831
45083,2016-03-10,17,220,1167,1387
45084,2016-03-10,18,121,1025,1146
45085,2016-03-10,19,110,616,726
45086,2016-03-10,20,71,382,453
45087,2016-03-10,21,64,315,379
45088,2016-03-10,22,36,185,221
45089,2016-03-10,23,23,154,177
45090,2016-03-11,0,25,57,82
45091,2016-03-11,1,17,25,42
45092,2016-03-11,2,4,9,13
45093,2016-03-11,3,2,9,11
45094,2016-03-11,4,1,4,5
45095,2016-03-11,5,1,69,70
45096,2016-03-11,6,5,220,225
45097,2016-03-11,7,15,648,663
45098,2016-03-11,8,31,1131,1162
45099,2016-03-11,9,62,488,550
45100,2016-03-11,10,86,232,318
45101,2016-03-11,11,154,289,443
45102,2016-03-11,12,162,390,552
45103,2016-03-11,13,215,398,613
45104,2016-03-11,14,259,313,572
45105,2016-03-11,15,248,438,686
45106,2016-03-11,16,262,714,976
45107,2016-03-11,17,234,1199,1433
45108,2016-03-11,18,173,896,1069
45109,2016-03-11,19,101,496,597
45110,2016-03-11,20,73,331,404
45111,2016-03-11,21,69,217,286
45112,2016-03-11,22,59,194,253
45113,2016-03-11,23,30,162,192
45114,2016-03-12,0,15,107,122
45115,2016-03-12,1,10,69,79
45116,2016-03-12,2,2,44,46
45117,2016-03-12,3,3,24,27
45118,2016-03-12,4,7,4,11
45119,2016-03-12,5,5,17,22
45120,2016-03-12,6,26,138,164
45121,2016-03-12,7,57,148,205
45122,2016-03-12,8,92,268,360
45123,2016-03-12,9,170,439,609
45124,2016-03-12,10,302,485,787
45125,2016-03-12,11,347,564,911
45126,2016-03-12,12,401,580,981
45127,2016-03-12,13,431,514,945
45128,2016-03-12,14,404,521,925
45129,2016-03-12,15,349,434,783
45130,2016-03-12,16,283,392,675
45131,2016-03-12,17,357,396,753
45132,2016-03-12,18,212,409,621
45133,2016-03-12,19,137,268,405
45134,2016-03-12,20,121,208,329
45135,2016-03-12,21,83,161,244
45136,2016-03-12,22,71,125,196
45137,2016-03-12,23,75,151,226
45138,2016-03-13,0,32,110,142
45139,2016-03-13,1,17,104,121
45140,2016-03-13,3,18,70,88
45141,2016-03-13,4,4,14,18
45142,2016-03-13,5,1,7,8
45143,2016-03-13,6,2,18,20
45144,2016-03-13,7,8,31,39
45145,2016-03-13,8,35,101,136
45146,2016-03-13,9,51,136,187
45147,2016-03-13,10,99,288,387
45148,2016-03-13,11,130,385,515
45149,2016-03-13,12,227,410,637
45150,2016-03-13,13,222,463,685
45151,2016-03-13,14,271,467,738
45152,2016-03-13,15,82,240,322
45153,2016-03-13,16,44,141,185
45154,2016-03-13,17,68,197,265
45155,2016-03-13,18,56,204,260
45156,2016-03-13,19,23,172,195
45157,2016-03-13,20,24,93,117
45158,2016-03-13,21,3,74,77
45159,2016-03-13,22,6,28,34
45160,2016-03-13,23,1,14,15
45161,2016-03-14,0,1,5,6
45162,2016-03-14,1,0,6,6
45163,2016-03-14,2,0,2,2
45164,2016-03-14,4,0,5,5
45165,2016-03-14,5,3,36,39
45166,2016-03-14,6,11,155,166
45167,2016-03-14,7,8,389,397
45168,2016-03-14,8,20,830,850
45169,2016-03-14,9,34,540,574
45170,2016-03-14,10,62,172,234
45171,2016-03-14,11,70,189,259
45172,2016-03-14,12,61,219,280
45173,2016-03-14,13,72,228,300
45174,2016-03-14,14,66,212,278
45175,2016-03-14,15,101,241,342
45176,2016-03-14,16,75,459,534
45177,2016-03-14,17,97,1016,1113
45178,2016-03-14,18,75,926,1001
45179,2016-03-14,19,38,540,578
45180,2016-03-14,20,19,267,286
45181,2016-03-14,21,11,194,205
45182,2016-03-14,22,33,109,142
45183,2016-03-14,23,13,61,74
45184,2016-03-15,0,7,15,22
45185,2016-03-15,1,1,7,8
45186,2016-03-15,2,0,2,2
45187,2016-03-15,3,0,4,4
45188,2016-03-15,4,0,5,5
45189,2016-03-15,5,0,73,73
45190,2016-03-15,6,4,209,213
45191,2016-03-15,7,7,331,338
45192,2016-03-15,8,15,775,790
45193,2016-03-15,9,17,482,499
45194,2016-03-15,10,45,192,237
45195,2016-03-15,11,47,211,258
45196,2016-03-15,12,59,271,330
45197,2016-03-15,13,66,258,324
45198,2016-03-15,14,80,218,298
45199,2016-03-15,15,109,309,418
45200,2016-03-15,16,123,536,659
45201,2016-03-15,17,149,1088,1237
45202,2016-03-15,18,104,976,1080
45203,2016-03-15,19,68,615,683
45204,2016-03-15,20,35,397,432
45205,2016-03-15,21,31,272,303
45206,2016-03-15,22,25,212,237
45207,2016-03-15,23,22,85,107
45208,2016-03-16,0,6,31,37
45209,2016-03-16,1,3,15,18
45210,2016-03-16,2,0,5,5
45211,2016-03-16,3,2,8,10
45212,2016-03-16,4,3,6,9
45213,2016-03-16,5,10,72,82
45214,2016-03-16,6,51,291,342
45215,2016-03-16,7,138,809,947
45216,2016-03-16,8,205,1126,1331
45217,2016-03-16,9,175,524,699
45218,2016-03-16,10,184,240,424
45219,2016-03-16,11,157,261,418
45220,2016-03-16,12,201,326,527
45221,2016-03-16,13,258,343,601
45222,2016-03-16,14,288,339,627
45223,2016-03-16,15,290,419,709
45224,2016-03-16,16,436,724,1160
45225,2016-03-16,17,544,1230,1774
45226,2016-03-16,18,416,1087,1503
45227,2016-03-16,19,206,616,822
45228,2016-03-16,20,134,370,504
45229,2016-03-16,21,132,303,435
45230,2016-03-16,22,80,171,251
45231,2016-03-16,23,32,87,119
45232,2016-03-17,0,9,26,35
45233,2016-03-17,1,6,9,15
45234,2016-03-17,2,4,9,13
45235,2016-03-17,3,0,4,4
45236,2016-03-17,4,0,4,4
45237,2016-03-17,5,0,73,73
45238,2016-03-17,6,14,219,233
45239,2016-03-17,7,21,655,676
45240,2016-03-17,8,53,1200,1253
45241,2016-03-17,9,73,514,587
45242,2016-03-17,10,121,229,350
45243,2016-03-17,11,144,280,424
45244,2016-03-17,12,162,343,505
45245,2016-03-17,13,131,338,469
45246,2016-03-17,14,154,238,392
45247,2016-03-17,15,171,341,512
45248,2016-03-17,16,168,612,780
45249,2016-03-17,17,183,1088,1271
45250,2016-03-17,18,136,1069,1205
45251,2016-03-17,19,84,604,688
45252,2016-03-17,20,60,369,429
45253,2016-03-17,21,23,315,338
45254,2016-03-17,22,46,229,275
45255,2016-03-17,23,23,119,142
45256,2016-03-18,0,16,59,75
45257,2016-03-18,1,8,30,38
45258,2016-03-18,2,7,14,21
45259,2016-03-18,3,2,8,10
45260,2016-03-18,4,0,6,6
45261,2016-03-18,5,3,68,71
45262,2016-03-18,6,7,199,206
45263,2016-03-18,7,37,597,634
45264,2016-03-18,8,56,1153,1209
45265,2016-03-18,9,89,517,606
45266,2016-03-18,10,115,227,342
45267,2016-03-18,11,187,344,531
45268,2016-03-18,12,221,411,632
45269,2016-03-18,13,221,416,637
45270,2016-03-18,14,206,316,522
45271,2016-03-18,15,229,443,672
45272,2016-03-18,16,269,637,906
45273,2016-03-18,17,259,1085,1344
45274,2016-03-18,18,177,877,1054
45275,2016-03-18,19,129,548,677
45276,2016-03-18,20,95,309,404
45277,2016-03-18,21,104,253,357
45278,2016-03-18,22,85,206,291
45279,2016-03-18,23,38,145,183
45280,2016-03-19,0,25,121,146
45281,2016-03-19,1,10,65,75
45282,2016-03-19,2,5,39,44
45283,2016-03-19,3,3,12,15
45284,2016-03-19,4,1,1,2
45285,2016-03-19,5,0,8,8
45286,2016-03-19,6,1,16,17
45287,2016-03-19,7,9,73,82
45288,2016-03-19,8,23,160,183
45289,2016-03-19,9,64,296,360
45290,2016-03-19,10,76,364,440
45291,2016-03-19,11,93,316,409
45292,2016-03-19,12,36,163,199
45293,2016-03-19,13,38,174,212
45294,2016-03-19,14,18,120,138
45295,2016-03-19,15,15,98,113
45296,2016-03-19,16,19,99,118
45297,2016-03-19,17,22,138,160
45298,2016-03-19,18,3,78,81
45299,2016-03-19,19,7,91,98
45300,2016-03-19,20,10,88,98
45301,2016-03-19,21,11,74,85
45302,2016-03-19,22,5,75,80
45303,2016-03-19,23,2,62,64
45304,2016-03-20,0,6,49,55
45305,2016-03-20,1,2,54,56
45306,2016-03-20,2,3,36,39
45307,2016-03-20,3,1,25,26
45308,2016-03-20,4,0,3,3
45309,2016-03-20,5,0,4,4
45310,2016-03-20,6,3,15,18
45311,2016-03-20,7,9,42,51
45312,2016-03-20,8,11,88,99
45313,2016-03-20,9,13,160,173
45314,2016-03-20,10,48,226,274
45315,2016-03-20,11,50,339,389
45316,2016-03-20,12,103,378,481
45317,2016-03-20,13,112,322,434
45318,2016-03-20,14,87,291,378
45319,2016-03-20,15,66,339,405
45320,2016-03-20,16,64,309,373
45321,2016-03-20,17,43,304,347
45322,2016-03-20,18,36,242,278
45323,2016-03-20,19,37,204,241
45324,2016-03-20,20,14,157,171
45325,2016-03-20,21,17,107,124
45326,2016-03-20,22,14,44,58
45327,2016-03-20,23,23,30,53
45328,2016-03-21,0,17,10,27
45329,2016-03-21,1,14,2,16
45330,2016-03-21,3,0,3,3
45331,2016-03-21,4,0,1,1
45332,2016-03-21,5,2,45,47
45333,2016-03-21,6,2,161,163
45334,2016-03-21,7,5,490,495
45335,2016-03-21,8,13,876,889
45336,2016-03-21,9,25,428,453
45337,2016-03-21,10,52,156,208
45338,2016-03-21,11,53,175,228
45339,2016-03-21,12,55,236,291
45340,2016-03-21,13,100,237,337
45341,2016-03-21,14,103,176,279
45342,2016-03-21,15,103,250,353
45343,2016-03-21,16,70,479,549
45344,2016-03-21,17,83,989,1072
45345,2016-03-21,18,67,920,987
45346,2016-03-21,19,34,470,504
45347,2016-03-21,20,24,263,287
45348,2016-03-21,21,7,188,195
45349,2016-03-21,22,6,130,136
45350,2016-03-21,23,3,57,60
45351,2016-03-22,0,3,27,30
45352,2016-03-22,1,4,13,17
45353,2016-03-22,2,0,3,3
45354,2016-03-22,3,0,4,4
45355,2016-03-22,4,0,2,2
45356,2016-03-22,5,1,69,70
45357,2016-03-22,6,5,221,226
45358,2016-03-22,7,16,598,614
45359,2016-03-22,8,21,1060,1081
45360,2016-03-22,9,42,439,481
45361,2016-03-22,10,67,166,233
45362,2016-03-22,11,81,191,272
45363,2016-03-22,12,115,268,383
45364,2016-03-22,13,120,268,388
45365,2016-03-22,14,165,220,385
45366,2016-03-22,15,139,321,460
45367,2016-03-22,16,156,589,745
45368,2016-03-22,17,142,1225,1367
45369,2016-03-22,18,98,1072,1170
45370,2016-03-22,19,92,635,727
45371,2016-03-22,20,54,400,454
45372,2016-03-22,21,39,316,355
45373,2016-03-22,22,32,173,205
45374,2016-03-22,23,18,72,90
45375,2016-03-23,0,5,24,29
45376,2016-03-23,1,1,15,16
45377,2016-03-23,2,1,6,7
45378,2016-03-23,3,0,4,4
45379,2016-03-23,4,0,4,4
45380,2016-03-23,5,1,81,82
45381,2016-03-23,6,9,268,277
45382,2016-03-23,7,33,728,761
45383,2016-03-23,8,41,1171,1212
45384,2016-03-23,9,92,516,608
45385,2016-03-23,10,99,235,334
45386,2016-03-23,11,143,270,413
45387,2016-03-23,12,203,386,589
45388,2016-03-23,13,212,338,550
45389,2016-03-23,14,261,281,542
45390,2016-03-23,15,230,390,620
45391,2016-03-23,16,199,687,886
45392,2016-03-23,17,219,1314,1533
45393,2016-03-23,18,251,1223,1474
45394,2016-03-23,19,129,813,942
45395,2016-03-23,20,124,471,595
45396,2016-03-23,21,64,399,463
45397,2016-03-23,22,41,232,273
45398,2016-03-23,23,22,104,126
45399,2016-03-24,0,7,55,62
45400,2016-03-24,1,4,17,21
45401,2016-03-24,2,2,7,9
45402,2016-03-24,3,2,4,6
45403,2016-03-24,4,1,10,11
45404,2016-03-24,5,13,70,83
45405,2016-03-24,6,18,276,294
45406,2016-03-24,7,37,741,778
45407,2016-03-24,8,61,1236,1297
45408,2016-03-24,9,80,533,613
45409,2016-03-24,10,171,239,410
45410,2016-03-24,11,206,278,484
45411,2016-03-24,12,263,391,654
45412,2016-03-24,13,224,416,640
45413,2016-03-24,14,271,340,611
45414,2016-03-24,15,323,390,713
45415,2016-03-24,16,304,680,984
45416,2016-03-24,17,364,1322,1686
45417,2016-03-24,18,309,1173,1482
45418,2016-03-24,19,146,812,958
45419,2016-03-24,20,126,499,625
45420,2016-03-24,21,99,349,448
45421,2016-03-24,22,67,231,298
45422,2016-03-24,23,41,153,194
45423,2016-03-25,0,13,95,108
45424,2016-03-25,1,5,29,34
45425,2016-03-25,2,4,14,18
45426,2016-03-25,3,1,8,9
45427,2016-03-25,4,1,5,6
45428,2016-03-25,5,3,66,69
45429,2016-03-25,6,10,218,228
45430,2016-03-25,7,38,591,629
45431,2016-03-25,8,63,1072,1135
45432,2016-03-25,9,109,575,684
45433,2016-03-25,10,159,300,459
45434,2016-03-25,11,128,232,360
45435,2016-03-25,12,192,344,536
45436,2016-03-25,13,296,378,674
45437,2016-03-25,14,364,465,829
45438,2016-03-25,15,369,523,892
45439,2016-03-25,16,399,782,1181
45440,2016-03-25,17,340,1108,1448
45441,2016-03-25,18,298,855,1153
45442,2016-03-25,19,230,525,755
45443,2016-03-25,20,122,316,438
45444,2016-03-25,21,76,206,282
45445,2016-03-25,22,46,145,191
45446,2016-03-25,23,8,86,94
45447,2016-03-26,0,11,102,113
45448,2016-03-26,1,9,55,64
45449,2016-03-26,2,6,34,40
45450,2016-03-26,3,1,15,16
45451,2016-03-26,4,1,4,5
45452,2016-03-26,5,4,10,14
45453,2016-03-26,6,41,65,106
45454,2016-03-26,7,61,109,170
45455,2016-03-26,8,105,248,353
45456,2016-03-26,9,253,390,643
45457,2016-03-26,10,409,439,848
45458,2016-03-26,11,566,517,1083
45459,2016-03-26,12,639,587,1226
45460,2016-03-26,13,799,596,1395
45461,2016-03-26,14,796,567,1363
45462,2016-03-26,15,756,636,1392
45463,2016-03-26,16,753,595,1348
45464,2016-03-26,17,591,526,1117
45465,2016-03-26,18,484,477,961
45466,2016-03-26,19,295,387,682
45467,2016-03-26,20,172,251,423
45468,2016-03-26,21,120,182,302
45469,2016-03-26,22,112,142,254
45470,2016-03-26,23,42,150,192
45471,2016-03-27,0,23,90,113
45472,2016-03-27,1,14,68,82
45473,2016-03-27,2,3,47,50
45474,2016-03-27,3,10,24,34
45475,2016-03-27,4,6,6,12
45476,2016-03-27,5,13,11,24
45477,2016-03-27,6,40,54,94
45478,2016-03-27,7,70,96,166
45479,2016-03-27,8,115,182,297
45480,2016-03-27,9,258,251,509
45481,2016-03-27,10,372,326,698
45482,2016-03-27,11,369,412,781
45483,2016-03-27,12,396,453,849
45484,2016-03-27,13,378,437,815
45485,2016-03-27,14,455,455,910
45486,2016-03-27,15,385,375,760
45487,2016-03-27,16,316,350,666
45488,2016-03-27,17,230,383,613
45489,2016-03-27,18,158,317,475
45490,2016-03-27,19,54,189,243
45491,2016-03-27,20,34,124,158
45492,2016-03-27,21,18,83,101
45493,2016-03-27,22,11,51,62
45494,2016-03-27,23,16,35,51
45495,2016-03-28,0,2,13,15
45496,2016-03-28,1,2,5,7
45497,2016-03-28,2,1,1,2
45498,2016-03-28,3,0,3,3
45499,2016-03-28,4,0,8,8
45500,2016-03-28,5,0,42,42
45501,2016-03-28,6,1,80,81
45502,2016-03-28,7,1,196,197
45503,2016-03-28,8,11,576,587
45504,2016-03-28,9,36,428,464
45505,2016-03-28,10,76,175,251
45506,2016-03-28,11,126,258,384
45507,2016-03-28,12,167,319,486
45508,2016-03-28,13,170,310,480
45509,2016-03-28,14,172,309,481
45510,2016-03-28,15,130,307,437
45511,2016-03-28,16,155,541,696
45512,2016-03-28,17,158,1173,1331
45513,2016-03-28,18,126,987,1113
45514,2016-03-28,19,89,531,620
45515,2016-03-28,20,25,299,324
45516,2016-03-28,21,12,214,226
45517,2016-03-28,22,16,132,148
45518,2016-03-28,23,7,38,45
45519,2016-03-29,0,5,26,31
45520,2016-03-29,1,4,7,11
45521,2016-03-29,2,0,9,9
45522,2016-03-29,3,1,2,3
45523,2016-03-29,4,0,8,8
45524,2016-03-29,5,2,77,79
45525,2016-03-29,6,8,232,240
45526,2016-03-29,7,28,699,727
45527,2016-03-29,8,42,1169,1211
45528,2016-03-29,9,73,491,564
45529,2016-03-29,10,133,225,358
45530,2016-03-29,11,152,241,393
45531,2016-03-29,12,100,288,388
45532,2016-03-29,13,147,297,444
45533,2016-03-29,14,149,283,432
45534,2016-03-29,15,168,306,474
45535,2016-03-29,16,157,543,700
45536,2016-03-29,17,153,1196,1349
45537,2016-03-29,18,101,1059,1160
45538,2016-03-29,19,76,624,700
45539,2016-03-29,20,63,337,400
45540,2016-03-29,21,56,223,279
45541,2016-03-29,22,34,144,178
45542,2016-03-29,23,5,77,82
45543,2016-03-30,0,2,29,31
45544,2016-03-30,1,4,14,18
45545,2016-03-30,2,0,4,4
45546,2016-03-30,3,0,6,6
45547,2016-03-30,4,0,7,7
45548,2016-03-30,5,1,78,79
45549,2016-03-30,6,4,211,215
45550,2016-03-30,7,28,675,703
45551,2016-03-30,8,51,1125,1176
45552,2016-03-30,9,87,506,593
45553,2016-03-30,10,148,232,380
45554,2016-03-30,11,171,229,400
45555,2016-03-30,12,172,328,500
45556,2016-03-30,13,205,336,541
45557,2016-03-30,14,203,290,493
45558,2016-03-30,15,218,327,545
45559,2016-03-30,16,189,560,749
45560,2016-03-30,17,189,1186,1375
45561,2016-03-30,18,159,1057,1216
45562,2016-03-30,19,97,625,722
45563,2016-03-30,20,53,415,468
45564,2016-03-30,21,33,279,312
45565,2016-03-30,22,16,215,231
45566,2016-03-30,23,19,89,108
45567,2016-03-31,0,6,22,28
45568,2016-03-31,1,2,14,16
45569,2016-03-31,2,1,9,10
45570,2016-03-31,3,0,2,2
45571,2016-03-31,4,1,7,8
45572,2016-03-31,5,3,77,80
45573,2016-03-31,6,10,230,240
45574,2016-03-31,7,37,713,750
45575,2016-03-31,8,48,1127,1175
45576,2016-03-31,9,82,507,589
45577,2016-03-31,10,117,239,356
45578,2016-03-31,11,160,255,415
45579,2016-03-31,12,152,331,483
45580,2016-03-31,13,198,368,566
45581,2016-03-31,14,153,278,431
45582,2016-03-31,15,159,345,504
45583,2016-03-31,16,169,577,746
45584,2016-03-31,17,192,1120,1312
45585,2016-03-31,18,171,1069,1240
45586,2016-03-31,19,126,681,807
45587,2016-03-31,20,51,484,535
45588,2016-03-31,21,47,299,346
45589,2016-03-31,22,29,211,240
45590,2016-03-31,23,36,114,150
45591,2016-04-01,0,9,55,64
45592,2016-04-01,1,14,27,41
45593,2016-04-01,2,16,12,28
45594,2016-04-01,3,3,6,9
45595,2016-04-01,4,4,7,11
45596,2016-04-01,5,0,53,53
45597,2016-04-01,6,15,172,187
45598,2016-04-01,7,25,602,627
45599,2016-04-01,8,27,576,603
45600,2016-04-01,9,30,358,388
45601,2016-04-01,10,77,227,304
45602,2016-04-01,11,120,303,423
45603,2016-04-01,12,165,361,526
45604,2016-04-01,13,225,385,610
45605,2016-04-01,14,273,380,653
45606,2016-04-01,15,248,472,720
45607,2016-04-01,16,280,709,989
45608,2016-04-01,17,277,1190,1467
45609,2016-04-01,18,227,896,1123
45610,2016-04-01,19,198,532,730
45611,2016-04-01,20,95,341,436
45612,2016-04-01,21,87,288,375
45613,2016-04-01,22,70,232,302
45614,2016-04-01,23,57,147,204
45615,2016-04-02,0,38,112,150
45616,2016-04-02,1,22,80,102
45617,2016-04-02,2,9,66,75
45618,2016-04-02,3,11,18,29
45619,2016-04-02,4,4,8,12
45620,2016-04-02,5,3,14,17
45621,2016-04-02,6,7,18,25
45622,2016-04-02,7,6,39,45
45623,2016-04-02,8,20,96,116
45624,2016-04-02,9,46,148,194
45625,2016-04-02,10,55,189,244
45626,2016-04-02,11,117,310,427
45627,2016-04-02,12,280,494,774
45628,2016-04-02,13,395,531,926
45629,2016-04-02,14,435,518,953
45630,2016-04-02,15,440,580,1020
45631,2016-04-02,16,442,572,1014
45632,2016-04-02,17,395,545,940
45633,2016-04-02,18,333,478,811
45634,2016-04-02,19,187,373,560
45635,2016-04-02,20,133,239,372
45636,2016-04-02,21,58,199,257
45637,2016-04-02,22,31,128,159
45638,2016-04-02,23,10,48,58
45639,2016-04-03,0,3,57,60
45640,2016-04-03,1,3,58,61
45641,2016-04-03,2,5,31,36
45642,2016-04-03,3,1,18,19
45643,2016-04-03,4,0,6,6
45644,2016-04-03,5,2,10,12
45645,2016-04-03,6,5,109,114
45646,2016-04-03,7,15,90,105
45647,2016-04-03,8,25,110,135
45648,2016-04-03,9,33,206,239
45649,2016-04-03,10,88,271,359
45650,2016-04-03,11,165,317,482
45651,2016-04-03,12,167,388,555
45652,2016-04-03,13,189,398,587
45653,2016-04-03,14,169,437,606
45654,2016-04-03,15,240,440,680
45655,2016-04-03,16,219,397,616
45656,2016-04-03,17,213,379,592
45657,2016-04-03,18,152,376,528
45658,2016-04-03,19,98,292,390
45659,2016-04-03,20,54,216,270
45660,2016-04-03,21,38,126,164
45661,2016-04-03,22,32,99,131
45662,2016-04-03,23,5,48,53
45663,2016-04-04,0,14,25,39
45664,2016-04-04,1,3,10,13
45665,2016-04-04,2,3,1,4
45666,2016-04-04,3,0,3,3
45667,2016-04-04,4,1,7,8
45668,2016-04-04,5,0,62,62
45669,2016-04-04,6,5,213,218
45670,2016-04-04,7,25,705,730
45671,2016-04-04,8,38,1165,1203
45672,2016-04-04,9,54,458,512
45673,2016-04-04,10,82,203,285
45674,2016-04-04,11,140,232,372
45675,2016-04-04,12,117,315,432
45676,2016-04-04,13,153,303,456
45677,2016-04-04,14,110,239,349
45678,2016-04-04,15,70,337,407
45679,2016-04-04,16,44,282,326
45680,2016-04-04,17,26,413,439
45681,2016-04-04,18,17,314,331
45682,2016-04-04,19,31,383,414
45683,2016-04-04,20,15,340,355
45684,2016-04-04,21,9,218,227
45685,2016-04-04,22,13,116,129
45686,2016-04-04,23,1,83,84
45687,2016-04-05,0,3,22,25
45688,2016-04-05,1,0,7,7
45689,2016-04-05,2,0,2,2
45690,2016-04-05,3,0,3,3
45691,2016-04-05,4,0,6,6
45692,2016-04-05,5,0,67,67
45693,2016-04-05,6,7,182,189
45694,2016-04-05,7,12,527,539
45695,2016-04-05,8,19,867,886
45696,2016-04-05,9,40,359,399
45697,2016-04-05,10,35,157,192
45698,2016-04-05,11,35,156,191
45699,2016-04-05,12,41,244,285
45700,2016-04-05,13,32,229,261
45701,2016-04-05,14,48,199,247
45702,2016-04-05,15,51,259,310
45703,2016-04-05,16,69,473,542
45704,2016-04-05,17,93,977,1070
45705,2016-04-05,18,80,841,921
45706,2016-04-05,19,31,530,561
45707,2016-04-05,20,6,330,336
45708,2016-04-05,21,20,241,261
45709,2016-04-05,22,20,121,141
45710,2016-04-05,23,3,68,71
45711,2016-04-06,0,0,33,33
45712,2016-04-06,1,1,4,5
45713,2016-04-06,2,1,3,4
45714,2016-04-06,3,0,1,1
45715,2016-04-06,4,1,4,5
45716,2016-04-06,5,0,49,49
45717,2016-04-06,6,2,190,192
45718,2016-04-06,7,16,570,586
45719,2016-04-06,8,20,1028,1048
45720,2016-04-06,9,40,469,509
45721,2016-04-06,10,47,187,234
45722,2016-04-06,11,79,227,306
45723,2016-04-06,12,71,271,342
45724,2016-04-06,13,101,255,356
45725,2016-04-06,14,89,251,340
45726,2016-04-06,15,98,273,371
45727,2016-04-06,16,107,520,627
45728,2016-04-06,17,120,1071,1191
45729,2016-04-06,18,84,1022,1106
45730,2016-04-06,19,60,631,691
45731,2016-04-06,20,54,410,464
45732,2016-04-06,21,30,304,334
45733,2016-04-06,22,21,164,185
45734,2016-04-06,23,12,75,87
45735,2016-04-07,0,3,33,36
45736,2016-04-07,1,4,14,18
45737,2016-04-07,2,1,3,4
45738,2016-04-07,3,0,1,1
45739,2016-04-07,4,0,9,9
45740,2016-04-07,5,1,59,60
45741,2016-04-07,6,3,229,232
45742,2016-04-07,7,7,259,266
45743,2016-04-07,8,4,341,345
45744,2016-04-07,9,3,95,98
45745,2016-04-07,10,3,25,28
45746,2016-04-07,11,12,142,154
45747,2016-04-07,12,35,204,239
45748,2016-04-07,13,46,248,294
45749,2016-04-07,14,65,271,336
45750,2016-04-07,15,72,336,408
45751,2016-04-07,16,64,356,420
45752,2016-04-07,17,27,320,347
45753,2016-04-07,18,44,699,743
45754,2016-04-07,19,45,429,474
45755,2016-04-07,20,23,336,359
45756,2016-04-07,21,17,246,263
45757,2016-04-07,22,10,186,196
45758,2016-04-07,23,1,102,103
45759,2016-04-08,0,5,41,46
45760,2016-04-08,1,7,13,20
45761,2016-04-08,2,4,14,18
45762,2016-04-08,3,0,2,2
45763,2016-04-08,4,0,11,11
45764,2016-04-08,5,1,48,49
45765,2016-04-08,6,4,198,202
45766,2016-04-08,7,15,591,606
45767,2016-04-08,8,34,982,1016
45768,2016-04-08,9,65,525,590
45769,2016-04-08,10,79,224,303
45770,2016-04-08,11,110,273,383
45771,2016-04-08,12,115,285,400
45772,2016-04-08,13,136,330,466
45773,2016-04-08,14,138,288,426
45774,2016-04-08,15,189,355,544
45775,2016-04-08,16,163,578,741
45776,2016-04-08,17,192,955,1147
45777,2016-04-08,18,144,794,938
45778,2016-04-08,19,115,528,643
45779,2016-04-08,20,50,311,361
45780,2016-04-08,21,34,233,267
45781,2016-04-08,22,18,173,191
45782,2016-04-08,23,33,126,159
45783,2016-04-09,0,9,102,111
45784,2016-04-09,1,12,47,59
45785,2016-04-09,2,8,41,49
45786,2016-04-09,3,5,20,25
45787,2016-04-09,4,0,4,4
45788,2016-04-09,5,0,3,3
45789,2016-04-09,6,6,17,23
45790,2016-04-09,7,8,37,45
45791,2016-04-09,8,13,110,123
45792,2016-04-09,9,33,187,220
45793,2016-04-09,10,6,100,106
45794,2016-04-09,11,20,126,146
45795,2016-04-09,12,45,217,262
45796,2016-04-09,13,60,270,330
45797,2016-04-09,14,87,286,373
45798,2016-04-09,15,153,345,498
45799,2016-04-09,16,138,269,407
45800,2016-04-09,17,66,270,336
45801,2016-04-09,18,52,241,293
45802,2016-04-09,19,36,189,225
45803,2016-04-09,20,16,138,154
45804,2016-04-09,21,13,118,131
45805,2016-04-09,22,7,75,82
45806,2016-04-09,23,2,62,64
45807,2016-04-10,0,1,51,52
45808,2016-04-10,1,7,51,58
45809,2016-04-10,2,3,29,32
45810,2016-04-10,3,4,19,23
45811,2016-04-10,4,0,3,3
45812,2016-04-10,5,1,2,3
45813,2016-04-10,6,3,9,12
45814,2016-04-10,7,11,37,48
45815,2016-04-10,8,24,103,127
45816,2016-04-10,9,76,178,254
45817,2016-04-10,10,132,314,446
45818,2016-04-10,11,205,375,580
45819,2016-04-10,12,250,424,674
45820,2016-04-10,13,283,433,716
45821,2016-04-10,14,286,400,686
45822,2016-04-10,15,287,419,706
45823,2016-04-10,16,252,501,753
45824,2016-04-10,17,263,432,695
45825,2016-04-10,18,163,383,546
45826,2016-04-10,19,98,313,411
45827,2016-04-10,20,73,182,255
45828,2016-04-10,21,46,122,168
45829,2016-04-10,22,29,101,130
45830,2016-04-10,23,10,33,43
45831,2016-04-11,0,5,17,22
45832,2016-04-11,1,2,5,7
45833,2016-04-11,2,3,5,8
45834,2016-04-11,3,0,1,1
45835,2016-04-11,4,0,5,5
45836,2016-04-11,5,1,60,61
45837,2016-04-11,6,3,158,161
45838,2016-04-11,7,13,458,471
45839,2016-04-11,8,13,647,660
45840,2016-04-11,9,32,443,475
45841,2016-04-11,10,65,167,232
45842,2016-04-11,11,108,215,323
45843,2016-04-11,12,89,272,361
45844,2016-04-11,13,114,298,412
45845,2016-04-11,14,127,261,388
45846,2016-04-11,15,145,311,456
45847,2016-04-11,16,177,579,756
45848,2016-04-11,17,134,1186,1320
45849,2016-04-11,18,168,1153,1321
45850,2016-04-11,19,113,685,798
45851,2016-04-11,20,53,458,511
45852,2016-04-11,21,50,318,368
45853,2016-04-11,22,39,202,241
45854,2016-04-11,23,25,73,98
45855,2016-04-12,0,9,38,47
45856,2016-04-12,1,1,8,9
45857,2016-04-12,2,5,7,12
45858,2016-04-12,3,0,4,4
45859,2016-04-12,4,0,8,8
45860,2016-04-12,5,0,81,81
45861,2016-04-12,6,5,190,195
45862,2016-04-12,7,3,423,426
45863,2016-04-12,8,18,779,797
45864,2016-04-12,9,7,180,187
45865,2016-04-12,10,26,145,171
45866,2016-04-12,11,47,229,276
45867,2016-04-12,12,42,250,292
45868,2016-04-12,13,56,299,355
45869,2016-04-12,14,95,265,360
45870,2016-04-12,15,92,367,459
45871,2016-04-12,16,137,611,748
45872,2016-04-12,17,122,1223,1345
45873,2016-04-12,18,78,984,1062
45874,2016-04-12,19,64,611,675
45875,2016-04-12,20,59,381,440
45876,2016-04-12,21,22,281,303
45877,2016-04-12,22,29,212,241
45878,2016-04-12,23,9,80,89
45879,2016-04-13,0,7,23,30
45880,2016-04-13,1,8,11,19
45881,2016-04-13,2,4,3,7
45882,2016-04-13,3,0,2,2
45883,2016-04-13,4,1,11,12
45884,2016-04-13,5,1,70,71
45885,2016-04-13,6,3,252,255
45886,2016-04-13,7,18,729,747
45887,2016-04-13,8,30,1148,1178
45888,2016-04-13,9,53,485,538
45889,2016-04-13,10,60,214,274
45890,2016-04-13,11,85,236,321
45891,2016-04-13,12,92,314,406
45892,2016-04-13,13,102,320,422
45893,2016-04-13,14,114,223,337
45894,2016-04-13,15,96,338,434
45895,2016-04-13,16,88,610,698
45896,2016-04-13,17,114,1296,1410
45897,2016-04-13,18,103,1075,1178
45898,2016-04-13,19,67,634,701
45899,2016-04-13,20,28,396,424
45900,2016-04-13,21,41,306,347
45901,2016-04-13,22,24,199,223
45902,2016-04-13,23,12,84,96
45903,2016-04-14,0,3,22,25
45904,2016-04-14,1,4,17,21
45905,2016-04-14,2,0,10,10
45906,2016-04-14,3,0,2,2
45907,2016-04-14,4,3,5,8
45908,2016-04-14,5,1,55,56
45909,2016-04-14,6,5,232,237
45910,2016-04-14,7,22,688,710
45911,2016-04-14,8,39,1158,1197
45912,2016-04-14,9,53,492,545
45913,2016-04-14,10,62,230,292
45914,2016-04-14,11,117,252,369
45915,2016-04-14,12,80,343,423
45916,2016-04-14,13,94,364,458
45917,2016-04-14,14,149,304,453
45918,2016-04-14,15,133,393,526
45919,2016-04-14,16,128,597,725
45920,2016-04-14,17,137,1256,1393
45921,2016-04-14,18,102,1083,1185
45922,2016-04-14,19,92,619,711
45923,2016-04-14,20,43,442,485
45924,2016-04-14,21,32,299,331
45925,2016-04-14,22,19,222,241
45926,2016-04-14,23,5,115,120
45927,2016-04-15,0,5,44,49
45928,2016-04-15,1,1,34,35
45929,2016-04-15,2,0,13,13
45930,2016-04-15,3,4,3,7
45931,2016-04-15,4,2,4,6
45932,2016-04-15,5,1,59,60
45933,2016-04-15,6,2,193,195
45934,2016-04-15,7,39,594,633
45935,2016-04-15,8,57,1089,1146
45936,2016-04-15,9,58,540,598
45937,2016-04-15,10,90,254,344
45938,2016-04-15,11,153,345,498
45939,2016-04-15,12,212,415,627
45940,2016-04-15,13,226,433,659
45941,2016-04-15,14,243,358,601
45942,2016-04-15,15,271,424,695
45943,2016-04-15,16,246,701,947
45944,2016-04-15,17,246,1135,1381
45945,2016-04-15,18,161,885,1046
45946,2016-04-15,19,113,617,730
45947,2016-04-15,20,78,378,456
45948,2016-04-15,21,40,209,249
45949,2016-04-15,22,45,192,237
45950,2016-04-15,23,35,146,181
45951,2016-04-16,0,16,90,106
45952,2016-04-16,1,4,71,75
45953,2016-04-16,2,2,41,43
45954,2016-04-16,3,1,17,18
45955,2016-04-16,4,2,3,5
45956,2016-04-16,5,0,13,13
45957,2016-04-16,6,10,31,41
45958,2016-04-16,7,27,95,122
45959,2016-04-16,8,58,223,281
45960,2016-04-16,9,141,432,573
45961,2016-04-16,10,288,464,752
45962,2016-04-16,11,420,549,969
45963,2016-04-16,12,567,728,1295
45964,2016-04-16,13,596,582,1178
45965,2016-04-16,14,657,547,1204
45966,2016-04-16,15,704,673,1377
45967,2016-04-16,16,601,610,1211
45968,2016-04-16,17,564,546,1110
45969,2016-04-16,18,426,505,931
45970,2016-04-16,19,319,454,773
45971,2016-04-16,20,223,295,518
45972,2016-04-16,21,148,257,405
45973,2016-04-16,22,105,187,292
45974,2016-04-16,23,90,122,212
45975,2016-04-17,0,27,104,131
45976,2016-04-17,1,22,77,99
45977,2016-04-17,2,13,53,66
45978,2016-04-17,3,3,30,33
45979,2016-04-17,4,1,4,5
45980,2016-04-17,5,3,9,12
45981,2016-04-17,6,10,14,24
45982,2016-04-17,7,17,55,72
45983,2016-04-17,8,79,191,270
45984,2016-04-17,9,179,300,479
45985,2016-04-17,10,312,422,734
45986,2016-04-17,11,451,533,984
45987,2016-04-17,12,492,635,1127
45988,2016-04-17,13,557,650,1207
45989,2016-04-17,14,492,653,1145
45990,2016-04-17,15,542,633,1175
45991,2016-04-17,16,504,570,1074
45992,2016-04-17,17,469,588,1057
45993,2016-04-17,18,354,525,879
45994,2016-04-17,19,288,431,719
45995,2016-04-17,20,186,295,481
45996,2016-04-17,21,137,200,337
45997,2016-04-17,22,76,93,169
45998,2016-04-17,23,36,49,85
45999,2016-04-18,0,25,26,51
46000,2016-04-18,1,9,12,21
46001,2016-04-18,2,3,8,11
46002,2016-04-18,3,0,5,5
46003,2016-04-18,4,1,9,10
46004,2016-04-18,5,0,58,58
46005,2016-04-18,6,12,258,270
46006,2016-04-18,7,25,754,779
46007,2016-04-18,8,71,1111,1182
46008,2016-04-18,9,101,497,598
46009,2016-04-18,10,114,189,303
46010,2016-04-18,11,141,262,403
46011,2016-04-18,12,147,324,471
46012,2016-04-18,13,235,348,583
46013,2016-04-18,14,203,274,477
46014,2016-04-18,15,178,344,522
46015,2016-04-18,16,182,634,816
46016,2016-04-18,17,212,1324,1536
46017,2016-04-18,18,200,1154,1354
46018,2016-04-18,19,169,752,921
46019,2016-04-18,20,110,521,631
46020,2016-04-18,21,118,357,475
46021,2016-04-18,22,88,177,265
46022,2016-04-18,23,65,75,140
46023,2016-04-19,0,8,21,29
46024,2016-04-19,1,14,9,23
46025,2016-04-19,2,3,8,11
46026,2016-04-19,3,4,1,5
46027,2016-04-19,4,3,9,12
46028,2016-04-19,5,4,85,89
46029,2016-04-19,6,21,300,321
46030,2016-04-19,7,41,860,901
46031,2016-04-19,8,54,1250,1304
46032,2016-04-19,9,61,504,565
46033,2016-04-19,10,125,257,382
46034,2016-04-19,11,110,287,397
46035,2016-04-19,12,165,326,491
46036,2016-04-19,13,140,319,459
46037,2016-04-19,14,155,288,443
46038,2016-04-19,15,177,384,561
46039,2016-04-19,16,183,626,809
46040,2016-04-19,17,226,1323,1549
46041,2016-04-19,18,152,1234,1386
46042,2016-04-19,19,136,775,911
46043,2016-04-19,20,79,488,567
46044,2016-04-19,21,41,337,378
46045,2016-04-19,22,44,173,217
46046,2016-04-19,23,15,101,116
46047,2016-04-20,0,27,34,61
46048,2016-04-20,1,10,12,22
46049,2016-04-20,2,0,6,6
46050,2016-04-20,3,0,4,4
46051,2016-04-20,4,0,6,6
46052,2016-04-20,5,1,89,90
46053,2016-04-20,6,9,319,328
46054,2016-04-20,7,21,833,854
46055,2016-04-20,8,54,1241,1295
46056,2016-04-20,9,69,554,623
46057,2016-04-20,10,76,209,285
46058,2016-04-20,11,104,279,383
46059,2016-04-20,12,105,376,481
46060,2016-04-20,13,85,372,457
46061,2016-04-20,14,145,289,434
46062,2016-04-20,15,145,348,493
46063,2016-04-20,16,190,697,887
46064,2016-04-20,17,176,1356,1532
46065,2016-04-20,18,149,1088,1237
46066,2016-04-20,19,119,744,863
46067,2016-04-20,20,91,465,556
46068,2016-04-20,21,82,318,400
46069,2016-04-20,22,29,205,234
46070,2016-04-20,23,22,94,116
46071,2016-04-21,0,13,30,43
46072,2016-04-21,1,3,16,19
46073,2016-04-21,2,0,4,4
46074,2016-04-21,3,0,3,3
46075,2016-04-21,4,1,5,6
46076,2016-04-21,5,1,82,83
46077,2016-04-21,6,1,289,290
46078,2016-04-21,7,23,818,841
46079,2016-04-21,8,51,1240,1291
46080,2016-04-21,9,56,499,555
46081,2016-04-21,10,74,239,313
46082,2016-04-21,11,113,280,393
46083,2016-04-21,12,133,371,504
46084,2016-04-21,13,139,346,485
46085,2016-04-21,14,142,304,446
46086,2016-04-21,15,144,360,504
46087,2016-04-21,16,193,667,860
46088,2016-04-21,17,187,1269,1456
46089,2016-04-21,18,172,1123,1295
46090,2016-04-21,19,107,655,762
46091,2016-04-21,20,73,449,522
46092,2016-04-21,21,71,333,404
46093,2016-04-21,22,26,217,243
46094,2016-04-21,23,15,110,125
46095,2016-04-22,0,21,56,77
46096,2016-04-22,1,9,28,37
46097,2016-04-22,2,6,5,11
46098,2016-04-22,3,1,13,14
46099,2016-04-22,4,1,16,17
46100,2016-04-22,5,1,86,87
46101,2016-04-22,6,5,284,289
46102,2016-04-22,7,13,698,711
46103,2016-04-22,8,54,1192,1246
46104,2016-04-22,9,96,492,588
46105,2016-04-22,10,144,247,391
46106,2016-04-22,11,176,267,443
46107,2016-04-22,12,191,384,575
46108,2016-04-22,13,160,322,482
46109,2016-04-22,14,160,286,446
46110,2016-04-22,15,176,383,559
46111,2016-04-22,16,209,725,934
46112,2016-04-22,17,179,1243,1422
46113,2016-04-22,18,164,872,1036
46114,2016-04-22,19,103,502,605
46115,2016-04-22,20,44,296,340
46116,2016-04-22,21,62,256,318
46117,2016-04-22,22,70,223,293
46118,2016-04-22,23,23,149,172
46119,2016-04-23,0,21,94,115
46120,2016-04-23,1,8,65,73
46121,2016-04-23,2,13,38,51
46122,2016-04-23,3,5,21,26
46123,2016-04-23,4,1,5,6
46124,2016-04-23,5,4,5,9
46125,2016-04-23,6,6,27,33
46126,2016-04-23,7,24,102,126
46127,2016-04-23,8,47,186,233
46128,2016-04-23,9,37,132,169
46129,2016-04-23,10,38,133,171
46130,2016-04-23,11,33,109,142
46131,2016-04-23,12,151,308,459
46132,2016-04-23,13,241,406,647
46133,2016-04-23,14,340,467,807
46134,2016-04-23,15,321,527,848
46135,2016-04-23,16,359,542,901
46136,2016-04-23,17,381,545,926
46137,2016-04-23,18,339,514,853
46138,2016-04-23,19,272,411,683
46139,2016-04-23,20,170,286,456
46140,2016-04-23,21,105,255,360
46141,2016-04-23,22,51,152,203
46142,2016-04-23,23,51,139,190
46143,2016-04-24,0,35,97,132
46144,2016-04-24,1,6,67,73
46145,2016-04-24,2,4,42,46
46146,2016-04-24,3,1,29,30
46147,2016-04-24,4,0,7,7
46148,2016-04-24,5,3,10,13
46149,2016-04-24,6,9,16,25
46150,2016-04-24,7,24,75,99
46151,2016-04-24,8,41,154,195
46152,2016-04-24,9,153,282,435
46153,2016-04-24,10,302,494,796
46154,2016-04-24,11,441,570,1011
46155,2016-04-24,12,505,662,1167
46156,2016-04-24,13,510,603,1113
46157,2016-04-24,14,569,600,1169
46158,2016-04-24,15,460,605,1065
46159,2016-04-24,16,478,635,1113
46160,2016-04-24,17,396,578,974
46161,2016-04-24,18,341,539,880
46162,2016-04-24,19,230,394,624
46163,2016-04-24,20,149,291,440
46164,2016-04-24,21,84,154,238
46165,2016-04-24,22,50,156,206
46166,2016-04-24,23,23,72,95
46167,2016-04-25,0,24,26,50
46168,2016-04-25,1,15,12,27
46169,2016-04-25,2,2,8,10
46170,2016-04-25,3,1,1,2
46171,2016-04-25,4,0,5,5
46172,2016-04-25,5,6,74,80
46173,2016-04-25,6,4,263,267
46174,2016-04-25,7,17,774,791
46175,2016-04-25,8,28,1150,1178
46176,2016-04-25,9,82,419,501
46177,2016-04-25,10,178,205,383
46178,2016-04-25,11,210,245,455
46179,2016-04-25,12,168,351,519
46180,2016-04-25,13,163,317,480
46181,2016-04-25,14,190,268,458
46182,2016-04-25,15,218,353,571
46183,2016-04-25,16,200,645,845
46184,2016-04-25,17,233,1349,1582
46185,2016-04-25,18,189,1136,1325
46186,2016-04-25,19,143,725,868
46187,2016-04-25,20,121,495,616
46188,2016-04-25,21,61,338,399
46189,2016-04-25,22,28,166,194
46190,2016-04-25,23,14,73,87
46191,2016-04-26,0,5,32,37
46192,2016-04-26,1,5,12,17
46193,2016-04-26,2,0,3,3
46194,2016-04-26,3,0,4,4
46195,2016-04-26,4,1,10,11
46196,2016-04-26,5,4,81,85
46197,2016-04-26,6,7,333,340
46198,2016-04-26,7,35,860,895
46199,2016-04-26,8,55,1278,1333
46200,2016-04-26,9,93,498,591
46201,2016-04-26,10,124,212,336
46202,2016-04-26,11,126,303,429
46203,2016-04-26,12,110,345,455
46204,2016-04-26,13,134,342,476
46205,2016-04-26,14,132,277,409
46206,2016-04-26,15,134,348,482
46207,2016-04-26,16,150,614,764
46208,2016-04-26,17,152,1321,1473
46209,2016-04-26,18,133,1184,1317
46210,2016-04-26,19,126,751,877
46211,2016-04-26,20,80,481,561
46212,2016-04-26,21,63,327,390
46213,2016-04-26,22,63,233,296
46214,2016-04-26,23,20,115,135
46215,2016-04-27,0,15,42,57
46216,2016-04-27,1,6,23,29
46217,2016-04-27,2,1,6,7
46218,2016-04-27,3,0,4,4
46219,2016-04-27,4,1,10,11
46220,2016-04-27,5,0,80,80
46221,2016-04-27,6,4,236,240
46222,2016-04-27,7,17,631,648
46223,2016-04-27,8,24,661,685
46224,2016-04-27,9,13,274,287
46225,2016-04-27,10,44,165,209
46226,2016-04-27,11,57,193,250
46227,2016-04-27,12,65,261,326
46228,2016-04-27,13,65,268,333
46229,2016-04-27,14,76,220,296
46230,2016-04-27,15,82,291,373
46231,2016-04-27,16,91,567,658
46232,2016-04-27,17,122,1134,1256
46233,2016-04-27,18,64,888,952
46234,2016-04-27,19,68,549,617
46235,2016-04-27,20,44,365,409
46236,2016-04-27,21,21,275,296
46237,2016-04-27,22,26,198,224
46238,2016-04-27,23,18,95,113
46239,2016-04-28,0,16,35,51
46240,2016-04-28,1,2,14,16
46241,2016-04-28,2,4,6,10
46242,2016-04-28,3,0,5,5
46243,2016-04-28,4,1,7,8
46244,2016-04-28,5,1,61,62
46245,2016-04-28,6,3,194,197
46246,2016-04-28,7,13,628,641
46247,2016-04-28,8,25,694,719
46248,2016-04-28,9,12,177,189
46249,2016-04-28,10,5,46,51
46250,2016-04-28,11,4,44,48
46251,2016-04-28,12,9,82,91
46252,2016-04-28,13,21,166,187
46253,2016-04-28,14,48,184,232
46254,2016-04-28,15,40,163,203
46255,2016-04-28,16,23,198,221
46256,2016-04-28,17,20,531,551
46257,2016-04-28,18,42,625,667
46258,2016-04-28,19,36,428,464
46259,2016-04-28,20,15,264,279
46260,2016-04-28,21,4,79,83
46261,2016-04-28,22,4,112,116
46262,2016-04-28,23,5,99,104
46263,2016-04-29,0,2,46,48
46264,2016-04-29,1,2,16,18
46265,2016-04-29,2,0,4,4
46266,2016-04-29,3,0,3,3
46267,2016-04-29,4,0,9,9
46268,2016-04-29,5,1,58,59
46269,2016-04-29,6,5,177,182
46270,2016-04-29,7,10,470,480
46271,2016-04-29,8,31,987,1018
46272,2016-04-29,9,26,508,534
46273,2016-04-29,10,32,192,224
46274,2016-04-29,11,69,184,253
46275,2016-04-29,12,73,310,383
46276,2016-04-29,13,84,292,376
46277,2016-04-29,14,100,305,405
46278,2016-04-29,15,123,331,454
46279,2016-04-29,16,93,529,622
46280,2016-04-29,17,118,948,1066
46281,2016-04-29,18,92,743,835
46282,2016-04-29,19,59,456,515
46283,2016-04-29,20,36,213,249
46284,2016-04-29,21,37,149,186
46285,2016-04-29,22,34,150,184
46286,2016-04-29,23,28,122,150
46287,2016-04-30,0,17,81,98
46288,2016-04-30,1,9,52,61
46289,2016-04-30,2,8,54,62
46290,2016-04-30,3,6,32,38
46291,2016-04-30,4,6,6,12
46292,2016-04-30,5,3,9,12
46293,2016-04-30,6,13,36,49
46294,2016-04-30,7,19,70,89
46295,2016-04-30,8,51,205,256
46296,2016-04-30,9,101,299,400
46297,2016-04-30,10,167,398,565
46298,2016-04-30,11,266,467,733
46299,2016-04-30,12,226,509,735
46300,2016-04-30,13,339,453,792
46301,2016-04-30,14,317,465,782
46302,2016-04-30,15,295,452,747
46303,2016-04-30,16,345,446,791
46304,2016-04-30,17,283,429,712
46305,2016-04-30,18,149,381,530
46306,2016-04-30,19,111,322,433
46307,2016-04-30,20,69,205,274
46308,2016-04-30,21,21,112,133
46309,2016-04-30,22,10,69,79
46310,2016-04-30,23,13,113,126
46311,2016-05-01,0,11,69,80
46312,2016-05-01,1,6,56,62
46313,2016-05-01,2,3,30,33
46314,2016-05-01,3,0,19,19
46315,2016-05-01,4,0,8,8
46316,2016-05-01,6,4,11,15
46317,2016-05-01,7,3,19,22
46318,2016-05-01,8,1,43,44
46319,2016-05-01,9,8,73,81
46320,2016-05-01,10,10,98,108
46321,2016-05-01,11,11,102,113
46322,2016-05-01,12,49,228,277
46323,2016-05-01,13,92,278,370
46324,2016-05-01,14,115,328,443
46325,2016-05-01,15,150,372,522
46326,2016-05-01,16,150,365,515
46327,2016-05-01,17,134,340,474
46328,2016-05-01,18,71,336,407
46329,2016-05-01,19,54,238,292
46330,2016-05-01,20,35,169,204
46331,2016-05-01,21,18,100,118
46332,2016-05-01,22,12,100,112
46333,2016-05-01,23,10,47,57
46334,2016-05-02,0,1,25,26
46335,2016-05-02,1,2,2,4
46336,2016-05-02,2,0,5,5
46337,2016-05-02,3,1,1,2
46338,2016-05-02,4,3,7,10
46339,2016-05-02,5,2,56,58
46340,2016-05-02,6,4,147,151
46341,2016-05-02,7,9,526,535
46342,2016-05-02,8,23,958,981
46343,2016-05-02,9,45,456,501
46344,2016-05-02,10,77,185,262
46345,2016-05-02,11,110,210,320
46346,2016-05-02,12,124,326,450
46347,2016-05-02,13,155,323,478
46348,2016-05-02,14,115,264,379
46349,2016-05-02,15,144,339,483
46350,2016-05-02,16,171,580,751
46351,2016-05-02,17,168,1276,1444
46352,2016-05-02,18,88,718,806
46353,2016-05-02,19,9,128,137
46354,2016-05-02,20,14,115,129
46355,2016-05-02,21,1,91,92
46356,2016-05-02,22,6,65,71
46357,2016-05-02,23,3,61,64
46358,2016-05-03,0,5,17,22
46359,2016-05-03,1,4,8,12
46360,2016-05-03,2,1,8,9
46361,2016-05-03,3,0,6,6
46362,2016-05-03,4,0,5,5
46363,2016-05-03,5,1,63,64
46364,2016-05-03,6,7,153,160
46365,2016-05-03,7,4,513,517
46366,2016-05-03,8,18,979,997
46367,2016-05-03,9,36,481,517
46368,2016-05-03,10,39,240,279
46369,2016-05-03,11,68,252,320
46370,2016-05-03,12,69,292,361
46371,2016-05-03,13,65,318,383
46372,2016-05-03,14,91,301,392
46373,2016-05-03,15,93,361,454
46374,2016-05-03,16,103,562,665
46375,2016-05-03,17,31,451,482
46376,2016-05-03,18,42,774,816
46377,2016-05-03,19,32,630,662
46378,2016-05-03,20,30,393,423
46379,2016-05-03,21,21,284,305
46380,2016-05-03,22,31,168,199
46381,2016-05-03,23,12,70,82
46382,2016-05-04,0,4,19,23
46383,2016-05-04,1,2,3,5
46384,2016-05-04,2,0,1,1
46385,2016-05-04,3,0,3,3
46386,2016-05-04,4,0,7,7
46387,2016-05-04,5,1,86,87
46388,2016-05-04,6,7,243,250
46389,2016-05-04,7,17,706,723
46390,2016-05-04,8,48,1122,1170
46391,2016-05-04,9,39,497,536
46392,2016-05-04,10,50,238,288
46393,2016-05-04,11,78,287,365
46394,2016-05-04,12,97,324,421
46395,2016-05-04,13,104,327,431
46396,2016-05-04,14,88,271,359
46397,2016-05-04,15,69,313,382
46398,2016-05-04,16,80,574,654
46399,2016-05-04,17,111,1197,1308
46400,2016-05-04,18,73,945,1018
46401,2016-05-04,19,43,507,550
46402,2016-05-04,20,42,366,408
46403,2016-05-04,21,32,309,341
46404,2016-05-04,22,22,159,181
46405,2016-05-04,23,10,103,113
46406,2016-05-05,0,7,43,50
46407,2016-05-05,1,0,12,12
46408,2016-05-05,2,0,2,2
46409,2016-05-05,3,2,3,5
46410,2016-05-05,4,0,7,7
46411,2016-05-05,5,0,54,54
46412,2016-05-05,6,7,219,226
46413,2016-05-05,7,15,395,410
46414,2016-05-05,8,25,892,917
46415,2016-05-05,9,36,444,480
46416,2016-05-05,10,36,165,201
46417,2016-05-05,11,42,231,273
46418,2016-05-05,12,50,243,293
46419,2016-05-05,13,61,281,342
46420,2016-05-05,14,68,235,303
46421,2016-05-05,15,74,322,396
46422,2016-05-05,16,105,554,659
46423,2016-05-05,17,158,1266,1424
46424,2016-05-05,18,86,964,1050
46425,2016-05-05,19,52,558,610
46426,2016-05-05,20,30,385,415
46427,2016-05-05,21,15,276,291
46428,2016-05-05,22,9,174,183
46429,2016-05-05,23,15,108,123
46430,2016-05-06,0,3,50,53
46431,2016-05-06,1,3,32,35
46432,2016-05-06,2,2,17,19
46433,2016-05-06,3,2,7,9
46434,2016-05-06,4,0,9,9
46435,2016-05-06,5,3,53,56
46436,2016-05-06,6,3,91,94
46437,2016-05-06,7,8,194,202
46438,2016-05-06,8,5,331,336
46439,2016-05-06,9,3,150,153
46440,2016-05-06,10,9,56,65
46441,2016-05-06,11,3,47,50
46442,2016-05-06,12,2,41,43
46443,2016-05-06,13,3,44,47
46444,2016-05-06,14,6,45,51
46445,2016-05-06,15,17,108,125
46446,2016-05-06,16,6,121,127
46447,2016-05-06,17,7,262,269
46448,2016-05-06,18,16,368,384
46449,2016-05-06,19,19,339,358
46450,2016-05-06,20,22,253,275
46451,2016-05-06,21,18,149,167
46452,2016-05-06,22,4,89,93
46453,2016-05-06,23,5,77,82
46454,2016-05-07,0,3,60,63
46455,2016-05-07,1,0,38,38
46456,2016-05-07,2,1,19,20
46457,2016-05-07,3,0,11,11
46458,2016-05-07,4,0,9,9
46459,2016-05-07,5,0,4,4
46460,2016-05-07,6,5,31,36
46461,2016-05-07,7,9,116,125
46462,2016-05-07,8,31,193,224
46463,2016-05-07,9,102,346,448
46464,2016-05-07,10,138,414,552
46465,2016-05-07,11,189,429,618
46466,2016-05-07,12,214,527,741
46467,2016-05-07,13,269,549,818
46468,2016-05-07,14,258,478,736
46469,2016-05-07,15,328,479,807
46470,2016-05-07,16,302,504,806
46471,2016-05-07,17,292,485,777
46472,2016-05-07,18,229,419,648
46473,2016-05-07,19,189,416,605
46474,2016-05-07,20,144,264,408
46475,2016-05-07,21,90,222,312
46476,2016-05-07,22,59,210,269
46477,2016-05-07,23,27,122,149
46478,2016-05-08,0,40,89,129
46479,2016-05-08,1,18,72,90
46480,2016-05-08,2,3,49,52
46481,2016-05-08,3,0,12,12
46482,2016-05-08,4,1,4,5
46483,2016-05-08,5,2,9,11
46484,2016-05-08,6,8,15,23
46485,2016-05-08,7,16,61,77
46486,2016-05-08,8,37,145,182
46487,2016-05-08,9,120,270,390
46488,2016-05-08,10,256,439,695
46489,2016-05-08,11,341,516,857
46490,2016-05-08,12,391,569,960
46491,2016-05-08,13,466,650,1116
46492,2016-05-08,14,451,592,1043
46493,2016-05-08,15,488,598,1086
46494,2016-05-08,16,441,553,994
46495,2016-05-08,17,333,518,851
46496,2016-05-08,18,218,513,731
46497,2016-05-08,19,181,391,572
46498,2016-05-08,20,110,311,421
46499,2016-05-08,21,70,162,232
46500,2016-05-08,22,37,143,180
46501,2016-05-08,23,26,65,91
46502,2016-05-09,0,10,30,40
46503,2016-05-09,1,2,11,13
46504,2016-05-09,2,0,7,7
46505,2016-05-09,3,0,3,3
46506,2016-05-09,4,2,7,9
46507,2016-05-09,5,3,58,61
46508,2016-05-09,6,10,240,250
46509,2016-05-09,7,18,744,762
46510,2016-05-09,8,42,1141,1183
46511,2016-05-09,9,68,456,524
46512,2016-05-09,10,71,199,270
46513,2016-05-09,11,47,101,148
46514,2016-05-09,12,28,109,137
46515,2016-05-09,13,20,101,121
46516,2016-05-09,14,54,154,208
46517,2016-05-09,15,73,266,339
46518,2016-05-09,16,100,523,623
46519,2016-05-09,17,127,1216,1343
46520,2016-05-09,18,119,1149,1268
46521,2016-05-09,19,88,662,750
46522,2016-05-09,20,48,435,483
46523,2016-05-09,21,33,271,304
46524,2016-05-09,22,31,188,219
46525,2016-05-09,23,28,70,98
46526,2016-05-10,0,4,34,38
46527,2016-05-10,1,2,9,11
46528,2016-05-10,2,0,9,9
46529,2016-05-10,3,1,3,4
46530,2016-05-10,4,0,11,11
46531,2016-05-10,5,1,79,80
46532,2016-05-10,6,9,248,257
46533,2016-05-10,7,23,744,767
46534,2016-05-10,8,22,974,996
46535,2016-05-10,9,38,392,430
46536,2016-05-10,10,63,211,274
46537,2016-05-10,11,88,248,336
46538,2016-05-10,12,81,333,414
46539,2016-05-10,13,120,328,448
46540,2016-05-10,14,119,241,360
46541,2016-05-10,15,109,304,413
46542,2016-05-10,16,130,619,749
46543,2016-05-10,17,166,1290,1456
46544,2016-05-10,18,118,1087,1205
46545,2016-05-10,19,79,713,792
46546,2016-05-10,20,64,431,495
46547,2016-05-10,21,38,296,334
46548,2016-05-10,22,18,207,225
46549,2016-05-10,23,18,120,138
46550,2016-05-11,0,5,32,37
46551,2016-05-11,1,4,9,13
46552,2016-05-11,2,5,9,14
46553,2016-05-11,3,0,1,1
46554,2016-05-11,4,0,6,6
46555,2016-05-11,5,7,79,86
46556,2016-05-11,6,7,280,287
46557,2016-05-11,7,20,749,769
46558,2016-05-11,8,35,1222,1257
46559,2016-05-11,9,30,358,388
46560,2016-05-11,10,29,138,167
46561,2016-05-11,11,54,189,243
46562,2016-05-11,12,33,126,159
46563,2016-05-11,13,24,103,127
46564,2016-05-11,14,30,93,123
46565,2016-05-11,15,21,97,118
46566,2016-05-11,16,35,317,352
46567,2016-05-11,17,57,777,834
46568,2016-05-11,18,55,914,969
46569,2016-05-11,19,58,546,604
46570,2016-05-11,20,41,363,404
46571,2016-05-11,21,28,304,332
46572,2016-05-11,22,26,219,245
46573,2016-05-11,23,15,117,132
46574,2016-05-12,0,5,38,43
46575,2016-05-12,1,4,25,29
46576,2016-05-12,2,12,7,19
46577,2016-05-12,3,5,1,6
46578,2016-05-12,4,2,6,8
46579,2016-05-12,5,0,83,83
46580,2016-05-12,6,3,247,250
46581,2016-05-12,7,12,781,793
46582,2016-05-12,8,42,1186,1228
46583,2016-05-12,9,59,480,539
46584,2016-05-12,10,69,220,289
46585,2016-05-12,11,82,245,327
46586,2016-05-12,12,107,320,427
46587,2016-05-12,13,148,334,482
46588,2016-05-12,14,110,274,384
46589,2016-05-12,15,119,366,485
46590,2016-05-12,16,139,589,728
46591,2016-05-12,17,158,1224,1382
46592,2016-05-12,18,112,1128,1240
46593,2016-05-12,19,108,653,761
46594,2016-05-12,20,69,477,546
46595,2016-05-12,21,55,285,340
46596,2016-05-12,22,35,215,250
46597,2016-05-12,23,32,133,165
46598,2016-05-13,0,33,54,87
46599,2016-05-13,1,19,33,52
46600,2016-05-13,2,6,19,25
46601,2016-05-13,3,0,2,2
46602,2016-05-13,4,0,10,10
46603,2016-05-13,5,1,68,69
46604,2016-05-13,6,17,232,249
46605,2016-05-13,7,29,618,647
46606,2016-05-13,8,43,1093,1136
46607,2016-05-13,9,38,468,506
46608,2016-05-13,10,61,179,240
46609,2016-05-13,11,27,79,106
46610,2016-05-13,12,25,164,189
46611,2016-05-13,13,63,288,351
46612,2016-05-13,14,114,304,418
46613,2016-05-13,15,135,411,546
46614,2016-05-13,16,145,712,857
46615,2016-05-13,17,168,1202,1370
46616,2016-05-13,18,133,956,1089
46617,2016-05-13,19,144,539,683
46618,2016-05-13,20,83,401,484
46619,2016-05-13,21,73,295,368
46620,2016-05-13,22,110,269,379
46621,2016-05-13,23,75,167,242
46622,2016-05-14,0,33,114,147
46623,2016-05-14,1,26,76,102
46624,2016-05-14,2,12,48,60
46625,2016-05-14,3,9,24,33
46626,2016-05-14,4,1,8,9
46627,2016-05-14,5,1,9,10
46628,2016-05-14,6,8,36,44
46629,2016-05-14,7,13,106,119
46630,2016-05-14,8,71,259,330
46631,2016-05-14,9,191,435,626
46632,2016-05-14,10,269,541,810
46633,2016-05-14,11,443,595,1038
46634,2016-05-14,12,453,701,1154
46635,2016-05-14,13,514,570,1084
46636,2016-05-14,14,390,529,919
46637,2016-05-14,15,81,165,246
46638,2016-05-14,16,51,102,153
46639,2016-05-14,17,175,242,417
46640,2016-05-14,18,231,411,642
46641,2016-05-14,19,166,302,468
46642,2016-05-14,20,110,264,374
46643,2016-05-14,21,50,219,269
46644,2016-05-14,22,38,147,185
46645,2016-05-14,23,25,124,149
46646,2016-05-15,0,18,93,111
46647,2016-05-15,1,7,82,89
46648,2016-05-15,2,8,31,39
46649,2016-05-15,3,2,19,21
46650,2016-05-15,4,1,8,9
46651,2016-05-15,5,0,7,7
46652,2016-05-15,6,8,39,47
46653,2016-05-15,7,20,91,111
46654,2016-05-15,8,61,170,231
46655,2016-05-15,9,85,257,342
46656,2016-05-15,10,157,391,548
46657,2016-05-15,11,229,425,654
46658,2016-05-15,12,253,580,833
46659,2016-05-15,13,302,517,819
46660,2016-05-15,14,242,523,765
46661,2016-05-15,15,245,487,732
46662,2016-05-15,16,239,472,711
46663,2016-05-15,17,227,424,651
46664,2016-05-15,18,182,355,537
46665,2016-05-15,19,199,298,497
46666,2016-05-15,20,97,240,337
46667,2016-05-15,21,56,129,185
46668,2016-05-15,22,23,124,147
46669,2016-05-15,23,24,58,82
46670,2016-05-16,0,4,24,28
46671,2016-05-16,1,9,13,22
46672,2016-05-16,2,0,3,3
46673,2016-05-16,3,0,1,1
46674,2016-05-16,4,0,4,4
46675,2016-05-16,5,1,69,70
46676,2016-05-16,6,3,233,236
46677,2016-05-16,7,26,714,740
46678,2016-05-16,8,39,1053,1092
46679,2016-05-16,9,60,450,510
46680,2016-05-16,10,110,195,305
46681,2016-05-16,11,189,220,409
46682,2016-05-16,12,196,300,496
46683,2016-05-16,13,147,341,488
46684,2016-05-16,14,262,273,535
46685,2016-05-16,15,250,386,636
46686,2016-05-16,16,208,655,863
46687,2016-05-16,17,191,1309,1500
46688,2016-05-16,18,172,1100,1272
46689,2016-05-16,19,134,676,810
46690,2016-05-16,20,107,490,597
46691,2016-05-16,21,102,315,417
46692,2016-05-16,22,35,180,215
46693,2016-05-16,23,21,86,107
46694,2016-05-17,0,11,24,35
46695,2016-05-17,1,3,10,13
46696,2016-05-17,2,5,4,9
46697,2016-05-17,3,0,5,5
46698,2016-05-17,4,1,4,5
46699,2016-05-17,5,2,71,73
46700,2016-05-17,6,6,284,290
46701,2016-05-17,7,23,664,687
46702,2016-05-17,8,13,563,576
46703,2016-05-17,9,7,196,203
46704,2016-05-17,10,9,76,85
46705,2016-05-17,11,9,52,61
46706,2016-05-17,12,17,55,72
46707,2016-05-17,13,10,83,93
46708,2016-05-17,14,12,54,66
46709,2016-05-17,15,12,74,86
46710,2016-05-17,16,13,215,228
46711,2016-05-17,17,23,650,673
46712,2016-05-17,18,27,738,765
46713,2016-05-17,19,29,544,573
46714,2016-05-17,20,30,286,316
46715,2016-05-17,21,14,212,226
46716,2016-05-17,22,10,137,147
46717,2016-05-17,23,7,80,87
46718,2016-05-18,0,6,27,33
46719,2016-05-18,1,0,11,11
46720,2016-05-18,2,2,6,8
46721,2016-05-18,3,1,6,7
46722,2016-05-18,4,2,7,9
46723,2016-05-18,5,3,91,94
46724,2016-05-18,6,5,270,275
46725,2016-05-18,7,15,760,775
46726,2016-05-18,8,30,1143,1173
46727,2016-05-18,9,44,539,583
46728,2016-05-18,10,58,259,317
46729,2016-05-18,11,65,278,343
46730,2016-05-18,12,83,332,415
46731,2016-05-18,13,79,321,400
46732,2016-05-18,14,89,274,363
46733,2016-05-18,15,109,357,466
46734,2016-05-18,16,134,641,775
46735,2016-05-18,17,126,1177,1303
46736,2016-05-18,18,86,1120,1206
46737,2016-05-18,19,87,696,783
46738,2016-05-18,20,43,462,505
46739,2016-05-18,21,38,290,328
46740,2016-05-18,22,34,239,273
46741,2016-05-18,23,23,115,138
46742,2016-05-19,0,6,31,37
46743,2016-05-19,1,2,16,18
46744,2016-05-19,2,2,12,14
46745,2016-05-19,3,1,3,4
46746,2016-05-19,4,1,6,7
46747,2016-05-19,5,2,61,63
46748,2016-05-19,6,6,271,277
46749,2016-05-19,7,16,822,838
46750,2016-05-19,8,41,1156,1197
46751,2016-05-19,9,48,478,526
46752,2016-05-19,10,58,201,259
46753,2016-05-19,11,136,258,394
46754,2016-05-19,12,121,362,483
46755,2016-05-19,13,115,365,480
46756,2016-05-19,14,158,280,438
46757,2016-05-19,15,180,334,514
46758,2016-05-19,16,179,648,827
46759,2016-05-19,17,214,1340,1554
46760,2016-05-19,18,246,1135,1381
46761,2016-05-19,19,150,748,898
46762,2016-05-19,20,98,517,615
46763,2016-05-19,21,87,359,446
46764,2016-05-19,22,50,265,315
46765,2016-05-19,23,21,112,133
46766,2016-05-20,0,13,54,67
46767,2016-05-20,1,8,43,51
46768,2016-05-20,2,2,11,13
46769,2016-05-20,3,2,10,12
46770,2016-05-20,4,1,8,9
46771,2016-05-20,5,1,70,71
46772,2016-05-20,6,24,311,335
46773,2016-05-20,7,66,893,959
46774,2016-05-20,8,62,1347,1409
46775,2016-05-20,9,86,564,650
46776,2016-05-20,10,184,242,426
46777,2016-05-20,11,198,317,515
46778,2016-05-20,12,244,465,709
46779,2016-05-20,13,290,473,763
46780,2016-05-20,14,303,389,692
46781,2016-05-20,15,337,502,839
46782,2016-05-20,16,294,824,1118
46783,2016-05-20,17,307,1308,1615
46784,2016-05-20,18,234,974,1208
46785,2016-05-20,19,205,687,892
46786,2016-05-20,20,113,409,522
46787,2016-05-20,21,100,319,419
46788,2016-05-20,22,97,224,321
46789,2016-05-20,23,67,177,244
46790,2016-05-21,0,45,135,180
46791,2016-05-21,1,31,80,111
46792,2016-05-21,2,7,46,53
46793,2016-05-21,3,8,24,32
46794,2016-05-21,4,4,12,16
46795,2016-05-21,5,5,12,17
46796,2016-05-21,6,3,14,17
46797,2016-05-21,7,1,26,27
46798,2016-05-21,8,0,26,26
46799,2016-05-21,9,11,80,91
46800,2016-05-21,10,47,223,270
46801,2016-05-21,11,61,327,388
46802,2016-05-21,12,155,362,517
46803,2016-05-21,13,150,386,536
46804,2016-05-21,14,118,313,431
46805,2016-05-21,15,72,217,289
46806,2016-05-21,16,55,224,279
46807,2016-05-21,17,60,168,228
46808,2016-05-21,18,51,153,204
46809,2016-05-21,19,49,147,196
46810,2016-05-21,20,38,123,161
46811,2016-05-21,21,32,104,136
46812,2016-05-21,22,36,99,135
46813,2016-05-21,23,20,72,92
46814,2016-05-22,0,5,43,48
46815,2016-05-22,1,4,30,34
46816,2016-05-22,2,1,37,38
46817,2016-05-22,3,1,13,14
46818,2016-05-22,4,1,10,11
46819,2016-05-22,5,0,11,11
46820,2016-05-22,6,2,11,13
46821,2016-05-22,7,9,55,64
46822,2016-05-22,8,4,85,89
46823,2016-05-22,9,25,130,155
46824,2016-05-22,10,44,224,268
46825,2016-05-22,11,77,301,378
46826,2016-05-22,12,35,166,201
46827,2016-05-22,13,31,139,170
46828,2016-05-22,14,37,198,235
46829,2016-05-22,15,41,210,251
46830,2016-05-22,16,29,190,219
46831,2016-05-22,17,26,115,141
46832,2016-05-22,18,18,111,129
46833,2016-05-22,19,11,107,118
46834,2016-05-22,20,5,87,92
46835,2016-05-22,21,13,66,79
46836,2016-05-22,22,7,52,59
46837,2016-05-22,23,0,34,34
46838,2016-05-23,0,0,16,16
46839,2016-05-23,1,0,7,7
46840,2016-05-23,3,0,2,2
46841,2016-05-23,5,1,61,62
46842,2016-05-23,6,6,209,215
46843,2016-05-23,7,11,639,650
46844,2016-05-23,8,42,1148,1190
46845,2016-05-23,9,62,456,518
46846,2016-05-23,10,103,201,304
46847,2016-05-23,11,121,254,375
46848,2016-05-23,12,132,356,488
46849,2016-05-23,13,146,311,457
46850,2016-05-23,14,168,268,436
46851,2016-05-23,15,117,218,335
46852,2016-05-23,16,88,439,527
46853,2016-05-23,17,69,673,742
46854,2016-05-23,18,36,336,372
46855,2016-05-23,19,31,388,419
46856,2016-05-23,20,34,350,384
46857,2016-05-23,21,35,229,264
46858,2016-05-23,22,27,146,173
46859,2016-05-23,23,19,92,111
46860,2016-05-24,0,11,16,27
46861,2016-05-24,1,6,5,11
46862,2016-05-24,2,8,6,14
46863,2016-05-24,3,2,5,7
46864,2016-05-24,4,4,5,9
46865,2016-05-24,5,2,81,83
46866,2016-05-24,6,11,318,329
46867,2016-05-24,7,28,942,970
46868,2016-05-24,8,51,1414,1465
46869,2016-05-24,9,60,515,575
46870,2016-05-24,10,106,221,327
46871,2016-05-24,11,133,304,437
46872,2016-05-24,12,188,389,577
46873,2016-05-24,13,180,371,551
46874,2016-05-24,14,235,308,543
46875,2016-05-24,15,168,387,555
46876,2016-05-24,16,173,689,862
46877,2016-05-24,17,263,1435,1698
46878,2016-05-24,18,236,1253,1489
46879,2016-05-24,19,179,772,951
46880,2016-05-24,20,141,571,712
46881,2016-05-24,21,102,372,474
46882,2016-05-24,22,79,326,405
46883,2016-05-24,23,30,133,163
46884,2016-05-25,0,22,48,70
46885,2016-05-25,1,17,29,46
46886,2016-05-25,2,2,4,6
46887,2016-05-25,3,0,4,4
46888,2016-05-25,4,0,4,4
46889,2016-05-25,5,1,95,96
46890,2016-05-25,6,16,326,342
46891,2016-05-25,7,49,965,1014
46892,2016-05-25,8,67,1278,1345
46893,2016-05-25,9,98,508,606
46894,2016-05-25,10,144,253,397
46895,2016-05-25,11,152,322,474
46896,2016-05-25,12,143,433,576
46897,2016-05-25,13,147,333,480
46898,2016-05-25,14,126,279,405
46899,2016-05-25,15,160,371,531
46900,2016-05-25,16,161,687,848
46901,2016-05-25,17,222,1342,1564
46902,2016-05-25,18,204,1175,1379
46903,2016-05-25,19,182,758,940
46904,2016-05-25,20,136,576,712
46905,2016-05-25,21,89,379,468
46906,2016-05-25,22,62,265,327
46907,2016-05-25,23,20,132,152
46908,2016-05-26,0,10,51,61
46909,2016-05-26,1,14,22,36
46910,2016-05-26,2,6,3,9
46911,2016-05-26,3,2,3,5
46912,2016-05-26,4,1,8,9
46913,2016-05-26,5,3,80,83
46914,2016-05-26,6,21,310,331
46915,2016-05-26,7,36,857,893
46916,2016-05-26,8,56,1231,1287
46917,2016-05-26,9,78,518,596
46918,2016-05-26,10,105,251,356
46919,2016-05-26,11,126,302,428
46920,2016-05-26,12,163,355,518
46921,2016-05-26,13,129,370,499
46922,2016-05-26,14,129,316,445
46923,2016-05-26,15,92,360,452
46924,2016-05-26,16,119,676,795
46925,2016-05-26,17,148,1282,1430
46926,2016-05-26,18,170,1194,1364
46927,2016-05-26,19,164,728,892
46928,2016-05-26,20,132,542,674
46929,2016-05-26,21,101,395,496
46930,2016-05-26,22,40,274,314
46931,2016-05-26,23,36,177,213
46932,2016-05-27,0,13,79,92
46933,2016-05-27,1,4,39,43
46934,2016-05-27,2,3,22,25
46935,2016-05-27,3,0,6,6
46936,2016-05-27,4,0,10,10
46937,2016-05-27,5,1,76,77
46938,2016-05-27,6,9,217,226
46939,2016-05-27,7,26,668,694
46940,2016-05-27,8,49,1087,1136
46941,2016-05-27,9,85,534,619
46942,2016-05-27,10,144,267,411
46943,2016-05-27,11,200,306,506
46944,2016-05-27,12,214,425,639
46945,2016-05-27,13,223,482,705
46946,2016-05-27,14,180,526,706
46947,2016-05-27,15,198,677,875
46948,2016-05-27,16,266,759,1025
46949,2016-05-27,17,241,939,1180
46950,2016-05-27,18,202,754,956
46951,2016-05-27,19,174,496,670
46952,2016-05-27,20,158,356,514
46953,2016-05-27,21,177,277,454
46954,2016-05-27,22,130,225,355
46955,2016-05-27,23,70,144,214
46956,2016-05-28,0,33,123,156
46957,2016-05-28,1,15,52,67
46958,2016-05-28,2,25,43,68
46959,2016-05-28,3,4,13,17
46960,2016-05-28,4,4,8,12
46961,2016-05-28,5,7,11,18
46962,2016-05-28,6,8,30,38
46963,2016-05-28,7,35,84,119
46964,2016-05-28,8,106,217,323
46965,2016-05-28,9,254,345,599
46966,2016-05-28,10,368,422,790
46967,2016-05-28,11,412,456,868
46968,2016-05-28,12,534,444,978
46969,2016-05-28,13,561,451,1012
46970,2016-05-28,14,473,420,893
46971,2016-05-28,15,473,404,877
46972,2016-05-28,16,540,349,889
46973,2016-05-28,17,434,361,795
46974,2016-05-28,18,402,401,803
46975,2016-05-28,19,390,287,677
46976,2016-05-28,20,305,281,586
46977,2016-05-28,21,242,214,456
46978,2016-05-28,22,136,167,303
46979,2016-05-28,23,85,130,215
46980,2016-05-29,0,51,97,148
46981,2016-05-29,1,19,64,83
46982,2016-05-29,2,14,36,50
46983,2016-05-29,3,18,24,42
46984,2016-05-29,4,12,18,30
46985,2016-05-29,5,7,13,20
46986,2016-05-29,6,33,25,58
46987,2016-05-29,7,52,77,129
46988,2016-05-29,8,107,149,256
46989,2016-05-29,9,239,289,528
46990,2016-05-29,10,456,396,852
46991,2016-05-29,11,468,427,895
46992,2016-05-29,12,649,506,1155
46993,2016-05-29,13,578,453,1031
46994,2016-05-29,14,669,427,1096
46995,2016-05-29,15,663,396,1059
46996,2016-05-29,16,482,356,838
46997,2016-05-29,17,127,92,219
46998,2016-05-29,18,45,48,93
46999,2016-05-29,19,66,38,104
47000,2016-05-29,20,44,73,117
47001,2016-05-29,21,54,53,107
47002,2016-05-29,22,18,48,66
47003,2016-05-29,23,39,53,92
47004,2016-05-30,0,55,37,92
47005,2016-05-30,1,31,27,58
47006,2016-05-30,2,25,18,43
47007,2016-05-30,3,9,12,21
47008,2016-05-30,4,0,4,4
47009,2016-05-30,5,5,8,13
47010,2016-05-30,6,16,19,35
47011,2016-05-30,7,36,64,100
47012,2016-05-30,8,96,151,247
47013,2016-05-30,9,223,242,465
47014,2016-05-30,10,318,367,685
47015,2016-05-30,11,346,460,806
47016,2016-05-30,12,449,492,941
47017,2016-05-30,13,406,532,938
47018,2016-05-30,14,361,499,860
47019,2016-05-30,15,377,459,836
47020,2016-05-30,16,359,436,795
47021,2016-05-30,17,272,447,719
47022,2016-05-30,18,236,370,606
47023,2016-05-30,19,186,361,547
47024,2016-05-30,20,198,274,472
47025,2016-05-30,21,121,208,329
47026,2016-05-30,22,77,113,190
47027,2016-05-30,23,25,101,126
47028,2016-05-31,0,30,38,68
47029,2016-05-31,1,11,12,23
47030,2016-05-31,2,0,7,7
47031,2016-05-31,3,5,2,7
47032,2016-05-31,4,0,5,5
47033,2016-05-31,5,3,96,99
47034,2016-05-31,6,14,289,303
47035,2016-05-31,7,35,767,802
47036,2016-05-31,8,59,1082,1141
47037,2016-05-31,9,107,426,533
47038,2016-05-31,10,132,207,339
47039,2016-05-31,11,155,253,408
47040,2016-05-31,12,146,313,459
47041,2016-05-31,13,168,351,519
47042,2016-05-31,14,175,274,449
47043,2016-05-31,15,158,354,512
47044,2016-05-31,16,156,636,792
47045,2016-05-31,17,144,1328,1472
47046,2016-05-31,18,151,1214,1365
47047,2016-05-31,19,140,760,900
47048,2016-05-31,20,113,508,621
47049,2016-05-31,21,89,356,445
47050,2016-05-31,22,48,173,221
47051,2016-05-31,23,6,82,88
47052,2016-06-01,0,3,25,28
47053,2016-06-01,1,5,13,18
47054,2016-06-01,2,4,3,7
47055,2016-06-01,3,2,3,5
47056,2016-06-01,4,3,8,11
47057,2016-06-01,5,7,120,127
47058,2016-06-01,6,12,338,350
47059,2016-06-01,7,29,979,1008
47060,2016-06-01,8,44,1288,1332
47061,2016-06-01,9,84,500,584
47062,2016-06-01,10,102,232,334
47063,2016-06-01,11,103,266,369
47064,2016-06-01,12,131,357,488
47065,2016-06-01,13,94,309,403
47066,2016-06-01,14,131,275,406
47067,2016-06-01,15,114,340,454
47068,2016-06-01,16,137,712,849
47069,2016-06-01,17,151,1484,1635
47070,2016-06-01,18,138,1289,1427
47071,2016-06-01,19,130,780,910
47072,2016-06-01,20,106,599,705
47073,2016-06-01,21,60,415,475
47074,2016-06-01,22,59,253,312
47075,2016-06-01,23,19,98,117
47076,2016-06-02,0,13,52,65
47077,2016-06-02,1,3,20,23
47078,2016-06-02,2,1,7,8
47079,2016-06-02,3,0,6,6
47080,2016-06-02,4,1,9,10
47081,2016-06-02,5,3,103,106
47082,2016-06-02,6,13,317,330
47083,2016-06-02,7,33,908,941
47084,2016-06-02,8,49,1284,1333
47085,2016-06-02,9,71,530,601
47086,2016-06-02,10,108,256,364
47087,2016-06-02,11,91,298,389
47088,2016-06-02,12,81,381,462
47089,2016-06-02,13,115,340,455
47090,2016-06-02,14,112,327,439
47091,2016-06-02,15,164,400,564
47092,2016-06-02,16,100,698,798
47093,2016-06-02,17,175,1436,1611
47094,2016-06-02,18,168,1198,1366
47095,2016-06-02,19,122,821,943
47096,2016-06-02,20,113,562,675
47097,2016-06-02,21,69,352,421
47098,2016-06-02,22,43,261,304
47099,2016-06-02,23,23,129,152
47100,2016-06-03,0,10,59,69
47101,2016-06-03,1,4,26,30
47102,2016-06-03,2,4,12,16
47103,2016-06-03,3,3,10,13
47104,2016-06-03,4,1,12,13
47105,2016-06-03,5,2,102,104
47106,2016-06-03,6,9,267,276
47107,2016-06-03,7,36,736,772
47108,2016-06-03,8,39,1219,1258
47109,2016-06-03,9,74,484,558
47110,2016-06-03,10,84,232,316
47111,2016-06-03,11,110,325,435
47112,2016-06-03,12,153,394,547
47113,2016-06-03,13,187,400,587
47114,2016-06-03,14,171,352,523
47115,2016-06-03,15,92,225,317
47116,2016-06-03,16,62,360,422
47117,2016-06-03,17,47,231,278
47118,2016-06-03,18,27,281,308
47119,2016-06-03,19,63,405,468
47120,2016-06-03,20,76,329,405
47121,2016-06-03,21,102,260,362
47122,2016-06-03,22,52,181,233
47123,2016-06-03,23,38,167,205
47124,2016-06-04,0,26,127,153
47125,2016-06-04,1,19,113,132
47126,2016-06-04,2,14,39,53
47127,2016-06-04,3,12,25,37
47128,2016-06-04,4,1,8,9
47129,2016-06-04,5,8,18,26
47130,2016-06-04,6,9,34,43
47131,2016-06-04,7,31,125,156
47132,2016-06-04,8,59,249,308
47133,2016-06-04,9,134,434,568
47134,2016-06-04,10,235,472,707
47135,2016-06-04,11,306,539,845
47136,2016-06-04,12,369,582,951
47137,2016-06-04,13,404,570,974
47138,2016-06-04,14,439,590,1029
47139,2016-06-04,15,418,568,986
47140,2016-06-04,16,340,554,894
47141,2016-06-04,17,402,567,969
47142,2016-06-04,18,302,543,845
47143,2016-06-04,19,259,490,749
47144,2016-06-04,20,218,363,581
47145,2016-06-04,21,142,259,401
47146,2016-06-04,22,85,245,330
47147,2016-06-04,23,54,191,245
47148,2016-06-05,0,39,163,202
47149,2016-06-05,1,17,80,97
47150,2016-06-05,2,7,32,39
47151,2016-06-05,3,2,17,19
47152,2016-06-05,4,0,8,8
47153,2016-06-05,5,2,9,11
47154,2016-06-05,6,11,32,43
47155,2016-06-05,7,15,57,72
47156,2016-06-05,8,53,157,210
47157,2016-06-05,9,121,295,416
47158,2016-06-05,10,182,462,644
47159,2016-06-05,11,204,534,738
47160,2016-06-05,12,300,559,859
47161,2016-06-05,13,342,601,943
47162,2016-06-05,14,305,543,848
47163,2016-06-05,15,250,585,835
47164,2016-06-05,16,263,538,801
47165,2016-06-05,17,203,485,688
47166,2016-06-05,18,169,352,521
47167,2016-06-05,19,86,310,396
47168,2016-06-05,20,111,269,380
47169,2016-06-05,21,79,179,258
47170,2016-06-05,22,54,180,234
47171,2016-06-05,23,36,79,115
47172,2016-06-06,0,11,27,38
47173,2016-06-06,1,6,14,20
47174,2016-06-06,2,1,10,11
47175,2016-06-06,3,1,2,3
47176,2016-06-06,4,1,5,6
47177,2016-06-06,5,2,79,81
47178,2016-06-06,6,11,320,331
47179,2016-06-06,7,26,915,941
47180,2016-06-06,8,67,1193,1260
47181,2016-06-06,9,78,538,616
47182,2016-06-06,10,128,222,350
47183,2016-06-06,11,109,236,345
47184,2016-06-06,12,120,333,453
47185,2016-06-06,13,155,315,470
47186,2016-06-06,14,157,283,440
47187,2016-06-06,15,168,365,533
47188,2016-06-06,16,176,705,881
47189,2016-06-06,17,176,1489,1665
47190,2016-06-06,18,200,1327,1527
47191,2016-06-06,19,173,815,988
47192,2016-06-06,20,125,574,699
47193,2016-06-06,21,76,349,425
47194,2016-06-06,22,58,200,258
47195,2016-06-06,23,30,97,127
47196,2016-06-07,0,17,46,63
47197,2016-06-07,1,6,16,22
47198,2016-06-07,2,5,9,14
47199,2016-06-07,3,4,3,7
47200,2016-06-07,4,4,11,15
47201,2016-06-07,5,5,103,108
47202,2016-06-07,6,13,394,407
47203,2016-06-07,7,50,1120,1170
47204,2016-06-07,8,64,1296,1360
47205,2016-06-07,9,78,474,552
47206,2016-06-07,10,88,248,336
47207,2016-06-07,11,134,269,403
47208,2016-06-07,12,138,388,526
47209,2016-06-07,13,135,341,476
47210,2016-06-07,14,163,300,463
47211,2016-06-07,15,138,393,531
47212,2016-06-07,16,190,728,918
47213,2016-06-07,17,198,1514,1712
47214,2016-06-07,18,204,1285,1489
47215,2016-06-07,19,166,866,1032
47216,2016-06-07,20,134,589,723
47217,2016-06-07,21,100,408,508
47218,2016-06-07,22,54,260,314
47219,2016-06-07,23,28,92,120
47220,2016-06-08,0,22,42,64
47221,2016-06-08,1,10,23,33
47222,2016-06-08,2,9,11,20
47223,2016-06-08,3,1,6,7
47224,2016-06-08,4,3,14,17
47225,2016-06-08,5,8,110,118
47226,2016-06-08,6,21,389,410
47227,2016-06-08,7,68,1053,1121
47228,2016-06-08,8,88,1328,1416
47229,2016-06-08,9,81,554,635
47230,2016-06-08,10,112,245,357
47231,2016-06-08,11,109,279,388
47232,2016-06-08,12,152,377,529
47233,2016-06-08,13,143,354,497
47234,2016-06-08,14,125,361,486
47235,2016-06-08,15,168,412,580
47236,2016-06-08,16,185,784,969
47237,2016-06-08,17,194,1547,1741
47238,2016-06-08,18,158,1305,1463
47239,2016-06-08,19,170,883,1053
47240,2016-06-08,20,128,669,797
47241,2016-06-08,21,71,368,439
47242,2016-06-08,22,48,248,296
47243,2016-06-08,23,23,126,149
47244,2016-06-09,0,12,52,64
47245,2016-06-09,1,2,12,14
47246,2016-06-09,2,1,14,15
47247,2016-06-09,3,1,3,4
47248,2016-06-09,4,2,10,12
47249,2016-06-09,5,4,93,97
47250,2016-06-09,6,15,340,355
47251,2016-06-09,7,40,975,1015
47252,2016-06-09,8,85,1323,1408
47253,2016-06-09,9,75,484,559
47254,2016-06-09,10,101,225,326
47255,2016-06-09,11,85,318,403
47256,2016-06-09,12,142,391,533
47257,2016-06-09,13,160,381,541
47258,2016-06-09,14,161,333,494
47259,2016-06-09,15,160,445,605
47260,2016-06-09,16,179,735,914
47261,2016-06-09,17,232,1435,1667
47262,2016-06-09,18,222,1222,1444
47263,2016-06-09,19,180,874,1054
47264,2016-06-09,20,150,634,784
47265,2016-06-09,21,107,416,523
47266,2016-06-09,22,68,304,372
47267,2016-06-09,23,33,187,220
47268,2016-06-10,0,24,65,89
47269,2016-06-10,1,7,33,40
47270,2016-06-10,2,1,24,25
47271,2016-06-10,3,0,9,9
47272,2016-06-10,4,4,11,15
47273,2016-06-10,5,4,88,92
47274,2016-06-10,6,15,319,334
47275,2016-06-10,7,51,859,910
47276,2016-06-10,8,75,1215,1290
47277,2016-06-10,9,83,485,568
47278,2016-06-10,10,136,281,417
47279,2016-06-10,11,158,351,509
47280,2016-06-10,12,195,444,639
47281,2016-06-10,13,206,436,642
47282,2016-06-10,14,231,453,684
47283,2016-06-10,15,253,526,779
47284,2016-06-10,16,250,892,1142
47285,2016-06-10,17,295,1374,1669
47286,2016-06-10,18,224,996,1220
47287,2016-06-10,19,176,627,803
47288,2016-06-10,20,180,514,694
47289,2016-06-10,21,154,346,500
47290,2016-06-10,22,110,291,401
47291,2016-06-10,23,59,200,259
47292,2016-06-11,0,36,144,180
47293,2016-06-11,1,12,98,110
47294,2016-06-11,2,16,46,62
47295,2016-06-11,3,13,32,45
47296,2016-06-11,4,6,9,15
47297,2016-06-11,5,4,21,25
47298,2016-06-11,6,26,117,143
47299,2016-06-11,7,36,153,189
47300,2016-06-11,8,80,322,402
47301,2016-06-11,9,156,471,627
47302,2016-06-11,10,297,517,814
47303,2016-06-11,11,383,670,1053
47304,2016-06-11,12,378,619,997
47305,2016-06-11,13,356,558,914
47306,2016-06-11,14,392,570,962
47307,2016-06-11,15,352,576,928
47308,2016-06-11,16,344,433,777
47309,2016-06-11,17,309,400,709
47310,2016-06-11,18,284,431,715
47311,2016-06-11,19,262,420,682
47312,2016-06-11,20,209,342,551
47313,2016-06-11,21,173,305,478
47314,2016-06-11,22,133,245,378
47315,2016-06-11,23,70,165,235
47316,2016-06-12,0,47,122,169
47317,2016-06-12,1,39,107,146
47318,2016-06-12,2,24,68,92
47319,2016-06-12,3,10,40,50
47320,2016-06-12,4,15,12,27
47321,2016-06-12,5,13,13,26
47322,2016-06-12,6,11,34,45
47323,2016-06-12,7,60,89,149
47324,2016-06-12,8,82,172,254
47325,2016-06-12,9,216,349,565
47326,2016-06-12,10,239,469,708
47327,2016-06-12,11,313,518,831
47328,2016-06-12,12,334,571,905
47329,2016-06-12,13,369,488,857
47330,2016-06-12,14,368,540,908
47331,2016-06-12,15,346,478,824
47332,2016-06-12,16,307,438,745
47333,2016-06-12,17,296,436,732
47334,2016-06-12,18,284,505,789
47335,2016-06-12,19,287,445,732
47336,2016-06-12,20,219,448,667
47337,2016-06-12,21,149,221,370
47338,2016-06-12,22,88,190,278
47339,2016-06-12,23,37,115,152
47340,2016-06-13,0,19,37,56
47341,2016-06-13,1,3,15,18
47342,2016-06-13,2,6,15,21
47343,2016-06-13,3,2,10,12
47344,2016-06-13,4,1,11,12
47345,2016-06-13,5,10,88,98
47346,2016-06-13,6,21,318,339
47347,2016-06-13,7,50,946,996
47348,2016-06-13,8,73,1248,1321
47349,2016-06-13,9,106,494,600
47350,2016-06-13,10,148,190,338
47351,2016-06-13,11,175,268,443
47352,2016-06-13,12,211,371,582
47353,2016-06-13,13,189,347,536
47354,2016-06-13,14,175,287,462
47355,2016-06-13,15,224,415,639
47356,2016-06-13,16,222,711,933
47357,2016-06-13,17,254,1478,1732
47358,2016-06-13,18,221,1308,1529
47359,2016-06-13,19,175,760,935
47360,2016-06-13,20,136,508,644
47361,2016-06-13,21,77,361,438
47362,2016-06-13,22,82,246,328
47363,2016-06-13,23,25,122,147
47364,2016-06-14,0,15,50,65
47365,2016-06-14,1,2,11,13
47366,2016-06-14,2,6,9,15
47367,2016-06-14,3,1,6,7
47368,2016-06-14,4,1,11,12
47369,2016-06-14,5,1,105,106
47370,2016-06-14,6,22,390,412
47371,2016-06-14,7,49,980,1029
47372,2016-06-14,8,66,1458,1524
47373,2016-06-14,9,70,537,607
47374,2016-06-14,10,127,258,385
47375,2016-06-14,11,145,318,463
47376,2016-06-14,12,142,424,566
47377,2016-06-14,13,164,342,506
47378,2016-06-14,14,147,325,472
47379,2016-06-14,15,181,405,586
47380,2016-06-14,16,205,775,980
47381,2016-06-14,17,250,1588,1838
47382,2016-06-14,18,237,1353,1590
47383,2016-06-14,19,176,825,1001
47384,2016-06-14,20,170,539,709
47385,2016-06-14,21,114,354,468
47386,2016-06-14,22,77,357,434
47387,2016-06-14,23,40,120,160
47388,2016-06-15,0,20,55,75
47389,2016-06-15,1,12,12,24
47390,2016-06-15,2,1,4,5
47391,2016-06-15,3,0,4,4
47392,2016-06-15,4,1,13,14
47393,2016-06-15,5,10,106,116
47394,2016-06-15,6,15,291,306
47395,2016-06-15,7,50,825,875
47396,2016-06-15,8,67,1392,1459
47397,2016-06-15,9,89,551,640
47398,2016-06-15,10,96,249,345
47399,2016-06-15,11,140,288,428
47400,2016-06-15,12,136,349,485
47401,2016-06-15,13,169,381,550
47402,2016-06-15,14,182,353,535
47403,2016-06-15,15,182,395,577
47404,2016-06-15,16,187,680,867
47405,2016-06-15,17,213,1407,1620
47406,2016-06-15,18,173,1207,1380
47407,2016-06-15,19,171,800,971
47408,2016-06-15,20,162,601,763
47409,2016-06-15,21,74,389,463
47410,2016-06-15,22,86,209,295
47411,2016-06-15,23,40,116,156
47412,2016-06-16,0,20,63,83
47413,2016-06-16,1,20,12,32
47414,2016-06-16,2,7,9,16
47415,2016-06-16,3,0,3,3
47416,2016-06-16,4,4,9,13
47417,2016-06-16,5,4,86,90
47418,2016-06-16,6,15,321,336
47419,2016-06-16,7,35,855,890
47420,2016-06-16,8,48,1104,1152
47421,2016-06-16,9,60,552,612
47422,2016-06-16,10,88,251,339
47423,2016-06-16,11,131,252,383
47424,2016-06-16,12,124,372,496
47425,2016-06-16,13,125,334,459
47426,2016-06-16,14,158,284,442
47427,2016-06-16,15,154,359,513
47428,2016-06-16,16,163,649,812
47429,2016-06-16,17,217,1443,1660
47430,2016-06-16,18,203,1125,1328
47431,2016-06-16,19,111,664,775
47432,2016-06-16,20,76,408,484
47433,2016-06-16,21,8,44,52
47434,2016-06-16,22,3,21,24
47435,2016-06-16,23,4,58,62
47436,2016-06-17,0,12,49,61
47437,2016-06-17,1,7,22,29
47438,2016-06-17,2,4,17,21
47439,2016-06-17,3,3,5,8
47440,2016-06-17,4,1,10,11
47441,2016-06-17,5,2,76,78
47442,2016-06-17,6,6,244,250
47443,2016-06-17,7,30,747,777
47444,2016-06-17,8,67,1224,1291
47445,2016-06-17,9,95,512,607
47446,2016-06-17,10,134,232,366
47447,2016-06-17,11,168,295,463
47448,2016-06-17,12,209,408,617
47449,2016-06-17,13,211,394,605
47450,2016-06-17,14,225,390,615
47451,2016-06-17,15,246,516,762
47452,2016-06-17,16,227,853,1080
47453,2016-06-17,17,242,1365,1607
47454,2016-06-17,18,198,1023,1221
47455,2016-06-17,19,233,728,961
47456,2016-06-17,20,201,489,690
47457,2016-06-17,21,134,394,528
47458,2016-06-17,22,116,257,373
47459,2016-06-17,23,54,214,268
47460,2016-06-18,0,73,173,246
47461,2016-06-18,1,28,73,101
47462,2016-06-18,2,22,56,78
47463,2016-06-18,3,7,35,42
47464,2016-06-18,4,2,21,23
47465,2016-06-18,5,2,25,27
47466,2016-06-18,6,21,47,68
47467,2016-06-18,7,44,132,176
47468,2016-06-18,8,87,267,354
47469,2016-06-18,9,191,456,647
47470,2016-06-18,10,325,558,883
47471,2016-06-18,11,439,618,1057
47472,2016-06-18,12,476,608,1084
47473,2016-06-18,13,485,560,1045
47474,2016-06-18,14,567,545,1112
47475,2016-06-18,15,542,557,1099
47476,2016-06-18,16,459,545,1004
47477,2016-06-18,17,485,495,980
47478,2016-06-18,18,412,498,910
47479,2016-06-18,19,338,438,776
47480,2016-06-18,20,317,362,679
47481,2016-06-18,21,230,284,514
47482,2016-06-18,22,151,191,342
47483,2016-06-18,23,117,180,297
47484,2016-06-19,0,84,156,240
47485,2016-06-19,1,46,92,138
47486,2016-06-19,2,55,71,126
47487,2016-06-19,3,23,37,60
47488,2016-06-19,4,17,12,29
47489,2016-06-19,5,7,13,20
47490,2016-06-19,6,13,29,42
47491,2016-06-19,7,34,86,120
47492,2016-06-19,8,100,203,303
47493,2016-06-19,9,184,303,487
47494,2016-06-19,10,287,474,761
47495,2016-06-19,11,362,520,882
47496,2016-06-19,12,369,541,910
47497,2016-06-19,13,398,557,955
47498,2016-06-19,14,465,513,978
47499,2016-06-19,15,451,520,971
47500,2016-06-19,16,369,505,874
47501,2016-06-19,17,387,578,965
47502,2016-06-19,18,353,459,812
47503,2016-06-19,19,272,460,732
47504,2016-06-19,20,212,371,583
47505,2016-06-19,21,137,237,374
47506,2016-06-19,22,94,180,274
47507,2016-06-19,23,57,131,188
47508,2016-06-20,0,22,33,55
47509,2016-06-20,1,5,19,24
47510,2016-06-20,2,10,11,21
47511,2016-06-20,3,2,2,4
47512,2016-06-20,4,3,9,12
47513,2016-06-20,5,7,89,96
47514,2016-06-20,6,29,282,311
47515,2016-06-20,7,49,906,955
47516,2016-06-20,8,89,1153,1242
47517,2016-06-20,9,118,492,610
47518,2016-06-20,10,154,246,400
47519,2016-06-20,11,172,268,440
47520,2016-06-20,12,175,327,502
47521,2016-06-20,13,175,299,474
47522,2016-06-20,14,160,296,456
47523,2016-06-20,15,226,366,592
47524,2016-06-20,16,224,659,883
47525,2016-06-20,17,241,1463,1704
47526,2016-06-20,18,265,1159,1424
47527,2016-06-20,19,209,757,966
47528,2016-06-20,20,193,569,762
47529,2016-06-20,21,141,379,520
47530,2016-06-20,22,112,222,334
47531,2016-06-20,23,36,88,124
47532,2016-06-21,0,16,46,62
47533,2016-06-21,1,14,17,31
47534,2016-06-21,2,3,4,7
47535,2016-06-21,3,7,3,10
47536,2016-06-21,4,4,15,19
47537,2016-06-21,5,6,111,117
47538,2016-06-21,6,32,371,403
47539,2016-06-21,7,57,961,1018
47540,2016-06-21,8,98,1275,1373
47541,2016-06-21,9,106,512,618
47542,2016-06-21,10,120,263,383
47543,2016-06-21,11,167,283,450
47544,2016-06-21,12,179,311,490
47545,2016-06-21,13,139,336,475
47546,2016-06-21,14,101,209,310
47547,2016-06-21,15,54,131,185
47548,2016-06-21,16,75,383,458
47549,2016-06-21,17,90,710,800
47550,2016-06-21,18,54,487,541
47551,2016-06-21,19,78,332,410
47552,2016-06-21,20,100,442,542
47553,2016-06-21,21,76,291,367
47554,2016-06-21,22,42,174,216
47555,2016-06-21,23,54,174,228
47556,2016-06-22,0,30,40,70
47557,2016-06-22,1,24,10,34
47558,2016-06-22,2,17,3,20
47559,2016-06-22,3,8,6,14
47560,2016-06-22,4,5,9,14
47561,2016-06-22,5,9,118,127
47562,2016-06-22,6,26,369,395
47563,2016-06-22,7,52,975,1027
47564,2016-06-22,8,89,1285,1374
47565,2016-06-22,9,101,534,635
47566,2016-06-22,10,158,257,415
47567,2016-06-22,11,216,280,496
47568,2016-06-22,12,202,347,549
47569,2016-06-22,13,224,348,572
47570,2016-06-22,14,159,318,477
47571,2016-06-22,15,203,389,592
47572,2016-06-22,16,213,693,906
47573,2016-06-22,17,245,1513,1758
47574,2016-06-22,18,256,1226,1482
47575,2016-06-22,19,215,805,1020
47576,2016-06-22,20,178,685,863
47577,2016-06-22,21,110,401,511
47578,2016-06-22,22,87,281,368
47579,2016-06-22,23,49,134,183
47580,2016-06-23,0,19,47,66
47581,2016-06-23,1,26,26,52
47582,2016-06-23,2,8,9,17
47583,2016-06-23,3,4,6,10
47584,2016-06-23,4,0,8,8
47585,2016-06-23,5,2,56,58
47586,2016-06-23,6,2,63,65
47587,2016-06-23,7,5,137,142
47588,2016-06-23,8,10,297,307
47589,2016-06-23,9,33,531,564
47590,2016-06-23,10,60,271,331
47591,2016-06-23,11,107,293,400
47592,2016-06-23,12,135,356,491
47593,2016-06-23,13,119,347,466
47594,2016-06-23,14,133,285,418
47595,2016-06-23,15,131,398,529
47596,2016-06-23,16,155,594,749
47597,2016-06-23,17,163,1270,1433
47598,2016-06-23,18,136,1010,1146
47599,2016-06-23,19,100,669,769
47600,2016-06-23,20,109,454,563
47601,2016-06-23,21,63,331,394
47602,2016-06-23,22,55,241,296
47603,2016-06-23,23,23,138,161
47604,2016-06-24,0,11,85,96
47605,2016-06-24,1,8,30,38
47606,2016-06-24,2,3,22,25
47607,2016-06-24,3,0,8,8
47608,2016-06-24,4,6,11,17
47609,2016-06-24,5,13,85,98
47610,2016-06-24,6,13,286,299
47611,2016-06-24,7,35,812,847
47612,2016-06-24,8,61,1138,1199
47613,2016-06-24,9,99,546,645
47614,2016-06-24,10,182,258,440
47615,2016-06-24,11,180,333,513
47616,2016-06-24,12,196,473,669
47617,2016-06-24,13,192,432,624
47618,2016-06-24,14,193,401,594
47619,2016-06-24,15,220,427,647
47620,2016-06-24,16,216,774,990
47621,2016-06-24,17,222,1204,1426
47622,2016-06-24,18,195,942,1137
47623,2016-06-24,19,157,502,659
47624,2016-06-24,20,140,362,502
47625,2016-06-24,21,132,250,382
47626,2016-06-24,22,77,225,302
47627,2016-06-24,23,63,182,245
47628,2016-06-25,0,48,153,201
47629,2016-06-25,1,24,91,115
47630,2016-06-25,2,21,68,89
47631,2016-06-25,3,1,19,20
47632,2016-06-25,4,0,11,11
47633,2016-06-25,5,9,13,22
47634,2016-06-25,6,22,51,73
47635,2016-06-25,7,50,116,166
47636,2016-06-25,8,100,250,350
47637,2016-06-25,9,210,386,596
47638,2016-06-25,10,301,530,831
47639,2016-06-25,11,447,585,1032
47640,2016-06-25,12,491,585,1076
47641,2016-06-25,13,574,642,1216
47642,2016-06-25,14,568,604,1172
47643,2016-06-25,15,473,588,1061
47644,2016-06-25,16,458,501,959
47645,2016-06-25,17,466,547,1013
47646,2016-06-25,18,382,477,859
47647,2016-06-25,19,361,418,779
47648,2016-06-25,20,338,415,753
47649,2016-06-25,21,266,290,556
47650,2016-06-25,22,166,232,398
47651,2016-06-25,23,81,168,249
47652,2016-06-26,0,57,145,202
47653,2016-06-26,1,29,85,114
47654,2016-06-26,2,21,66,87
47655,2016-06-26,3,17,38,55
47656,2016-06-26,4,14,23,37
47657,2016-06-26,5,7,16,23
47658,2016-06-26,6,15,25,40
47659,2016-06-26,7,34,74,108
47660,2016-06-26,8,83,191,274
47661,2016-06-26,9,187,317,504
47662,2016-06-26,10,288,472,760
47663,2016-06-26,11,440,530,970
47664,2016-06-26,12,500,551,1051
47665,2016-06-26,13,504,526,1030
47666,2016-06-26,14,465,557,1022
47667,2016-06-26,15,478,519,997
47668,2016-06-26,16,442,534,976
47669,2016-06-26,17,377,540,917
47670,2016-06-26,18,351,508,859
47671,2016-06-26,19,284,450,734
47672,2016-06-26,20,264,389,653
47673,2016-06-26,21,193,199,392
47674,2016-06-26,22,153,187,340
47675,2016-06-26,23,69,138,207
47676,2016-06-27,0,38,38,76
47677,2016-06-27,1,18,15,33
47678,2016-06-27,2,2,9,11
47679,2016-06-27,3,0,4,4
47680,2016-06-27,4,1,14,15
47681,2016-06-27,5,9,90,99
47682,2016-06-27,6,18,309,327
47683,2016-06-27,7,50,872,922
47684,2016-06-27,8,70,1155,1225
47685,2016-06-27,9,80,471,551
47686,2016-06-27,10,143,224,367
47687,2016-06-27,11,169,267,436
47688,2016-06-27,12,180,315,495
47689,2016-06-27,13,189,374,563
47690,2016-06-27,14,181,309,490
47691,2016-06-27,15,224,338,562
47692,2016-06-27,16,228,661,889
47693,2016-06-27,17,212,1534,1746
47694,2016-06-27,18,166,1031,1197
47695,2016-06-27,19,110,544,654
47696,2016-06-27,20,97,419,516
47697,2016-06-27,21,68,312,380
47698,2016-06-27,22,68,227,295
47699,2016-06-27,23,11,56,67
47700,2016-06-28,0,10,18,28
47701,2016-06-28,1,3,10,13
47702,2016-06-28,2,1,5,6
47703,2016-06-28,3,3,2,5
47704,2016-06-28,4,0,13,13
47705,2016-06-28,5,8,101,109
47706,2016-06-28,6,15,344,359
47707,2016-06-28,7,33,943,976
47708,2016-06-28,8,88,1269,1357
47709,2016-06-28,9,68,498,566
47710,2016-06-28,10,108,274,382
47711,2016-06-28,11,152,302,454
47712,2016-06-28,12,157,366,523
47713,2016-06-28,13,116,322,438
47714,2016-06-28,14,93,282,375
47715,2016-06-28,15,146,340,486
47716,2016-06-28,16,139,671,810
47717,2016-06-28,17,186,1514,1700
47718,2016-06-28,18,115,874,989
47719,2016-06-28,19,48,500,548
47720,2016-06-28,20,68,409,477
47721,2016-06-28,21,17,108,125
47722,2016-06-28,22,27,162,189
47723,2016-06-28,23,21,112,133
47724,2016-06-29,0,15,54,69
47725,2016-06-29,1,4,15,19
47726,2016-06-29,2,1,5,6
47727,2016-06-29,3,3,5,8
47728,2016-06-29,4,0,10,10
47729,2016-06-29,5,4,93,97
47730,2016-06-29,6,33,387,420
47731,2016-06-29,7,68,953,1021
47732,2016-06-29,8,79,1292,1371
47733,2016-06-29,9,133,535,668
47734,2016-06-29,10,122,289,411
47735,2016-06-29,11,120,292,412
47736,2016-06-29,12,156,383,539
47737,2016-06-29,13,157,397,554
47738,2016-06-29,14,198,337,535
47739,2016-06-29,15,162,426,588
47740,2016-06-29,16,207,711,918
47741,2016-06-29,17,247,1499,1746
47742,2016-06-29,18,195,1241,1436
47743,2016-06-29,19,163,818,981
47744,2016-06-29,20,181,650,831
47745,2016-06-29,21,101,442,543
47746,2016-06-29,22,60,328,388
47747,2016-06-29,23,55,152,207
47748,2016-06-30,0,19,46,65
47749,2016-06-30,1,2,21,23
47750,2016-06-30,2,10,14,24
47751,2016-06-30,3,4,7,11
47752,2016-06-30,4,0,10,10
47753,2016-06-30,5,8,87,95
47754,2016-06-30,6,21,324,345
47755,2016-06-30,7,34,925,959
47756,2016-06-30,8,56,1260,1316
47757,2016-06-30,9,83,555,638
47758,2016-06-30,10,144,284,428
47759,2016-06-30,11,150,325,475
47760,2016-06-30,12,163,389,552
47761,2016-06-30,13,184,376,560
47762,2016-06-30,14,160,319,479
47763,2016-06-30,15,177,450,627
47764,2016-06-30,16,183,689,872
47765,2016-06-30,17,235,1346,1581
47766,2016-06-30,18,204,1177,1381
47767,2016-06-30,19,180,781,961
47768,2016-06-30,20,153,600,753
47769,2016-06-30,21,106,404,510
47770,2016-06-30,22,85,359,444
47771,2016-06-30,23,34,175,209
47772,2016-07-01,0,26,84,110
47773,2016-07-01,1,11,37,48
47774,2016-07-01,2,3,15,18
47775,2016-07-01,3,1,6,7
47776,2016-07-01,4,1,16,17
47777,2016-07-01,5,6,91,97
47778,2016-07-01,6,18,237,255
47779,2016-07-01,7,34,666,700
47780,2016-07-01,8,76,1139,1215
47781,2016-07-01,9,93,539,632
47782,2016-07-01,10,182,273,455
47783,2016-07-01,11,218,334,552
47784,2016-07-01,12,189,452,641
47785,2016-07-01,13,224,532,756
47786,2016-07-01,14,279,565,844
47787,2016-07-01,15,250,733,983
47788,2016-07-01,16,251,821,1072
47789,2016-07-01,17,237,811,1048
47790,2016-07-01,18,220,629,849
47791,2016-07-01,19,200,434,634
47792,2016-07-01,20,238,387,625
47793,2016-07-01,21,93,227,320
47794,2016-07-01,22,109,172,281
47795,2016-07-01,23,67,177,244
47796,2016-07-02,0,47,117,164
47797,2016-07-02,1,46,76,122
47798,2016-07-02,2,30,47,77
47799,2016-07-02,3,15,28,43
47800,2016-07-02,4,10,14,24
47801,2016-07-02,5,16,19,35
47802,2016-07-02,6,16,45,61
47803,2016-07-02,7,26,116,142
47804,2016-07-02,8,106,210,316
47805,2016-07-02,9,216,347,563
47806,2016-07-02,10,333,429,762
47807,2016-07-02,11,482,493,975
47808,2016-07-02,12,592,551,1143
47809,2016-07-02,13,656,543,1199
47810,2016-07-02,14,666,540,1206
47811,2016-07-02,15,675,509,1184
47812,2016-07-02,16,636,451,1087
47813,2016-07-02,17,640,447,1087
47814,2016-07-02,18,567,487,1054
47815,2016-07-02,19,445,361,806
47816,2016-07-02,20,427,313,740
47817,2016-07-02,21,346,226,572
47818,2016-07-02,22,230,196,426
47819,2016-07-02,23,134,147,281
47820,2016-07-03,0,100,107,207
47821,2016-07-03,1,90,83,173
47822,2016-07-03,2,34,55,89
47823,2016-07-03,3,11,37,48
47824,2016-07-03,4,11,11,22
47825,2016-07-03,5,11,17,28
47826,2016-07-03,6,10,17,27
47827,2016-07-03,7,33,46,79
47828,2016-07-03,8,74,115,189
47829,2016-07-03,9,163,210,373
47830,2016-07-03,10,364,366,730
47831,2016-07-03,11,536,429,965
47832,2016-07-03,12,705,493,1198
47833,2016-07-03,13,772,484,1256
47834,2016-07-03,14,838,459,1297
47835,2016-07-03,15,838,439,1277
47836,2016-07-03,16,651,334,985
47837,2016-07-03,17,478,303,781
47838,2016-07-03,18,504,250,754
47839,2016-07-03,19,428,251,679
47840,2016-07-03,20,390,238,628
47841,2016-07-03,21,323,217,540
47842,2016-07-03,22,244,189,433
47843,2016-07-03,23,150,127,277
47844,2016-07-04,0,115,68,183
47845,2016-07-04,1,57,57,114
47846,2016-07-04,2,27,43,70
47847,2016-07-04,3,10,26,36
47848,2016-07-04,4,6,13,19
47849,2016-07-04,5,6,19,25
47850,2016-07-04,6,22,31,53
47851,2016-07-04,7,26,58,84
47852,2016-07-04,8,92,119,211
47853,2016-07-04,9,218,256,474
47854,2016-07-04,10,315,376,691
47855,2016-07-04,11,453,398,851
47856,2016-07-04,12,481,420,901
47857,2016-07-04,13,386,318,704
47858,2016-07-04,14,164,144,308
47859,2016-07-04,15,116,90,206
47860,2016-07-04,16,112,97,209
47861,2016-07-04,17,183,152,335
47862,2016-07-04,18,200,197,397
47863,2016-07-04,19,130,112,242
47864,2016-07-04,20,204,269,473
47865,2016-07-04,21,207,343,550
47866,2016-07-04,22,125,200,325
47867,2016-07-04,23,52,85,137
47868,2016-07-05,0,19,45,64
47869,2016-07-05,1,14,10,24
47870,2016-07-05,2,8,2,10
47871,2016-07-05,3,4,7,11
47872,2016-07-05,4,1,7,8
47873,2016-07-05,5,0,21,21
47874,2016-07-05,6,11,139,150
47875,2016-07-05,7,33,546,579
47876,2016-07-05,8,74,1043,1117
47877,2016-07-05,9,145,424,569
47878,2016-07-05,10,259,250,509
47879,2016-07-05,11,249,268,517
47880,2016-07-05,12,317,346,663
47881,2016-07-05,13,206,313,519
47882,2016-07-05,14,287,266,553
47883,2016-07-05,15,256,340,596
47884,2016-07-05,16,261,647,908
47885,2016-07-05,17,249,1288,1537
47886,2016-07-05,18,198,1064,1262
47887,2016-07-05,19,173,688,861
47888,2016-07-05,20,144,525,669
47889,2016-07-05,21,87,316,403
47890,2016-07-05,22,63,209,272
47891,2016-07-05,23,48,98,146
47892,2016-07-06,0,23,33,56
47893,2016-07-06,1,13,11,24
47894,2016-07-06,2,4,4,8
47895,2016-07-06,3,2,5,7
47896,2016-07-06,4,3,11,14
47897,2016-07-06,5,7,117,124
47898,2016-07-06,6,21,351,372
47899,2016-07-06,7,38,887,925
47900,2016-07-06,8,62,1222,1284
47901,2016-07-06,9,126,498,624
47902,2016-07-06,10,134,214,348
47903,2016-07-06,11,173,260,433
47904,2016-07-06,12,179,297,476
47905,2016-07-06,13,199,289,488
47906,2016-07-06,14,136,270,406
47907,2016-07-06,15,168,362,530
47908,2016-07-06,16,183,604,787
47909,2016-07-06,17,209,1279,1488
47910,2016-07-06,18,186,1095,1281
47911,2016-07-06,19,217,801,1018
47912,2016-07-06,20,185,594,779
47913,2016-07-06,21,123,401,524
47914,2016-07-06,22,90,201,291
47915,2016-07-06,23,49,111,160
47916,2016-07-07,0,25,58,83
47917,2016-07-07,1,4,15,19
47918,2016-07-07,2,3,8,11
47919,2016-07-07,3,1,6,7
47920,2016-07-07,4,0,11,11
47921,2016-07-07,5,6,100,106
47922,2016-07-07,6,24,355,379
47923,2016-07-07,7,38,848,886
47924,2016-07-07,8,62,1206,1268
47925,2016-07-07,9,104,544,648
47926,2016-07-07,10,157,211,368
47927,2016-07-07,11,156,215,371
47928,2016-07-07,12,173,283,456
47929,2016-07-07,13,179,303,482
47930,2016-07-07,14,131,260,391
47931,2016-07-07,15,124,304,428
47932,2016-07-07,16,160,602,762
47933,2016-07-07,17,212,1305,1517
47934,2016-07-07,18,198,1102,1300
47935,2016-07-07,19,155,744,899
47936,2016-07-07,20,164,628,792
47937,2016-07-07,21,112,450,562
47938,2016-07-07,22,52,263,315
47939,2016-07-07,23,29,127,156
47940,2016-07-08,0,15,50,65
47941,2016-07-08,1,7,24,31
47942,2016-07-08,2,1,13,14
47943,2016-07-08,3,0,4,4
47944,2016-07-08,4,2,15,17
47945,2016-07-08,5,6,86,92
47946,2016-07-08,6,17,269,286
47947,2016-07-08,7,40,744,784
47948,2016-07-08,8,60,1125,1185
47949,2016-07-08,9,111,524,635
47950,2016-07-08,10,136,248,384
47951,2016-07-08,11,131,268,399
47952,2016-07-08,12,168,341,509
47953,2016-07-08,13,201,396,597
47954,2016-07-08,14,149,343,492
47955,2016-07-08,15,105,327,432
47956,2016-07-08,16,170,602,772
47957,2016-07-08,17,219,1142,1361
47958,2016-07-08,18,170,856,1026
47959,2016-07-08,19,156,588,744
47960,2016-07-08,20,149,485,634
47961,2016-07-08,21,142,369,511
47962,2016-07-08,22,92,253,345
47963,2016-07-08,23,62,200,262
47964,2016-07-09,0,46,144,190
47965,2016-07-09,1,32,86,118
47966,2016-07-09,2,18,43,61
47967,2016-07-09,3,7,27,34
47968,2016-07-09,4,7,17,24
47969,2016-07-09,5,11,21,32
47970,2016-07-09,6,20,70,90
47971,2016-07-09,7,26,138,164
47972,2016-07-09,8,76,281,357
47973,2016-07-09,9,168,444,612
47974,2016-07-09,10,264,510,774
47975,2016-07-09,11,320,545,865
47976,2016-07-09,12,384,550,934
47977,2016-07-09,13,417,579,996
47978,2016-07-09,14,422,576,998
47979,2016-07-09,15,468,481,949
47980,2016-07-09,16,409,486,895
47981,2016-07-09,17,400,471,871
47982,2016-07-09,18,337,429,766
47983,2016-07-09,19,322,473,795
47984,2016-07-09,20,273,352,625
47985,2016-07-09,21,180,270,450
47986,2016-07-09,22,133,198,331
47987,2016-07-09,23,77,189,266
47988,2016-07-10,0,71,120,191
47989,2016-07-10,1,34,100,134
47990,2016-07-10,2,22,68,90
47991,2016-07-10,3,11,37,48
47992,2016-07-10,4,6,14,20
47993,2016-07-10,5,4,12,16
47994,2016-07-10,6,21,30,51
47995,2016-07-10,7,32,79,111
47996,2016-07-10,8,68,201,269
47997,2016-07-10,9,155,288,443
47998,2016-07-10,10,242,442,684
47999,2016-07-10,11,305,532,837
48000,2016-07-10,12,429,619,1048
48001,2016-07-10,13,428,628,1056
48002,2016-07-10,14,489,617,1106
48003,2016-07-10,15,407,559,966
48004,2016-07-10,16,426,511,937
48005,2016-07-10,17,365,537,902
48006,2016-07-10,18,354,548,902
48007,2016-07-10,19,312,442,754
48008,2016-07-10,20,223,408,631
48009,2016-07-10,21,161,261,422
48010,2016-07-10,22,84,164,248
48011,2016-07-10,23,31,83,114
48012,2016-07-11,0,19,48,67
48013,2016-07-11,1,16,14,30
48014,2016-07-11,2,1,7,8
48015,2016-07-11,3,1,10,11
48016,2016-07-11,4,6,14,20
48017,2016-07-11,5,8,79,87
48018,2016-07-11,6,23,318,341
48019,2016-07-11,7,44,914,958
48020,2016-07-11,8,80,1061,1141
48021,2016-07-11,9,124,483,607
48022,2016-07-11,10,176,195,371
48023,2016-07-11,11,176,209,385
48024,2016-07-11,12,156,311,467
48025,2016-07-11,13,198,316,514
48026,2016-07-11,14,239,299,538
48027,2016-07-11,15,213,328,541
48028,2016-07-11,16,178,665,843
48029,2016-07-11,17,202,1353,1555
48030,2016-07-11,18,234,1187,1421
48031,2016-07-11,19,219,784,1003
48032,2016-07-11,20,182,630,812
48033,2016-07-11,21,129,417,546
48034,2016-07-11,22,87,218,305
48035,2016-07-11,23,40,98,138
48036,2016-07-12,0,20,50,70
48037,2016-07-12,1,12,14,26
48038,2016-07-12,2,2,4,6
48039,2016-07-12,3,3,3,6
48040,2016-07-12,4,0,11,11
48041,2016-07-12,5,11,103,114
48042,2016-07-12,6,18,380,398
48043,2016-07-12,7,44,927,971
48044,2016-07-12,8,97,1246,1343
48045,2016-07-12,9,107,501,608
48046,2016-07-12,10,120,250,370
48047,2016-07-12,11,109,272,381
48048,2016-07-12,12,160,336,496
48049,2016-07-12,13,175,335,510
48050,2016-07-12,14,188,290,478
48051,2016-07-12,15,169,344,513
48052,2016-07-12,16,232,717,949
48053,2016-07-12,17,287,1396,1683
48054,2016-07-12,18,192,1162,1354
48055,2016-07-12,19,226,852,1078
48056,2016-07-12,20,167,637,804
48057,2016-07-12,21,118,401,519
48058,2016-07-12,22,59,269,328
48059,2016-07-12,23,27,124,151
48060,2016-07-13,0,24,42,66
48061,2016-07-13,1,9,22,31
48062,2016-07-13,2,4,5,9
48063,2016-07-13,3,1,4,5
48064,2016-07-13,4,1,13,14
48065,2016-07-13,5,10,120,130
48066,2016-07-13,6,25,380,405
48067,2016-07-13,7,39,904,943
48068,2016-07-13,8,78,1209,1287
48069,2016-07-13,9,76,506,582
48070,2016-07-13,10,108,238,346
48071,2016-07-13,11,170,232,402
48072,2016-07-13,12,148,300,448
48073,2016-07-13,13,137,314,451
48074,2016-07-13,14,150,240,390
48075,2016-07-13,15,184,312,496
48076,2016-07-13,16,187,671,858
48077,2016-07-13,17,198,1365,1563
48078,2016-07-13,18,188,1099,1287
48079,2016-07-13,19,215,834,1049
48080,2016-07-13,20,143,626,769
48081,2016-07-13,21,100,362,462
48082,2016-07-13,22,71,281,352
48083,2016-07-13,23,44,129,173
48084,2016-07-14,0,29,45,74
48085,2016-07-14,1,20,19,39
48086,2016-07-14,2,9,9,18
48087,2016-07-14,3,2,2,4
48088,2016-07-14,4,0,15,15
48089,2016-07-14,5,4,93,97
48090,2016-07-14,6,20,340,360
48091,2016-07-14,7,43,883,926
48092,2016-07-14,8,67,1107,1174
48093,2016-07-14,9,89,504,593
48094,2016-07-14,10,172,230,402
48095,2016-07-14,11,158,238,396
48096,2016-07-14,12,123,317,440
48097,2016-07-14,13,159,279,438
48098,2016-07-14,14,166,242,408
48099,2016-07-14,15,156,332,488
48100,2016-07-14,16,149,635,784
48101,2016-07-14,17,213,1197,1410
48102,2016-07-14,18,211,1054,1265
48103,2016-07-14,19,183,709,892
48104,2016-07-14,20,137,576,713
48105,2016-07-14,21,149,387,536
48106,2016-07-14,22,117,275,392
48107,2016-07-14,23,56,165,221
48108,2016-07-15,0,27,67,94
48109,2016-07-15,1,26,26,52
48110,2016-07-15,2,11,16,27
48111,2016-07-15,3,8,9,17
48112,2016-07-15,4,0,12,12
48113,2016-07-15,5,10,82,92
48114,2016-07-15,6,17,298,315
48115,2016-07-15,7,38,769,807
48116,2016-07-15,8,86,1096,1182
48117,2016-07-15,9,104,497,601
48118,2016-07-15,10,152,235,387
48119,2016-07-15,11,207,288,495
48120,2016-07-15,12,228,329,557
48121,2016-07-15,13,206,392,598
48122,2016-07-15,14,202,312,514
48123,2016-07-15,15,249,454,703
48124,2016-07-15,16,232,714,946
48125,2016-07-15,17,256,1099,1355
48126,2016-07-15,18,201,908,1109
48127,2016-07-15,19,236,582,818
48128,2016-07-15,20,190,448,638
48129,2016-07-15,21,178,365,543
48130,2016-07-15,22,148,307,455
48131,2016-07-15,23,99,197,296
48132,2016-07-16,0,56,164,220
48133,2016-07-16,1,41,112,153
48134,2016-07-16,2,24,66,90
48135,2016-07-16,3,18,38,56
48136,2016-07-16,4,5,21,26
48137,2016-07-16,5,10,14,24
48138,2016-07-16,6,21,60,81
48139,2016-07-16,7,71,147,218
48140,2016-07-16,8,127,326,453
48141,2016-07-16,9,298,430,728
48142,2016-07-16,10,528,441,969
48143,2016-07-16,11,591,557,1148
48144,2016-07-16,12,679,561,1240
48145,2016-07-16,13,756,534,1290
48146,2016-07-16,14,691,462,1153
48147,2016-07-16,15,625,483,1108
48148,2016-07-16,16,673,470,1143
48149,2016-07-16,17,588,394,982
48150,2016-07-16,18,206,174,380
48151,2016-07-16,19,215,153,368
48152,2016-07-16,20,333,278,611
48153,2016-07-16,21,327,226,553
48154,2016-07-16,22,256,185,441
48155,2016-07-16,23,219,180,399
48156,2016-07-17,0,131,120,251
48157,2016-07-17,1,83,91,174
48158,2016-07-17,2,43,62,105
48159,2016-07-17,3,37,43,80
48160,2016-07-17,4,8,17,25
48161,2016-07-17,5,10,10,20
48162,2016-07-17,6,38,27,65
48163,2016-07-17,7,107,89,196
48164,2016-07-17,8,163,207,370
48165,2016-07-17,9,363,337,700
48166,2016-07-17,10,465,445,910
48167,2016-07-17,11,630,518,1148
48168,2016-07-17,12,655,560,1215
48169,2016-07-17,13,694,500,1194
48170,2016-07-17,14,761,539,1300
48171,2016-07-17,15,781,510,1291
48172,2016-07-17,16,666,488,1154
48173,2016-07-17,17,717,503,1220
48174,2016-07-17,18,566,484,1050
48175,2016-07-17,19,532,447,979
48176,2016-07-17,20,511,351,862
48177,2016-07-17,21,382,306,688
48178,2016-07-17,22,198,146,344
48179,2016-07-17,23,85,97,182
48180,2016-07-18,0,44,53,97
48181,2016-07-18,1,14,18,32
48182,2016-07-18,2,9,7,16
48183,2016-07-18,3,2,8,10
48184,2016-07-18,4,0,7,7
48185,2016-07-18,5,10,85,95
48186,2016-07-18,6,14,330,344
48187,2016-07-18,7,59,810,869
48188,2016-07-18,8,107,1013,1120
48189,2016-07-18,9,111,448,559
48190,2016-07-18,10,133,184,317
48191,2016-07-18,11,164,214,378
48192,2016-07-18,12,137,271,408
48193,2016-07-18,13,152,255,407
48194,2016-07-18,14,166,190,356
48195,2016-07-18,15,153,334,487
48196,2016-07-18,16,80,314,394
48197,2016-07-18,17,61,317,378
48198,2016-07-18,18,114,885,999
48199,2016-07-18,19,212,662,874
48200,2016-07-18,20,209,485,694
48201,2016-07-18,21,154,307,461
48202,2016-07-18,22,79,195,274
48203,2016-07-18,23,41,112,153
48204,2016-07-19,0,15,30,45
48205,2016-07-19,1,4,16,20
48206,2016-07-19,2,3,2,5
48207,2016-07-19,3,2,2,4
48208,2016-07-19,4,2,14,16
48209,2016-07-19,5,8,103,111
48210,2016-07-19,6,19,381,400
48211,2016-07-19,7,32,889,921
48212,2016-07-19,8,61,1151,1212
48213,2016-07-19,9,100,500,600
48214,2016-07-19,10,158,220,378
48215,2016-07-19,11,135,245,380
48216,2016-07-19,12,185,333,518
48217,2016-07-19,13,193,266,459
48218,2016-07-19,14,145,282,427
48219,2016-07-19,15,163,384,547
48220,2016-07-19,16,189,589,778
48221,2016-07-19,17,244,1369,1613
48222,2016-07-19,18,207,1154,1361
48223,2016-07-19,19,190,803,993
48224,2016-07-19,20,148,551,699
48225,2016-07-19,21,106,398,504
48226,2016-07-19,22,66,231,297
48227,2016-07-19,23,8,28,36
48228,2016-07-20,0,11,30,41
48229,2016-07-20,1,8,10,18
48230,2016-07-20,2,1,11,12
48231,2016-07-20,3,2,4,6
48232,2016-07-20,4,1,14,15
48233,2016-07-20,5,7,95,102
48234,2016-07-20,6,18,358,376
48235,2016-07-20,7,45,877,922
48236,2016-07-20,8,67,1240,1307
48237,2016-07-20,9,94,527,621
48238,2016-07-20,10,131,259,390
48239,2016-07-20,11,132,280,412
48240,2016-07-20,12,151,362,513
48241,2016-07-20,13,142,332,474
48242,2016-07-20,14,193,300,493
48243,2016-07-20,15,157,404,561
48244,2016-07-20,16,211,704,915
48245,2016-07-20,17,283,1386,1669
48246,2016-07-20,18,233,1180,1413
48247,2016-07-20,19,194,787,981
48248,2016-07-20,20,201,594,795
48249,2016-07-20,21,144,451,595
48250,2016-07-20,22,90,349,439
48251,2016-07-20,23,53,177,230
48252,2016-07-21,0,15,77,92
48253,2016-07-21,1,12,15,27
48254,2016-07-21,2,5,6,11
48255,2016-07-21,3,3,6,9
48256,2016-07-21,4,4,9,13
48257,2016-07-21,5,7,84,91
48258,2016-07-21,6,15,318,333
48259,2016-07-21,7,37,917,954
48260,2016-07-21,8,85,1201,1286
48261,2016-07-21,9,94,509,603
48262,2016-07-21,10,148,252,400
48263,2016-07-21,11,143,272,415
48264,2016-07-21,12,166,330,496
48265,2016-07-21,13,132,329,461
48266,2016-07-21,14,155,297,452
48267,2016-07-21,15,159,396,555
48268,2016-07-21,16,219,684,903
48269,2016-07-21,17,248,1321,1569
48270,2016-07-21,18,210,1101,1311
48271,2016-07-21,19,221,789,1010
48272,2016-07-21,20,199,547,746
48273,2016-07-21,21,135,428,563
48274,2016-07-21,22,71,289,360
48275,2016-07-21,23,44,156,200
48276,2016-07-22,0,25,69,94
48277,2016-07-22,1,15,38,53
48278,2016-07-22,2,10,14,24
48279,2016-07-22,3,6,6,12
48280,2016-07-22,4,2,12,14
48281,2016-07-22,5,8,80,88
48282,2016-07-22,6,19,264,283
48283,2016-07-22,7,48,721,769
48284,2016-07-22,8,92,1069,1161
48285,2016-07-22,9,133,505,638
48286,2016-07-22,10,207,256,463
48287,2016-07-22,11,214,240,454
48288,2016-07-22,12,236,354,590
48289,2016-07-22,13,230,346,576
48290,2016-07-22,14,207,348,555
48291,2016-07-22,15,193,426,619
48292,2016-07-22,16,212,677,889
48293,2016-07-22,17,176,1091,1267
48294,2016-07-22,18,184,855,1039
48295,2016-07-22,19,229,539,768
48296,2016-07-22,20,215,415,630
48297,2016-07-22,21,182,283,465
48298,2016-07-22,22,123,262,385
48299,2016-07-22,23,67,202,269
48300,2016-07-23,0,52,127,179
48301,2016-07-23,1,29,66,95
48302,2016-07-23,2,28,53,81
48303,2016-07-23,3,18,27,45
48304,2016-07-23,4,6,14,20
48305,2016-07-23,5,12,20,32
48306,2016-07-23,6,17,54,71
48307,2016-07-23,7,34,148,182
48308,2016-07-23,8,84,292,376
48309,2016-07-23,9,175,359,534
48310,2016-07-23,10,252,449,701
48311,2016-07-23,11,283,469,752
48312,2016-07-23,12,310,474,784
48313,2016-07-23,13,286,408,694
48314,2016-07-23,14,320,342,662
48315,2016-07-23,15,297,435,732
48316,2016-07-23,16,332,377,709
48317,2016-07-23,17,298,370,668
48318,2016-07-23,18,274,345,619
48319,2016-07-23,19,257,334,591
48320,2016-07-23,20,313,299,612
48321,2016-07-23,21,220,236,456
48322,2016-07-23,22,162,252,414
48323,2016-07-23,23,108,144,252
48324,2016-07-24,0,52,118,170
48325,2016-07-24,1,40,90,130
48326,2016-07-24,2,18,69,87
48327,2016-07-24,3,19,47,66
48328,2016-07-24,4,4,10,14
48329,2016-07-24,5,9,15,24
48330,2016-07-24,6,23,34,57
48331,2016-07-24,7,38,88,126
48332,2016-07-24,8,86,189,275
48333,2016-07-24,9,169,292,461
48334,2016-07-24,10,305,361,666
48335,2016-07-24,11,308,405,713
48336,2016-07-24,12,314,426,740
48337,2016-07-24,13,316,446,762
48338,2016-07-24,14,327,401,728
48339,2016-07-24,15,345,389,734
48340,2016-07-24,16,274,378,652
48341,2016-07-24,17,256,377,633
48342,2016-07-24,18,306,407,713
48343,2016-07-24,19,275,351,626
48344,2016-07-24,20,223,284,507
48345,2016-07-24,21,126,213,339
48346,2016-07-24,22,101,169,270
48347,2016-07-24,23,52,69,121
48348,2016-07-25,0,16,30,46
48349,2016-07-25,1,11,16,27
48350,2016-07-25,2,8,11,19
48351,2016-07-25,3,3,8,11
48352,2016-07-25,4,4,14,18
48353,2016-07-25,5,11,80,91
48354,2016-07-25,6,20,310,330
48355,2016-07-25,7,48,753,801
48356,2016-07-25,8,83,950,1033
48357,2016-07-25,9,85,378,463
48358,2016-07-25,10,109,168,277
48359,2016-07-25,11,144,206,350
48360,2016-07-25,12,129,221,350
48361,2016-07-25,13,121,208,329
48362,2016-07-25,14,131,210,341
48363,2016-07-25,15,141,297,438
48364,2016-07-25,16,133,493,626
48365,2016-07-25,17,182,1176,1358
48366,2016-07-25,18,176,935,1111
48367,2016-07-25,19,191,639,830
48368,2016-07-25,20,178,439,617
48369,2016-07-25,21,121,290,411
48370,2016-07-25,22,112,160,272
48371,2016-07-25,23,43,81,124
48372,2016-07-26,0,13,33,46
48373,2016-07-26,1,11,19,30
48374,2016-07-26,2,3,6,9
48375,2016-07-26,3,6,5,11
48376,2016-07-26,4,6,6,12
48377,2016-07-26,5,12,96,108
48378,2016-07-26,6,20,343,363
48379,2016-07-26,7,42,815,857
48380,2016-07-26,8,66,1124,1190
48381,2016-07-26,9,80,397,477
48382,2016-07-26,10,131,195,326
48383,2016-07-26,11,125,211,336
48384,2016-07-26,12,147,274,421
48385,2016-07-26,13,155,226,381
48386,2016-07-26,14,143,194,337
48387,2016-07-26,15,139,274,413
48388,2016-07-26,16,129,557,686
48389,2016-07-26,17,182,1212,1394
48390,2016-07-26,18,151,1111,1262
48391,2016-07-26,19,193,753,946
48392,2016-07-26,20,134,498,632
48393,2016-07-26,21,118,357,475
48394,2016-07-26,22,75,199,274
48395,2016-07-26,23,25,136,161
48396,2016-07-27,0,16,35,51
48397,2016-07-27,1,16,29,45
48398,2016-07-27,2,6,11,17
48399,2016-07-27,3,4,5,9
48400,2016-07-27,4,5,10,15
48401,2016-07-27,5,10,92,102
48402,2016-07-27,6,36,346,382
48403,2016-07-27,7,47,895,942
48404,2016-07-27,8,71,1058,1129
48405,2016-07-27,9,71,458,529
48406,2016-07-27,10,131,217,348
48407,2016-07-27,11,144,229,373
48408,2016-07-27,12,102,278,380
48409,2016-07-27,13,125,284,409
48410,2016-07-27,14,126,273,399
48411,2016-07-27,15,141,321,462
48412,2016-07-27,16,120,615,735
48413,2016-07-27,17,126,1283,1409
48414,2016-07-27,18,172,1114,1286
48415,2016-07-27,19,182,738,920
48416,2016-07-27,20,170,533,703
48417,2016-07-27,21,145,335,480
48418,2016-07-27,22,67,229,296
48419,2016-07-27,23,29,117,146
48420,2016-07-28,0,21,59,80
48421,2016-07-28,1,17,26,43
48422,2016-07-28,2,26,10,36
48423,2016-07-28,3,13,7,20
48424,2016-07-28,4,2,7,9
48425,2016-07-28,5,9,88,97
48426,2016-07-28,6,14,298,312
48427,2016-07-28,7,31,793,824
48428,2016-07-28,8,69,1091,1160
48429,2016-07-28,9,72,495,567
48430,2016-07-28,10,112,211,323
48431,2016-07-28,11,125,237,362
48432,2016-07-28,12,134,292,426
48433,2016-07-28,13,135,301,436
48434,2016-07-28,14,164,241,405
48435,2016-07-28,15,180,318,498
48436,2016-07-28,16,187,571,758
48437,2016-07-28,17,107,583,690
48438,2016-07-28,18,125,756,881
48439,2016-07-28,19,153,612,765
48440,2016-07-28,20,78,356,434
48441,2016-07-28,21,19,91,110
48442,2016-07-28,22,15,76,91
48443,2016-07-28,23,4,33,37
48444,2016-07-29,0,3,31,34
48445,2016-07-29,1,1,19,20
48446,2016-07-29,2,8,7,15
48447,2016-07-29,3,0,4,4
48448,2016-07-29,4,3,9,12
48449,2016-07-29,5,4,64,68
48450,2016-07-29,6,7,212,219
48451,2016-07-29,7,35,664,699
48452,2016-07-29,8,63,1055,1118
48453,2016-07-29,9,124,492,616
48454,2016-07-29,10,184,298,482
48455,2016-07-29,11,240,309,549
48456,2016-07-29,12,271,374,645
48457,2016-07-29,13,248,350,598
48458,2016-07-29,14,260,350,610
48459,2016-07-29,15,229,448,677
48460,2016-07-29,16,238,715,953
48461,2016-07-29,17,227,1098,1325
48462,2016-07-29,18,224,861,1085
48463,2016-07-29,19,219,595,814
48464,2016-07-29,20,179,450,629
48465,2016-07-29,21,141,305,446
48466,2016-07-29,22,89,222,311
48467,2016-07-29,23,62,158,220
48468,2016-07-30,0,69,119,188
48469,2016-07-30,1,51,87,138
48470,2016-07-30,2,26,61,87
48471,2016-07-30,3,15,27,42
48472,2016-07-30,4,7,10,17
48473,2016-07-30,5,9,17,26
48474,2016-07-30,6,26,52,78
48475,2016-07-30,7,33,99,132
48476,2016-07-30,8,80,234,314
48477,2016-07-30,9,157,411,568
48478,2016-07-30,10,297,425,722
48479,2016-07-30,11,384,518,902
48480,2016-07-30,12,301,410,711
48481,2016-07-30,13,257,360,617
48482,2016-07-30,14,368,396,764
48483,2016-07-30,15,425,437,862
48484,2016-07-30,16,404,408,812
48485,2016-07-30,17,334,393,727
48486,2016-07-30,18,238,320,558
48487,2016-07-30,19,81,130,211
48488,2016-07-30,20,23,36,59
48489,2016-07-30,21,25,52,77
48490,2016-07-30,22,53,87,140
48491,2016-07-30,23,44,140,184
48492,2016-07-31,0,44,127,171
48493,2016-07-31,1,25,71,96
48494,2016-07-31,2,21,62,83
48495,2016-07-31,3,8,27,35
48496,2016-07-31,4,8,11,19
48497,2016-07-31,5,7,9,16
48498,2016-07-31,6,12,35,47
48499,2016-07-31,7,41,90,131
48500,2016-07-31,8,75,184,259
48501,2016-07-31,9,224,324,548
48502,2016-07-31,10,308,450,758
48503,2016-07-31,11,382,558,940
48504,2016-07-31,12,411,587,998
48505,2016-07-31,13,383,499,882
48506,2016-07-31,14,431,517,948
48507,2016-07-31,15,466,506,972
48508,2016-07-31,16,385,461,846
48509,2016-07-31,17,284,423,707
48510,2016-07-31,18,230,377,607
48511,2016-07-31,19,196,336,532
48512,2016-07-31,20,189,304,493
48513,2016-07-31,21,137,226,363
48514,2016-07-31,22,100,178,278
48515,2016-07-31,23,31,83,114
48516,2016-08-01,0,11,34,45
48517,2016-08-01,1,17,21,38
48518,2016-08-01,2,11,11,22
48519,2016-08-01,3,4,4,8
48520,2016-08-01,4,1,11,12
48521,2016-08-01,5,18,82,100
48522,2016-08-01,6,16,316,332
48523,2016-08-01,7,60,824,884
48524,2016-08-01,8,81,983,1064
48525,2016-08-01,9,104,420,524
48526,2016-08-01,10,140,184,324
48527,2016-08-01,11,218,200,418
48528,2016-08-01,12,226,286,512
48529,2016-08-01,13,185,270,455
48530,2016-08-01,14,181,289,470
48531,2016-08-01,15,193,327,520
48532,2016-08-01,16,196,571,767
48533,2016-08-01,17,253,1385,1638
48534,2016-08-01,18,186,1147,1333
48535,2016-08-01,19,193,759,952
48536,2016-08-01,20,153,515,668
48537,2016-08-01,21,116,300,416
48538,2016-08-01,22,91,195,286
48539,2016-08-01,23,59,104,163
48540,2016-08-02,0,19,50,69
48541,2016-08-02,1,12,14,26
48542,2016-08-02,2,8,6,14
48543,2016-08-02,3,1,5,6
48544,2016-08-02,4,3,15,18
48545,2016-08-02,5,4,101,105
48546,2016-08-02,6,16,429,445
48547,2016-08-02,7,40,934,974
48548,2016-08-02,8,95,1161,1256
48549,2016-08-02,9,84,470,554
48550,2016-08-02,10,142,241,383
48551,2016-08-02,11,181,268,449
48552,2016-08-02,12,166,333,499
48553,2016-08-02,13,172,323,495
48554,2016-08-02,14,191,263,454
48555,2016-08-02,15,190,344,534
48556,2016-08-02,16,213,662,875
48557,2016-08-02,17,286,1450,1736
48558,2016-08-02,18,260,1281,1541
48559,2016-08-02,19,242,830,1072
48560,2016-08-02,20,170,635,805
48561,2016-08-02,21,153,403,556
48562,2016-08-02,22,83,249,332
48563,2016-08-02,23,38,136,174
48564,2016-08-03,0,8,48,56
48565,2016-08-03,1,11,22,33
48566,2016-08-03,2,2,9,11
48567,2016-08-03,3,1,7,8
48568,2016-08-03,4,2,16,18
48569,2016-08-03,5,11,122,133
48570,2016-08-03,6,30,360,390
48571,2016-08-03,7,52,953,1005
48572,2016-08-03,8,81,1212,1293
48573,2016-08-03,9,97,515,612
48574,2016-08-03,10,164,247,411
48575,2016-08-03,11,172,305,477
48576,2016-08-03,12,197,375,572
48577,2016-08-03,13,187,391,578
48578,2016-08-03,14,226,286,512
48579,2016-08-03,15,229,416,645
48580,2016-08-03,16,246,692,938
48581,2016-08-03,17,269,1364,1633
48582,2016-08-03,18,258,1151,1409
48583,2016-08-03,19,232,845,1077
48584,2016-08-03,20,180,601,781
48585,2016-08-03,21,128,348,476
48586,2016-08-03,22,92,266,358
48587,2016-08-03,23,36,128,164
48588,2016-08-04,0,36,46,82
48589,2016-08-04,1,34,13,47
48590,2016-08-04,2,21,10,31
48591,2016-08-04,3,20,8,28
48592,2016-08-04,4,1,11,12
48593,2016-08-04,5,9,103,112
48594,2016-08-04,6,22,337,359
48595,2016-08-04,7,40,839,879
48596,2016-08-04,8,79,1189,1268
48597,2016-08-04,9,109,503,612
48598,2016-08-04,10,143,245,388
48599,2016-08-04,11,142,262,404
48600,2016-08-04,12,226,372,598
48601,2016-08-04,13,215,362,577
48602,2016-08-04,14,190,333,523
48603,2016-08-04,15,236,386,622
48604,2016-08-04,16,244,667,911
48605,2016-08-04,17,314,1331,1645
48606,2016-08-04,18,284,1158,1442
48607,2016-08-04,19,258,809,1067
48608,2016-08-04,20,251,624,875
48609,2016-08-04,21,149,408,557
48610,2016-08-04,22,87,240,327
48611,2016-08-04,23,47,142,189
48612,2016-08-05,0,21,51,72
48613,2016-08-05,1,21,36,57
48614,2016-08-05,2,5,20,25
48615,2016-08-05,3,3,12,15
48616,2016-08-05,4,0,9,9
48617,2016-08-05,5,3,102,105
48618,2016-08-05,6,23,262,285
48619,2016-08-05,7,51,671,722
48620,2016-08-05,8,88,1114,1202
48621,2016-08-05,9,124,519,643
48622,2016-08-05,10,189,283,472
48623,2016-08-05,11,203,277,480
48624,2016-08-05,12,314,419,733
48625,2016-08-05,13,244,419,663
48626,2016-08-05,14,290,392,682
48627,2016-08-05,15,283,451,734
48628,2016-08-05,16,269,736,1005
48629,2016-08-05,17,297,1156,1453
48630,2016-08-05,18,270,919,1189
48631,2016-08-05,19,215,670,885
48632,2016-08-05,20,203,421,624
48633,2016-08-05,21,130,348,478
48634,2016-08-05,22,130,268,398
48635,2016-08-05,23,86,168,254
48636,2016-08-06,0,67,138,205
48637,2016-08-06,1,52,96,148
48638,2016-08-06,2,21,42,63
48639,2016-08-06,3,12,25,37
48640,2016-08-06,4,16,13,29
48641,2016-08-06,5,3,23,26
48642,2016-08-06,6,20,44,64
48643,2016-08-06,7,23,136,159
48644,2016-08-06,8,93,241,334
48645,2016-08-06,9,239,389,628
48646,2016-08-06,10,290,515,805
48647,2016-08-06,11,379,492,871
48648,2016-08-06,12,377,503,880
48649,2016-08-06,13,455,465,920
48650,2016-08-06,14,364,407,771
48651,2016-08-06,15,288,397,685
48652,2016-08-06,16,415,425,840
48653,2016-08-06,17,389,420,809
48654,2016-08-06,18,310,401,711
48655,2016-08-06,19,355,362,717
48656,2016-08-06,20,251,289,540
48657,2016-08-06,21,216,257,473
48658,2016-08-06,22,188,209,397
48659,2016-08-06,23,70,157,227
48660,2016-08-07,0,55,115,170
48661,2016-08-07,1,32,105,137
48662,2016-08-07,2,31,62,93
48663,2016-08-07,3,18,34,52
48664,2016-08-07,4,3,11,14
48665,2016-08-07,5,14,18,32
48666,2016-08-07,6,12,33,45
48667,2016-08-07,7,32,83,115
48668,2016-08-07,8,98,165,263
48669,2016-08-07,9,212,334,546
48670,2016-08-07,10,355,452,807
48671,2016-08-07,11,393,540,933
48672,2016-08-07,12,439,534,973
48673,2016-08-07,13,438,542,980
48674,2016-08-07,14,439,538,977
48675,2016-08-07,15,464,521,985
48676,2016-08-07,16,449,554,1003
48677,2016-08-07,17,397,503,900
48678,2016-08-07,18,342,472,814
48679,2016-08-07,19,343,415,758
48680,2016-08-07,20,237,342,579
48681,2016-08-07,21,171,235,406
48682,2016-08-07,22,94,151,245
48683,2016-08-07,23,53,80,133
48684,2016-08-08,0,30,35,65
48685,2016-08-08,1,11,11,22
48686,2016-08-08,2,4,6,10
48687,2016-08-08,3,3,3,6
48688,2016-08-08,4,2,14,16
48689,2016-08-08,5,4,85,89
48690,2016-08-08,6,20,310,330
48691,2016-08-08,7,44,824,868
48692,2016-08-08,8,70,1061,1131
48693,2016-08-08,9,121,433,554
48694,2016-08-08,10,165,220,385
48695,2016-08-08,11,199,221,420
48696,2016-08-08,12,197,308,505
48697,2016-08-08,13,179,272,451
48698,2016-08-08,14,183,283,466
48699,2016-08-08,15,192,314,506
48700,2016-08-08,16,214,634,848
48701,2016-08-08,17,262,1364,1626
48702,2016-08-08,18,250,1060,1310
48703,2016-08-08,19,203,714,917
48704,2016-08-08,20,128,498,626
48705,2016-08-08,21,112,299,411
48706,2016-08-08,22,79,179,258
48707,2016-08-08,23,36,70,106
48708,2016-08-09,0,11,34,45
48709,2016-08-09,1,10,20,30
48710,2016-08-09,2,3,3,6
48711,2016-08-09,3,2,0,2
48712,2016-08-09,4,0,11,11
48713,2016-08-09,5,6,97,103
48714,2016-08-09,6,31,330,361
48715,2016-08-09,7,48,918,966
48716,2016-08-09,8,66,1236,1302
48717,2016-08-09,9,114,491,605
48718,2016-08-09,10,133,221,354
48719,2016-08-09,11,184,254,438
48720,2016-08-09,12,200,349,549
48721,2016-08-09,13,170,362,532
48722,2016-08-09,14,215,239,454
48723,2016-08-09,15,198,365,563
48724,2016-08-09,16,219,669,888
48725,2016-08-09,17,238,1379,1617
48726,2016-08-09,18,199,1102,1301
48727,2016-08-09,19,164,655,819
48728,2016-08-09,20,113,488,601
48729,2016-08-09,21,104,304,408
48730,2016-08-09,22,91,225,316
48731,2016-08-09,23,43,110,153
48732,2016-08-10,0,24,39,63
48733,2016-08-10,1,14,17,31
48734,2016-08-10,2,5,0,5
48735,2016-08-10,3,0,4,4
48736,2016-08-10,4,2,12,14
48737,2016-08-10,5,16,109,125
48738,2016-08-10,6,26,305,331
48739,2016-08-10,7,42,903,945
48740,2016-08-10,8,51,1184,1235
48741,2016-08-10,9,78,480,558
48742,2016-08-10,10,144,245,389
48743,2016-08-10,11,167,234,401
48744,2016-08-10,12,128,313,441
48745,2016-08-10,13,128,346,474
48746,2016-08-10,14,192,301,493
48747,2016-08-10,15,194,387,581
48748,2016-08-10,16,170,646,816
48749,2016-08-10,17,205,1263,1468
48750,2016-08-10,18,229,1124,1353
48751,2016-08-10,19,213,739,952
48752,2016-08-10,20,135,535,670
48753,2016-08-10,21,111,323,434
48754,2016-08-10,22,80,215,295
48755,2016-08-10,23,38,142,180
48756,2016-08-11,0,19,53,72
48757,2016-08-11,1,7,16,23
48758,2016-08-11,2,14,7,21
48759,2016-08-11,3,4,4,8
48760,2016-08-11,4,0,10,10
48761,2016-08-11,5,3,92,95
48762,2016-08-11,6,21,323,344
48763,2016-08-11,7,47,813,860
48764,2016-08-11,8,79,1098,1177
48765,2016-08-11,9,123,488,611
48766,2016-08-11,10,149,218,367
48767,2016-08-11,11,180,241,421
48768,2016-08-11,12,155,312,467
48769,2016-08-11,13,135,289,424
48770,2016-08-11,14,145,219,364
48771,2016-08-11,15,145,322,467
48772,2016-08-11,16,204,526,730
48773,2016-08-11,17,186,1188,1374
48774,2016-08-11,18,217,974,1191
48775,2016-08-11,19,201,672,873
48776,2016-08-11,20,171,454,625
48777,2016-08-11,21,142,296,438
48778,2016-08-11,22,105,219,324
48779,2016-08-11,23,43,136,179
48780,2016-08-12,0,20,58,78
48781,2016-08-12,1,10,28,38
48782,2016-08-12,2,4,21,25
48783,2016-08-12,3,4,8,12
48784,2016-08-12,4,2,10,12
48785,2016-08-12,5,4,79,83
48786,2016-08-12,6,28,286,314
48787,2016-08-12,7,38,697,735
48788,2016-08-12,8,76,999,1075
48789,2016-08-12,9,141,455,596
48790,2016-08-12,10,137,227,364
48791,2016-08-12,11,190,270,460
48792,2016-08-12,12,176,301,477
48793,2016-08-12,13,175,346,521
48794,2016-08-12,14,177,301,478
48795,2016-08-12,15,196,379,575
48796,2016-08-12,16,186,583,769
48797,2016-08-12,17,214,933,1147
48798,2016-08-12,18,205,714,919
48799,2016-08-12,19,180,542,722
48800,2016-08-12,20,177,330,507
48801,2016-08-12,21,115,258,373
48802,2016-08-12,22,104,240,344
48803,2016-08-12,23,68,161,229
48804,2016-08-13,0,33,113,146
48805,2016-08-13,1,21,57,78
48806,2016-08-13,2,15,55,70
48807,2016-08-13,3,11,23,34
48808,2016-08-13,4,0,12,12
48809,2016-08-13,5,0,17,17
48810,2016-08-13,6,0,61,61
48811,2016-08-13,7,32,118,150
48812,2016-08-13,8,92,246,338
48813,2016-08-13,9,148,344,492
48814,2016-08-13,10,218,360,578
48815,2016-08-13,11,252,421,673
48816,2016-08-13,12,287,423,710
48817,2016-08-13,13,281,370,651
48818,2016-08-13,14,273,340,613
48819,2016-08-13,15,237,334,571
48820,2016-08-13,16,278,335,613
48821,2016-08-13,17,261,277,538
48822,2016-08-13,18,204,327,531
48823,2016-08-13,19,235,299,534
48824,2016-08-13,20,172,273,445
48825,2016-08-13,21,141,188,329
48826,2016-08-13,22,124,190,314
48827,2016-08-13,23,85,133,218
48828,2016-08-14,0,56,125,181
48829,2016-08-14,1,17,82,99
48830,2016-08-14,2,14,51,65
48831,2016-08-14,3,11,29,40
48832,2016-08-14,4,9,15,24
48833,2016-08-14,5,5,4,9
48834,2016-08-14,6,11,41,52
48835,2016-08-14,7,27,75,102
48836,2016-08-14,8,57,157,214
48837,2016-08-14,9,111,254,365
48838,2016-08-14,10,193,361,554
48839,2016-08-14,11,269,411,680
48840,2016-08-14,12,233,375,608
48841,2016-08-14,13,221,409,630
48842,2016-08-14,14,229,348,577
48843,2016-08-14,15,229,349,578
48844,2016-08-14,16,171,385,556
48845,2016-08-14,17,191,334,525
48846,2016-08-14,18,179,332,511
48847,2016-08-14,19,154,289,443
48848,2016-08-14,20,139,194,333
48849,2016-08-14,21,92,153,245
48850,2016-08-14,22,78,123,201
48851,2016-08-14,23,36,80,116
48852,2016-08-15,0,39,25,64
48853,2016-08-15,1,14,9,23
48854,2016-08-15,2,12,7,19
48855,2016-08-15,3,9,8,17
48856,2016-08-15,4,6,15,21
48857,2016-08-15,5,4,75,79
48858,2016-08-15,6,25,293,318
48859,2016-08-15,7,43,759,802
48860,2016-08-15,8,71,1037,1108
48861,2016-08-15,9,94,433,527
48862,2016-08-15,10,151,206,357
48863,2016-08-15,11,154,171,325
48864,2016-08-15,12,139,274,413
48865,2016-08-15,13,123,263,386
48866,2016-08-15,14,148,219,367
48867,2016-08-15,15,131,283,414
48868,2016-08-15,16,160,574,734
48869,2016-08-15,17,203,1188,1391
48870,2016-08-15,18,118,812,930
48871,2016-08-15,19,80,526,606
48872,2016-08-15,20,31,184,215
48873,2016-08-15,21,3,47,50
48874,2016-08-15,22,6,36,42
48875,2016-08-15,23,2,30,32
48876,2016-08-16,0,3,27,30
48877,2016-08-16,1,4,11,15
48878,2016-08-16,2,3,4,7
48879,2016-08-16,3,0,6,6
48880,2016-08-16,4,2,8,10
48881,2016-08-16,5,7,91,98
48882,2016-08-16,6,21,329,350
48883,2016-08-16,7,43,870,913
48884,2016-08-16,8,81,1105,1186
48885,2016-08-16,9,91,428,519
48886,2016-08-16,10,104,251,355
48887,2016-08-16,11,128,253,381
48888,2016-08-16,12,123,280,403
48889,2016-08-16,13,129,258,387
48890,2016-08-16,14,127,245,372
48891,2016-08-16,15,122,294,416
48892,2016-08-16,16,148,593,741
48893,2016-08-16,17,184,1262,1446
48894,2016-08-16,18,165,1093,1258
48895,2016-08-16,19,199,738,937
48896,2016-08-16,20,144,511,655
48897,2016-08-16,21,117,312,429
48898,2016-08-16,22,65,211,276
48899,2016-08-16,23,49,77,126
48900,2016-08-17,0,39,47,86
48901,2016-08-17,1,13,16,29
48902,2016-08-17,2,1,5,6
48903,2016-08-17,3,3,3,6
48904,2016-08-17,4,5,17,22
48905,2016-08-17,5,5,89,94
48906,2016-08-17,6,15,380,395
48907,2016-08-17,7,27,832,859
48908,2016-08-17,8,48,1178,1226
48909,2016-08-17,9,75,467,542
48910,2016-08-17,10,104,202,306
48911,2016-08-17,11,144,223,367
48912,2016-08-17,12,109,300,409
48913,2016-08-17,13,124,253,377
48914,2016-08-17,14,166,234,400
48915,2016-08-17,15,133,310,443
48916,2016-08-17,16,173,615,788
48917,2016-08-17,17,245,1272,1517
48918,2016-08-17,18,196,1111,1307
48919,2016-08-17,19,185,751,936
48920,2016-08-17,20,124,472,596
48921,2016-08-17,21,22,118,140
48922,2016-08-17,22,10,60,70
48923,2016-08-17,23,11,56,67
48924,2016-08-18,0,11,29,40
48925,2016-08-18,1,2,12,14
48926,2016-08-18,2,5,11,16
48927,2016-08-18,3,6,3,9
48928,2016-08-18,4,8,16,24
48929,2016-08-18,5,4,79,83
48930,2016-08-18,6,17,304,321
48931,2016-08-18,7,42,817,859
48932,2016-08-18,8,95,1130,1225
48933,2016-08-18,9,93,535,628
48934,2016-08-18,10,147,223,370
48935,2016-08-18,11,167,253,420
48936,2016-08-18,12,179,339,518
48937,2016-08-18,13,114,313,427
48938,2016-08-18,14,180,258,438
48939,2016-08-18,15,149,354,503
48940,2016-08-18,16,176,630,806
48941,2016-08-18,17,206,1258,1464
48942,2016-08-18,18,211,1087,1298
48943,2016-08-18,19,178,641,819
48944,2016-08-18,20,137,529,666
48945,2016-08-18,21,113,287,400
48946,2016-08-18,22,80,206,286
48947,2016-08-18,23,60,126,186
48948,2016-08-19,0,37,66,103
48949,2016-08-19,1,12,23,35
48950,2016-08-19,2,8,16,24
48951,2016-08-19,3,2,7,9
48952,2016-08-19,4,2,16,18
48953,2016-08-19,5,2,89,91
48954,2016-08-19,6,17,274,291
48955,2016-08-19,7,30,716,746
48956,2016-08-19,8,83,1037,1120
48957,2016-08-19,9,94,498,592
48958,2016-08-19,10,152,261,413
48959,2016-08-19,11,191,325,516
48960,2016-08-19,12,165,413,578
48961,2016-08-19,13,180,400,580
48962,2016-08-19,14,213,351,564
48963,2016-08-19,15,178,456,634
48964,2016-08-19,16,232,709,941
48965,2016-08-19,17,207,1023,1230
48966,2016-08-19,18,220,795,1015
48967,2016-08-19,19,171,608,779
48968,2016-08-19,20,157,426,583
48969,2016-08-19,21,129,283,412
48970,2016-08-19,22,113,268,381
48971,2016-08-19,23,74,186,260
48972,2016-08-20,0,48,110,158
48973,2016-08-20,1,21,64,85
48974,2016-08-20,2,8,55,63
48975,2016-08-20,3,9,32,41
48976,2016-08-20,4,2,16,18
48977,2016-08-20,5,6,14,20
48978,2016-08-20,6,14,64,78
48979,2016-08-20,7,40,109,149
48980,2016-08-20,8,101,274,375
48981,2016-08-20,9,167,394,561
48982,2016-08-20,10,304,474,778
48983,2016-08-20,11,370,473,843
48984,2016-08-20,12,387,536,923
48985,2016-08-20,13,412,488,900
48986,2016-08-20,14,466,459,925
48987,2016-08-20,15,463,470,933
48988,2016-08-20,16,420,469,889
48989,2016-08-20,17,320,421,741
48990,2016-08-20,18,315,461,776
48991,2016-08-20,19,324,412,736
48992,2016-08-20,20,219,297,516
48993,2016-08-20,21,209,249,458
48994,2016-08-20,22,157,160,317
48995,2016-08-20,23,87,157,244
48996,2016-08-21,0,69,122,191
48997,2016-08-21,1,42,99,141
48998,2016-08-21,2,27,72,99
48999,2016-08-21,3,9,35,44
49000,2016-08-21,4,9,16,25
49001,2016-08-21,5,9,14,23
49002,2016-08-21,6,11,33,44
49003,2016-08-21,7,24,81,105
49004,2016-08-21,8,85,146,231
49005,2016-08-21,9,173,295,468
49006,2016-08-21,10,251,380,631
49007,2016-08-21,11,341,426,767
49008,2016-08-21,12,311,473,784
49009,2016-08-21,13,319,439,758
49010,2016-08-21,14,199,330,529
49011,2016-08-21,15,58,102,160
49012,2016-08-21,16,68,125,193
49013,2016-08-21,17,151,332,483
49014,2016-08-21,18,171,347,518
49015,2016-08-21,19,99,205,304
49016,2016-08-21,20,68,202,270
49017,2016-08-21,21,95,147,242
49018,2016-08-21,22,57,99,156
49019,2016-08-21,23,20,66,86
49020,2016-08-22,0,23,33,56
49021,2016-08-22,1,3,15,18
49022,2016-08-22,2,4,5,9
49023,2016-08-22,3,2,3,5
49024,2016-08-22,4,3,15,18
49025,2016-08-22,5,8,90,98
49026,2016-08-22,6,14,311,325
49027,2016-08-22,7,36,867,903
49028,2016-08-22,8,88,1027,1115
49029,2016-08-22,9,77,398,475
49030,2016-08-22,10,136,211,347
49031,2016-08-22,11,191,218,409
49032,2016-08-22,12,172,311,483
49033,2016-08-22,13,189,278,467
49034,2016-08-22,14,178,257,435
49035,2016-08-22,15,190,351,541
49036,2016-08-22,16,216,681,897
49037,2016-08-22,17,244,1394,1638
49038,2016-08-22,18,246,1255,1501
49039,2016-08-22,19,225,801,1026
49040,2016-08-22,20,191,547,738
49041,2016-08-22,21,91,346,437
49042,2016-08-22,22,80,182,262
49043,2016-08-22,23,57,89,146
49044,2016-08-23,0,7,42,49
49045,2016-08-23,1,5,13,18
49046,2016-08-23,2,2,11,13
49047,2016-08-23,3,2,2,4
49048,2016-08-23,4,3,8,11
49049,2016-08-23,5,7,113,120
49050,2016-08-23,6,19,366,385
49051,2016-08-23,7,42,972,1014
49052,2016-08-23,8,86,1225,1311
49053,2016-08-23,9,81,517,598
49054,2016-08-23,10,129,230,359
49055,2016-08-23,11,171,292,463
49056,2016-08-23,12,204,342,546
49057,2016-08-23,13,181,333,514
49058,2016-08-23,14,166,303,469
49059,2016-08-23,15,164,376,540
49060,2016-08-23,16,199,740,939
49061,2016-08-23,17,227,1456,1683
49062,2016-08-23,18,209,1209,1418
49063,2016-08-23,19,209,818,1027
49064,2016-08-23,20,157,559,716
49065,2016-08-23,21,86,350,436
49066,2016-08-23,22,47,221,268
49067,2016-08-23,23,30,111,141
49068,2016-08-24,0,15,47,62
49069,2016-08-24,1,11,20,31
49070,2016-08-24,2,4,9,13
49071,2016-08-24,3,7,2,9
49072,2016-08-24,4,1,8,9
49073,2016-08-24,5,9,119,128
49074,2016-08-24,6,27,396,423
49075,2016-08-24,7,52,954,1006
49076,2016-08-24,8,70,1161,1231
49077,2016-08-24,9,82,496,578
49078,2016-08-24,10,151,250,401
49079,2016-08-24,11,125,249,374
49080,2016-08-24,12,194,403,597
49081,2016-08-24,13,180,314,494
49082,2016-08-24,14,178,313,491
49083,2016-08-24,15,192,337,529
49084,2016-08-24,16,184,666,850
49085,2016-08-24,17,198,1439,1637
49086,2016-08-24,18,195,1172,1367
49087,2016-08-24,19,194,789,983
49088,2016-08-24,20,100,476,576
49089,2016-08-24,21,95,360,455
49090,2016-08-24,22,55,287,342
49091,2016-08-24,23,36,129,165
49092,2016-08-25,0,21,48,69
49093,2016-08-25,1,3,27,30
49094,2016-08-25,2,9,10,19
49095,2016-08-25,3,2,8,10
49096,2016-08-25,4,3,7,10
49097,2016-08-25,5,3,108,111
49098,2016-08-25,6,18,333,351
49099,2016-08-25,7,44,936,980
49100,2016-08-25,8,59,1190,1249
49101,2016-08-25,9,84,455,539
49102,2016-08-25,10,143,275,418
49103,2016-08-25,11,186,282,468
49104,2016-08-25,12,176,333,509
49105,2016-08-25,13,170,343,513
49106,2016-08-25,14,183,295,478
49107,2016-08-25,15,193,387,580
49108,2016-08-25,16,207,662,869
49109,2016-08-25,17,240,1283,1523
49110,2016-08-25,18,181,1112,1293
49111,2016-08-25,19,168,717,885
49112,2016-08-25,20,148,506,654
49113,2016-08-25,21,73,385,458
49114,2016-08-25,22,79,260,339
49115,2016-08-25,23,34,134,168
49116,2016-08-26,0,22,56,78
49117,2016-08-26,1,8,29,37
49118,2016-08-26,2,7,19,26
49119,2016-08-26,3,4,5,9
49120,2016-08-26,4,1,15,16
49121,2016-08-26,5,10,82,92
49122,2016-08-26,6,16,266,282
49123,2016-08-26,7,41,727,768
49124,2016-08-26,8,60,1065,1125
49125,2016-08-26,9,113,498,611
49126,2016-08-26,10,154,262,416
49127,2016-08-26,11,146,257,403
49128,2016-08-26,12,161,374,535
49129,2016-08-26,13,163,346,509
49130,2016-08-26,14,173,319,492
49131,2016-08-26,15,165,423,588
49132,2016-08-26,16,188,734,922
49133,2016-08-26,17,222,1049,1271
49134,2016-08-26,18,189,809,998
49135,2016-08-26,19,160,538,698
49136,2016-08-26,20,134,365,499
49137,2016-08-26,21,113,260,373
49138,2016-08-26,22,84,220,304
49139,2016-08-26,23,53,191,244
49140,2016-08-27,0,54,145,199
49141,2016-08-27,1,17,75,92
49142,2016-08-27,2,12,57,69
49143,2016-08-27,3,5,27,32
49144,2016-08-27,4,5,14,19
49145,2016-08-27,5,12,18,30
49146,2016-08-27,6,12,58,70
49147,2016-08-27,7,27,131,158
49148,2016-08-27,8,76,277,353
49149,2016-08-27,9,158,368,526
49150,2016-08-27,10,296,509,805
49151,2016-08-27,11,330,529,859
49152,2016-08-27,12,361,506,867
49153,2016-08-27,13,384,501,885
49154,2016-08-27,14,327,461,788
49155,2016-08-27,15,363,443,806
49156,2016-08-27,16,369,458,827
49157,2016-08-27,17,377,424,801
49158,2016-08-27,18,370,443,813
49159,2016-08-27,19,300,389,689
49160,2016-08-27,20,238,280,518
49161,2016-08-27,21,161,272,433
49162,2016-08-27,22,112,205,317
49163,2016-08-27,23,81,159,240
49164,2016-08-28,0,38,106,144
49165,2016-08-28,1,35,83,118
49166,2016-08-28,2,28,59,87
49167,2016-08-28,3,11,26,37
49168,2016-08-28,4,11,9,20
49169,2016-08-28,5,6,5,11
49170,2016-08-28,6,9,34,43
49171,2016-08-28,7,42,96,138
49172,2016-08-28,8,92,182,274
49173,2016-08-28,9,141,301,442
49174,2016-08-28,10,308,400,708
49175,2016-08-28,11,297,479,776
49176,2016-08-28,12,357,557,914
49177,2016-08-28,13,359,521,880
49178,2016-08-28,14,363,481,844
49179,2016-08-28,15,332,487,819
49180,2016-08-28,16,291,540,831
49181,2016-08-28,17,288,533,821
49182,2016-08-28,18,274,573,847
49183,2016-08-28,19,215,396,611
49184,2016-08-28,20,170,312,482
49185,2016-08-28,21,122,215,337
49186,2016-08-28,22,75,153,228
49187,2016-08-28,23,35,77,112
49188,2016-08-29,0,23,48,71
49189,2016-08-29,1,14,11,25
49190,2016-08-29,2,5,8,13
49191,2016-08-29,3,2,3,5
49192,2016-08-29,4,1,12,13
49193,2016-08-29,5,4,88,92
49194,2016-08-29,6,13,336,349
49195,2016-08-29,7,40,896,936
49196,2016-08-29,8,70,1069,1139
49197,2016-08-29,9,107,411,518
49198,2016-08-29,10,114,213,327
49199,2016-08-29,11,128,242,370
49200,2016-08-29,12,181,305,486
49201,2016-08-29,13,140,304,444
49202,2016-08-29,14,158,247,405
49203,2016-08-29,15,143,292,435
49204,2016-08-29,16,158,637,795
49205,2016-08-29,17,171,1385,1556
49206,2016-08-29,18,153,1085,1238
49207,2016-08-29,19,163,742,905
49208,2016-08-29,20,98,471,569
49209,2016-08-29,21,77,311,388
49210,2016-08-29,22,63,178,241
49211,2016-08-29,23,30,83,113
49212,2016-08-30,0,13,37,50
49213,2016-08-30,1,7,15,22
49214,2016-08-30,2,4,1,5
49215,2016-08-30,3,0,6,6
49216,2016-08-30,4,0,20,20
49217,2016-08-30,5,3,104,107
49218,2016-08-30,6,17,376,393
49219,2016-08-30,7,57,972,1029
49220,2016-08-30,8,62,1240,1302
49221,2016-08-30,9,74,510,584
49222,2016-08-30,10,107,251,358
49223,2016-08-30,11,136,273,409
49224,2016-08-30,12,129,324,453
49225,2016-08-30,13,134,311,445
49226,2016-08-30,14,151,269,420
49227,2016-08-30,15,112,355,467
49228,2016-08-30,16,147,683,830
49229,2016-08-30,17,190,1402,1592
49230,2016-08-30,18,177,1203,1380
49231,2016-08-30,19,156,813,969
49232,2016-08-30,20,101,512,613
49233,2016-08-30,21,77,348,425
49234,2016-08-30,22,40,190,230
49235,2016-08-30,23,20,87,107
49236,2016-08-31,0,8,39,47
49237,2016-08-31,1,4,16,20
49238,2016-08-31,2,3,6,9
49239,2016-08-31,3,1,5,6
49240,2016-08-31,4,3,19,22
49241,2016-08-31,5,9,112,121
49242,2016-08-31,6,19,391,410
49243,2016-08-31,7,53,985,1038
49244,2016-08-31,8,54,1196,1250
49245,2016-08-31,9,73,449,522
49246,2016-08-31,10,85,237,322
49247,2016-08-31,11,94,258,352
49248,2016-08-31,12,110,348,458
49249,2016-08-31,13,99,341,440
49250,2016-08-31,14,93,273,366
49251,2016-08-31,15,103,350,453
49252,2016-08-31,16,128,621,749
49253,2016-08-31,17,160,1402,1562
49254,2016-08-31,18,133,1153,1286
49255,2016-08-31,19,105,725,830
49256,2016-08-31,20,80,527,607
49257,2016-08-31,21,63,319,382
49258,2016-08-31,22,54,188,242
49259,2016-08-31,23,19,99,118
49260,2016-09-01,0,13,38,51
49261,2016-09-01,1,4,5,9
49262,2016-09-01,2,1,5,6
49263,2016-09-01,3,1,6,7
49264,2016-09-01,4,2,10,12
49265,2016-09-01,5,2,95,97
49266,2016-09-01,6,24,371,395
49267,2016-09-01,7,25,505,530
49268,2016-09-01,8,40,962,1002
49269,2016-09-01,9,55,313,368
49270,2016-09-01,10,46,223,269
49271,2016-09-01,11,90,242,332
49272,2016-09-01,12,65,316,381
49273,2016-09-01,13,117,309,426
49274,2016-09-01,14,127,331,458
49275,2016-09-01,15,190,405,595
49276,2016-09-01,16,170,697,867
49277,2016-09-01,17,194,1326,1520
49278,2016-09-01,18,154,996,1150
49279,2016-09-01,19,87,405,492
49280,2016-09-01,20,39,378,417
49281,2016-09-01,21,46,247,293
49282,2016-09-01,22,32,166,198
49283,2016-09-01,23,21,102,123
49284,2016-09-02,0,38,149,187
49285,2016-09-02,1,15,40,55
49286,2016-09-02,2,3,26,29
49287,2016-09-02,3,2,7,9
49288,2016-09-02,4,2,13,15
49289,2016-09-02,5,7,80,87
49290,2016-09-02,6,16,218,234
49291,2016-09-02,7,43,705,748
49292,2016-09-02,8,77,1062,1139
49293,2016-09-02,9,104,524,628
49294,2016-09-02,10,165,242,407
49295,2016-09-02,11,220,342,562
49296,2016-09-02,12,199,475,674
49297,2016-09-02,13,267,501,768
49298,2016-09-02,14,245,571,816
49299,2016-09-02,15,270,724,994
49300,2016-09-02,16,276,758,1034
49301,2016-09-02,17,326,929,1255
49302,2016-09-02,18,243,728,971
49303,2016-09-02,19,192,492,684
49304,2016-09-02,20,166,375,541
49305,2016-09-02,21,138,251,389
49306,2016-09-02,22,92,187,279
49307,2016-09-02,23,67,142,209
49308,2016-09-03,0,34,88,122
49309,2016-09-03,1,22,56,78
49310,2016-09-03,2,29,45,74
49311,2016-09-03,3,11,25,36
49312,2016-09-03,4,3,15,18
49313,2016-09-03,5,5,17,22
49314,2016-09-03,6,14,39,53
49315,2016-09-03,7,27,97,124
49316,2016-09-03,8,37,206,243
49317,2016-09-03,9,141,311,452
49318,2016-09-03,10,219,367,586
49319,2016-09-03,11,315,444,759
49320,2016-09-03,12,450,462,912
49321,2016-09-03,13,480,459,939
49322,2016-09-03,14,576,386,962
49323,2016-09-03,15,570,364,934
49324,2016-09-03,16,544,396,940
49325,2016-09-03,17,540,404,944
49326,2016-09-03,18,425,369,794
49327,2016-09-03,19,339,375,714
49328,2016-09-03,20,265,269,534
49329,2016-09-03,21,163,176,339
49330,2016-09-03,22,128,141,269
49331,2016-09-03,23,67,111,178
49332,2016-09-04,0,67,64,131
49333,2016-09-04,1,43,66,109
49334,2016-09-04,2,31,32,63
49335,2016-09-04,3,23,16,39
49336,2016-09-04,4,6,13,19
49337,2016-09-04,5,5,13,18
49338,2016-09-04,6,10,28,38
49339,2016-09-04,7,25,72,97
49340,2016-09-04,8,73,139,212
49341,2016-09-04,9,200,252,452
49342,2016-09-04,10,373,332,705
49343,2016-09-04,11,541,400,941
49344,2016-09-04,12,641,455,1096
49345,2016-09-04,13,686,435,1121
49346,2016-09-04,14,762,420,1182
49347,2016-09-04,15,678,416,1094
49348,2016-09-04,16,710,419,1129
49349,2016-09-04,17,688,406,1094
49350,2016-09-04,18,575,369,944
49351,2016-09-04,19,401,430,831
49352,2016-09-04,20,259,244,503
49353,2016-09-04,21,225,218,443
49354,2016-09-04,22,164,132,296
49355,2016-09-04,23,107,123,230
49356,2016-09-05,0,99,70,169
49357,2016-09-05,1,27,49,76
49358,2016-09-05,2,25,32,57
49359,2016-09-05,3,9,7,16
49360,2016-09-05,4,0,6,6
49361,2016-09-05,5,9,23,32
49362,2016-09-05,6,15,28,43
49363,2016-09-05,7,26,93,119
49364,2016-09-05,8,104,166,270
49365,2016-09-05,9,216,273,489
49366,2016-09-05,10,355,375,730
49367,2016-09-05,11,468,497,965
49368,2016-09-05,12,472,551,1023
49369,2016-09-05,13,501,550,1051
49370,2016-09-05,14,490,578,1068
49371,2016-09-05,15,390,518,908
49372,2016-09-05,16,377,493,870
49373,2016-09-05,17,381,473,854
49374,2016-09-05,18,342,487,829
49375,2016-09-05,19,262,405,667
49376,2016-09-05,20,164,261,425
49377,2016-09-05,21,102,172,274
49378,2016-09-05,22,71,108,179
49379,2016-09-05,23,39,59,98
49380,2016-09-06,0,13,30,43
49381,2016-09-06,1,9,11,20
49382,2016-09-06,2,0,7,7
49383,2016-09-06,3,2,3,5
49384,2016-09-06,4,8,18,26
49385,2016-09-06,5,9,110,119
49386,2016-09-06,6,11,349,360
49387,2016-09-06,7,46,886,932
49388,2016-09-06,8,48,1022,1070
49389,2016-09-06,9,62,413,475
49390,2016-09-06,10,135,202,337
49391,2016-09-06,11,136,218,354
49392,2016-09-06,12,154,299,453
49393,2016-09-06,13,187,327,514
49394,2016-09-06,14,152,263,415
49395,2016-09-06,15,151,358,509
49396,2016-09-06,16,169,659,828
49397,2016-09-06,17,207,1433,1640
49398,2016-09-06,18,201,1216,1417
49399,2016-09-06,19,164,770,934
49400,2016-09-06,20,95,459,554
49401,2016-09-06,21,67,316,383
49402,2016-09-06,22,38,201,239
49403,2016-09-06,23,20,96,116
49404,2016-09-07,0,16,31,47
49405,2016-09-07,1,6,18,24
49406,2016-09-07,2,2,12,14
49407,2016-09-07,3,1,7,8
49408,2016-09-07,4,0,16,16
49409,2016-09-07,5,8,132,140
49410,2016-09-07,6,16,403,419
49411,2016-09-07,7,47,1029,1076
49412,2016-09-07,8,59,1200,1259
49413,2016-09-07,9,89,478,567
49414,2016-09-07,10,98,219,317
49415,2016-09-07,11,136,266,402
49416,2016-09-07,12,135,355,490
49417,2016-09-07,13,115,325,440
49418,2016-09-07,14,120,282,402
49419,2016-09-07,15,113,358,471
49420,2016-09-07,16,135,665,800
49421,2016-09-07,17,130,939,1069
49422,2016-09-07,18,140,1004,1144
49423,2016-09-07,19,90,750,840
49424,2016-09-07,20,54,346,400
49425,2016-09-07,21,40,278,318
49426,2016-09-07,22,27,218,245
49427,2016-09-07,23,24,94,118
49428,2016-09-08,0,10,56,66
49429,2016-09-08,1,12,16,28
49430,2016-09-08,2,3,9,12
49431,2016-09-08,3,0,10,10
49432,2016-09-08,4,1,9,10
49433,2016-09-08,5,7,108,115
49434,2016-09-08,6,18,382,400
49435,2016-09-08,7,46,1013,1059
49436,2016-09-08,8,59,1040,1099
49437,2016-09-08,9,70,450,520
49438,2016-09-08,10,107,220,327
49439,2016-09-08,11,121,256,377
49440,2016-09-08,12,110,338,448
49441,2016-09-08,13,118,280,398
49442,2016-09-08,14,101,223,324
49443,2016-09-08,15,103,365,468
49444,2016-09-08,16,116,634,750
49445,2016-09-08,17,151,1253,1404
49446,2016-09-08,18,147,1120,1267
49447,2016-09-08,19,125,793,918
49448,2016-09-08,20,94,476,570
49449,2016-09-08,21,57,326,383
49450,2016-09-08,22,57,250,307
49451,2016-09-08,23,46,164,210
49452,2016-09-09,0,17,92,109
49453,2016-09-09,1,16,28,44
49454,2016-09-09,2,8,12,20
49455,2016-09-09,3,2,12,14
49456,2016-09-09,4,0,13,13
49457,2016-09-09,5,7,96,103
49458,2016-09-09,6,16,300,316
49459,2016-09-09,7,49,905,954
49460,2016-09-09,8,94,1092,1186
49461,2016-09-09,9,67,420,487
49462,2016-09-09,10,111,236,347
49463,2016-09-09,11,140,281,421
49464,2016-09-09,12,114,334,448
49465,2016-09-09,13,147,353,500
49466,2016-09-09,14,150,299,449
49467,2016-09-09,15,137,420,557
49468,2016-09-09,16,151,693,844
49469,2016-09-09,17,209,1180,1389
49470,2016-09-09,18,156,937,1093
49471,2016-09-09,19,120,586,706
49472,2016-09-09,20,111,374,485
49473,2016-09-09,21,85,296,381
49474,2016-09-09,22,71,244,315
49475,2016-09-09,23,48,185,233
49476,2016-09-10,0,25,126,151
49477,2016-09-10,1,20,97,117
49478,2016-09-10,2,11,59,70
49479,2016-09-10,3,5,20,25
49480,2016-09-10,4,3,19,22
49481,2016-09-10,5,2,18,20
49482,2016-09-10,6,7,52,59
49483,2016-09-10,7,24,141,165
49484,2016-09-10,8,73,286,359
49485,2016-09-10,9,155,433,588
49486,2016-09-10,10,182,508,690
49487,2016-09-10,11,257,569,826
49488,2016-09-10,12,317,530,847
49489,2016-09-10,13,321,500,821
49490,2016-09-10,14,306,455,761
49491,2016-09-10,15,297,457,754
49492,2016-09-10,16,317,435,752
49493,2016-09-10,17,298,446,744
49494,2016-09-10,18,285,425,710
49495,2016-09-10,19,190,377,567
49496,2016-09-10,20,146,281,427
49497,2016-09-10,21,109,249,358
49498,2016-09-10,22,110,202,312
49499,2016-09-10,23,68,161,229
49500,2016-09-11,0,46,121,167
49501,2016-09-11,1,41,64,105
49502,2016-09-11,2,23,63,86
49503,2016-09-11,3,22,31,53
49504,2016-09-11,4,4,18,22
49505,2016-09-11,5,13,32,45
49506,2016-09-11,6,24,65,89
49507,2016-09-11,7,42,94,136
49508,2016-09-11,8,107,237,344
49509,2016-09-11,9,152,373,525
49510,2016-09-11,10,229,528,757
49511,2016-09-11,11,330,529,859
49512,2016-09-11,12,334,632,966
49513,2016-09-11,13,345,565,910
49514,2016-09-11,14,368,571,939
49515,2016-09-11,15,352,586,938
49516,2016-09-11,16,368,584,952
49517,2016-09-11,17,411,566,977
49518,2016-09-11,18,317,532,849
49519,2016-09-11,19,261,495,756
49520,2016-09-11,20,151,280,431
49521,2016-09-11,21,147,193,340
49522,2016-09-11,22,85,135,220
49523,2016-09-11,23,44,72,116
49524,2016-09-12,0,21,29,50
49525,2016-09-12,1,6,20,26
49526,2016-09-12,2,6,9,15
49527,2016-09-12,3,1,7,8
49528,2016-09-12,4,1,11,12
49529,2016-09-12,5,5,104,109
49530,2016-09-12,6,20,362,382
49531,2016-09-12,7,63,949,1012
49532,2016-09-12,8,87,998,1085
49533,2016-09-12,9,91,461,552
49534,2016-09-12,10,156,226,382
49535,2016-09-12,11,128,254,382
49536,2016-09-12,12,178,318,496
49537,2016-09-12,13,155,320,475
49538,2016-09-12,14,189,300,489
49539,2016-09-12,15,154,407,561
49540,2016-09-12,16,169,698,867
49541,2016-09-12,17,214,1424,1638
49542,2016-09-12,18,239,1265,1504
49543,2016-09-12,19,125,763,888
49544,2016-09-12,20,116,431,547
49545,2016-09-12,21,76,323,399
49546,2016-09-12,22,55,239,294
49547,2016-09-12,23,29,109,138
49548,2016-09-13,0,11,31,42
49549,2016-09-13,1,5,10,15
49550,2016-09-13,2,0,6,6
49551,2016-09-13,3,0,3,3
49552,2016-09-13,4,0,12,12
49553,2016-09-13,5,3,124,127
49554,2016-09-13,6,22,383,405
49555,2016-09-13,7,62,1074,1136
49556,2016-09-13,8,79,1171,1250
49557,2016-09-13,9,84,454,538
49558,2016-09-13,10,113,243,356
49559,2016-09-13,11,120,244,364
49560,2016-09-13,12,138,353,491
49561,2016-09-13,13,141,344,485
49562,2016-09-13,14,165,287,452
49563,2016-09-13,15,131,418,549
49564,2016-09-13,16,199,710,909
49565,2016-09-13,17,261,1416,1677
49566,2016-09-13,18,206,1285,1491
49567,2016-09-13,19,123,790,913
49568,2016-09-13,20,88,494,582
49569,2016-09-13,21,81,416,497
49570,2016-09-13,22,58,306,364
49571,2016-09-13,23,19,119,138
49572,2016-09-14,0,21,46,67
49573,2016-09-14,1,5,18,23
49574,2016-09-14,2,4,6,10
49575,2016-09-14,3,4,5,9
49576,2016-09-14,4,3,17,20
49577,2016-09-14,5,8,105,113
49578,2016-09-14,6,35,399,434
49579,2016-09-14,7,69,1079,1148
49580,2016-09-14,8,64,1184,1248
49581,2016-09-14,9,80,427,507
49582,2016-09-14,10,116,190,306
49583,2016-09-14,11,99,267,366
49584,2016-09-14,12,146,373,519
49585,2016-09-14,13,96,336,432
49586,2016-09-14,14,115,314,429
49587,2016-09-14,15,124,418,542
49588,2016-09-14,16,167,678,845
49589,2016-09-14,17,177,1388,1565
49590,2016-09-14,18,178,1226,1404
49591,2016-09-14,19,159,857,1016
49592,2016-09-14,20,92,541,633
49593,2016-09-14,21,82,364,446
49594,2016-09-14,22,46,251,297
49595,2016-09-14,23,21,125,146
49596,2016-09-15,0,12,45,57
49597,2016-09-15,1,12,22,34
49598,2016-09-15,2,9,5,14
49599,2016-09-15,3,2,5,7
49600,2016-09-15,4,1,15,16
49601,2016-09-15,5,6,115,121
49602,2016-09-15,6,26,358,384
49603,2016-09-15,7,56,1018,1074
49604,2016-09-15,8,75,1328,1403
49605,2016-09-15,9,92,514,606
49606,2016-09-15,10,96,272,368
49607,2016-09-15,11,133,292,425
49608,2016-09-15,12,121,412,533
49609,2016-09-15,13,132,343,475
49610,2016-09-15,14,162,344,506
49611,2016-09-15,15,182,457,639
49612,2016-09-15,16,248,791,1039
49613,2016-09-15,17,237,1405,1642
49614,2016-09-15,18,237,1239,1476
49615,2016-09-15,19,135,781,916
49616,2016-09-15,20,99,537,636
49617,2016-09-15,21,77,379,456
49618,2016-09-15,22,53,218,271
49619,2016-09-15,23,29,146,175
49620,2016-09-16,0,24,58,82
49621,2016-09-16,1,10,28,38
49622,2016-09-16,2,18,20,38
49623,2016-09-16,3,10,7,17
49624,2016-09-16,4,3,13,16
49625,2016-09-16,5,6,100,106
49626,2016-09-16,6,16,302,318
49627,2016-09-16,7,47,917,964
49628,2016-09-16,8,80,1178,1258
49629,2016-09-16,9,68,491,559
49630,2016-09-16,10,108,314,422
49631,2016-09-16,11,201,345,546
49632,2016-09-16,12,208,420,628
49633,2016-09-16,13,227,409,636
49634,2016-09-16,14,234,405,639
49635,2016-09-16,15,268,493,761
49636,2016-09-16,16,256,818,1074
49637,2016-09-16,17,308,1366,1674
49638,2016-09-16,18,241,981,1222
49639,2016-09-16,19,165,622,787
49640,2016-09-16,20,97,409,506
49641,2016-09-16,21,84,290,374
49642,2016-09-16,22,101,199,300
49643,2016-09-16,23,61,184,245
49644,2016-09-17,0,56,131,187
49645,2016-09-17,1,47,77,124
49646,2016-09-17,2,29,66,95
49647,2016-09-17,3,26,28,54
49648,2016-09-17,4,2,18,20
49649,2016-09-17,5,4,21,25
49650,2016-09-17,6,8,40,48
49651,2016-09-17,7,46,144,190
49652,2016-09-17,8,71,281,352
49653,2016-09-17,9,184,455,639
49654,2016-09-17,10,277,591,868
49655,2016-09-17,11,385,656,1041
49656,2016-09-17,12,452,653,1105
49657,2016-09-17,13,461,640,1101
49658,2016-09-17,14,438,569,1007
49659,2016-09-17,15,473,570,1043
49660,2016-09-17,16,500,504,1004
49661,2016-09-17,17,463,526,989
49662,2016-09-17,18,348,530,878
49663,2016-09-17,19,235,497,732
49664,2016-09-17,20,202,299,501
49665,2016-09-17,21,151,244,395
49666,2016-09-17,22,93,164,257
49667,2016-09-17,23,89,156,245
49668,2016-09-18,0,58,148,206
49669,2016-09-18,1,59,94,153
49670,2016-09-18,2,44,61,105
49671,2016-09-18,3,10,43,53
49672,2016-09-18,4,5,12,17
49673,2016-09-18,5,13,28,41
49674,2016-09-18,6,41,80,121
49675,2016-09-18,7,32,103,135
49676,2016-09-18,8,105,217,322
49677,2016-09-18,9,160,362,522
49678,2016-09-18,10,324,521,845
49679,2016-09-18,11,380,561,941
49680,2016-09-18,12,375,611,986
49681,2016-09-18,13,415,590,1005
49682,2016-09-18,14,411,556,967
49683,2016-09-18,15,395,527,922
49684,2016-09-18,16,317,499,816
49685,2016-09-18,17,312,492,804
49686,2016-09-18,18,316,531,847
49687,2016-09-18,19,180,418,598
49688,2016-09-18,20,113,267,380
49689,2016-09-18,21,85,163,248
49690,2016-09-18,22,72,125,197
49691,2016-09-18,23,30,82,112
49692,2016-09-19,0,14,34,48
49693,2016-09-19,1,7,18,25
49694,2016-09-19,2,7,1,8
49695,2016-09-19,3,1,7,8
49696,2016-09-19,4,1,13,14
49697,2016-09-19,5,1,88,89
49698,2016-09-19,6,8,256,264
49699,2016-09-19,7,27,813,840
49700,2016-09-19,8,64,1112,1176
49701,2016-09-19,9,54,290,344
49702,2016-09-19,10,24,58,82
49703,2016-09-19,11,22,44,66
49704,2016-09-19,12,13,51,64
49705,2016-09-19,13,20,93,113
49706,2016-09-19,14,18,75,93
49707,2016-09-19,15,50,196,246
49708,2016-09-19,16,99,528,627
49709,2016-09-19,17,117,1191,1308
49710,2016-09-19,18,118,1121,1239
49711,2016-09-19,19,86,647,733
49712,2016-09-19,20,78,388,466
49713,2016-09-19,21,51,262,313
49714,2016-09-19,22,51,150,201
49715,2016-09-19,23,22,75,97
49716,2016-09-20,0,6,44,50
49717,2016-09-20,1,7,14,21
49718,2016-09-20,2,2,6,8
49719,2016-09-20,3,0,5,5
49720,2016-09-20,4,0,12,12
49721,2016-09-20,5,4,100,104
49722,2016-09-20,6,15,376,391
49723,2016-09-20,7,29,1014,1043
49724,2016-09-20,8,70,1297,1367
49725,2016-09-20,9,101,491,592
49726,2016-09-20,10,124,247,371
49727,2016-09-20,11,108,274,382
49728,2016-09-20,12,165,375,540
49729,2016-09-20,13,162,375,537
49730,2016-09-20,14,152,300,452
49731,2016-09-20,15,162,398,560
49732,2016-09-20,16,140,735,875
49733,2016-09-20,17,202,1446,1648
49734,2016-09-20,18,182,1258,1440
49735,2016-09-20,19,111,771,882
49736,2016-09-20,20,72,508,580
49737,2016-09-20,21,56,366,422
49738,2016-09-20,22,41,214,255
49739,2016-09-20,23,15,78,93
49740,2016-09-21,0,8,34,42
49741,2016-09-21,1,6,12,18
49742,2016-09-21,2,3,5,8
49743,2016-09-21,3,0,4,4
49744,2016-09-21,4,2,13,15
49745,2016-09-21,5,13,139,152
49746,2016-09-21,6,27,377,404
49747,2016-09-21,7,49,1011,1060
49748,2016-09-21,8,56,1282,1338
49749,2016-09-21,9,85,484,569
49750,2016-09-21,10,80,262,342
49751,2016-09-21,11,115,289,404
49752,2016-09-21,12,132,384,516
49753,2016-09-21,13,116,285,401
49754,2016-09-21,14,137,339,476
49755,2016-09-21,15,145,391,536
49756,2016-09-21,16,142,732,874
49757,2016-09-21,17,193,1406,1599
49758,2016-09-21,18,189,1168,1357
49759,2016-09-21,19,138,739,877
49760,2016-09-21,20,106,536,642
49761,2016-09-21,21,66,393,459
49762,2016-09-21,22,37,215,252
49763,2016-09-21,23,14,130,144
49764,2016-09-22,0,7,36,43
49765,2016-09-22,1,8,13,21
49766,2016-09-22,2,2,14,16
49767,2016-09-22,3,1,7,8
49768,2016-09-22,4,0,13,13
49769,2016-09-22,5,6,95,101
49770,2016-09-22,6,9,367,376
49771,2016-09-22,7,39,951,990
49772,2016-09-22,8,79,1261,1340
49773,2016-09-22,9,83,521,604
49774,2016-09-22,10,101,274,375
49775,2016-09-22,11,113,313,426
49776,2016-09-22,12,145,379,524
49777,2016-09-22,13,131,352,483
49778,2016-09-22,14,154,318,472
49779,2016-09-22,15,146,408,554
49780,2016-09-22,16,174,741,915
49781,2016-09-22,17,240,1412,1652
49782,2016-09-22,18,244,1211,1455
49783,2016-09-22,19,145,774,919
49784,2016-09-22,20,96,473,569
49785,2016-09-22,21,57,352,409
49786,2016-09-22,22,35,245,280
49787,2016-09-22,23,31,154,185
49788,2016-09-23,0,21,59,80
49789,2016-09-23,1,8,37,45
49790,2016-09-23,2,6,17,23
49791,2016-09-23,3,2,7,9
49792,2016-09-23,4,2,18,20
49793,2016-09-23,5,7,101,108
49794,2016-09-23,6,20,323,343
49795,2016-09-23,7,63,835,898
49796,2016-09-23,8,87,1124,1211
49797,2016-09-23,9,105,496,601
49798,2016-09-23,10,128,272,400
49799,2016-09-23,11,196,326,522
49800,2016-09-23,12,170,414,584
49801,2016-09-23,13,206,390,596
49802,2016-09-23,14,214,373,587
49803,2016-09-23,15,224,460,684
49804,2016-09-23,16,249,804,1053
49805,2016-09-23,17,357,1469,1826
49806,2016-09-23,18,259,1086,1345
49807,2016-09-23,19,159,651,810
49808,2016-09-23,20,147,401,548
49809,2016-09-23,21,140,283,423
49810,2016-09-23,22,116,218,334
49811,2016-09-23,23,101,190,291
49812,2016-09-24,0,96,98,194
49813,2016-09-24,1,24,79,103
49814,2016-09-24,2,13,48,61
49815,2016-09-24,3,6,31,37
49816,2016-09-24,4,1,11,12
49817,2016-09-24,5,5,17,22
49818,2016-09-24,6,9,46,55
49819,2016-09-24,7,37,155,192
49820,2016-09-24,8,101,305,406
49821,2016-09-24,9,216,484,700
49822,2016-09-24,10,322,544,866
49823,2016-09-24,11,344,609,953
49824,2016-09-24,12,430,630,1060
49825,2016-09-24,13,475,618,1093
49826,2016-09-24,14,454,562,1016
49827,2016-09-24,15,499,565,1064
49828,2016-09-24,16,457,539,996
49829,2016-09-24,17,446,565,1011
49830,2016-09-24,18,411,551,962
49831,2016-09-24,19,233,413,646
49832,2016-09-24,20,211,314,525
49833,2016-09-24,21,164,279,443
49834,2016-09-24,22,139,259,398
49835,2016-09-24,23,94,189,283
49836,2016-09-25,0,60,145,205
49837,2016-09-25,1,55,129,184
49838,2016-09-25,2,33,67,100
49839,2016-09-25,3,7,28,35
49840,2016-09-25,4,13,9,22
49841,2016-09-25,5,6,18,24
49842,2016-09-25,6,13,20,33
49843,2016-09-25,7,31,71,102
49844,2016-09-25,8,95,179,274
49845,2016-09-25,9,169,325,494
49846,2016-09-25,10,289,475,764
49847,2016-09-25,11,429,612,1041
49848,2016-09-25,12,408,661,1069
49849,2016-09-25,13,476,568,1044
49850,2016-09-25,14,479,617,1096
49851,2016-09-25,15,433,578,1011
49852,2016-09-25,16,418,649,1067
49853,2016-09-25,17,365,550,915
49854,2016-09-25,18,346,513,859
49855,2016-09-25,19,204,439,643
49856,2016-09-25,20,136,243,379
49857,2016-09-25,21,104,201,305
49858,2016-09-25,22,70,112,182
49859,2016-09-25,23,33,65,98
49860,2016-09-26,0,20,24,44
49861,2016-09-26,1,7,13,20
49862,2016-09-26,2,2,11,13
49863,2016-09-26,3,2,3,5
49864,2016-09-26,4,5,15,20
49865,2016-09-26,5,5,97,102
49866,2016-09-26,6,16,357,373
49867,2016-09-26,7,40,904,944
49868,2016-09-26,8,68,999,1067
49869,2016-09-26,9,94,450,544
49870,2016-09-26,10,100,222,322
49871,2016-09-26,11,126,256,382
49872,2016-09-26,12,151,317,468
49873,2016-09-26,13,152,308,460
49874,2016-09-26,14,140,274,414
49875,2016-09-26,15,169,373,542
49876,2016-09-26,16,152,717,869
49877,2016-09-26,17,218,1469,1687
49878,2016-09-26,18,131,1087,1218
49879,2016-09-26,19,105,660,765
49880,2016-09-26,20,73,537,610
49881,2016-09-26,21,24,114,138
49882,2016-09-26,22,25,169,194
49883,2016-09-26,23,18,232,250
49884,2016-09-27,0,11,45,56
49885,2016-09-27,1,5,16,21
49886,2016-09-27,2,2,4,6
49887,2016-09-27,3,0,1,1
49888,2016-09-27,4,1,13,14
49889,2016-09-27,5,1,54,55
49890,2016-09-27,6,10,275,285
49891,2016-09-27,7,34,800,834
49892,2016-09-27,8,67,1243,1310
49893,2016-09-27,9,51,513,564
49894,2016-09-27,10,74,245,319
49895,2016-09-27,11,87,284,371
49896,2016-09-27,12,110,368,478
49897,2016-09-27,13,123,351,474
49898,2016-09-27,14,125,316,441
49899,2016-09-27,15,162,422,584
49900,2016-09-27,16,167,749,916
49901,2016-09-27,17,227,1480,1707
49902,2016-09-27,18,215,1266,1481
49903,2016-09-27,19,127,808,935
49904,2016-09-27,20,101,517,618
49905,2016-09-27,21,82,370,452
49906,2016-09-27,22,80,242,322
49907,2016-09-27,23,20,92,112
49908,2016-09-28,0,15,28,43
49909,2016-09-28,1,6,13,19
49910,2016-09-28,2,1,4,5
49911,2016-09-28,3,1,4,5
49912,2016-09-28,4,1,13,14
49913,2016-09-28,5,5,107,112
49914,2016-09-28,6,18,318,336
49915,2016-09-28,7,26,679,705
49916,2016-09-28,8,22,634,656
49917,2016-09-28,9,45,464,509
49918,2016-09-28,10,53,200,253
49919,2016-09-28,11,78,180,258
49920,2016-09-28,12,69,231,300
49921,2016-09-28,13,59,199,258
49922,2016-09-28,14,72,244,316
49923,2016-09-28,15,74,285,359
49924,2016-09-28,16,98,538,636
49925,2016-09-28,17,90,795,885
49926,2016-09-28,18,74,700,774
49927,2016-09-28,19,60,494,554
49928,2016-09-28,20,39,368,407
49929,2016-09-28,21,24,140,164
49930,2016-09-28,22,14,95,109
49931,2016-09-28,23,2,48,50
49932,2016-09-29,0,7,26,33
49933,2016-09-29,1,8,7,15
49934,2016-09-29,2,0,6,6
49935,2016-09-29,3,0,1,1
49936,2016-09-29,4,0,2,2
49937,2016-09-29,5,0,27,27
49938,2016-09-29,6,4,150,154
49939,2016-09-29,7,7,214,221
49940,2016-09-29,8,25,687,712
49941,2016-09-29,9,32,434,466
49942,2016-09-29,10,33,132,165
49943,2016-09-29,11,28,157,185
49944,2016-09-29,12,37,196,233
49945,2016-09-29,13,38,147,185
49946,2016-09-29,14,29,159,188
49947,2016-09-29,15,36,199,235
49948,2016-09-29,16,43,413,456
49949,2016-09-29,17,58,904,962
49950,2016-09-29,18,61,782,843
49951,2016-09-29,19,28,310,338
49952,2016-09-29,20,6,179,185
49953,2016-09-29,21,6,112,118
49954,2016-09-29,22,7,89,96
49955,2016-09-29,23,2,58,60
49956,2016-09-30,0,9,25,34
49957,2016-09-30,1,0,10,10
49958,2016-09-30,2,1,5,6
49959,2016-09-30,3,0,6,6
49960,2016-09-30,4,0,10,10
49961,2016-09-30,5,8,81,89
49962,2016-09-30,6,10,208,218
49963,2016-09-30,7,24,617,641
49964,2016-09-30,8,40,1006,1046
49965,2016-09-30,9,49,482,531
49966,2016-09-30,10,83,258,341
49967,2016-09-30,11,65,304,369
49968,2016-09-30,12,101,376,477
49969,2016-09-30,13,95,372,467
49970,2016-09-30,14,167,349,516
49971,2016-09-30,15,118,418,536
49972,2016-09-30,16,111,561,672
49973,2016-09-30,17,112,802,914
49974,2016-09-30,18,76,599,675
49975,2016-09-30,19,22,223,245
49976,2016-09-30,20,27,181,208
49977,2016-09-30,21,33,155,188
49978,2016-09-30,22,28,146,174
49979,2016-09-30,23,37,115,152
49980,2016-10-01,0,23,80,103
49981,2016-10-01,1,10,53,63
49982,2016-10-01,2,6,27,33
49983,2016-10-01,3,3,20,23
49984,2016-10-01,4,0,11,11
49985,2016-10-01,5,1,14,15
49986,2016-10-01,6,4,38,42
49987,2016-10-01,7,11,104,115
49988,2016-10-01,8,13,133,146
49989,2016-10-01,9,29,145,174
49990,2016-10-01,10,44,228,272
49991,2016-10-01,11,124,353,477
49992,2016-10-01,12,180,382,562
49993,2016-10-01,13,130,286,416
49994,2016-10-01,14,137,326,463
49995,2016-10-01,15,201,424,625
49996,2016-10-01,16,183,368,551
49997,2016-10-01,17,201,431,632
49998,2016-10-01,18,172,364,536
49999,2016-10-01,19,98,351,449
50000,2016-10-01,20,66,238,304
50001,2016-10-01,21,54,194,248
50002,2016-10-01,22,46,162,208
50003,2016-10-01,23,46,115,161
50004,2016-10-02,0,49,142,191
50005,2016-10-02,1,25,77,102
50006,2016-10-02,2,24,47,71
50007,2016-10-02,3,13,23,36
50008,2016-10-02,4,0,9,9
50009,2016-10-02,5,1,4,5
50010,2016-10-02,6,11,34,45
50011,2016-10-02,7,25,68,93
50012,2016-10-02,8,57,152,209
50013,2016-10-02,9,109,297,406
50014,2016-10-02,10,252,418,670
50015,2016-10-02,11,301,490,791
50016,2016-10-02,12,346,580,926
50017,2016-10-02,13,332,560,892
50018,2016-10-02,14,411,511,922
50019,2016-10-02,15,417,530,947
50020,2016-10-02,16,410,561,971
50021,2016-10-02,17,340,557,897
50022,2016-10-02,18,322,531,853
50023,2016-10-02,19,192,396,588
50024,2016-10-02,20,120,228,348
50025,2016-10-02,21,64,145,209
50026,2016-10-02,22,54,121,175
50027,2016-10-02,23,34,50,84
50028,2016-10-03,0,12,31,43
50029,2016-10-03,1,2,14,16
50030,2016-10-03,2,9,10,19
50031,2016-10-03,3,0,7,7
50032,2016-10-03,4,2,14,16
50033,2016-10-03,5,3,89,92
50034,2016-10-03,6,14,295,309
50035,2016-10-03,7,43,812,855
50036,2016-10-03,8,71,1080,1151
50037,2016-10-03,9,94,505,599
50038,2016-10-03,10,110,230,340
50039,2016-10-03,11,173,270,443
50040,2016-10-03,12,234,348,582
50041,2016-10-03,13,206,350,556
50042,2016-10-03,14,221,298,519
50043,2016-10-03,15,202,405,607
50044,2016-10-03,16,197,731,928
50045,2016-10-03,17,261,1444,1705
50046,2016-10-03,18,233,1215,1448
50047,2016-10-03,19,120,749,869
50048,2016-10-03,20,94,403,497
50049,2016-10-03,21,44,305,349
50050,2016-10-03,22,61,163,224
50051,2016-10-03,23,39,88,127
50052,2016-10-04,0,4,34,38
50053,2016-10-04,1,5,12,17
50054,2016-10-04,2,7,4,11
50055,2016-10-04,3,1,5,6
50056,2016-10-04,4,2,16,18
50057,2016-10-04,5,5,95,100
50058,2016-10-04,6,10,342,352
50059,2016-10-04,7,43,975,1018
50060,2016-10-04,8,82,1325,1407
50061,2016-10-04,9,103,577,680
50062,2016-10-04,10,147,235,382
50063,2016-10-04,11,141,276,417
50064,2016-10-04,12,170,389,559
50065,2016-10-04,13,171,346,517
50066,2016-10-04,14,209,320,529
50067,2016-10-04,15,162,438,600
50068,2016-10-04,16,194,748,942
50069,2016-10-04,17,229,1486,1715
50070,2016-10-04,18,202,1197,1399
50071,2016-10-04,19,124,676,800
50072,2016-10-04,20,79,484,563
50073,2016-10-04,21,71,284,355
50074,2016-10-04,22,46,196,242
50075,2016-10-04,23,29,97,126
50076,2016-10-05,0,9,35,44
50077,2016-10-05,1,0,9,9
50078,2016-10-05,2,3,10,13
50079,2016-10-05,3,0,2,2
50080,2016-10-05,4,0,16,16
50081,2016-10-05,5,7,93,100
50082,2016-10-05,6,18,349,367
50083,2016-10-05,7,43,1035,1078
50084,2016-10-05,8,71,1231,1302
50085,2016-10-05,9,66,558,624
50086,2016-10-05,10,106,253,359
50087,2016-10-05,11,131,294,425
50088,2016-10-05,12,109,384,493
50089,2016-10-05,13,127,385,512
50090,2016-10-05,14,136,333,469
50091,2016-10-05,15,160,426,586
50092,2016-10-05,16,170,809,979
50093,2016-10-05,17,230,1450,1680
50094,2016-10-05,18,172,1185,1357
50095,2016-10-05,19,91,754,845
50096,2016-10-05,20,73,477,550
50097,2016-10-05,21,43,350,393
50098,2016-10-05,22,55,180,235
50099,2016-10-05,23,35,117,152
50100,2016-10-06,0,20,29,49
50101,2016-10-06,1,1,18,19
50102,2016-10-06,2,2,6,8
50103,2016-10-06,3,0,2,2
50104,2016-10-06,4,4,10,14
50105,2016-10-06,5,3,87,90
50106,2016-10-06,6,6,303,309
50107,2016-10-06,7,29,907,936
50108,2016-10-06,8,86,1235,1321
50109,2016-10-06,9,45,515,560
50110,2016-10-06,10,104,252,356
50111,2016-10-06,11,139,267,406
50112,2016-10-06,12,149,381,530
50113,2016-10-06,13,156,362,518
50114,2016-10-06,14,158,304,462
50115,2016-10-06,15,207,404,611
50116,2016-10-06,16,212,735,947
50117,2016-10-06,17,225,1346,1571
50118,2016-10-06,18,221,1179,1400
50119,2016-10-06,19,138,707,845
50120,2016-10-06,20,112,457,569
50121,2016-10-06,21,60,330,390
50122,2016-10-06,22,72,227,299
50123,2016-10-06,23,29,121,150
50124,2016-10-07,0,19,64,83
50125,2016-10-07,1,9,26,35
50126,2016-10-07,2,9,8,17
50127,2016-10-07,3,1,8,9
50128,2016-10-07,4,2,18,20
50129,2016-10-07,5,2,73,75
50130,2016-10-07,6,9,255,264
50131,2016-10-07,7,62,789,851
50132,2016-10-07,8,96,1113,1209
50133,2016-10-07,9,121,525,646
50134,2016-10-07,10,131,261,392
50135,2016-10-07,11,202,320,522
50136,2016-10-07,12,225,443,668
50137,2016-10-07,13,276,450,726
50138,2016-10-07,14,296,442,738
50139,2016-10-07,15,338,583,921
50140,2016-10-07,16,330,894,1224
50141,2016-10-07,17,334,1173,1507
50142,2016-10-07,18,270,822,1092
50143,2016-10-07,19,171,511,682
50144,2016-10-07,20,129,338,467
50145,2016-10-07,21,145,354,499
50146,2016-10-07,22,119,229,348
50147,2016-10-07,23,62,138,200
50148,2016-10-08,0,46,125,171
50149,2016-10-08,1,39,75,114
50150,2016-10-08,2,25,51,76
50151,2016-10-08,3,8,19,27
50152,2016-10-08,4,3,14,17
50153,2016-10-08,5,4,17,21
50154,2016-10-08,6,9,40,49
50155,2016-10-08,7,27,109,136
50156,2016-10-08,8,47,230,277
50157,2016-10-08,9,123,367,490
50158,2016-10-08,10,121,342,463
50159,2016-10-08,11,87,236,323
50160,2016-10-08,12,82,152,234
50161,2016-10-08,13,62,125,187
50162,2016-10-08,14,32,99,131
50163,2016-10-08,15,49,122,171
50164,2016-10-08,16,121,191,312
50165,2016-10-08,17,130,214,344
50166,2016-10-08,18,107,262,369
50167,2016-10-08,19,101,197,298
50168,2016-10-08,20,70,186,256
50169,2016-10-08,21,83,169,252
50170,2016-10-08,22,57,149,206
50171,2016-10-08,23,65,135,200
50172,2016-10-09,0,44,85,129
50173,2016-10-09,1,16,65,81
50174,2016-10-09,2,21,58,79
50175,2016-10-09,3,7,17,24
50176,2016-10-09,4,10,5,15
50177,2016-10-09,5,6,5,11
50178,2016-10-09,6,4,26,30
50179,2016-10-09,7,14,84,98
50180,2016-10-09,8,47,152,199
50181,2016-10-09,9,122,270,392
50182,2016-10-09,10,200,379,579
50183,2016-10-09,11,282,448,730
50184,2016-10-09,12,383,607,990
50185,2016-10-09,13,334,411,745
50186,2016-10-09,14,450,425,875
50187,2016-10-09,15,464,462,926
50188,2016-10-09,16,489,521,1010
50189,2016-10-09,17,439,574,1013
50190,2016-10-09,18,289,467,756
50191,2016-10-09,19,143,347,490
50192,2016-10-09,20,113,257,370
50193,2016-10-09,21,30,102,132
50194,2016-10-09,22,52,126,178
50195,2016-10-09,23,44,129,173
50196,2016-10-10,0,14,55,69
50197,2016-10-10,1,13,27,40
50198,2016-10-10,2,5,16,21
50199,2016-10-10,3,1,9,10
50200,2016-10-10,4,1,11,12
50201,2016-10-10,5,4,31,35
50202,2016-10-10,6,6,117,123
50203,2016-10-10,7,16,276,292
50204,2016-10-10,8,46,525,571
50205,2016-10-10,9,87,368,455
50206,2016-10-10,10,173,298,471
50207,2016-10-10,11,220,358,578
50208,2016-10-10,12,310,411,721
50209,2016-10-10,13,318,462,780
50210,2016-10-10,14,389,500,889
50211,2016-10-10,15,352,481,833
50212,2016-10-10,16,349,562,911
50213,2016-10-10,17,312,821,1133
50214,2016-10-10,18,211,683,894
50215,2016-10-10,19,152,513,665
50216,2016-10-10,20,71,300,371
50217,2016-10-10,21,59,208,267
50218,2016-10-10,22,38,163,201
50219,2016-10-10,23,18,52,70
50220,2016-10-11,0,5,22,27
50221,2016-10-11,1,4,11,15
50222,2016-10-11,2,1,5,6
50223,2016-10-11,3,3,5,8
50224,2016-10-11,4,4,12,16
50225,2016-10-11,5,4,78,82
50226,2016-10-11,6,10,265,275
50227,2016-10-11,7,25,812,837
50228,2016-10-11,8,47,1059,1106
50229,2016-10-11,9,62,468,530
50230,2016-10-11,10,106,227,333
50231,2016-10-11,11,118,275,393
50232,2016-10-11,12,149,355,504
50233,2016-10-11,13,117,355,472
50234,2016-10-11,14,170,311,481
50235,2016-10-11,15,167,392,559
50236,2016-10-11,16,202,798,1000
50237,2016-10-11,17,247,1533,1780
50238,2016-10-11,18,177,1145,1322
50239,2016-10-11,19,104,589,693
50240,2016-10-11,20,53,373,426
50241,2016-10-11,21,43,281,324
50242,2016-10-11,22,33,218,251
50243,2016-10-11,23,19,69,88
50244,2016-10-12,0,2,26,28
50245,2016-10-12,1,4,9,13
50246,2016-10-12,2,3,3,6
50247,2016-10-12,3,2,4,6
50248,2016-10-12,4,0,9,9
50249,2016-10-12,5,4,77,81
50250,2016-10-12,6,13,313,326
50251,2016-10-12,7,35,830,865
50252,2016-10-12,8,85,1202,1287
50253,2016-10-12,9,69,478,547
50254,2016-10-12,10,112,233,345
50255,2016-10-12,11,139,267,406
50256,2016-10-12,12,108,340,448
50257,2016-10-12,13,146,365,511
50258,2016-10-12,14,160,304,464
50259,2016-10-12,15,173,392,565
50260,2016-10-12,16,179,726,905
50261,2016-10-12,17,222,1449,1671
50262,2016-10-12,18,180,1183,1363
50263,2016-10-12,19,119,641,760
50264,2016-10-12,20,65,427,492
50265,2016-10-12,21,46,313,359
50266,2016-10-12,22,36,200,236
50267,2016-10-12,23,17,87,104
50268,2016-10-13,0,10,40,50
50269,2016-10-13,1,6,11,17
50270,2016-10-13,2,4,5,9
50271,2016-10-13,3,3,8,11
50272,2016-10-13,4,3,9,12
50273,2016-10-13,5,4,75,79
50274,2016-10-13,6,10,283,293
50275,2016-10-13,7,20,913,933
50276,2016-10-13,8,70,1236,1306
50277,2016-10-13,9,92,488,580
50278,2016-10-13,10,114,230,344
50279,2016-10-13,11,131,273,404
50280,2016-10-13,12,154,405,559
50281,2016-10-13,13,144,333,477
50282,2016-10-13,14,162,315,477
50283,2016-10-13,15,196,389,585
50284,2016-10-13,16,218,742,960
50285,2016-10-13,17,257,1416,1673
50286,2016-10-13,18,215,1244,1459
50287,2016-10-13,19,123,672,795
50288,2016-10-13,20,69,416,485
50289,2016-10-13,21,31,326,357
50290,2016-10-13,22,34,207,241
50291,2016-10-13,23,19,113,132
50292,2016-10-14,0,32,187,219
50293,2016-10-14,1,58,107,165
50294,2016-10-14,2,6,20,26
50295,2016-10-14,3,2,14,16
50296,2016-10-14,4,8,11,19
50297,2016-10-14,5,4,53,57
50298,2016-10-14,6,5,229,234
50299,2016-10-14,7,30,716,746
50300,2016-10-14,8,59,1128,1187
50301,2016-10-14,9,88,586,674
50302,2016-10-14,10,158,273,431
50303,2016-10-14,11,210,331,541
50304,2016-10-14,12,152,392,544
50305,2016-10-14,13,273,389,662
50306,2016-10-14,14,321,360,681
50307,2016-10-14,15,271,472,743
50308,2016-10-14,16,310,806,1116
50309,2016-10-14,17,312,1192,1504
50310,2016-10-14,18,231,908,1139
50311,2016-10-14,19,84,536,620
50312,2016-10-14,20,136,299,435
50313,2016-10-14,21,88,231,319
50314,2016-10-14,22,72,154,226
50315,2016-10-14,23,46,120,166
50316,2016-10-15,0,29,120,149
50317,2016-10-15,1,15,62,77
50318,2016-10-15,2,13,47,60
50319,2016-10-15,3,9,17,26
50320,2016-10-15,4,4,6,10
50321,2016-10-15,5,2,19,21
50322,2016-10-15,6,3,36,39
50323,2016-10-15,7,19,114,133
50324,2016-10-15,8,60,237,297
50325,2016-10-15,9,153,375,528
50326,2016-10-15,10,254,443,697
50327,2016-10-15,11,454,559,1013
50328,2016-10-15,12,502,555,1057
50329,2016-10-15,13,597,592,1189
50330,2016-10-15,14,675,532,1207
50331,2016-10-15,15,685,521,1206
50332,2016-10-15,16,605,509,1114
50333,2016-10-15,17,441,562,1003
50334,2016-10-15,18,352,483,835
50335,2016-10-15,19,169,352,521
50336,2016-10-15,20,132,240,372
50337,2016-10-15,21,97,175,272
50338,2016-10-15,22,102,150,252
50339,2016-10-15,23,69,171,240
50340,2016-10-16,0,48,101,149
50341,2016-10-16,1,44,72,116
50342,2016-10-16,2,18,51,69
50343,2016-10-16,3,7,34,41
50344,2016-10-16,4,2,17,19
50345,2016-10-16,5,3,9,12
50346,2016-10-16,6,9,20,29
50347,2016-10-16,7,28,74,102
50348,2016-10-16,8,55,141,196
50349,2016-10-16,9,172,265,437
50350,2016-10-16,10,326,426,752
50351,2016-10-16,11,422,543,965
50352,2016-10-16,12,438,582,1020
50353,2016-10-16,13,439,600,1039
50354,2016-10-16,14,466,603,1069
50355,2016-10-16,15,424,536,960
50356,2016-10-16,16,471,615,1086
50357,2016-10-16,17,375,578,953
50358,2016-10-16,18,321,509,830
50359,2016-10-16,19,175,354,529
50360,2016-10-16,20,141,220,361
50361,2016-10-16,21,80,182,262
50362,2016-10-16,22,59,116,175
50363,2016-10-16,23,22,58,80
50364,2016-10-17,0,5,25,30
50365,2016-10-17,1,0,16,16
50366,2016-10-17,2,5,5,10
50367,2016-10-17,3,1,4,5
50368,2016-10-17,4,2,15,17
50369,2016-10-17,5,5,82,87
50370,2016-10-17,6,10,292,302
50371,2016-10-17,7,36,754,790
50372,2016-10-17,8,87,1036,1123
50373,2016-10-17,9,115,411,526
50374,2016-10-17,10,161,222,383
50375,2016-10-17,11,189,263,452
50376,2016-10-17,12,198,368,566
50377,2016-10-17,13,211,343,554
50378,2016-10-17,14,215,327,542
50379,2016-10-17,15,180,377,557
50380,2016-10-17,16,229,736,965
50381,2016-10-17,17,231,1412,1643
50382,2016-10-17,18,200,1160,1360
50383,2016-10-17,19,100,623,723
50384,2016-10-17,20,114,424,538
50385,2016-10-17,21,93,280,373
50386,2016-10-17,22,50,167,217
50387,2016-10-17,23,24,101,125
50388,2016-10-18,0,16,33,49
50389,2016-10-18,1,6,15,21
50390,2016-10-18,2,5,7,12
50391,2016-10-18,3,0,6,6
50392,2016-10-18,4,2,8,10
50393,2016-10-18,5,5,102,107
50394,2016-10-18,6,14,354,368
50395,2016-10-18,7,53,990,1043
50396,2016-10-18,8,83,1242,1325
50397,2016-10-18,9,88,531,619
50398,2016-10-18,10,111,260,371
50399,2016-10-18,11,104,313,417
50400,2016-10-18,12,149,401,550
50401,2016-10-18,13,167,382,549
50402,2016-10-18,14,166,327,493
50403,2016-10-18,15,217,434,651
50404,2016-10-18,16,176,715,891
50405,2016-10-18,17,290,1523,1813
50406,2016-10-18,18,214,1289,1503
50407,2016-10-18,19,117,728,845
50408,2016-10-18,20,87,479,566
50409,2016-10-18,21,58,352,410
50410,2016-10-18,22,35,197,232
50411,2016-10-18,23,29,106,135
50412,2016-10-19,0,15,35,50
50413,2016-10-19,1,9,16,25
50414,2016-10-19,2,1,8,9
50415,2016-10-19,3,0,6,6
50416,2016-10-19,4,2,9,11
50417,2016-10-19,5,9,110,119
50418,2016-10-19,6,17,339,356
50419,2016-10-19,7,77,1003,1080
50420,2016-10-19,8,92,1261,1353
50421,2016-10-19,9,99,545,644
50422,2016-10-19,10,101,248,349
50423,2016-10-19,11,147,306,453
50424,2016-10-19,12,116,421,537
50425,2016-10-19,13,160,366,526
50426,2016-10-19,14,152,329,481
50427,2016-10-19,15,165,404,569
50428,2016-10-19,16,183,741,924
50429,2016-10-19,17,247,1457,1704
50430,2016-10-19,18,190,1183,1373
50431,2016-10-19,19,119,708,827
50432,2016-10-19,20,75,566,641
50433,2016-10-19,21,48,250,298
50434,2016-10-19,22,54,248,302
50435,2016-10-19,23,43,241,284
50436,2016-10-20,0,21,50,71
50437,2016-10-20,1,15,15,30
50438,2016-10-20,2,1,11,12
50439,2016-10-20,3,7,7,14
50440,2016-10-20,4,1,10,11
50441,2016-10-20,5,4,86,90
50442,2016-10-20,6,10,289,299
50443,2016-10-20,7,39,939,978
50444,2016-10-20,8,88,1289,1377
50445,2016-10-20,9,74,536,610
50446,2016-10-20,10,113,263,376
50447,2016-10-20,11,158,283,441
50448,2016-10-20,12,203,369,572
50449,2016-10-20,13,178,382,560
50450,2016-10-20,14,190,333,523
50451,2016-10-20,15,203,402,605
50452,2016-10-20,16,188,795,983
50453,2016-10-20,17,299,1433,1732
50454,2016-10-20,18,221,1209,1430
50455,2016-10-20,19,145,682,827
50456,2016-10-20,20,94,495,589
50457,2016-10-20,21,77,331,408
50458,2016-10-20,22,61,246,307
50459,2016-10-20,23,36,139,175
50460,2016-10-21,0,23,77,100
50461,2016-10-21,1,15,27,42
50462,2016-10-21,2,5,16,21
50463,2016-10-21,3,1,8,9
50464,2016-10-21,4,1,15,16
50465,2016-10-21,5,4,83,87
50466,2016-10-21,6,21,273,294
50467,2016-10-21,7,32,787,819
50468,2016-10-21,8,80,1233,1313
50469,2016-10-21,9,81,545,626
50470,2016-10-21,10,155,279,434
50471,2016-10-21,11,204,349,553
50472,2016-10-21,12,220,450,670
50473,2016-10-21,13,256,426,682
50474,2016-10-21,14,48,132,180
50475,2016-10-21,15,107,257,364
50476,2016-10-21,16,125,656,781
50477,2016-10-21,17,192,1133,1325
50478,2016-10-21,18,95,807,902
50479,2016-10-21,19,71,467,538
50480,2016-10-21,20,44,227,271
50481,2016-10-21,21,41,179,220
50482,2016-10-21,22,42,143,185
50483,2016-10-21,23,41,110,151
50484,2016-10-22,0,21,100,121
50485,2016-10-22,1,8,60,68
50486,2016-10-22,2,8,26,34
50487,2016-10-22,3,6,13,19
50488,2016-10-22,4,0,8,8
50489,2016-10-22,5,0,13,13
50490,2016-10-22,6,6,28,34
50491,2016-10-22,7,12,106,118
50492,2016-10-22,8,36,262,298
50493,2016-10-22,9,114,392,506
50494,2016-10-22,10,211,454,665
50495,2016-10-22,11,256,493,749
50496,2016-10-22,12,294,515,809
50497,2016-10-22,13,318,489,807
50498,2016-10-22,14,371,502,873
50499,2016-10-22,15,283,462,745
50500,2016-10-22,16,291,453,744
50501,2016-10-22,17,218,440,658
50502,2016-10-22,18,132,380,512
50503,2016-10-22,19,75,242,317
50504,2016-10-22,20,58,212,270
50505,2016-10-22,21,52,167,219
50506,2016-10-22,22,24,121,145
50507,2016-10-22,23,35,137,172
50508,2016-10-23,0,20,95,115
50509,2016-10-23,1,12,49,61
50510,2016-10-23,2,9,44,53
50511,2016-10-23,3,7,23,30
50512,2016-10-23,4,5,7,12
50513,2016-10-23,5,2,3,5
50514,2016-10-23,6,3,21,24
50515,2016-10-23,7,18,59,77
50516,2016-10-23,8,33,149,182
50517,2016-10-23,9,119,298,417
50518,2016-10-23,10,203,425,628
50519,2016-10-23,11,310,461,771
50520,2016-10-23,12,388,540,928
50521,2016-10-23,13,415,532,947
50522,2016-10-23,14,404,506,910
50523,2016-10-23,15,413,506,919
50524,2016-10-23,16,363,529,892
50525,2016-10-23,17,368,493,861
50526,2016-10-23,18,219,475,694
50527,2016-10-23,19,107,268,375
50528,2016-10-23,20,65,216,281
50529,2016-10-23,21,67,141,208
50530,2016-10-23,22,52,83,135
50531,2016-10-23,23,22,56,78
50532,2016-10-24,0,13,21,34
50533,2016-10-24,1,11,8,19
50534,2016-10-24,2,2,11,13
50535,2016-10-24,3,0,3,3
50536,2016-10-24,4,0,10,10
50537,2016-10-24,5,3,84,87
50538,2016-10-24,6,11,278,289
50539,2016-10-24,7,34,783,817
50540,2016-10-24,8,46,975,1021
50541,2016-10-24,9,61,463,524
50542,2016-10-24,10,103,263,366
50543,2016-10-24,11,139,276,415
50544,2016-10-24,12,130,332,462
50545,2016-10-24,13,170,321,491
50546,2016-10-24,14,149,308,457
50547,2016-10-24,15,186,383,569
50548,2016-10-24,16,165,717,882
50549,2016-10-24,17,195,1399,1594
50550,2016-10-24,18,108,1096,1204
50551,2016-10-24,19,78,592,670
50552,2016-10-24,20,47,349,396
50553,2016-10-24,21,33,208,241
50554,2016-10-24,22,23,133,156
50555,2016-10-24,23,15,63,78
50556,2016-10-25,0,8,18,26
50557,2016-10-25,1,1,1,2
50558,2016-10-25,2,1,7,8
50559,2016-10-25,3,1,4,5
50560,2016-10-25,4,0,11,11
50561,2016-10-25,5,3,93,96
50562,2016-10-25,6,11,316,327
50563,2016-10-25,7,25,867,892
50564,2016-10-25,8,65,1231,1296
50565,2016-10-25,9,47,482,529
50566,2016-10-25,10,100,241,341
50567,2016-10-25,11,127,249,376
50568,2016-10-25,12,126,379,505
50569,2016-10-25,13,115,336,451
50570,2016-10-25,14,133,312,445
50571,2016-10-25,15,144,373,517
50572,2016-10-25,16,115,690,805
50573,2016-10-25,17,173,1392,1565
50574,2016-10-25,18,127,1062,1189
50575,2016-10-25,19,71,630,701
50576,2016-10-25,20,39,396,435
50577,2016-10-25,21,44,314,358
50578,2016-10-25,22,23,172,195
50579,2016-10-25,23,20,86,106
50580,2016-10-26,0,17,47,64
50581,2016-10-26,1,4,12,16
50582,2016-10-26,2,0,5,5
50583,2016-10-26,3,1,4,5
50584,2016-10-26,4,1,11,12
50585,2016-10-26,5,2,89,91
50586,2016-10-26,6,11,280,291
50587,2016-10-26,7,24,801,825
50588,2016-10-26,8,48,1155,1203
50589,2016-10-26,9,47,494,541
50590,2016-10-26,10,79,250,329
50591,2016-10-26,11,83,278,361
50592,2016-10-26,12,99,347,446
50593,2016-10-26,13,119,384,503
50594,2016-10-26,14,107,314,421
50595,2016-10-26,15,108,398,506
50596,2016-10-26,16,126,694,820
50597,2016-10-26,17,169,1318,1487
50598,2016-10-26,18,118,1020,1138
50599,2016-10-26,19,64,618,682
50600,2016-10-26,20,29,356,385
50601,2016-10-26,21,32,242,274
50602,2016-10-26,22,27,163,190
50603,2016-10-26,23,20,82,102
50604,2016-10-27,0,1,28,29
50605,2016-10-27,1,8,15,23
50606,2016-10-27,2,2,6,8
50607,2016-10-27,3,3,7,10
50608,2016-10-27,4,3,12,15
50609,2016-10-27,5,1,82,83
50610,2016-10-27,6,8,274,282
50611,2016-10-27,7,17,796,813
50612,2016-10-27,8,40,1236,1276
50613,2016-10-27,9,58,520,578
50614,2016-10-27,10,82,260,342
50615,2016-10-27,11,85,264,349
50616,2016-10-27,12,29,278,307
50617,2016-10-27,13,48,159,207
50618,2016-10-27,14,26,142,168
50619,2016-10-27,15,47,237,284
50620,2016-10-27,16,65,543,608
50621,2016-10-27,17,102,1100,1202
50622,2016-10-27,18,70,926,996
50623,2016-10-27,19,51,557,608
50624,2016-10-27,20,40,353,393
50625,2016-10-27,21,40,322,362
50626,2016-10-27,22,24,181,205
50627,2016-10-27,23,10,122,132
50628,2016-10-28,0,6,44,50
50629,2016-10-28,1,9,17,26
50630,2016-10-28,2,5,8,13
50631,2016-10-28,3,4,11,15
50632,2016-10-28,4,1,10,11
50633,2016-10-28,5,3,63,66
50634,2016-10-28,6,10,216,226
50635,2016-10-28,7,36,671,707
50636,2016-10-28,8,61,1077,1138
50637,2016-10-28,9,59,500,559
50638,2016-10-28,10,84,279,363
50639,2016-10-28,11,101,337,438
50640,2016-10-28,12,141,399,540
50641,2016-10-28,13,126,425,551
50642,2016-10-28,14,164,384,548
50643,2016-10-28,15,172,482,654
50644,2016-10-28,16,211,809,1020
50645,2016-10-28,17,216,1145,1361
50646,2016-10-28,18,97,810,907
50647,2016-10-28,19,48,473,521
50648,2016-10-28,20,52,294,346
50649,2016-10-28,21,39,189,228
50650,2016-10-28,22,50,154,204
50651,2016-10-28,23,25,110,135
50652,2016-10-29,0,20,82,102
50653,2016-10-29,1,18,67,85
50654,2016-10-29,2,19,47,66
50655,2016-10-29,3,3,26,29
50656,2016-10-29,4,3,9,12
50657,2016-10-29,5,3,18,21
50658,2016-10-29,6,6,29,35
50659,2016-10-29,7,24,84,108
50660,2016-10-29,8,48,197,245
50661,2016-10-29,9,109,332,441
50662,2016-10-29,10,174,463,637
50663,2016-10-29,11,336,538,874
50664,2016-10-29,12,408,652,1060
50665,2016-10-29,13,550,567,1117
50666,2016-10-29,14,563,558,1121
50667,2016-10-29,15,563,634,1197
50668,2016-10-29,16,517,583,1100
50669,2016-10-29,17,437,540,977
50670,2016-10-29,18,262,504,766
50671,2016-10-29,19,173,326,499
50672,2016-10-29,20,129,227,356
50673,2016-10-29,21,115,209,324
50674,2016-10-29,22,87,171,258
50675,2016-10-29,23,56,128,184
50676,2016-10-30,0,36,122,158
50677,2016-10-30,1,41,109,150
50678,2016-10-30,2,32,109,141
50679,2016-10-30,3,19,57,76
50680,2016-10-30,4,6,24,30
50681,2016-10-30,5,13,23,36
50682,2016-10-30,6,27,50,77
50683,2016-10-30,7,61,90,151
50684,2016-10-30,8,153,197,350
50685,2016-10-30,9,305,319,624
50686,2016-10-30,10,358,453,811
50687,2016-10-30,11,443,510,953
50688,2016-10-30,12,323,572,895
50689,2016-10-30,13,439,559,998
50690,2016-10-30,14,505,576,1081
50691,2016-10-30,15,502,546,1048
50692,2016-10-30,16,488,560,1048
50693,2016-10-30,17,447,578,1025
50694,2016-10-30,18,135,332,467
50695,2016-10-30,19,57,174,231
50696,2016-10-30,20,55,130,185
50697,2016-10-30,21,28,115,143
50698,2016-10-30,22,32,94,126
50699,2016-10-30,23,30,66,96
50700,2016-10-31,0,18,34,52
50701,2016-10-31,1,6,11,17
50702,2016-10-31,2,1,3,4
50703,2016-10-31,3,1,5,6
50704,2016-10-31,4,0,16,16
50705,2016-10-31,5,3,78,81
50706,2016-10-31,6,16,261,277
50707,2016-10-31,7,36,781,817
50708,2016-10-31,8,58,945,1003
50709,2016-10-31,9,93,488,581
50710,2016-10-31,10,120,232,352
50711,2016-10-31,11,139,283,422
50712,2016-10-31,12,181,363,544
50713,2016-10-31,13,154,332,486
50714,2016-10-31,14,217,317,534
50715,2016-10-31,15,193,459,652
50716,2016-10-31,16,190,796,986
50717,2016-10-31,17,165,1361,1526
50718,2016-10-31,18,102,929,1031
50719,2016-10-31,19,66,469,535
50720,2016-10-31,20,42,282,324
50721,2016-10-31,21,33,200,233
50722,2016-10-31,22,31,128,159
50723,2016-10-31,23,20,67,87
50724,2016-11-01,0,18,20,38
50725,2016-11-01,1,9,7,16
50726,2016-11-01,2,0,5,5
50727,2016-11-01,3,6,6,12
50728,2016-11-01,4,2,7,9
50729,2016-11-01,5,2,89,91
50730,2016-11-01,6,13,309,322
50731,2016-11-01,7,44,906,950
50732,2016-11-01,8,62,1282,1344
50733,2016-11-01,9,74,548,622
50734,2016-11-01,10,81,251,332
50735,2016-11-01,11,114,282,396
50736,2016-11-01,12,102,385,487
50737,2016-11-01,13,102,334,436
50738,2016-11-01,14,111,279,390
50739,2016-11-01,15,134,384,518
50740,2016-11-01,16,126,701,827
50741,2016-11-01,17,164,1445,1609
50742,2016-11-01,18,101,1065,1166
50743,2016-11-01,19,61,622,683
50744,2016-11-01,20,67,399,466
50745,2016-11-01,21,41,275,316
50746,2016-11-01,22,30,179,209
50747,2016-11-01,23,24,101,125
50748,2016-11-02,0,16,43,59
50749,2016-11-02,1,3,6,9
50750,2016-11-02,2,1,2,3
50751,2016-11-02,3,0,3,3
50752,2016-11-02,4,1,9,10
50753,2016-11-02,5,4,100,104
50754,2016-11-02,6,16,332,348
50755,2016-11-02,7,38,953,991
50756,2016-11-02,8,60,1241,1301
50757,2016-11-02,9,55,521,576
50758,2016-11-02,10,87,221,308
50759,2016-11-02,11,143,321,464
50760,2016-11-02,12,122,395,517
50761,2016-11-02,13,111,383,494
50762,2016-11-02,14,113,348,461
50763,2016-11-02,15,144,454,598
50764,2016-11-02,16,126,812,938
50765,2016-11-02,17,200,1489,1689
50766,2016-11-02,18,163,1154,1317
50767,2016-11-02,19,79,710,789
50768,2016-11-02,20,58,416,474
50769,2016-11-02,21,53,297,350
50770,2016-11-02,22,36,194,230
50771,2016-11-02,23,0,90,90
50772,2016-11-03,0,12,70,82
50773,2016-11-03,1,11,57,68
50774,2016-11-03,2,2,6,8
50775,2016-11-03,3,2,6,8
50776,2016-11-03,4,1,14,15
50777,2016-11-03,5,3,74,77
50778,2016-11-03,6,10,294,304
50779,2016-11-03,7,38,806,844
50780,2016-11-03,8,55,1330,1385
50781,2016-11-03,9,56,558,614
50782,2016-11-03,10,107,266,373
50783,2016-11-03,11,102,305,407
50784,2016-11-03,12,132,398,530
50785,2016-11-03,13,85,408,493
50786,2016-11-03,14,108,255,363
50787,2016-11-03,15,130,383,513
50788,2016-11-03,16,161,764,925
50789,2016-11-03,17,225,1387,1612
50790,2016-11-03,18,126,1124,1250
50791,2016-11-03,19,93,660,753
50792,2016-11-03,20,68,477,545
50793,2016-11-03,21,61,327,388
50794,2016-11-03,22,50,215,265
50795,2016-11-03,23,21,113,134
50796,2016-11-04,0,20,46,66
50797,2016-11-04,1,11,30,41
50798,2016-11-04,2,16,23,39
50799,2016-11-04,3,1,7,8
50800,2016-11-04,4,1,13,14
50801,2016-11-04,5,6,92,98
50802,2016-11-04,6,11,260,271
50803,2016-11-04,7,35,738,773
50804,2016-11-04,8,59,1174,1233
50805,2016-11-04,9,86,540,626
50806,2016-11-04,10,110,272,382
50807,2016-11-04,11,155,307,462
50808,2016-11-04,12,175,414,589
50809,2016-11-04,13,218,403,621
50810,2016-11-04,14,238,420,658
50811,2016-11-04,15,198,524,722
50812,2016-11-04,16,260,800,1060
50813,2016-11-04,17,290,1259,1549
50814,2016-11-04,18,153,888,1041
50815,2016-11-04,19,111,524,635
50816,2016-11-04,20,89,291,380
50817,2016-11-04,21,82,235,317
50818,2016-11-04,22,33,194,227
50819,2016-11-04,23,39,128,167
50820,2016-11-05,0,26,76,102
50821,2016-11-05,1,34,54,88
50822,2016-11-05,2,8,55,63
50823,2016-11-05,3,11,5,16
50824,2016-11-05,4,10,11,21
50825,2016-11-05,5,3,16,19
50826,2016-11-05,6,2,39,41
50827,2016-11-05,7,12,115,127
50828,2016-11-05,8,40,255,295
50829,2016-11-05,9,115,344,459
50830,2016-11-05,10,207,466,673
50831,2016-11-05,11,295,516,811
50832,2016-11-05,12,388,576,964
50833,2016-11-05,13,524,583,1107
50834,2016-11-05,14,525,565,1090
50835,2016-11-05,15,548,559,1107
50836,2016-11-05,16,523,584,1107
50837,2016-11-05,17,463,537,1000
50838,2016-11-05,18,252,468,720
50839,2016-11-05,19,160,307,467
50840,2016-11-05,20,124,188,312
50841,2016-11-05,21,85,163,248
50842,2016-11-05,22,98,156,254
50843,2016-11-05,23,74,138,212
50844,2016-11-06,0,60,85,145
50845,2016-11-06,1,36,102,138
50846,2016-11-06,2,6,17,23
50847,2016-11-06,3,6,5,11
50848,2016-11-06,4,0,9,9
50849,2016-11-06,5,4,6,10
50850,2016-11-06,6,15,40,55
50851,2016-11-06,7,26,95,121
50852,2016-11-06,8,80,220,300
50853,2016-11-06,9,197,366,563
50854,2016-11-06,10,284,532,816
50855,2016-11-06,11,387,512,899
50856,2016-11-06,12,438,609,1047
50857,2016-11-06,13,409,566,975
50858,2016-11-06,14,395,528,923
50859,2016-11-06,15,400,539,939
50860,2016-11-06,16,383,567,950
50861,2016-11-06,17,179,424,603
50862,2016-11-06,18,120,307,427
50863,2016-11-06,19,74,224,298
50864,2016-11-06,20,64,196,260
50865,2016-11-06,21,48,122,170
50866,2016-11-06,22,25,73,98
50867,2016-11-06,23,9,49,58
50868,2016-11-07,0,6,14,20
50869,2016-11-07,1,3,5,8
50870,2016-11-07,2,4,9,13
50871,2016-11-07,3,0,10,10
50872,2016-11-07,4,0,12,12
50873,2016-11-07,5,3,73,76
50874,2016-11-07,6,14,340,354
50875,2016-11-07,7,36,891,927
50876,2016-11-07,8,62,1074,1136
50877,2016-11-07,9,71,476,547
50878,2016-11-07,10,120,216,336
50879,2016-11-07,11,115,257,372
50880,2016-11-07,12,132,303,435
50881,2016-11-07,13,128,336,464
50882,2016-11-07,14,172,293,465
50883,2016-11-07,15,142,369,511
50884,2016-11-07,16,132,696,828
50885,2016-11-07,17,114,1253,1367
50886,2016-11-07,18,75,877,952
50887,2016-11-07,19,45,498,543
50888,2016-11-07,20,32,303,335
50889,2016-11-07,21,22,233,255
50890,2016-11-07,22,18,101,119
50891,2016-11-07,23,5,64,69
50892,2016-11-08,0,3,23,26
50893,2016-11-08,1,4,11,15
50894,2016-11-08,2,2,7,9
50895,2016-11-08,3,0,4,4
50896,2016-11-08,4,3,13,16
50897,2016-11-08,5,4,90,94
50898,2016-11-08,6,9,321,330
50899,2016-11-08,7,37,874,911
50900,2016-11-08,8,58,1159,1217
50901,2016-11-08,9,54,573,627
50902,2016-11-08,10,107,310,417
50903,2016-11-08,11,132,354,486
50904,2016-11-08,12,164,424,588
50905,2016-11-08,13,150,424,574
50906,2016-11-08,14,177,385,562
50907,2016-11-08,15,233,540,773
50908,2016-11-08,16,202,822,1024
50909,2016-11-08,17,136,1231,1367
50910,2016-11-08,18,114,965,1079
50911,2016-11-08,19,69,619,688
50912,2016-11-08,20,59,320,379
50913,2016-11-08,21,63,205,268
50914,2016-11-08,22,41,243,284
50915,2016-11-08,23,43,244,287
50916,2016-11-09,0,40,154,194
50917,2016-11-09,1,36,99,135
50918,2016-11-09,2,16,33,49
50919,2016-11-09,3,14,23,37
50920,2016-11-09,4,3,14,17
50921,2016-11-09,5,1,46,47
50922,2016-11-09,6,7,109,116
50923,2016-11-09,7,8,251,259
50924,2016-11-09,8,12,375,387
50925,2016-11-09,9,19,423,442
50926,2016-11-09,10,52,273,325
50927,2016-11-09,11,82,255,337
50928,2016-11-09,12,96,338,434
50929,2016-11-09,13,82,308,390
50930,2016-11-09,14,93,315,408
50931,2016-11-09,15,79,265,344
50932,2016-11-09,16,42,398,440
50933,2016-11-09,17,71,899,970
50934,2016-11-09,18,54,715,769
50935,2016-11-09,19,39,446,485
50936,2016-11-09,20,25,295,320
50937,2016-11-09,21,38,242,280
50938,2016-11-09,22,23,109,132
50939,2016-11-09,23,14,68,82
50940,2016-11-10,0,5,25,30
50941,2016-11-10,1,6,8,14
50942,2016-11-10,2,1,8,9
50943,2016-11-10,3,0,4,4
50944,2016-11-10,4,0,12,12
50945,2016-11-10,5,3,64,67
50946,2016-11-10,6,8,265,273
50947,2016-11-10,7,30,766,796
50948,2016-11-10,8,62,1123,1185
50949,2016-11-10,9,52,486,538
50950,2016-11-10,10,102,243,345
50951,2016-11-10,11,82,248,330
50952,2016-11-10,12,78,361,439
50953,2016-11-10,13,108,322,430
50954,2016-11-10,14,120,346,466
50955,2016-11-10,15,162,450,612
50956,2016-11-10,16,152,693,845
50957,2016-11-10,17,102,1090,1192
50958,2016-11-10,18,105,883,988
50959,2016-11-10,19,64,491,555
50960,2016-11-10,20,33,422,455
50961,2016-11-10,21,34,263,297
50962,2016-11-10,22,44,203,247
50963,2016-11-10,23,24,98,122
50964,2016-11-11,0,22,63,85
50965,2016-11-11,1,6,39,45
50966,2016-11-11,2,3,20,23
50967,2016-11-11,3,3,11,14
50968,2016-11-11,4,2,11,13
50969,2016-11-11,5,2,39,41
50970,2016-11-11,6,12,126,138
50971,2016-11-11,7,30,389,419
50972,2016-11-11,8,49,700,749
50973,2016-11-11,9,127,474,601
50974,2016-11-11,10,169,308,477
50975,2016-11-11,11,224,364,588
50976,2016-11-11,12,251,414,665
50977,2016-11-11,13,316,384,700
50978,2016-11-11,14,326,458,784
50979,2016-11-11,15,294,482,776
50980,2016-11-11,16,235,588,823
50981,2016-11-11,17,187,747,934
50982,2016-11-11,18,120,558,678
50983,2016-11-11,19,71,379,450
50984,2016-11-11,20,48,225,273
50985,2016-11-11,21,32,205,237
50986,2016-11-11,22,43,172,215
50987,2016-11-11,23,22,96,118
50988,2016-11-12,0,13,75,88
50989,2016-11-12,1,6,41,47
50990,2016-11-12,2,5,39,44
50991,2016-11-12,3,5,9,14
50992,2016-11-12,4,2,10,12
50993,2016-11-12,5,4,14,18
50994,2016-11-12,6,9,29,38
50995,2016-11-12,7,22,91,113
50996,2016-11-12,8,55,197,252
50997,2016-11-12,9,105,261,366
50998,2016-11-12,10,228,354,582
50999,2016-11-12,11,296,391,687
51000,2016-11-12,12,295,435,730
51001,2016-11-12,13,384,449,833
51002,2016-11-12,14,500,458,958
51003,2016-11-12,15,401,434,835
51004,2016-11-12,16,369,422,791
51005,2016-11-12,17,186,380,566
51006,2016-11-12,18,100,275,375
51007,2016-11-12,19,76,228,304
51008,2016-11-12,20,32,178,210
51009,2016-11-12,21,33,149,182
51010,2016-11-12,22,44,133,177
51011,2016-11-12,23,22,83,105
51012,2016-11-13,0,13,58,71
51013,2016-11-13,1,23,48,71
51014,2016-11-13,2,11,36,47
51015,2016-11-13,3,6,15,21
51016,2016-11-13,4,4,8,12
51017,2016-11-13,5,2,3,5
51018,2016-11-13,6,7,18,25
51019,2016-11-13,7,30,83,113
51020,2016-11-13,8,45,119,164
51021,2016-11-13,9,125,240,365
51022,2016-11-13,10,189,357,546
51023,2016-11-13,11,277,370,647
51024,2016-11-13,12,333,464,797
51025,2016-11-13,13,356,522,878
51026,2016-11-13,14,367,514,881
51027,2016-11-13,15,446,537,983
51028,2016-11-13,16,303,492,795
51029,2016-11-13,17,159,417,576
51030,2016-11-13,18,114,283,397
51031,2016-11-13,19,67,214,281
51032,2016-11-13,20,45,165,210
51033,2016-11-13,21,24,117,141
51034,2016-11-13,22,16,68,84
51035,2016-11-13,23,7,37,44
51036,2016-11-14,0,0,16,16
51037,2016-11-14,1,2,6,8
51038,2016-11-14,2,2,5,7
51039,2016-11-14,4,3,6,9
51040,2016-11-14,5,4,75,79
51041,2016-11-14,6,11,248,259
51042,2016-11-14,7,37,768,805
51043,2016-11-14,8,59,1018,1077
51044,2016-11-14,9,48,423,471
51045,2016-11-14,10,101,215,316
51046,2016-11-14,11,134,234,368
51047,2016-11-14,12,114,294,408
51048,2016-11-14,13,114,268,382
51049,2016-11-14,14,110,266,376
51050,2016-11-14,15,124,350,474
51051,2016-11-14,16,109,611,720
51052,2016-11-14,17,93,1053,1146
51053,2016-11-14,18,68,837,905
51054,2016-11-14,19,47,491,538
51055,2016-11-14,20,34,351,385
51056,2016-11-14,21,37,229,266
51057,2016-11-14,22,17,117,134
51058,2016-11-14,23,7,54,61
51059,2016-11-15,0,4,22,26
51060,2016-11-15,1,2,7,9
51061,2016-11-15,2,1,2,3
51062,2016-11-15,3,0,2,2
51063,2016-11-15,4,0,6,6
51064,2016-11-15,5,5,75,80
51065,2016-11-15,6,11,308,319
51066,2016-11-15,7,32,873,905
51067,2016-11-15,8,54,1174,1228
51068,2016-11-15,9,47,515,562
51069,2016-11-15,10,51,250,301
51070,2016-11-15,11,82,263,345
51071,2016-11-15,12,102,362,464
51072,2016-11-15,13,108,310,418
51073,2016-11-15,14,96,307,403
51074,2016-11-15,15,109,419,528
51075,2016-11-15,16,134,750,884
51076,2016-11-15,17,93,1209,1302
51077,2016-11-15,18,83,922,1005
51078,2016-11-15,19,65,521,586
51079,2016-11-15,20,37,314,351
51080,2016-11-15,21,47,317,364
51081,2016-11-15,22,24,184,208
51082,2016-11-15,23,14,82,96
51083,2016-11-16,0,4,28,32
51084,2016-11-16,1,11,6,17
51085,2016-11-16,2,0,8,8
51086,2016-11-16,3,0,1,1
51087,2016-11-16,4,1,7,8
51088,2016-11-16,5,6,89,95
51089,2016-11-16,6,11,315,326
51090,2016-11-16,7,35,907,942
51091,2016-11-16,8,64,1173,1237
51092,2016-11-16,9,78,532,610
51093,2016-11-16,10,66,231,297
51094,2016-11-16,11,92,278,370
51095,2016-11-16,12,83,342,425
51096,2016-11-16,13,91,343,434
51097,2016-11-16,14,96,271,367
51098,2016-11-16,15,51,271,322
51099,2016-11-16,16,91,563,654
51100,2016-11-16,17,87,1094,1181
51101,2016-11-16,18,67,911,978
51102,2016-11-16,19,65,565,630
51103,2016-11-16,20,44,402,446
51104,2016-11-16,21,37,283,320
51105,2016-11-16,22,38,200,238
51106,2016-11-16,23,18,90,108
51107,2016-11-17,0,3,26,29
51108,2016-11-17,1,6,5,11
51109,2016-11-17,2,0,12,12
51110,2016-11-17,3,0,4,4
51111,2016-11-17,4,1,9,10
51112,2016-11-17,5,2,75,77
51113,2016-11-17,6,10,290,300
51114,2016-11-17,7,28,871,899
51115,2016-11-17,8,63,1134,1197
51116,2016-11-17,9,55,520,575
51117,2016-11-17,10,74,223,297
51118,2016-11-17,11,97,295,392
51119,2016-11-17,12,96,375,471
51120,2016-11-17,13,71,364,435
51121,2016-11-17,14,95,335,430
51122,2016-11-17,15,110,445,555
51123,2016-11-17,16,99,670,769
51124,2016-11-17,17,137,1151,1288
51125,2016-11-17,18,77,1012,1089
51126,2016-11-17,19,58,522,580
51127,2016-11-17,20,38,366,404
51128,2016-11-17,21,36,310,346
51129,2016-11-17,22,43,168,211
51130,2016-11-17,23,18,96,114
51131,2016-11-18,0,14,45,59
51132,2016-11-18,1,8,20,28
51133,2016-11-18,2,3,6,9
51134,2016-11-18,3,1,4,5
51135,2016-11-18,4,0,6,6
51136,2016-11-18,5,2,62,64
51137,2016-11-18,6,11,234,245
51138,2016-11-18,7,26,763,789
51139,2016-11-18,8,63,1097,1160
51140,2016-11-18,9,49,455,504
51141,2016-11-18,10,91,263,354
51142,2016-11-18,11,110,321,431
51143,2016-11-18,12,175,413,588
51144,2016-11-18,13,183,415,598
51145,2016-11-18,14,232,419,651
51146,2016-11-18,15,231,501,732
51147,2016-11-18,16,279,805,1084
51148,2016-11-18,17,170,1153,1323
51149,2016-11-18,18,79,826,905
51150,2016-11-18,19,91,475,566
51151,2016-11-18,20,66,306,372
51152,2016-11-18,21,66,241,307
51153,2016-11-18,22,60,202,262
51154,2016-11-18,23,48,162,210
51155,2016-11-19,0,51,121,172
51156,2016-11-19,1,26,59,85
51157,2016-11-19,2,19,44,63
51158,2016-11-19,3,11,14,25
51159,2016-11-19,4,3,11,14
51160,2016-11-19,5,6,9,15
51161,2016-11-19,6,17,34,51
51162,2016-11-19,7,11,104,115
51163,2016-11-19,8,73,211,284
51164,2016-11-19,9,140,370,510
51165,2016-11-19,10,213,474,687
51166,2016-11-19,11,371,508,879
51167,2016-11-19,12,475,594,1069
51168,2016-11-19,13,532,615,1147
51169,2016-11-19,14,605,536,1141
51170,2016-11-19,15,286,400,686
51171,2016-11-19,16,135,252,387
51172,2016-11-19,17,13,89,102
51173,2016-11-19,18,19,121,140
51174,2016-11-19,19,25,141,166
51175,2016-11-19,20,32,130,162
51176,2016-11-19,21,21,112,133
51177,2016-11-19,22,23,98,121
51178,2016-11-19,23,12,78,90
51179,2016-11-20,0,11,64,75
51180,2016-11-20,1,11,42,53
51181,2016-11-20,2,8,26,34
51182,2016-11-20,3,1,12,13
51183,2016-11-20,4,0,10,10
51184,2016-11-20,5,3,2,5
51185,2016-11-20,6,1,10,11
51186,2016-11-20,7,10,45,55
51187,2016-11-20,8,18,97,115
51188,2016-11-20,9,59,182,241
51189,2016-11-20,10,87,238,325
51190,2016-11-20,11,97,275,372
51191,2016-11-20,12,66,304,370
51192,2016-11-20,13,84,312,396
51193,2016-11-20,14,75,237,312
51194,2016-11-20,15,70,275,345
51195,2016-11-20,16,52,278,330
51196,2016-11-20,17,24,224,248
51197,2016-11-20,18,14,158,172
51198,2016-11-20,19,13,123,136
51199,2016-11-20,20,14,80,94
51200,2016-11-20,21,5,52,57
51201,2016-11-20,22,2,38,40
51202,2016-11-20,23,2,15,17
51203,2016-11-21,0,1,13,14
51204,2016-11-21,1,1,6,7
51205,2016-11-21,2,0,1,1
51206,2016-11-21,3,1,0,1
51207,2016-11-21,4,2,5,7
51208,2016-11-21,5,2,58,60
51209,2016-11-21,6,1,209,210
51210,2016-11-21,7,17,574,591
51211,2016-11-21,8,39,831,870
51212,2016-11-21,9,18,399,417
51213,2016-11-21,10,25,185,210
51214,2016-11-21,11,45,201,246
51215,2016-11-21,12,52,210,262
51216,2016-11-21,13,48,216,264
51217,2016-11-21,14,46,206,252
51218,2016-11-21,15,37,299,336
51219,2016-11-21,16,40,518,558
51220,2016-11-21,17,50,873,923
51221,2016-11-21,18,31,631,662
51222,2016-11-21,19,20,355,375
51223,2016-11-21,20,21,244,265
51224,2016-11-21,21,14,146,160
51225,2016-11-21,22,6,84,90
51226,2016-11-21,23,9,34,43
51227,2016-11-22,0,0,17,17
51228,2016-11-22,1,1,9,10
51229,2016-11-22,2,0,4,4
51230,2016-11-22,3,1,2,3
51231,2016-11-22,4,2,6,8
51232,2016-11-22,5,1,74,75
51233,2016-11-22,6,0,210,210
51234,2016-11-22,7,18,625,643
51235,2016-11-22,8,28,974,1002
51236,2016-11-22,9,28,466,494
51237,2016-11-22,10,41,238,279
51238,2016-11-22,11,54,231,285
51239,2016-11-22,12,64,303,367
51240,2016-11-22,13,78,221,299
51241,2016-11-22,14,92,259,351
51242,2016-11-22,15,81,314,395
51243,2016-11-22,16,79,542,621
51244,2016-11-22,17,95,871,966
51245,2016-11-22,18,40,644,684
51246,2016-11-22,19,24,371,395
51247,2016-11-22,20,19,198,217
51248,2016-11-22,21,21,131,152
51249,2016-11-22,22,6,98,104
51250,2016-11-22,23,6,39,45
51251,2016-11-23,0,1,22,23
51252,2016-11-23,1,2,9,11
51253,2016-11-23,2,5,6,11
51254,2016-11-23,3,1,2,3
51255,2016-11-23,4,4,5,9
51256,2016-11-23,5,1,55,56
51257,2016-11-23,6,1,159,160
51258,2016-11-23,7,11,427,438
51259,2016-11-23,8,39,751,790
51260,2016-11-23,9,30,422,452
51261,2016-11-23,10,48,213,261
51262,2016-11-23,11,98,235,333
51263,2016-11-23,12,123,338,461
51264,2016-11-23,13,153,380,533
51265,2016-11-23,14,154,462,616
51266,2016-11-23,15,168,528,696
51267,2016-11-23,16,105,508,613
51268,2016-11-23,17,66,385,451
51269,2016-11-23,18,49,285,334
51270,2016-11-23,19,41,202,243
51271,2016-11-23,20,42,116,158
51272,2016-11-23,21,14,95,109
51273,2016-11-23,22,12,76,88
51274,2016-11-23,23,4,49,53
51275,2016-11-24,0,7,27,34
51276,2016-11-24,1,8,19,27
51277,2016-11-24,2,12,18,30
51278,2016-11-24,3,4,7,11
51279,2016-11-24,4,0,5,5
51280,2016-11-24,5,6,8,14
51281,2016-11-24,6,1,21,22
51282,2016-11-24,7,10,66,76
51283,2016-11-24,8,11,99,110
51284,2016-11-24,9,38,128,166
51285,2016-11-24,10,94,156,250
51286,2016-11-24,11,204,172,376
51287,2016-11-24,12,156,174,330
51288,2016-11-24,13,194,155,349
51289,2016-11-24,14,181,135,316
51290,2016-11-24,15,161,107,268
51291,2016-11-24,16,158,102,260
51292,2016-11-24,17,104,70,174
51293,2016-11-24,18,62,47,109
51294,2016-11-24,19,52,45,97
51295,2016-11-24,20,34,59,93
51296,2016-11-24,21,27,52,79
51297,2016-11-24,22,20,43,63
51298,2016-11-24,23,22,47,69
51299,2016-11-25,0,16,33,49
51300,2016-11-25,1,8,11,19
51301,2016-11-25,2,0,3,3
51302,2016-11-25,3,0,3,3
51303,2016-11-25,4,0,4,4
51304,2016-11-25,5,5,10,15
51305,2016-11-25,6,2,43,45
51306,2016-11-25,7,18,98,116
51307,2016-11-25,8,37,153,190
51308,2016-11-25,9,113,146,259
51309,2016-11-25,10,162,163,325
51310,2016-11-25,11,238,176,414
51311,2016-11-25,12,294,209,503
51312,2016-11-25,13,304,230,534
51313,2016-11-25,14,360,228,588
51314,2016-11-25,15,354,277,631
51315,2016-11-25,16,328,295,623
51316,2016-11-25,17,164,242,406
51317,2016-11-25,18,109,182,291
51318,2016-11-25,19,108,147,255
51319,2016-11-25,20,106,118,224
51320,2016-11-25,21,50,83,133
51321,2016-11-25,22,44,73,117
51322,2016-11-25,23,30,54,84
51323,2016-11-26,0,47,26,73
51324,2016-11-26,1,16,30,46
51325,2016-11-26,2,13,19,32
51326,2016-11-26,3,7,12,19
51327,2016-11-26,4,1,4,5
51328,2016-11-26,5,4,7,11
51329,2016-11-26,6,1,16,17
51330,2016-11-26,7,16,38,54
51331,2016-11-26,8,55,78,133
51332,2016-11-26,9,92,151,243
51333,2016-11-26,10,203,214,417
51334,2016-11-26,11,213,260,473
51335,2016-11-26,12,226,254,480
51336,2016-11-26,13,242,252,494
51337,2016-11-26,14,234,262,496
51338,2016-11-26,15,254,215,469
51339,2016-11-26,16,169,218,387
51340,2016-11-26,17,92,191,283
51341,2016-11-26,18,54,164,218
51342,2016-11-26,19,46,144,190
51343,2016-11-26,20,39,112,151
51344,2016-11-26,21,37,97,134
51345,2016-11-26,22,24,71,95
51346,2016-11-26,23,9,62,71
51347,2016-11-27,0,12,46,58
51348,2016-11-27,1,9,38,47
51349,2016-11-27,2,5,25,30
51350,2016-11-27,3,1,10,11
51351,2016-11-27,4,2,4,6
51352,2016-11-27,5,1,8,9
51353,2016-11-27,6,2,13,15
51354,2016-11-27,7,5,30,35
51355,2016-11-27,8,26,96,122
51356,2016-11-27,9,41,153,194
51357,2016-11-27,10,99,236,335
51358,2016-11-27,11,119,310,429
51359,2016-11-27,12,126,358,484
51360,2016-11-27,13,168,331,499
51361,2016-11-27,14,140,330,470
51362,2016-11-27,15,135,387,522
51363,2016-11-27,16,129,349,478
51364,2016-11-27,17,64,265,329
51365,2016-11-27,18,48,197,245
51366,2016-11-27,19,26,171,197
51367,2016-11-27,20,15,124,139
51368,2016-11-27,21,10,81,91
51369,2016-11-27,22,16,58,74
51370,2016-11-27,23,17,31,48
51371,2016-11-28,0,10,16,26
51372,2016-11-28,1,0,7,7
51373,2016-11-28,2,2,4,6
51374,2016-11-28,3,0,2,2
51375,2016-11-28,4,0,4,4
51376,2016-11-28,5,3,62,65
51377,2016-11-28,6,4,232,236
51378,2016-11-28,7,20,651,671
51379,2016-11-28,8,40,999,1039
51380,2016-11-28,9,33,431,464
51381,2016-11-28,10,51,176,227
51382,2016-11-28,11,33,197,230
51383,2016-11-28,12,52,265,317
51384,2016-11-28,13,57,290,347
51385,2016-11-28,14,77,234,311
51386,2016-11-28,15,57,304,361
51387,2016-11-28,16,71,560,631
51388,2016-11-28,17,75,986,1061
51389,2016-11-28,18,26,811,837
51390,2016-11-28,19,29,448,477
51391,2016-11-28,20,18,300,318
51392,2016-11-28,21,10,196,206
51393,2016-11-28,22,13,103,116
51394,2016-11-28,23,10,58,68
51395,2016-11-29,0,3,19,22
51396,2016-11-29,1,0,15,15
51397,2016-11-29,2,0,8,8
51398,2016-11-29,4,1,9,10
51399,2016-11-29,5,2,45,47
51400,2016-11-29,6,1,219,220
51401,2016-11-29,7,15,550,565
51402,2016-11-29,8,20,824,844
51403,2016-11-29,9,15,418,433
51404,2016-11-29,10,5,99,104
51405,2016-11-29,11,16,137,153
51406,2016-11-29,12,9,155,164
51407,2016-11-29,13,9,111,120
51408,2016-11-29,14,12,170,182
51409,2016-11-29,15,16,219,235
51410,2016-11-29,16,37,390,427
51411,2016-11-29,17,21,792,813
51412,2016-11-29,18,32,689,721
51413,2016-11-29,19,22,445,467
51414,2016-11-29,20,15,302,317
51415,2016-11-29,21,9,222,231
51416,2016-11-29,22,12,145,157
51417,2016-11-29,23,15,61,76
51418,2016-11-30,0,5,26,31
51419,2016-11-30,1,1,8,9
51420,2016-11-30,2,3,5,8
51421,2016-11-30,3,1,1,2
51422,2016-11-30,4,1,6,7
51423,2016-11-30,5,2,89,91
51424,2016-11-30,6,4,192,196
51425,2016-11-30,7,7,512,519
51426,2016-11-30,8,9,472,481
51427,2016-11-30,9,11,144,155
51428,2016-11-30,10,7,112,119
51429,2016-11-30,11,14,149,163
51430,2016-11-30,12,24,230,254
51431,2016-11-30,13,13,228,241
51432,2016-11-30,14,33,216,249
51433,2016-11-30,15,36,326,362
51434,2016-11-30,16,35,543,578
51435,2016-11-30,17,68,979,1047
51436,2016-11-30,18,14,643,657
51437,2016-11-30,19,29,415,444
51438,2016-11-30,20,19,284,303
51439,2016-11-30,21,0,88,88
51440,2016-11-30,22,6,88,94
51441,2016-11-30,23,7,65,72
51442,2016-12-01,0,11,33,44
51443,2016-12-01,1,0,5,5
51444,2016-12-01,2,0,2,2
51445,2016-12-01,3,1,3,4
51446,2016-12-01,4,0,3,3
51447,2016-12-01,5,3,71,74
51448,2016-12-01,6,4,252,256
51449,2016-12-01,7,24,771,795
51450,2016-12-01,8,30,1109,1139
51451,2016-12-01,9,35,480,515
51452,2016-12-01,10,27,237,264
51453,2016-12-01,11,29,230,259
51454,2016-12-01,12,41,330,371
51455,2016-12-01,13,60,343,403
51456,2016-12-01,14,50,285,335
51457,2016-12-01,15,62,391,453
51458,2016-12-01,16,54,677,731
51459,2016-12-01,17,62,1091,1153
51460,2016-12-01,18,63,869,932
51461,2016-12-01,19,35,516,551
51462,2016-12-01,20,23,299,322
51463,2016-12-01,21,17,235,252
51464,2016-12-01,22,14,164,178
51465,2016-12-01,23,11,79,90
51466,2016-12-02,0,13,34,47
51467,2016-12-02,1,11,16,27
51468,2016-12-02,2,6,8,14
51469,2016-12-02,3,1,5,6
51470,2016-12-02,4,1,13,14
51471,2016-12-02,5,6,64,70
51472,2016-12-02,6,4,218,222
51473,2016-12-02,7,27,609,636
51474,2016-12-02,8,42,1004,1046
51475,2016-12-02,9,37,464,501
51476,2016-12-02,10,49,230,279
51477,2016-12-02,11,58,250,308
51478,2016-12-02,12,77,337,414
51479,2016-12-02,13,90,316,406
51480,2016-12-02,14,72,326,398
51481,2016-12-02,15,95,407,502
51482,2016-12-02,16,77,621,698
51483,2016-12-02,17,72,941,1013
51484,2016-12-02,18,55,622,677
51485,2016-12-02,19,46,421,467
51486,2016-12-02,20,20,219,239
51487,2016-12-02,21,22,150,172
51488,2016-12-02,22,23,126,149
51489,2016-12-02,23,17,89,106
51490,2016-12-03,0,10,71,81
51491,2016-12-03,1,7,55,62
51492,2016-12-03,2,10,34,44
51493,2016-12-03,3,3,21,24
51494,2016-12-03,4,4,5,9
51495,2016-12-03,5,1,10,11
51496,2016-12-03,6,2,19,21
51497,2016-12-03,7,9,84,93
51498,2016-12-03,8,40,179,219
51499,2016-12-03,9,53,305,358
51500,2016-12-03,10,93,342,435
51501,2016-12-03,11,118,405,523
51502,2016-12-03,12,154,440,594
51503,2016-12-03,13,178,389,567
51504,2016-12-03,14,224,408,632
51505,2016-12-03,15,159,396,555
51506,2016-12-03,16,124,359,483
51507,2016-12-03,17,87,292,379
51508,2016-12-03,18,46,269,315
51509,2016-12-03,19,28,234,262
51510,2016-12-03,20,27,157,184
51511,2016-12-03,21,16,121,137
51512,2016-12-03,22,16,105,121
51513,2016-12-03,23,14,85,99
51514,2016-12-04,0,11,84,95
51515,2016-12-04,1,5,58,63
51516,2016-12-04,2,8,48,56
51517,2016-12-04,3,9,29,38
51518,2016-12-04,4,2,7,9
51519,2016-12-04,5,1,9,10
51520,2016-12-04,6,2,16,18
51521,2016-12-04,7,7,98,105
51522,2016-12-04,8,11,101,112
51523,2016-12-04,9,45,218,263
51524,2016-12-04,10,66,315,381
51525,2016-12-04,11,103,380,483
51526,2016-12-04,12,124,406,530
51527,2016-12-04,13,130,387,517
51528,2016-12-04,14,105,356,461
51529,2016-12-04,15,128,388,516
51530,2016-12-04,16,76,415,491
51531,2016-12-04,17,49,302,351
51532,2016-12-04,18,22,234,256
51533,2016-12-04,19,13,196,209
51534,2016-12-04,20,16,144,160
51535,2016-12-04,21,8,72,80
51536,2016-12-04,22,4,31,35
51537,2016-12-04,23,2,21,23
51538,2016-12-05,0,0,14,14
51539,2016-12-05,1,1,2,3
51540,2016-12-05,2,1,3,4
51541,2016-12-05,4,2,5,7
51542,2016-12-05,5,2,57,59
51543,2016-12-05,6,4,231,235
51544,2016-12-05,7,13,621,634
51545,2016-12-05,8,27,934,961
51546,2016-12-05,9,17,452,469
51547,2016-12-05,10,27,211,238
51548,2016-12-05,11,47,213,260
51549,2016-12-05,12,69,272,341
51550,2016-12-05,13,73,288,361
51551,2016-12-05,14,69,212,281
51552,2016-12-05,15,46,331,377
51553,2016-12-05,16,75,558,633
51554,2016-12-05,17,44,1073,1117
51555,2016-12-05,18,48,884,932
51556,2016-12-05,19,45,462,507
51557,2016-12-05,20,31,303,334
51558,2016-12-05,21,32,218,250
51559,2016-12-05,22,24,114,138
51560,2016-12-05,23,7,48,55
51561,2016-12-06,0,9,24,33
51562,2016-12-06,1,2,4,6
51563,2016-12-06,2,0,4,4
51564,2016-12-06,3,1,1,2
51565,2016-12-06,4,0,10,10
51566,2016-12-06,5,1,65,66
51567,2016-12-06,6,6,292,298
51568,2016-12-06,7,11,721,732
51569,2016-12-06,8,20,857,877
51570,2016-12-06,9,20,295,315
51571,2016-12-06,10,2,91,93
51572,2016-12-06,11,3,81,84
51573,2016-12-06,12,7,90,97
51574,2016-12-06,13,1,56,57
51575,2016-12-06,14,4,31,35
51576,2016-12-06,15,3,52,55
51577,2016-12-06,16,7,91,98
51578,2016-12-06,17,13,231,244
51579,2016-12-06,18,7,234,241
51580,2016-12-06,19,6,130,136
51581,2016-12-06,20,13,150,163
51582,2016-12-06,21,7,104,111
51583,2016-12-06,22,6,91,97
51584,2016-12-06,23,6,33,39
51585,2016-12-07,0,3,19,22
51586,2016-12-07,1,0,8,8
51587,2016-12-07,2,2,4,6
51588,2016-12-07,3,0,1,1
51589,2016-12-07,4,0,8,8
51590,2016-12-07,5,6,73,79
51591,2016-12-07,6,5,258,263
51592,2016-12-07,7,24,753,777
51593,2016-12-07,8,32,988,1020
51594,2016-12-07,9,26,438,464
51595,2016-12-07,10,18,212,230
51596,2016-12-07,11,27,221,248
51597,2016-12-07,12,58,330,388
51598,2016-12-07,13,43,322,365
51599,2016-12-07,14,66,278,344
51600,2016-12-07,15,58,356,414
51601,2016-12-07,16,64,582,646
51602,2016-12-07,17,66,1039,1105
51603,2016-12-07,18,39,843,882
51604,2016-12-07,19,38,514,552
51605,2016-12-07,20,23,320,343
51606,2016-12-07,21,15,220,235
51607,2016-12-07,22,12,142,154
51608,2016-12-07,23,13,88,101
51609,2016-12-08,0,12,23,35
51610,2016-12-08,1,6,14,20
51611,2016-12-08,2,2,4,6
51612,2016-12-08,3,0,1,1
51613,2016-12-08,4,0,5,5
51614,2016-12-08,5,5,59,64
51615,2016-12-08,6,3,237,240
51616,2016-12-08,7,20,709,729
51617,2016-12-08,8,35,1094,1129
51618,2016-12-08,9,27,533,560
51619,2016-12-08,10,26,215,241
51620,2016-12-08,11,35,239,274
51621,2016-12-08,12,30,297,327
51622,2016-12-08,13,41,277,318
51623,2016-12-08,14,48,259,307
51624,2016-12-08,15,39,330,369
51625,2016-12-08,16,40,534,574
51626,2016-12-08,17,51,882,933
51627,2016-12-08,18,49,710,759
51628,2016-12-08,19,19,423,442
51629,2016-12-08,20,17,255,272
51630,2016-12-08,21,20,190,210
51631,2016-12-08,22,10,119,129
51632,2016-12-08,23,2,47,49
51633,2016-12-09,0,3,28,31
51634,2016-12-09,1,3,12,15
51635,2016-12-09,2,3,15,18
51636,2016-12-09,3,1,1,2
51637,2016-12-09,4,1,3,4
51638,2016-12-09,5,2,46,48
51639,2016-12-09,6,1,167,168
51640,2016-12-09,7,13,461,474
51641,2016-12-09,8,27,881,908
51642,2016-12-09,9,26,429,455
51643,2016-12-09,10,26,224,250
51644,2016-12-09,11,34,240,274
51645,2016-12-09,12,35,266,301
51646,2016-12-09,13,42,248,290
51647,2016-12-09,14,39,245,284
51648,2016-12-09,15,46,323,369
51649,2016-12-09,16,29,473,502
51650,2016-12-09,17,38,658,696
51651,2016-12-09,18,23,466,489
51652,2016-12-09,19,16,272,288
51653,2016-12-09,20,15,186,201
51654,2016-12-09,21,8,147,155
51655,2016-12-09,22,11,103,114
51656,2016-12-09,23,13,70,83
51657,2016-12-10,0,9,60,69
51658,2016-12-10,1,6,39,45
51659,2016-12-10,2,2,18,20
51660,2016-12-10,3,2,9,11
51661,2016-12-10,4,3,3,6
51662,2016-12-10,5,2,3,5
51663,2016-12-10,6,5,14,19
51664,2016-12-10,7,11,63,74
51665,2016-12-10,8,10,148,158
51666,2016-12-10,9,29,212,241
51667,2016-12-10,10,31,250,281
51668,2016-12-10,11,63,279,342
51669,2016-12-10,12,83,333,416
51670,2016-12-10,13,101,352,453
51671,2016-12-10,14,72,276,348
51672,2016-12-10,15,86,318,404
51673,2016-12-10,16,59,252,311
51674,2016-12-10,17,53,210,263
51675,2016-12-10,18,29,183,212
51676,2016-12-10,19,16,134,150
51677,2016-12-10,20,10,109,119
51678,2016-12-10,21,9,102,111
51679,2016-12-10,22,8,63,71
51680,2016-12-10,23,11,61,72
51681,2016-12-11,0,9,46,55
51682,2016-12-11,1,7,45,52
51683,2016-12-11,2,2,44,46
51684,2016-12-11,3,4,10,14
51685,2016-12-11,4,0,4,4
51686,2016-12-11,5,1,9,10
51687,2016-12-11,6,2,16,18
51688,2016-12-11,7,3,36,39
51689,2016-12-11,8,11,82,93
51690,2016-12-11,9,24,141,165
51691,2016-12-11,10,44,212,256
51692,2016-12-11,11,56,263,319
51693,2016-12-11,12,70,300,370
51694,2016-12-11,13,65,324,389
51695,2016-12-11,14,51,286,337
51696,2016-12-11,15,63,295,358
51697,2016-12-11,16,51,294,345
51698,2016-12-11,17,35,228,263
51699,2016-12-11,18,26,166,192
51700,2016-12-11,19,13,173,186
51701,2016-12-11,20,18,105,123
51702,2016-12-11,21,14,77,91
51703,2016-12-11,22,11,51,62
51704,2016-12-11,23,5,23,28
51705,2016-12-12,0,2,12,14
51706,2016-12-12,1,0,8,8
51707,2016-12-12,2,1,3,4
51708,2016-12-12,3,0,3,3
51709,2016-12-12,4,0,4,4
51710,2016-12-12,5,2,27,29
51711,2016-12-12,6,2,124,126
51712,2016-12-12,7,9,426,435
51713,2016-12-12,8,25,790,815
51714,2016-12-12,9,14,428,442
51715,2016-12-12,10,28,176,204
51716,2016-12-12,11,26,168,194
51717,2016-12-12,12,36,240,276
51718,2016-12-12,13,47,234,281
51719,2016-12-12,14,55,241,296
51720,2016-12-12,15,57,308,365
51721,2016-12-12,16,60,561,621
51722,2016-12-12,17,60,998,1058
51723,2016-12-12,18,52,742,794
51724,2016-12-12,19,42,406,448
51725,2016-12-12,20,25,241,266
51726,2016-12-12,21,19,157,176
51727,2016-12-12,22,8,102,110
51728,2016-12-12,23,3,65,68
51729,2016-12-13,0,7,25,32
51730,2016-12-13,1,0,11,11
51731,2016-12-13,2,0,6,6
51732,2016-12-13,3,1,1,2
51733,2016-12-13,4,0,6,6
51734,2016-12-13,5,2,66,68
51735,2016-12-13,6,3,234,237
51736,2016-12-13,7,15,694,709
51737,2016-12-13,8,25,1036,1061
51738,2016-12-13,9,17,479,496
51739,2016-12-13,10,16,194,210
51740,2016-12-13,11,31,220,251
51741,2016-12-13,12,27,258,285
51742,2016-12-13,13,34,250,284
51743,2016-12-13,14,45,227,272
51744,2016-12-13,15,48,290,338
51745,2016-12-13,16,23,535,558
51746,2016-12-13,17,44,948,992
51747,2016-12-13,18,37,730,767
51748,2016-12-13,19,34,429,463
51749,2016-12-13,20,18,270,288
51750,2016-12-13,21,11,174,185
51751,2016-12-13,22,25,124,149
51752,2016-12-13,23,1,72,73
51753,2016-12-14,0,2,19,21
51754,2016-12-14,1,3,8,11
51755,2016-12-14,2,1,3,4
51756,2016-12-14,3,2,2,4
51757,2016-12-14,4,0,10,10
51758,2016-12-14,5,2,66,68
51759,2016-12-14,6,8,250,258
51760,2016-12-14,7,15,647,662
51761,2016-12-14,8,32,934,966
51762,2016-12-14,9,14,418,432
51763,2016-12-14,10,9,188,197
51764,2016-12-14,11,32,197,229
51765,2016-12-14,12,21,270,291
51766,2016-12-14,13,39,226,265
51767,2016-12-14,14,45,234,279
51768,2016-12-14,15,46,296,342
51769,2016-12-14,16,35,504,539
51770,2016-12-14,17,60,926,986
51771,2016-12-14,18,38,786,824
51772,2016-12-14,19,27,475,502
51773,2016-12-14,20,28,276,304
51774,2016-12-14,21,6,211,217
51775,2016-12-14,22,16,111,127
51776,2016-12-14,23,4,67,71
51777,2016-12-15,0,5,35,40
51778,2016-12-15,1,1,16,17
51779,2016-12-15,2,2,5,7
51780,2016-12-15,4,2,6,8
51781,2016-12-15,5,0,58,58
51782,2016-12-15,6,0,170,170
51783,2016-12-15,7,7,455,462
51784,2016-12-15,8,15,744,759
51785,2016-12-15,9,15,310,325
51786,2016-12-15,10,11,137,148
51787,2016-12-15,11,4,102,106
51788,2016-12-15,12,10,145,155
51789,2016-12-15,13,3,134,137
51790,2016-12-15,14,9,126,135
51791,2016-12-15,15,7,175,182
51792,2016-12-15,16,6,279,285
51793,2016-12-15,17,22,499,521
51794,2016-12-15,18,16,418,434
51795,2016-12-15,19,2,220,222
51796,2016-12-15,20,2,154,156
51797,2016-12-15,21,5,121,126
51798,2016-12-15,22,3,59,62
51799,2016-12-15,23,1,40,41
51800,2016-12-16,0,0,19,19
51801,2016-12-16,1,1,9,10
51802,2016-12-16,2,0,1,1
51803,2016-12-16,3,0,1,1
51804,2016-12-16,4,1,5,6
51805,2016-12-16,5,0,36,36
51806,2016-12-16,6,0,121,121
51807,2016-12-16,7,7,314,321
51808,2016-12-16,8,9,612,621
51809,2016-12-16,9,4,334,338
51810,2016-12-16,10,12,149,161
51811,2016-12-16,11,6,182,188
51812,2016-12-16,12,10,189,199
51813,2016-12-16,13,18,180,198
51814,2016-12-16,14,13,164,177
51815,2016-12-16,15,12,247,259
51816,2016-12-16,16,25,340,365
51817,2016-12-16,17,29,460,489
51818,2016-12-16,18,18,396,414
51819,2016-12-16,19,11,184,195
51820,2016-12-16,20,12,131,143
51821,2016-12-16,21,9,102,111
51822,2016-12-16,22,9,76,85
51823,2016-12-16,23,4,55,59
51824,2016-12-17,0,2,41,43
51825,2016-12-17,1,8,36,44
51826,2016-12-17,2,5,17,22
51827,2016-12-17,3,1,10,11
51828,2016-12-17,4,0,6,6
51829,2016-12-17,5,0,3,3
51830,2016-12-17,6,0,4,4
51831,2016-12-17,7,1,10,11
51832,2016-12-17,8,2,18,20
51833,2016-12-17,9,0,27,27
51834,2016-12-17,10,2,52,54
51835,2016-12-17,11,2,51,53
51836,2016-12-17,12,4,127,131
51837,2016-12-17,13,13,107,120
51838,2016-12-17,14,23,200,223
51839,2016-12-17,15,40,228,268
51840,2016-12-17,16,32,263,295
51841,2016-12-17,17,32,225,257
51842,2016-12-17,18,18,177,195
51843,2016-12-17,19,15,133,148
51844,2016-12-17,20,6,112,118
51845,2016-12-17,21,16,96,112
51846,2016-12-17,22,4,75,79
51847,2016-12-17,23,7,68,75
51848,2016-12-18,0,11,53,64
51849,2016-12-18,1,5,51,56
51850,2016-12-18,2,13,31,44
51851,2016-12-18,3,3,26,29
51852,2016-12-18,4,1,5,6
51853,2016-12-18,5,2,7,9
51854,2016-12-18,6,1,5,6
51855,2016-12-18,7,7,31,38
51856,2016-12-18,8,9,83,92
51857,2016-12-18,9,20,111,131
51858,2016-12-18,10,26,220,246
51859,2016-12-18,11,42,268,310
51860,2016-12-18,12,73,306,379
51861,2016-12-18,13,62,275,337
51862,2016-12-18,14,23,176,199
51863,2016-12-18,15,25,204,229
51864,2016-12-18,16,28,266,294
51865,2016-12-18,17,26,188,214
51866,2016-12-18,18,10,193,203
51867,2016-12-18,19,12,150,162
51868,2016-12-18,20,5,70,75
51869,2016-12-18,21,10,92,102
51870,2016-12-18,22,9,49,58
51871,2016-12-18,23,2,28,30
51872,2016-12-19,0,2,12,14
51873,2016-12-19,1,0,7,7
51874,2016-12-19,2,1,1,2
51875,2016-12-19,3,0,1,1
51876,2016-12-19,4,5,5,10
51877,2016-12-19,5,2,49,51
51878,2016-12-19,6,4,167,171
51879,2016-12-19,7,8,492,500
51880,2016-12-19,8,5,763,768
51881,2016-12-19,9,23,395,418
51882,2016-12-19,10,32,159,191
51883,2016-12-19,11,39,189,228
51884,2016-12-19,12,50,262,312
51885,2016-12-19,13,65,221,286
51886,2016-12-19,14,56,198,254
51887,2016-12-19,15,66,264,330
51888,2016-12-19,16,45,399,444
51889,2016-12-19,17,31,753,784
51890,2016-12-19,18,25,651,676
51891,2016-12-19,19,8,375,383
51892,2016-12-19,20,9,219,228
51893,2016-12-19,21,7,132,139
51894,2016-12-19,22,9,67,76
51895,2016-12-19,23,1,53,54
51896,2016-12-20,0,6,23,29
51897,2016-12-20,1,0,16,16
51898,2016-12-20,2,0,5,5
51899,2016-12-20,3,1,1,2
51900,2016-12-20,4,0,5,5
51901,2016-12-20,5,1,73,74
51902,2016-12-20,6,3,188,191
51903,2016-12-20,7,3,466,469
51904,2016-12-20,8,13,773,786
51905,2016-12-20,9,18,382,400
51906,2016-12-20,10,23,161,184
51907,2016-12-20,11,43,199,242
51908,2016-12-20,12,43,225,268
51909,2016-12-20,13,39,212,251
51910,2016-12-20,14,40,207,247
51911,2016-12-20,15,29,259,288
51912,2016-12-20,16,28,408,436
51913,2016-12-20,17,35,699,734
51914,2016-12-20,18,24,585,609
51915,2016-12-20,19,11,333,344
51916,2016-12-20,20,10,220,230
51917,2016-12-20,21,10,157,167
51918,2016-12-20,22,1,82,83
51919,2016-12-20,23,3,43,46
51920,2016-12-21,0,0,19,19
51921,2016-12-21,1,0,3,3
51922,2016-12-21,2,0,3,3
51923,2016-12-21,3,0,3,3
51924,2016-12-21,4,2,8,10
51925,2016-12-21,5,2,61,63
51926,2016-12-21,6,1,166,167
51927,2016-12-21,7,6,465,471
51928,2016-12-21,8,19,756,775
51929,2016-12-21,9,23,434,457
51930,2016-12-21,10,27,200,227
51931,2016-12-21,11,39,219,258
51932,2016-12-21,12,50,289,339
51933,2016-12-21,13,50,269,319
51934,2016-12-21,14,66,253,319
51935,2016-12-21,15,66,293,359
51936,2016-12-21,16,56,460,516
51937,2016-12-21,17,40,756,796
51938,2016-12-21,18,40,546,586
51939,2016-12-21,19,25,374,399
51940,2016-12-21,20,19,171,190
51941,2016-12-21,21,6,135,141
51942,2016-12-21,22,13,94,107
51943,2016-12-21,23,10,50,60
51944,2016-12-22,0,4,26,30
51945,2016-12-22,1,0,11,11
51946,2016-12-22,2,0,8,8
51947,2016-12-22,3,0,4,4
51948,2016-12-22,4,1,2,3
51949,2016-12-22,5,6,39,45
51950,2016-12-22,6,8,149,157
51951,2016-12-22,7,6,407,413
51952,2016-12-22,8,22,671,693
51953,2016-12-22,9,33,415,448
51954,2016-12-22,10,38,195,233
51955,2016-12-22,11,62,247,309
51956,2016-12-22,12,59,320,379
51957,2016-12-22,13,94,346,440
51958,2016-12-22,14,91,281,372
51959,2016-12-22,15,69,306,375
51960,2016-12-22,16,44,465,509
51961,2016-12-22,17,46,576,622
51962,2016-12-22,18,29,427,456
51963,2016-12-22,19,15,249,264
51964,2016-12-22,20,19,162,181
51965,2016-12-22,21,9,109,118
51966,2016-12-22,22,10,60,70
51967,2016-12-22,23,5,42,47
51968,2016-12-23,0,2,25,27
51969,2016-12-23,1,1,17,18
51970,2016-12-23,2,1,4,5
51971,2016-12-23,3,3,1,4
51972,2016-12-23,4,1,3,4
51973,2016-12-23,5,0,35,35
51974,2016-12-23,6,1,79,80
51975,2016-12-23,7,4,192,196
51976,2016-12-23,8,21,376,397
51977,2016-12-23,9,22,255,277
51978,2016-12-23,10,44,176,220
51979,2016-12-23,11,47,195,242
51980,2016-12-23,12,34,274,308
51981,2016-12-23,13,56,315,371
51982,2016-12-23,14,65,345,410
51983,2016-12-23,15,56,341,397
51984,2016-12-23,16,51,310,361
51985,2016-12-23,17,37,240,277
51986,2016-12-23,18,16,180,196
51987,2016-12-23,19,21,91,112
51988,2016-12-23,20,13,86,99
51989,2016-12-23,21,10,72,82
51990,2016-12-23,22,11,39,50
51991,2016-12-23,23,6,34,40
51992,2016-12-24,0,5,23,28
51993,2016-12-24,1,1,20,21
51994,2016-12-24,2,0,13,13
51995,2016-12-24,3,0,9,9
51996,2016-12-24,4,5,4,9
51997,2016-12-24,5,0,1,1
51998,2016-12-24,6,0,2,2
51999,2016-12-24,7,0,10,10
52000,2016-12-24,8,2,14,16
52001,2016-12-24,9,2,26,28
52002,2016-12-24,10,2,42,44
52003,2016-12-24,11,3,80,83
52004,2016-12-24,12,17,111,128
52005,2016-12-24,13,33,125,158
52006,2016-12-24,14,45,113,158
52007,2016-12-24,15,45,93,138
52008,2016-12-24,16,41,93,134
52009,2016-12-24,17,38,79,117
52010,2016-12-24,18,11,68,79
52011,2016-12-24,19,13,57,70
52012,2016-12-24,20,4,25,29
52013,2016-12-24,21,7,31,38
52014,2016-12-24,22,4,35,39
52015,2016-12-24,23,3,17,20
52016,2016-12-25,0,0,11,11
52017,2016-12-25,1,4,8,12
52018,2016-12-25,2,3,8,11
52019,2016-12-25,3,0,1,1
52020,2016-12-25,5,1,7,8
52021,2016-12-25,6,1,9,10
52022,2016-12-25,7,1,6,7
52023,2016-12-25,8,6,15,21
52024,2016-12-25,9,11,34,45
52025,2016-12-25,10,50,58,108
52026,2016-12-25,11,114,75,189
52027,2016-12-25,12,161,70,231
52028,2016-12-25,13,198,109,307
52029,2016-12-25,14,206,87,293
52030,2016-12-25,15,178,115,293
52031,2016-12-25,16,152,98,250
52032,2016-12-25,17,60,58,118
52033,2016-12-25,18,30,42,72
52034,2016-12-25,19,26,29,55
52035,2016-12-25,20,11,21,32
52036,2016-12-25,21,13,25,38
52037,2016-12-25,22,5,18,23
52038,2016-12-25,23,8,11,19
52039,2016-12-26,0,11,10,21
52040,2016-12-26,1,2,4,6
52041,2016-12-26,2,3,4,7
52042,2016-12-26,4,0,2,2
52043,2016-12-26,5,1,6,7
52044,2016-12-26,6,4,16,20
52045,2016-12-26,7,5,29,34
52046,2016-12-26,8,21,32,53
52047,2016-12-26,9,40,74,114
52048,2016-12-26,10,45,72,117
52049,2016-12-26,11,57,117,174
52050,2016-12-26,12,82,107,189
52051,2016-12-26,13,97,116,213
52052,2016-12-26,14,92,112,204
52053,2016-12-26,15,90,170,260
52054,2016-12-26,16,111,169,280
52055,2016-12-26,17,42,141,183
52056,2016-12-26,18,36,115,151
52057,2016-12-26,19,28,87,115
52058,2016-12-26,20,25,56,81
52059,2016-12-26,21,16,48,64
52060,2016-12-26,22,6,36,42
52061,2016-12-26,23,4,19,23
52062,2016-12-27,0,4,11,15
52063,2016-12-27,1,4,7,11
52064,2016-12-27,2,0,2,2
52065,2016-12-27,4,2,1,3
52066,2016-12-27,5,0,32,32
52067,2016-12-27,6,2,99,101
52068,2016-12-27,7,11,203,214
52069,2016-12-27,8,25,328,353
52070,2016-12-27,9,58,257,315
52071,2016-12-27,10,79,145,224
52072,2016-12-27,11,126,164,290
52073,2016-12-27,12,114,237,351
52074,2016-12-27,13,184,242,426
52075,2016-12-27,14,239,242,481
52076,2016-12-27,15,230,303,533
52077,2016-12-27,16,209,389,598
52078,2016-12-27,17,160,530,690
52079,2016-12-27,18,71,390,461
52080,2016-12-27,19,40,232,272
52081,2016-12-27,20,29,150,179
52082,2016-12-27,21,26,89,115
52083,2016-12-27,22,25,66,91
52084,2016-12-27,23,7,38,45
52085,2016-12-28,0,6,16,22
52086,2016-12-28,1,4,8,12
52087,2016-12-28,2,2,5,7
52088,2016-12-28,3,1,2,3
52089,2016-12-28,4,3,5,8
52090,2016-12-28,5,3,39,42
52091,2016-12-28,6,2,129,131
52092,2016-12-28,7,11,287,298
52093,2016-12-28,8,46,468,514
52094,2016-12-28,9,87,308,395
52095,2016-12-28,10,167,170,337
52096,2016-12-28,11,191,184,375
52097,2016-12-28,12,205,266,471
52098,2016-12-28,13,221,255,476
52099,2016-12-28,14,195,214,409
52100,2016-12-28,15,217,263,480
52101,2016-12-28,16,189,414,603
52102,2016-12-28,17,139,545,684
52103,2016-12-28,18,69,387,456
52104,2016-12-28,19,59,205,264
52105,2016-12-28,20,19,118,137
52106,2016-12-28,21,29,97,126
52107,2016-12-28,22,31,64,95
52108,2016-12-28,23,14,36,50
52109,2016-12-29,0,4,13,17
52110,2016-12-29,1,8,7,15
52111,2016-12-29,2,0,6,6
52112,2016-12-29,4,0,1,1
52113,2016-12-29,5,0,13,13
52114,2016-12-29,6,1,36,37
52115,2016-12-29,7,7,117,124
52116,2016-12-29,8,6,169,175
52117,2016-12-29,9,24,153,177
52118,2016-12-29,10,37,124,161
52119,2016-12-29,11,52,137,189
52120,2016-12-29,12,80,196,276
52121,2016-12-29,13,67,191,258
52122,2016-12-29,14,104,202,306
52123,2016-12-29,15,124,265,389
52124,2016-12-29,16,122,372,494
52125,2016-12-29,17,78,515,593
52126,2016-12-29,18,34,358,392
52127,2016-12-29,19,24,214,238
52128,2016-12-29,20,16,108,124
52129,2016-12-29,21,22,99,121
52130,2016-12-29,22,19,70,89
52131,2016-12-29,23,13,45,58
52132,2016-12-30,0,3,15,18
52133,2016-12-30,1,4,16,20
52134,2016-12-30,2,4,11,15
52135,2016-12-30,3,0,3,3
52136,2016-12-30,4,0,1,1
52137,2016-12-30,5,1,23,24
52138,2016-12-30,6,7,89,96
52139,2016-12-30,7,15,208,223
52140,2016-12-30,8,34,368,402
52141,2016-12-30,9,50,257,307
52142,2016-12-30,10,47,168,215
52143,2016-12-30,11,90,192,282
52144,2016-12-30,12,80,211,291
52145,2016-12-30,13,99,268,367
52146,2016-12-30,14,98,235,333
52147,2016-12-30,15,90,321,411
52148,2016-12-30,16,65,327,392
52149,2016-12-30,17,41,286,327
52150,2016-12-30,18,36,212,248
52151,2016-12-30,19,21,136,157
52152,2016-12-30,20,18,100,118
52153,2016-12-30,21,11,72,83
52154,2016-12-30,22,5,52,57
52155,2016-12-30,23,13,44,57
52156,2016-12-31,0,7,32,39
52157,2016-12-31,1,4,26,30
52158,2016-12-31,2,1,7,8
52159,2016-12-31,3,3,11,14
52160,2016-12-31,4,0,2,2
52161,2016-12-31,5,1,2,3
52162,2016-12-31,6,1,9,10
52163,2016-12-31,7,2,27,29
52164,2016-12-31,8,15,77,92
52165,2016-12-31,9,47,103,150
52166,2016-12-31,10,88,173,261
52167,2016-12-31,11,98,197,295
52168,2016-12-31,12,120,218,338
52169,2016-12-31,13,127,194,321
52170,2016-12-31,14,142,186,328
52171,2016-12-31,15,105,173,278
52172,2016-12-31,16,49,206,255
52173,2016-12-31,17,62,150,212
52174,2016-12-31,18,17,127,144
52175,2016-12-31,19,19,107,126
52176,2016-12-31,20,18,73,91
52177,2016-12-31,21,17,59,76
52178,2016-12-31,22,17,40,57
52179,2016-12-31,23,17,41,58
52180,2017-01-01,0,23,54,77
52181,2017-01-01,1,16,64,80
52182,2017-01-01,2,5,57,62
52183,2017-01-01,3,3,15,18
52184,2017-01-01,4,0,5,5
52185,2017-01-01,5,2,3,5
52186,2017-01-01,6,1,7,8
52187,2017-01-01,7,4,20,24
52188,2017-01-01,8,7,46,53
52189,2017-01-01,9,15,93,108
52190,2017-01-01,10,50,118,168
52191,2017-01-01,11,85,163,248
52192,2017-01-01,12,169,206,375
52193,2017-01-01,13,197,223,420
52194,2017-01-01,14,306,216,522
52195,2017-01-01,15,271,275,546
52196,2017-01-01,16,136,254,390
52197,2017-01-01,17,129,172,301
52198,2017-01-01,18,55,129,184
52199,2017-01-01,19,32,130,162
52200,2017-01-01,20,29,81,110
52201,2017-01-01,21,25,66,91
52202,2017-01-01,22,10,50,60
52203,2017-01-01,23,10,36,46
52204,2017-01-02,0,22,22,44
52205,2017-01-02,1,14,8,22
52206,2017-01-02,2,1,5,6
52207,2017-01-02,3,0,1,1
52208,2017-01-02,4,0,2,2
52209,2017-01-02,5,0,10,10
52210,2017-01-02,6,1,19,20
52211,2017-01-02,7,2,31,33
52212,2017-01-02,8,8,33,41
52213,2017-01-02,9,9,41,50
52214,2017-01-02,10,11,65,76
52215,2017-01-02,11,15,104,119
52216,2017-01-02,12,7,96,103
52217,2017-01-02,13,11,83,94
52218,2017-01-02,14,6,79,85
52219,2017-01-02,15,9,89,98
52220,2017-01-02,16,15,128,143
52221,2017-01-02,17,14,157,171
52222,2017-01-02,18,6,144,150
52223,2017-01-02,19,8,106,114
52224,2017-01-02,20,8,87,95
52225,2017-01-02,21,7,70,77
52226,2017-01-02,22,2,48,50
52227,2017-01-02,23,5,28,33
52228,2017-01-03,0,1,12,13
52229,2017-01-03,1,1,4,5
52230,2017-01-03,2,0,2,2
52231,2017-01-03,4,0,2,2
52232,2017-01-03,5,0,47,47
52233,2017-01-03,6,2,87,89
52234,2017-01-03,7,3,127,130
52235,2017-01-03,8,5,173,178
52236,2017-01-03,9,3,54,57
52237,2017-01-03,10,4,33,37
52238,2017-01-03,11,8,44,52
52239,2017-01-03,12,11,71,82
52240,2017-01-03,13,12,113,125
52241,2017-01-03,14,10,119,129
52242,2017-01-03,15,17,204,221
52243,2017-01-03,16,30,361,391
52244,2017-01-03,17,39,727,766
52245,2017-01-03,18,26,611,637
52246,2017-01-03,19,31,307,338
52247,2017-01-03,20,9,186,195
52248,2017-01-03,21,22,120,142
52249,2017-01-03,22,15,82,97
52250,2017-01-03,23,5,31,36
52251,2017-01-04,0,5,11,16
52252,2017-01-04,1,3,5,8
52253,2017-01-04,2,3,3,6
52254,2017-01-04,3,1,0,1
52255,2017-01-04,4,0,8,8
52256,2017-01-04,5,1,65,66
52257,2017-01-04,6,4,230,234
52258,2017-01-04,7,12,621,633
52259,2017-01-04,8,24,921,945
52260,2017-01-04,9,27,396,423
52261,2017-01-04,10,18,95,113
52262,2017-01-04,11,42,152,194
52263,2017-01-04,12,49,227,276
52264,2017-01-04,13,73,226,299
52265,2017-01-04,14,132,209,341
52266,2017-01-04,15,99,304,403
52267,2017-01-04,16,102,486,588
52268,2017-01-04,17,60,903,963
52269,2017-01-04,18,30,708,738
52270,2017-01-04,19,22,400,422
52271,2017-01-04,20,17,188,205
52272,2017-01-04,21,12,155,167
52273,2017-01-04,22,9,80,89
52274,2017-01-04,23,3,44,47
52275,2017-01-05,0,3,20,23
52276,2017-01-05,1,5,4,9
52277,2017-01-05,2,1,1,2
52278,2017-01-05,3,1,1,2
52279,2017-01-05,4,0,2,2
52280,2017-01-05,5,0,61,61
52281,2017-01-05,6,1,207,208
52282,2017-01-05,7,10,537,547
52283,2017-01-05,8,17,832,849
52284,2017-01-05,9,14,402,416
52285,2017-01-05,10,21,153,174
52286,2017-01-05,11,36,175,211
52287,2017-01-05,12,32,198,230
52288,2017-01-05,13,42,218,260
52289,2017-01-05,14,26,196,222
52290,2017-01-05,15,39,243,282
52291,2017-01-05,16,48,380,428
52292,2017-01-05,17,35,742,777
52293,2017-01-05,18,20,591,611
52294,2017-01-05,19,14,362,376
52295,2017-01-05,20,12,225,237
52296,2017-01-05,21,14,122,136
52297,2017-01-05,22,7,99,106
52298,2017-01-05,23,3,41,44
52299,2017-01-06,0,3,16,19
52300,2017-01-06,1,1,4,5
52301,2017-01-06,2,2,5,7
52302,2017-01-06,3,0,2,2
52303,2017-01-06,4,0,3,3
52304,2017-01-06,5,2,48,50
52305,2017-01-06,6,2,148,150
52306,2017-01-06,7,3,436,439
52307,2017-01-06,8,13,774,787
52308,2017-01-06,9,14,392,406
52309,2017-01-06,10,14,145,159
52310,2017-01-06,11,32,178,210
52311,2017-01-06,12,37,229,266
52312,2017-01-06,13,36,213,249
52313,2017-01-06,14,22,202,224
52314,2017-01-06,15,23,256,279
52315,2017-01-06,16,22,384,406
52316,2017-01-06,17,32,689,721
52317,2017-01-06,18,15,485,500
52318,2017-01-06,19,16,242,258
52319,2017-01-06,20,4,157,161
52320,2017-01-06,21,9,110,119
52321,2017-01-06,22,5,87,92
52322,2017-01-06,23,2,56,58
52323,2017-01-07,0,0,42,42
52324,2017-01-07,1,3,36,39
52325,2017-01-07,2,5,16,21
52326,2017-01-07,3,0,7,7
52327,2017-01-07,4,0,4,4
52328,2017-01-07,5,1,4,5
52329,2017-01-07,6,0,9,9
52330,2017-01-07,7,1,56,57
52331,2017-01-07,8,6,93,99
52332,2017-01-07,9,7,128,135
52333,2017-01-07,10,18,179,197
52334,2017-01-07,11,14,169,183
52335,2017-01-07,12,12,103,115
52336,2017-01-07,13,9,81,90
52337,2017-01-07,14,4,94,98
52338,2017-01-07,15,11,119,130
52339,2017-01-07,16,12,114,126
52340,2017-01-07,17,10,101,111
52341,2017-01-07,18,7,99,106
52342,2017-01-07,19,4,60,64
52343,2017-01-07,20,2,61,63
52344,2017-01-07,21,1,34,35
52345,2017-01-07,22,1,36,37
52346,2017-01-07,23,3,33,36
52347,2017-01-08,0,1,32,33
52348,2017-01-08,1,0,19,19
52349,2017-01-08,2,0,12,12
52350,2017-01-08,3,0,7,7
52351,2017-01-08,5,0,1,1
52352,2017-01-08,6,0,8,8
52353,2017-01-08,7,1,21,22
52354,2017-01-08,8,5,63,68
52355,2017-01-08,9,7,64,71
52356,2017-01-08,10,7,137,144
52357,2017-01-08,11,16,127,143
52358,2017-01-08,12,7,187,194
52359,2017-01-08,13,27,149,176
52360,2017-01-08,14,15,134,149
52361,2017-01-08,15,16,177,193
52362,2017-01-08,16,14,151,165
52363,2017-01-08,17,6,143,149
52364,2017-01-08,18,8,94,102
52365,2017-01-08,19,2,81,83
52366,2017-01-08,20,1,67,68
52367,2017-01-08,21,3,45,48
52368,2017-01-08,22,4,44,48
52369,2017-01-08,23,2,15,17
52370,2017-01-09,0,0,6,6
52371,2017-01-09,1,0,2,2
52372,2017-01-09,2,1,3,4
52373,2017-01-09,4,1,3,4
52374,2017-01-09,5,0,55,55
52375,2017-01-09,6,0,167,167
52376,2017-01-09,7,6,390,396
52377,2017-01-09,8,14,594,608
52378,2017-01-09,9,11,295,306
52379,2017-01-09,10,6,119,125
52380,2017-01-09,11,19,108,127
52381,2017-01-09,12,13,164,177
52382,2017-01-09,13,17,140,157
52383,2017-01-09,14,19,127,146
52384,2017-01-09,15,17,154,171
52385,2017-01-09,16,17,304,321
52386,2017-01-09,17,14,621,635
52387,2017-01-09,18,9,520,529
52388,2017-01-09,19,8,302,310
52389,2017-01-09,20,9,163,172
52390,2017-01-09,21,4,109,113
52391,2017-01-09,22,4,52,56
52392,2017-01-09,23,5,25,30
52393,2017-01-10,0,0,21,21
52394,2017-01-10,1,1,7,8
52395,2017-01-10,2,0,2,2
52396,2017-01-10,4,0,1,1
52397,2017-01-10,5,0,51,51
52398,2017-01-10,6,0,187,187
52399,2017-01-10,7,15,458,473
52400,2017-01-10,8,26,748,774
52401,2017-01-10,9,16,349,365
52402,2017-01-10,10,10,136,146
52403,2017-01-10,11,12,141,153
52404,2017-01-10,12,16,176,192
52405,2017-01-10,13,13,203,216
52406,2017-01-10,14,17,175,192
52407,2017-01-10,15,15,207,222
52408,2017-01-10,16,25,375,400
52409,2017-01-10,17,16,696,712
52410,2017-01-10,18,11,589,600
52411,2017-01-10,19,10,337,347
52412,2017-01-10,20,12,226,238
52413,2017-01-10,21,3,146,149
52414,2017-01-10,22,10,91,101
52415,2017-01-10,23,16,40,56
52416,2017-01-11,0,5,14,19
52417,2017-01-11,1,1,4,5
52418,2017-01-11,2,1,3,4
52419,2017-01-11,3,0,1,1
52420,2017-01-11,4,0,4,4
52421,2017-01-11,5,1,52,53
52422,2017-01-11,6,4,227,231
52423,2017-01-11,7,14,581,595
52424,2017-01-11,8,32,979,1011
52425,2017-01-11,9,27,456,483
52426,2017-01-11,10,38,189,227
52427,2017-01-11,11,46,212,258
52428,2017-01-11,12,53,276,329
52429,2017-01-11,13,49,250,299
52430,2017-01-11,14,70,239,309
52431,2017-01-11,15,57,295,352
52432,2017-01-11,16,62,470,532
52433,2017-01-11,17,52,935,987
52434,2017-01-11,18,29,754,783
52435,2017-01-11,19,5,254,259
52436,2017-01-11,20,5,167,172
52437,2017-01-11,21,11,141,152
52438,2017-01-11,22,16,108,124
52439,2017-01-11,23,11,67,78
52440,2017-01-12,0,4,26,30
52441,2017-01-12,1,1,13,14
52442,2017-01-12,2,2,2,4
52443,2017-01-12,3,0,5,5
52444,2017-01-12,4,1,8,9
52445,2017-01-12,5,0,54,54
52446,2017-01-12,6,7,230,237
52447,2017-01-12,7,11,652,663
52448,2017-01-12,8,36,1042,1078
52449,2017-01-12,9,39,434,473
52450,2017-01-12,10,40,194,234
52451,2017-01-12,11,56,223,279
52452,2017-01-12,12,66,300,366
52453,2017-01-12,13,62,329,391
52454,2017-01-12,14,74,288,362
52455,2017-01-12,15,100,395,495
52456,2017-01-12,16,84,597,681
52457,2017-01-12,17,111,1059,1170
52458,2017-01-12,18,78,889,967
52459,2017-01-12,19,56,540,596
52460,2017-01-12,20,31,358,389
52461,2017-01-12,21,33,268,301
52462,2017-01-12,22,28,153,181
52463,2017-01-12,23,23,88,111
52464,2017-01-13,0,17,43,60
52465,2017-01-13,1,20,23,43
52466,2017-01-13,2,3,10,13
52467,2017-01-13,3,2,2,4
52468,2017-01-13,4,2,8,10
52469,2017-01-13,5,2,65,67
52470,2017-01-13,6,1,193,194
52471,2017-01-13,7,11,592,603
52472,2017-01-13,8,33,1021,1054
52473,2017-01-13,9,33,472,505
52474,2017-01-13,10,35,208,243
52475,2017-01-13,11,55,246,301
52476,2017-01-13,12,62,322,384
52477,2017-01-13,13,85,322,407
52478,2017-01-13,14,109,323,432
52479,2017-01-13,15,104,383,487
52480,2017-01-13,16,106,580,686
52481,2017-01-13,17,72,826,898
52482,2017-01-13,18,37,598,635
52483,2017-01-13,19,22,387,409
52484,2017-01-13,20,30,167,197
52485,2017-01-13,21,26,143,169
52486,2017-01-13,22,21,117,138
52487,2017-01-13,23,10,81,91
52488,2017-01-14,0,6,58,64
52489,2017-01-14,1,6,49,55
52490,2017-01-14,2,6,31,37
52491,2017-01-14,3,1,11,12
52492,2017-01-14,4,1,3,4
52493,2017-01-14,5,1,4,5
52494,2017-01-14,6,0,21,21
52495,2017-01-14,7,1,43,44
52496,2017-01-14,8,0,75,75
52497,2017-01-14,9,10,115,125
52498,2017-01-14,10,9,135,144
52499,2017-01-14,11,9,166,175
52500,2017-01-14,12,14,121,135
52501,2017-01-14,13,10,93,103
52502,2017-01-14,14,21,124,145
52503,2017-01-14,15,21,181,202
52504,2017-01-14,16,11,102,113
52505,2017-01-14,17,4,72,76
52506,2017-01-14,18,2,61,63
52507,2017-01-14,19,6,45,51
52508,2017-01-14,20,6,36,42
52509,2017-01-14,21,4,50,54
52510,2017-01-14,22,5,52,57
52511,2017-01-14,23,11,51,62
52512,2017-01-15,0,2,50,52
52513,2017-01-15,1,0,35,35
52514,2017-01-15,2,3,19,22
52515,2017-01-15,3,1,12,13
52516,2017-01-15,4,0,6,6
52517,2017-01-15,5,2,5,7
52518,2017-01-15,6,0,15,15
52519,2017-01-15,7,5,33,38
52520,2017-01-15,8,15,79,94
52521,2017-01-15,9,35,167,202
52522,2017-01-15,10,80,271,351
52523,2017-01-15,11,77,328,405
52524,2017-01-15,12,143,376,519
52525,2017-01-15,13,212,431,643
52526,2017-01-15,14,194,383,577
52527,2017-01-15,15,214,401,615
52528,2017-01-15,16,185,336,521
52529,2017-01-15,17,93,258,351
52530,2017-01-15,18,62,198,260
52531,2017-01-15,19,32,134,166
52532,2017-01-15,20,26,138,164
52533,2017-01-15,21,27,103,130
52534,2017-01-15,22,19,76,95
52535,2017-01-15,23,9,58,67
52536,2017-01-16,0,10,33,43
52537,2017-01-16,1,2,24,26
52538,2017-01-16,2,5,4,9
52539,2017-01-16,3,3,10,13
52540,2017-01-16,4,2,2,4
52541,2017-01-16,5,0,14,14
52542,2017-01-16,6,1,39,40
52543,2017-01-16,7,2,109,111
52544,2017-01-16,8,14,186,200
52545,2017-01-16,9,42,178,220
52546,2017-01-16,10,24,219,243
52547,2017-01-16,11,55,275,330
52548,2017-01-16,12,49,328,377
52549,2017-01-16,13,63,282,345
52550,2017-01-16,14,69,321,390
52551,2017-01-16,15,60,315,375
52552,2017-01-16,16,57,325,382
52553,2017-01-16,17,39,336,375
52554,2017-01-16,18,33,308,341
52555,2017-01-16,19,14,208,222
52556,2017-01-16,20,7,170,177
52557,2017-01-16,21,15,104,119
52558,2017-01-16,22,12,91,103
52559,2017-01-16,23,0,26,26
52560,2017-01-17,0,0,16,16
52561,2017-01-17,1,1,7,8
52562,2017-01-17,2,1,6,7
52563,2017-01-17,4,0,9,9
52564,2017-01-17,5,3,63,66
52565,2017-01-17,6,4,224,228
52566,2017-01-17,7,4,548,552
52567,2017-01-17,8,24,846,870
52568,2017-01-17,9,7,276,283
52569,2017-01-17,10,4,52,56
52570,2017-01-17,11,2,137,139
52571,2017-01-17,12,16,174,190
52572,2017-01-17,13,4,149,153
52573,2017-01-17,14,5,76,81
52574,2017-01-17,15,2,113,115
52575,2017-01-17,16,8,331,339
52576,2017-01-17,17,20,692,712
52577,2017-01-17,18,30,655,685
52578,2017-01-17,19,8,412,420
52579,2017-01-17,20,12,288,300
52580,2017-01-17,21,12,176,188
52581,2017-01-17,22,7,93,100
52582,2017-01-17,23,9,48,57
52583,2017-01-18,0,2,14,16
52584,2017-01-18,1,0,8,8
52585,2017-01-18,2,0,6,6
52586,2017-01-18,3,2,4,6
52587,2017-01-18,4,0,4,4
52588,2017-01-18,5,0,58,58
52589,2017-01-18,6,6,205,211
52590,2017-01-18,7,14,547,561
52591,2017-01-18,8,38,885,923
52592,2017-01-18,9,10,411,421
52593,2017-01-18,10,34,216,250
52594,2017-01-18,11,29,238,267
52595,2017-01-18,12,49,316,365
52596,2017-01-18,13,48,280,328
52597,2017-01-18,14,37,250,287
52598,2017-01-18,15,55,295,350
52599,2017-01-18,16,47,428,475
52600,2017-01-18,17,65,804,869
52601,2017-01-18,18,28,709,737
52602,2017-01-18,19,27,454,481
52603,2017-01-18,20,8,299,307
52604,2017-01-18,21,14,211,225
52605,2017-01-18,22,14,115,129
52606,2017-01-18,23,8,53,61
52607,2017-01-19,0,6,28,34
52608,2017-01-19,1,5,9,14
52609,2017-01-19,2,4,6,10
52610,2017-01-19,4,1,4,5
52611,2017-01-19,5,3,46,49
52612,2017-01-19,6,4,162,166
52613,2017-01-19,7,14,448,462
52614,2017-01-19,8,38,693,731
52615,2017-01-19,9,26,406,432
52616,2017-01-19,10,38,209,247
52617,2017-01-19,11,54,236,290
52618,2017-01-19,12,93,306,399
52619,2017-01-19,13,70,299,369
52620,2017-01-19,14,89,274,363
52621,2017-01-19,15,116,345,461
52622,2017-01-19,16,83,441,524
52623,2017-01-19,17,115,678,793
52624,2017-01-19,18,82,625,707
52625,2017-01-19,19,60,409,469
52626,2017-01-19,20,31,263,294
52627,2017-01-19,21,51,220,271
52628,2017-01-19,22,34,157,191
52629,2017-01-19,23,13,80,93
52630,2017-01-20,0,8,71,79
52631,2017-01-20,1,15,37,52
52632,2017-01-20,2,5,26,31
52633,2017-01-20,3,5,14,19
52634,2017-01-20,4,0,18,18
52635,2017-01-20,5,15,44,59
52636,2017-01-20,6,17,78,95
52637,2017-01-20,7,35,143,178
52638,2017-01-20,8,49,233,282
52639,2017-01-20,9,75,194,269
52640,2017-01-20,10,91,270,361
52641,2017-01-20,11,112,297,409
52642,2017-01-20,12,109,283,392
52643,2017-01-20,13,151,292,443
52644,2017-01-20,14,138,280,418
52645,2017-01-20,15,102,255,357
52646,2017-01-20,16,119,290,409
52647,2017-01-20,17,84,314,398
52648,2017-01-20,18,55,281,336
52649,2017-01-20,19,46,245,291
52650,2017-01-20,20,40,192,232
52651,2017-01-20,21,43,134,177
52652,2017-01-20,22,34,105,139
52653,2017-01-20,23,35,86,121
52654,2017-01-21,0,27,70,97
52655,2017-01-21,1,25,37,62
52656,2017-01-21,2,12,24,36
52657,2017-01-21,3,0,9,9
52658,2017-01-21,4,1,7,8
52659,2017-01-21,5,9,11,20
52660,2017-01-21,6,19,30,49
52661,2017-01-21,7,50,109,159
52662,2017-01-21,8,197,336,533
52663,2017-01-21,9,390,444,834
52664,2017-01-21,10,312,348,660
52665,2017-01-21,11,232,295,527
52666,2017-01-21,12,254,334,588
52667,2017-01-21,13,259,290,549
52668,2017-01-21,14,307,406,713
52669,2017-01-21,15,367,449,816
52670,2017-01-21,16,350,424,774
52671,2017-01-21,17,224,301,525
52672,2017-01-21,18,125,228,353
52673,2017-01-21,19,69,172,241
52674,2017-01-21,20,48,140,188
52675,2017-01-21,21,54,104,158
52676,2017-01-21,22,48,92,140
52677,2017-01-21,23,32,85,117
52678,2017-01-22,0,24,73,97
52679,2017-01-22,1,24,54,78
52680,2017-01-22,2,17,23,40
52681,2017-01-22,3,5,12,17
52682,2017-01-22,4,1,3,4
52683,2017-01-22,5,1,3,4
52684,2017-01-22,6,0,12,12
52685,2017-01-22,7,11,29,40
52686,2017-01-22,8,25,71,96
52687,2017-01-22,9,55,166,221
52688,2017-01-22,10,92,252,344
52689,2017-01-22,11,164,286,450
52690,2017-01-22,12,172,365,537
52691,2017-01-22,13,196,359,555
52692,2017-01-22,14,151,296,447
52693,2017-01-22,15,29,124,153
52694,2017-01-22,16,82,147,229
52695,2017-01-22,17,47,152,199
52696,2017-01-22,18,22,133,155
52697,2017-01-22,19,23,117,140
52698,2017-01-22,20,12,65,77
52699,2017-01-22,21,10,68,78
52700,2017-01-22,22,14,55,69
52701,2017-01-22,23,3,21,24
52702,2017-01-23,0,12,7,19
52703,2017-01-23,1,1,6,7
52704,2017-01-23,2,0,4,4
52705,2017-01-23,3,4,0,4
52706,2017-01-23,4,0,3,3
52707,2017-01-23,5,0,38,38
52708,2017-01-23,6,0,124,124
52709,2017-01-23,7,3,217,220
52710,2017-01-23,8,10,277,287
52711,2017-01-23,9,8,133,141
52712,2017-01-23,10,7,49,56
52713,2017-01-23,11,4,50,54
52714,2017-01-23,12,3,54,57
52715,2017-01-23,13,2,38,40
52716,2017-01-23,14,0,43,43
52717,2017-01-23,15,2,86,88
52718,2017-01-23,16,2,171,173
52719,2017-01-23,17,16,434,450
52720,2017-01-23,18,18,409,427
52721,2017-01-23,19,7,265,272
52722,2017-01-23,20,7,167,174
52723,2017-01-23,21,4,121,125
52724,2017-01-23,22,7,63,70
52725,2017-01-23,23,1,28,29
52726,2017-01-24,0,1,12,13
52727,2017-01-24,1,0,10,10
52728,2017-01-24,2,0,2,2
52729,2017-01-24,4,0,5,5
52730,2017-01-24,5,0,56,56
52731,2017-01-24,6,1,222,223
52732,2017-01-24,7,6,600,606
52733,2017-01-24,8,25,926,951
52734,2017-01-24,9,13,414,427
52735,2017-01-24,10,27,191,218
52736,2017-01-24,11,32,209,241
52737,2017-01-24,12,39,214,253
52738,2017-01-24,13,36,232,268
52739,2017-01-24,14,25,199,224
52740,2017-01-24,15,21,307,328
52741,2017-01-24,16,32,528,560
52742,2017-01-24,17,39,894,933
52743,2017-01-24,18,28,807,835
52744,2017-01-24,19,28,466,494
52745,2017-01-24,20,18,315,333
52746,2017-01-24,21,21,198,219
52747,2017-01-24,22,16,116,132
52748,2017-01-24,23,8,50,58
52749,2017-01-25,0,2,15,17
52750,2017-01-25,1,1,6,7
52751,2017-01-25,2,0,5,5
52752,2017-01-25,4,0,9,9
52753,2017-01-25,5,2,83,85
52754,2017-01-25,6,4,257,261
52755,2017-01-25,7,11,726,737
52756,2017-01-25,8,46,1037,1083
52757,2017-01-25,9,19,425,444
52758,2017-01-25,10,26,168,194
52759,2017-01-25,11,44,229,273
52760,2017-01-25,12,55,287,342
52761,2017-01-25,13,72,285,357
52762,2017-01-25,14,85,278,363
52763,2017-01-25,15,104,382,486
52764,2017-01-25,16,84,615,699
52765,2017-01-25,17,87,1144,1231
52766,2017-01-25,18,61,888,949
52767,2017-01-25,19,31,567,598
52768,2017-01-25,20,13,340,353
52769,2017-01-25,21,13,257,270
52770,2017-01-25,22,19,157,176
52771,2017-01-25,23,14,70,84
52772,2017-01-26,0,1,18,19
52773,2017-01-26,1,1,9,10
52774,2017-01-26,2,1,8,9
52775,2017-01-26,3,1,5,6
52776,2017-01-26,4,0,10,10
52777,2017-01-26,5,1,57,58
52778,2017-01-26,6,2,242,244
52779,2017-01-26,7,16,681,697
52780,2017-01-26,8,36,1095,1131
52781,2017-01-26,9,29,470,499
52782,2017-01-26,10,26,191,217
52783,2017-01-26,11,31,248,279
52784,2017-01-26,12,49,311,360
52785,2017-01-26,13,30,284,314
52786,2017-01-26,14,27,280,307
52787,2017-01-26,15,42,331,373
52788,2017-01-26,16,35,485,520
52789,2017-01-26,17,32,942,974
52790,2017-01-26,18,32,752,784
52791,2017-01-26,19,24,459,483
52792,2017-01-26,20,21,325,346
52793,2017-01-26,21,7,190,197
52794,2017-01-26,22,13,125,138
52795,2017-01-26,23,6,67,73
52796,2017-01-27,0,0,25,25
52797,2017-01-27,1,1,18,19
52798,2017-01-27,2,0,2,2
52799,2017-01-27,3,0,1,1
52800,2017-01-27,4,0,7,7
52801,2017-01-27,5,1,62,63
52802,2017-01-27,6,2,180,182
52803,2017-01-27,7,16,581,597
52804,2017-01-27,8,22,932,954
52805,2017-01-27,9,20,454,474
52806,2017-01-27,10,34,196,230
52807,2017-01-27,11,38,211,249
52808,2017-01-27,12,53,280,333
52809,2017-01-27,13,51,272,323
52810,2017-01-27,14,39,212,251
52811,2017-01-27,15,41,334,375
52812,2017-01-27,16,63,493,556
52813,2017-01-27,17,56,804,860
52814,2017-01-27,18,38,544,582
52815,2017-01-27,19,14,293,307
52816,2017-01-27,20,16,169,185
52817,2017-01-27,21,11,113,124
52818,2017-01-27,22,3,117,120
52819,2017-01-27,23,5,63,68
52820,2017-01-28,0,5,54,59
52821,2017-01-28,1,12,33,45
52822,2017-01-28,2,7,23,30
52823,2017-01-28,3,4,12,16
52824,2017-01-28,4,3,9,12
52825,2017-01-28,5,0,5,5
52826,2017-01-28,6,0,14,14
52827,2017-01-28,7,1,63,64
52828,2017-01-28,8,16,123,139
52829,2017-01-28,9,41,216,257
52830,2017-01-28,10,57,280,337
52831,2017-01-28,11,88,303,391
52832,2017-01-28,12,104,380,484
52833,2017-01-28,13,144,349,493
52834,2017-01-28,14,184,361,545
52835,2017-01-28,15,180,375,555
52836,2017-01-28,16,200,355,555
52837,2017-01-28,17,142,297,439
52838,2017-01-28,18,66,276,342
52839,2017-01-28,19,26,244,270
52840,2017-01-28,20,11,138,149
52841,2017-01-28,21,21,118,139
52842,2017-01-28,22,16,118,134
52843,2017-01-28,23,7,73,80
52844,2017-01-29,0,8,62,70
52845,2017-01-29,1,9,52,61
52846,2017-01-29,2,9,39,48
52847,2017-01-29,3,3,23,26
52848,2017-01-29,4,4,5,9
52849,2017-01-29,5,1,5,6
52850,2017-01-29,6,2,7,9
52851,2017-01-29,7,4,29,33
52852,2017-01-29,8,11,86,97
52853,2017-01-29,9,12,153,165
52854,2017-01-29,10,80,262,342
52855,2017-01-29,11,86,296,382
52856,2017-01-29,12,148,490,638
52857,2017-01-29,13,127,403,530
52858,2017-01-29,14,129,350,479
52859,2017-01-29,15,103,481,584
52860,2017-01-29,16,114,473,587
52861,2017-01-29,17,67,320,387
52862,2017-01-29,18,49,202,251
52863,2017-01-29,19,31,168,199
52864,2017-01-29,20,10,137,147
52865,2017-01-29,21,22,80,102
52866,2017-01-29,22,10,55,65
52867,2017-01-29,23,2,30,32
52868,2017-01-30,0,3,12,15
52869,2017-01-30,1,2,10,12
52870,2017-01-30,2,0,5,5
52871,2017-01-30,4,0,5,5
52872,2017-01-30,5,0,49,49
52873,2017-01-30,6,0,153,153
52874,2017-01-30,7,9,376,385
52875,2017-01-30,8,12,686,698
52876,2017-01-30,9,12,304,316
52877,2017-01-30,10,10,141,151
52878,2017-01-30,11,7,140,147
52879,2017-01-30,12,16,167,183
52880,2017-01-30,13,13,178,191
52881,2017-01-30,14,15,133,148
52882,2017-01-30,15,10,200,210
52883,2017-01-30,16,8,366,374
52884,2017-01-30,17,27,766,793
52885,2017-01-30,18,14,646,660
52886,2017-01-30,19,17,408,425
52887,2017-01-30,20,8,243,251
52888,2017-01-30,21,4,141,145
52889,2017-01-30,22,7,64,71
52890,2017-01-30,23,0,33,33
52891,2017-01-31,0,1,19,20
52892,2017-01-31,1,0,7,7
52893,2017-01-31,2,0,5,5
52894,2017-01-31,3,0,4,4
52895,2017-01-31,4,0,7,7
52896,2017-01-31,5,1,57,58
52897,2017-01-31,6,0,226,226
52898,2017-01-31,7,3,569,572
52899,2017-01-31,8,20,916,936
52900,2017-01-31,9,20,427,447
52901,2017-01-31,10,13,226,239
52902,2017-01-31,11,18,206,224
52903,2017-01-31,12,35,275,310
52904,2017-01-31,13,22,225,247
52905,2017-01-31,14,30,204,234
52906,2017-01-31,15,43,337,380
52907,2017-01-31,16,55,542,597
52908,2017-01-31,17,79,981,1060
52909,2017-01-31,18,39,836,875
52910,2017-01-31,19,26,472,498
52911,2017-01-31,20,22,343,365
52912,2017-01-31,21,19,230,249
52913,2017-01-31,22,10,141,151
52914,2017-01-31,23,7,46,53
52915,2017-02-01,0,4,23,27
52916,2017-02-01,1,2,8,10
52917,2017-02-01,2,1,8,9
52918,2017-02-01,3,1,2,3
52919,2017-02-01,4,0,6,6
52920,2017-02-01,5,1,91,92
52921,2017-02-01,6,3,247,250
52922,2017-02-01,7,17,666,683
52923,2017-02-01,8,24,1095,1119
52924,2017-02-01,9,20,465,485
52925,2017-02-01,10,29,201,230
52926,2017-02-01,11,31,240,271
52927,2017-02-01,12,28,269,297
52928,2017-02-01,13,19,262,281
52929,2017-02-01,14,26,199,225
52930,2017-02-01,15,24,299,323
52931,2017-02-01,16,45,544,589
52932,2017-02-01,17,64,1075,1139
52933,2017-02-01,18,51,773,824
52934,2017-02-01,19,25,492,517
52935,2017-02-01,20,20,323,343
52936,2017-02-01,21,18,219,237
52937,2017-02-01,22,11,176,187
52938,2017-02-01,23,5,79,84
52939,2017-02-02,0,1,24,25
52940,2017-02-02,1,4,9,13
52941,2017-02-02,2,2,0,2
52942,2017-02-02,3,1,4,5
52943,2017-02-02,4,1,7,8
52944,2017-02-02,5,0,55,55
52945,2017-02-02,6,10,241,251
52946,2017-02-02,7,14,690,704
52947,2017-02-02,8,32,1077,1109
52948,2017-02-02,9,34,444,478
52949,2017-02-02,10,15,184,199
52950,2017-02-02,11,16,210,226
52951,2017-02-02,12,20,281,301
52952,2017-02-02,13,22,287,309
52953,2017-02-02,14,31,220,251
52954,2017-02-02,15,40,328,368
52955,2017-02-02,16,52,501,553
52956,2017-02-02,17,68,886,954
52957,2017-02-02,18,25,733,758
52958,2017-02-02,19,19,396,415
52959,2017-02-02,20,10,270,280
52960,2017-02-02,21,9,191,200
52961,2017-02-02,22,12,113,125
52962,2017-02-02,23,1,58,59
52963,2017-02-03,0,1,49,50
52964,2017-02-03,1,1,15,16
52965,2017-02-03,2,0,5,5
52966,2017-02-03,3,0,1,1
52967,2017-02-03,4,1,5,6
52968,2017-02-03,5,0,54,54
52969,2017-02-03,6,4,183,187
52970,2017-02-03,7,12,518,530
52971,2017-02-03,8,32,884,916
52972,2017-02-03,9,20,452,472
52973,2017-02-03,10,21,200,221
52974,2017-02-03,11,25,240,265
52975,2017-02-03,12,25,276,301
52976,2017-02-03,13,29,276,305
52977,2017-02-03,14,26,242,268
52978,2017-02-03,15,37,323,360
52979,2017-02-03,16,37,450,487
52980,2017-02-03,17,34,742,776
52981,2017-02-03,18,30,518,548
52982,2017-02-03,19,23,282,305
52983,2017-02-03,20,3,179,182
52984,2017-02-03,21,10,124,134
52985,2017-02-03,22,4,83,87
52986,2017-02-03,23,7,59,66
52987,2017-02-04,0,2,47,49
52988,2017-02-04,1,6,27,33
52989,2017-02-04,2,0,6,6
52990,2017-02-04,3,1,8,9
52991,2017-02-04,4,2,4,6
52992,2017-02-04,5,1,8,9
52993,2017-02-04,6,3,16,19
52994,2017-02-04,7,4,64,68
52995,2017-02-04,8,10,131,141
52996,2017-02-04,9,38,213,251
52997,2017-02-04,10,36,224,260
52998,2017-02-04,11,75,298,373
52999,2017-02-04,12,80,333,413
53000,2017-02-04,13,106,341,447
53001,2017-02-04,14,125,366,491
53002,2017-02-04,15,118,360,478
53003,2017-02-04,16,109,357,466
53004,2017-02-04,17,81,290,371
53005,2017-02-04,18,35,224,259
53006,2017-02-04,19,17,184,201
53007,2017-02-04,20,29,137,166
53008,2017-02-04,21,19,86,105
53009,2017-02-04,22,10,103,113
53010,2017-02-04,23,11,62,73
53011,2017-02-05,0,3,54,57
53012,2017-02-05,1,5,45,50
53013,2017-02-05,2,9,28,37
53014,2017-02-05,3,3,14,17
53015,2017-02-05,4,3,3,6
53016,2017-02-05,5,1,7,8
53017,2017-02-05,6,5,10,15
53018,2017-02-05,7,8,42,50
53019,2017-02-05,8,17,95,112
53020,2017-02-05,9,28,152,180
53021,2017-02-05,10,65,290,355
53022,2017-02-05,11,100,326,426
53023,2017-02-05,12,121,384,505
53024,2017-02-05,13,118,398,516
53025,2017-02-05,14,138,380,518
53026,2017-02-05,15,142,420,562
53027,2017-02-05,16,119,402,521
53028,2017-02-05,17,114,410,524
53029,2017-02-05,18,45,290,335
53030,2017-02-05,19,28,115,143
53031,2017-02-05,20,16,89,105
53032,2017-02-05,21,14,76,90
53033,2017-02-05,22,30,226,256
53034,2017-02-05,23,10,90,100
53035,2017-02-06,0,7,15,22
53036,2017-02-06,1,0,10,10
53037,2017-02-06,2,5,11,16
53038,2017-02-06,3,0,8,8
53039,2017-02-06,4,0,6,6
53040,2017-02-06,5,1,55,56
53041,2017-02-06,6,2,191,193
53042,2017-02-06,7,19,554,573
53043,2017-02-06,8,61,1100,1161
53044,2017-02-06,9,36,413,449
53045,2017-02-06,10,30,173,203
53046,2017-02-06,11,53,211,264
53047,2017-02-06,12,45,266,311
53048,2017-02-06,13,68,263,331
53049,2017-02-06,14,70,234,304
53050,2017-02-06,15,98,310,408
53051,2017-02-06,16,93,551,644
53052,2017-02-06,17,103,1101,1204
53053,2017-02-06,18,63,870,933
53054,2017-02-06,19,29,510,539
53055,2017-02-06,20,39,295,334
53056,2017-02-06,21,25,208,233
53057,2017-02-06,22,19,126,145
53058,2017-02-06,23,13,39,52
53059,2017-02-07,0,0,14,14
53060,2017-02-07,1,1,8,9
53061,2017-02-07,3,0,3,3
53062,2017-02-07,4,0,5,5
53063,2017-02-07,5,1,68,69
53064,2017-02-07,6,5,287,292
53065,2017-02-07,7,17,693,710
53066,2017-02-07,8,46,1148,1194
53067,2017-02-07,9,31,436,467
53068,2017-02-07,10,39,226,265
53069,2017-02-07,11,45,264,309
53070,2017-02-07,12,44,352,396
53071,2017-02-07,13,71,342,413
53072,2017-02-07,14,64,257,321
53073,2017-02-07,15,90,372,462
53074,2017-02-07,16,122,611,733
53075,2017-02-07,17,145,1296,1441
53076,2017-02-07,18,80,968,1048
53077,2017-02-07,19,44,608,652
53078,2017-02-07,20,39,366,405
53079,2017-02-07,21,35,273,308
53080,2017-02-07,22,28,175,203
53081,2017-02-07,23,16,61,77
53082,2017-02-08,0,6,24,30
53083,2017-02-08,1,1,16,17
53084,2017-02-08,2,1,4,5
53085,2017-02-08,3,1,5,6
53086,2017-02-08,4,0,8,8
53087,2017-02-08,5,2,96,98
53088,2017-02-08,6,11,310,321
53089,2017-02-08,7,25,838,863
53090,2017-02-08,8,47,1205,1252
53091,2017-02-08,9,33,457,490
53092,2017-02-08,10,49,218,267
53093,2017-02-08,11,44,295,339
53094,2017-02-08,12,100,402,502
53095,2017-02-08,13,97,400,497
53096,2017-02-08,14,117,337,454
53097,2017-02-08,15,104,373,477
53098,2017-02-08,16,129,688,817
53099,2017-02-08,17,153,1356,1509
53100,2017-02-08,18,89,1004,1093
53101,2017-02-08,19,50,575,625
53102,2017-02-08,20,40,378,418
53103,2017-02-08,21,36,249,285
53104,2017-02-08,22,27,129,156
53105,2017-02-08,23,12,75,87
53106,2017-02-09,0,4,19,23
53107,2017-02-09,1,1,6,7
53108,2017-02-09,2,0,5,5
53109,2017-02-09,4,0,4,4
53110,2017-02-09,5,2,33,35
53111,2017-02-09,6,3,161,164
53112,2017-02-09,7,7,442,449
53113,2017-02-09,8,24,811,835
53114,2017-02-09,9,27,386,413
53115,2017-02-09,10,16,163,179
53116,2017-02-09,11,21,141,162
53117,2017-02-09,12,6,215,221
53118,2017-02-09,13,14,177,191
53119,2017-02-09,14,15,166,181
53120,2017-02-09,15,9,197,206
53121,2017-02-09,16,16,354,370
53122,2017-02-09,17,22,647,669
53123,2017-02-09,18,13,525,538
53124,2017-02-09,19,6,289,295
53125,2017-02-09,20,4,161,165
53126,2017-02-09,21,5,130,135
53127,2017-02-09,22,4,77,81
53128,2017-02-09,23,0,41,41
53129,2017-02-10,0,3,16,19
53130,2017-02-10,1,1,9,10
53131,2017-02-10,2,3,5,8
53132,2017-02-10,3,0,1,1
53133,2017-02-10,4,0,5,5
53134,2017-02-10,5,0,34,34
53135,2017-02-10,6,6,153,159
53136,2017-02-10,7,5,406,411
53137,2017-02-10,8,27,745,772
53138,2017-02-10,9,16,378,394
53139,2017-02-10,10,22,171,193
53140,2017-02-10,11,23,179,202
53141,2017-02-10,12,60,264,324
53142,2017-02-10,13,40,247,287
53143,2017-02-10,14,36,214,250
53144,2017-02-10,15,37,306,343
53145,2017-02-10,16,32,476,508
53146,2017-02-10,17,32,714,746
53147,2017-02-10,18,13,492,505
53148,2017-02-10,19,10,293,303
53149,2017-02-10,20,15,155,170
53150,2017-02-10,21,13,118,131
53151,2017-02-10,22,17,87,104
53152,2017-02-10,23,14,81,95
53153,2017-02-11,0,8,44,52
53154,2017-02-11,1,9,38,47
53155,2017-02-11,2,5,25,30
53156,2017-02-11,3,8,13,21
53157,2017-02-11,4,2,7,9
53158,2017-02-11,5,0,7,7
53159,2017-02-11,6,0,19,19
53160,2017-02-11,7,10,64,74
53161,2017-02-11,8,12,143,155
53162,2017-02-11,9,45,244,289
53163,2017-02-11,10,94,313,407
53164,2017-02-11,11,136,371,507
53165,2017-02-11,12,183,467,650
53166,2017-02-11,13,257,364,621
53167,2017-02-11,14,247,401,648
53168,2017-02-11,15,244,412,656
53169,2017-02-11,16,247,366,613
53170,2017-02-11,17,182,384,566
53171,2017-02-11,18,116,343,459
53172,2017-02-11,19,79,212,291
53173,2017-02-11,20,54,153,207
53174,2017-02-11,21,57,158,215
53175,2017-02-11,22,20,118,138
53176,2017-02-11,23,29,107,136
53177,2017-02-12,0,31,71,102
53178,2017-02-12,1,30,61,91
53179,2017-02-12,2,22,39,61
53180,2017-02-12,3,4,26,30
53181,2017-02-12,4,7,8,15
53182,2017-02-12,5,2,8,10
53183,2017-02-12,6,3,14,17
53184,2017-02-12,7,8,40,48
53185,2017-02-12,8,17,98,115
53186,2017-02-12,9,33,163,196
53187,2017-02-12,10,43,187,230
53188,2017-02-12,11,35,142,177
53189,2017-02-12,12,70,264,334
53190,2017-02-12,13,104,282,386
53191,2017-02-12,14,149,398,547
53192,2017-02-12,15,157,432,589
53193,2017-02-12,16,143,316,459
53194,2017-02-12,17,70,305,375
53195,2017-02-12,18,49,264,313
53196,2017-02-12,19,29,203,232
53197,2017-02-12,20,39,130,169
53198,2017-02-12,21,23,93,116
53199,2017-02-12,22,12,58,70
53200,2017-02-12,23,5,32,37
53201,2017-02-13,0,3,22,25
53202,2017-02-13,1,1,8,9
53203,2017-02-13,2,0,2,2
53204,2017-02-13,3,0,1,1
53205,2017-02-13,4,1,5,6
53206,2017-02-13,5,1,49,50
53207,2017-02-13,6,6,184,190
53208,2017-02-13,7,12,470,482
53209,2017-02-13,8,26,728,754
53210,2017-02-13,9,20,334,354
53211,2017-02-13,10,24,131,155
53212,2017-02-13,11,18,137,155
53213,2017-02-13,12,28,178,206
53214,2017-02-13,13,29,179,208
53215,2017-02-13,14,49,183,232
53216,2017-02-13,15,35,256,291
53217,2017-02-13,16,32,436,468
53218,2017-02-13,17,42,851,893
53219,2017-02-13,18,35,742,777
53220,2017-02-13,19,19,442,461
53221,2017-02-13,20,11,279,290
53222,2017-02-13,21,14,179,193
53223,2017-02-13,22,1,110,111
53224,2017-02-13,23,2,49,51
53225,2017-02-14,0,3,19,22
53226,2017-02-14,1,1,9,10
53227,2017-02-14,2,0,2,2
53228,2017-02-14,3,0,3,3
53229,2017-02-14,4,0,5,5
53230,2017-02-14,5,2,63,65
53231,2017-02-14,6,0,251,251
53232,2017-02-14,7,7,629,636
53233,2017-02-14,8,30,927,957
53234,2017-02-14,9,34,401,435
53235,2017-02-14,10,21,182,203
53236,2017-02-14,11,18,185,203
53237,2017-02-14,12,29,230,259
53238,2017-02-14,13,16,221,237
53239,2017-02-14,14,21,206,227
53240,2017-02-14,15,29,324,353
53241,2017-02-14,16,43,528,571
53242,2017-02-14,17,62,1033,1095
53243,2017-02-14,18,34,794,828
53244,2017-02-14,19,19,412,431
53245,2017-02-14,20,14,237,251
53246,2017-02-14,21,7,201,208
53247,2017-02-14,22,14,100,114
53248,2017-02-14,23,2,41,43
53249,2017-02-15,0,6,20,26
53250,2017-02-15,1,3,5,8
53251,2017-02-15,2,1,7,8
53252,2017-02-15,3,0,3,3
53253,2017-02-15,4,1,5,6
53254,2017-02-15,5,1,66,67
53255,2017-02-15,6,0,259,259
53256,2017-02-15,7,19,632,651
53257,2017-02-15,8,24,1047,1071
53258,2017-02-15,9,32,458,490
53259,2017-02-15,10,23,196,219
53260,2017-02-15,11,40,218,258
53261,2017-02-15,12,37,270,307
53262,2017-02-15,13,36,282,318
53263,2017-02-15,14,60,220,280
53264,2017-02-15,15,50,270,320
53265,2017-02-15,16,26,438,464
53266,2017-02-15,17,57,909,966
53267,2017-02-15,18,34,697,731
53268,2017-02-15,19,18,414,432
53269,2017-02-15,20,18,239,257
53270,2017-02-15,21,17,181,198
53271,2017-02-15,22,8,90,98
53272,2017-02-15,23,0,48,48
53273,2017-02-16,0,0,14,14
53274,2017-02-16,1,1,5,6
53275,2017-02-16,2,1,3,4
53276,2017-02-16,3,1,2,3
53277,2017-02-16,4,0,4,4
53278,2017-02-16,5,2,57,59
53279,2017-02-16,6,1,204,205
53280,2017-02-16,7,14,570,584
53281,2017-02-16,8,24,856,880
53282,2017-02-16,9,21,446,467
53283,2017-02-16,10,17,168,185
53284,2017-02-16,11,25,201,226
53285,2017-02-16,12,17,206,223
53286,2017-02-16,13,17,206,223
53287,2017-02-16,14,29,187,216
53288,2017-02-16,15,23,246,269
53289,2017-02-16,16,27,412,439
53290,2017-02-16,17,35,785,820
53291,2017-02-16,18,24,660,684
53292,2017-02-16,19,22,305,327
53293,2017-02-16,20,14,237,251
53294,2017-02-16,21,14,169,183
53295,2017-02-16,22,7,87,94
53296,2017-02-16,23,3,57,60
53297,2017-02-17,0,2,23,25
53298,2017-02-17,1,9,15,24
53299,2017-02-17,2,2,3,5
53300,2017-02-17,3,0,1,1
53301,2017-02-17,4,0,7,7
53302,2017-02-17,5,2,49,51
53303,2017-02-17,6,1,154,155
53304,2017-02-17,7,11,440,451
53305,2017-02-17,8,29,847,876
53306,2017-02-17,9,23,413,436
53307,2017-02-17,10,33,187,220
53308,2017-02-17,11,27,233,260
53309,2017-02-17,12,63,335,398
53310,2017-02-17,13,52,309,361
53311,2017-02-17,14,84,299,383
53312,2017-02-17,15,102,369,471
53313,2017-02-17,16,114,566,680
53314,2017-02-17,17,84,797,881
53315,2017-02-17,18,67,530,597
53316,2017-02-17,19,50,345,395
53317,2017-02-17,20,14,211,225
53318,2017-02-17,21,19,137,156
53319,2017-02-17,22,14,111,125
53320,2017-02-17,23,13,86,99
53321,2017-02-18,0,12,49,61
53322,2017-02-18,1,7,35,42
53323,2017-02-18,2,4,26,30
53324,2017-02-18,3,1,14,15
53325,2017-02-18,4,2,11,13
53326,2017-02-18,5,2,7,9
53327,2017-02-18,6,3,28,31
53328,2017-02-18,7,13,57,70
53329,2017-02-18,8,28,118,146
53330,2017-02-18,9,99,263,362
53331,2017-02-18,10,209,315,524
53332,2017-02-18,11,394,391,785
53333,2017-02-18,12,526,490,1016
53334,2017-02-18,13,632,463,1095
53335,2017-02-18,14,792,510,1302
53336,2017-02-18,15,760,496,1256
53337,2017-02-18,16,727,489,1216
53338,2017-02-18,17,577,416,993
53339,2017-02-18,18,267,297,564
53340,2017-02-18,19,163,241,404
53341,2017-02-18,20,92,151,243
53342,2017-02-18,21,82,118,200
53343,2017-02-18,22,65,122,187
53344,2017-02-18,23,71,88,159
53345,2017-02-19,0,39,87,126
53346,2017-02-19,1,20,47,67
53347,2017-02-19,2,12,43,55
53348,2017-02-19,3,7,19,26
53349,2017-02-19,4,3,5,8
53350,2017-02-19,5,2,11,13
53351,2017-02-19,6,6,16,22
53352,2017-02-19,7,13,42,55
53353,2017-02-19,8,68,102,170
53354,2017-02-19,9,178,171,349
53355,2017-02-19,10,370,356,726
53356,2017-02-19,11,569,378,947
53357,2017-02-19,12,740,522,1262
53358,2017-02-19,13,844,517,1361
53359,2017-02-19,14,899,538,1437
53360,2017-02-19,15,948,571,1519
53361,2017-02-19,16,868,504,1372
53362,2017-02-19,17,694,432,1126
53363,2017-02-19,18,274,336,610
53364,2017-02-19,19,132,206,338
53365,2017-02-19,20,134,126,260
53366,2017-02-19,21,96,133,229
53367,2017-02-19,22,76,82,158
53368,2017-02-19,23,51,56,107
53369,2017-02-20,0,45,46,91
53370,2017-02-20,1,13,19,32
53371,2017-02-20,2,3,8,11
53372,2017-02-20,3,3,8,11
53373,2017-02-20,4,0,8,8
53374,2017-02-20,5,2,31,33
53375,2017-02-20,6,7,43,50
53376,2017-02-20,7,32,138,170
53377,2017-02-20,8,80,292,372
53378,2017-02-20,9,171,291,462
53379,2017-02-20,10,279,326,605
53380,2017-02-20,11,415,404,819
53381,2017-02-20,12,430,451,881
53382,2017-02-20,13,504,505,1009
53383,2017-02-20,14,488,478,966
53384,2017-02-20,15,462,509,971
53385,2017-02-20,16,494,526,1020
53386,2017-02-20,17,345,598,943
53387,2017-02-20,18,129,451,580
53388,2017-02-20,19,104,330,434
53389,2017-02-20,20,57,217,274
53390,2017-02-20,21,51,113,164
53391,2017-02-20,22,16,93,109
53392,2017-02-20,23,6,34,40
53393,2017-02-21,0,6,6,12
53394,2017-02-21,1,3,11,14
53395,2017-02-21,2,0,4,4
53396,2017-02-21,3,0,7,7
53397,2017-02-21,4,0,5,5
53398,2017-02-21,5,3,73,76
53399,2017-02-21,6,3,271,274
53400,2017-02-21,7,33,715,748
53401,2017-02-21,8,44,952,996
53402,2017-02-21,9,76,305,381
53403,2017-02-21,10,89,161,250
53404,2017-02-21,11,113,205,318
53405,2017-02-21,12,115,277,392
53406,2017-02-21,13,85,234,319
53407,2017-02-21,14,68,219,287
53408,2017-02-21,15,104,352,456
53409,2017-02-21,16,112,575,687
53410,2017-02-21,17,147,1119,1266
53411,2017-02-21,18,68,866,934
53412,2017-02-21,19,54,500,554
53413,2017-02-21,20,34,304,338
53414,2017-02-21,21,40,241,281
53415,2017-02-21,22,24,119,143
53416,2017-02-21,23,18,55,73
53417,2017-02-22,0,5,23,28
53418,2017-02-22,1,1,10,11
53419,2017-02-22,2,1,3,4
53420,2017-02-22,3,0,2,2
53421,2017-02-22,4,2,6,8
53422,2017-02-22,5,2,83,85
53423,2017-02-22,6,4,296,300
53424,2017-02-22,7,30,760,790
53425,2017-02-22,8,37,1056,1093
53426,2017-02-22,9,32,396,428
53427,2017-02-22,10,69,186,255
53428,2017-02-22,11,72,218,290
53429,2017-02-22,12,91,291,382
53430,2017-02-22,13,100,290,390
53431,2017-02-22,14,85,290,375
53432,2017-02-22,15,137,337,474
53433,2017-02-22,16,135,640,775
53434,2017-02-22,17,135,1154,1289
53435,2017-02-22,18,80,935,1015
53436,2017-02-22,19,60,543,603
53437,2017-02-22,20,64,379,443
53438,2017-02-22,21,54,289,343
53439,2017-02-22,22,18,167,185
53440,2017-02-22,23,12,78,90
53441,2017-02-23,0,4,25,29
53442,2017-02-23,1,4,15,19
53443,2017-02-23,2,0,2,2
53444,2017-02-23,3,1,2,3
53445,2017-02-23,4,1,9,10
53446,2017-02-23,5,4,67,71
53447,2017-02-23,6,6,322,328
53448,2017-02-23,7,42,838,880
53449,2017-02-23,8,82,1205,1287
53450,2017-02-23,9,72,473,545
53451,2017-02-23,10,93,203,296
53452,2017-02-23,11,101,311,412
53453,2017-02-23,12,167,446,613
53454,2017-02-23,13,184,367,551
53455,2017-02-23,14,196,351,547
53456,2017-02-23,15,199,406,605
53457,2017-02-23,16,251,677,928
53458,2017-02-23,17,223,1316,1539
53459,2017-02-23,18,164,998,1162
53460,2017-02-23,19,99,615,714
53461,2017-02-23,20,67,410,477
53462,2017-02-23,21,58,322,380
53463,2017-02-23,22,36,175,211
53464,2017-02-23,23,35,100,135
53465,2017-02-24,0,27,42,69
53466,2017-02-24,1,16,28,44
53467,2017-02-24,2,1,11,12
53468,2017-02-24,3,1,6,7
53469,2017-02-24,4,0,9,9
53470,2017-02-24,5,5,73,78
53471,2017-02-24,6,4,264,268
53472,2017-02-24,7,33,766,799
53473,2017-02-24,8,75,1164,1239
53474,2017-02-24,9,106,464,570
53475,2017-02-24,10,145,251,396
53476,2017-02-24,11,186,351,537
53477,2017-02-24,12,272,445,717
53478,2017-02-24,13,274,470,744
53479,2017-02-24,14,336,428,764
53480,2017-02-24,15,402,554,956
53481,2017-02-24,16,356,854,1210
53482,2017-02-24,17,374,1261,1635
53483,2017-02-24,18,237,836,1073
53484,2017-02-24,19,143,482,625
53485,2017-02-24,20,93,309,402
53486,2017-02-24,21,123,216,339
53487,2017-02-24,22,68,172,240
53488,2017-02-24,23,87,138,225
53489,2017-02-25,0,26,105,131
53490,2017-02-25,1,34,64,98
53491,2017-02-25,2,25,33,58
53492,2017-02-25,3,20,16,36
53493,2017-02-25,4,5,6,11
53494,2017-02-25,5,2,23,25
53495,2017-02-25,6,8,30,38
53496,2017-02-25,7,33,90,123
53497,2017-02-25,8,70,245,315
53498,2017-02-25,9,165,422,587
53499,2017-02-25,10,288,494,782
53500,2017-02-25,11,435,566,1001
53501,2017-02-25,12,432,582,1014
53502,2017-02-25,13,397,528,925
53503,2017-02-25,14,234,327,561
53504,2017-02-25,15,131,172,303
53505,2017-02-25,16,170,274,444
53506,2017-02-25,17,170,284,454
53507,2017-02-25,18,86,287,373
53508,2017-02-25,19,77,201,278
53509,2017-02-25,20,65,158,223
53510,2017-02-25,21,34,131,165
53511,2017-02-25,22,26,97,123
53512,2017-02-25,23,22,82,104
53513,2017-02-26,0,20,84,104
53514,2017-02-26,1,6,47,53
53515,2017-02-26,2,12,36,48
53516,2017-02-26,3,12,13,25
53517,2017-02-26,4,0,3,3
53518,2017-02-26,5,1,7,8
53519,2017-02-26,6,1,14,15
53520,2017-02-26,7,7,43,50
53521,2017-02-26,8,34,137,171
53522,2017-02-26,9,72,212,284
53523,2017-02-26,10,131,333,464
53524,2017-02-26,11,159,316,475
53525,2017-02-26,12,182,404,586
53526,2017-02-26,13,256,417,673
53527,2017-02-26,14,239,392,631
53528,2017-02-26,15,223,432,655
53529,2017-02-26,16,205,397,602
53530,2017-02-26,17,176,331,507
53531,2017-02-26,18,78,289,367
53532,2017-02-26,19,39,201,240
53533,2017-02-26,20,25,115,140
53534,2017-02-26,21,16,89,105
53535,2017-02-26,22,15,74,89
53536,2017-02-26,23,8,34,42
53537,2017-02-27,0,4,36,40
53538,2017-02-27,1,0,5,5
53539,2017-02-27,2,1,3,4
53540,2017-02-27,3,0,1,1
53541,2017-02-27,4,0,7,7
53542,2017-02-27,5,4,60,64
53543,2017-02-27,6,7,258,265
53544,2017-02-27,7,21,576,597
53545,2017-02-27,8,45,933,978
53546,2017-02-27,9,42,400,442
53547,2017-02-27,10,54,159,213
53548,2017-02-27,11,77,183,260
53549,2017-02-27,12,68,290,358
53550,2017-02-27,13,70,265,335
53551,2017-02-27,14,84,211,295
53552,2017-02-27,15,94,342,436
53553,2017-02-27,16,71,541,612
53554,2017-02-27,17,95,1037,1132
53555,2017-02-27,18,53,838,891
53556,2017-02-27,19,48,503,551
53557,2017-02-27,20,29,281,310
53558,2017-02-27,21,29,221,250
53559,2017-02-27,22,32,117,149
53560,2017-02-27,23,8,60,68
53561,2017-02-28,0,3,22,25
53562,2017-02-28,1,1,8,9
53563,2017-02-28,2,0,5,5
53564,2017-02-28,3,0,2,2
53565,2017-02-28,4,0,7,7
53566,2017-02-28,5,13,71,84
53567,2017-02-28,6,12,309,321
53568,2017-02-28,7,28,860,888
53569,2017-02-28,8,65,1210,1275
53570,2017-02-28,9,49,454,503
53571,2017-02-28,10,63,217,280
53572,2017-02-28,11,82,283,365
53573,2017-02-28,12,84,365,449
53574,2017-02-28,13,106,331,437
53575,2017-02-28,14,122,289,411
53576,2017-02-28,15,128,357,485
53577,2017-02-28,16,98,636,734
53578,2017-02-28,17,60,777,837
53579,2017-02-28,18,5,215,220
53580,2017-02-28,19,10,118,128
53581,2017-02-28,20,4,101,105
53582,2017-02-28,21,3,83,86
53583,2017-02-28,22,13,97,110
53584,2017-02-28,23,0,62,62
53585,2017-03-01,0,5,22,27
53586,2017-03-01,1,3,16,19
53587,2017-03-01,2,3,8,11
53588,2017-03-01,3,2,2,4
53589,2017-03-01,4,0,8,8
53590,2017-03-01,5,8,82,90
53591,2017-03-01,6,8,310,318
53592,2017-03-01,7,32,763,795
53593,2017-03-01,8,63,1016,1079
53594,2017-03-01,9,29,377,406
53595,2017-03-01,10,54,192,246
53596,2017-03-01,11,55,284,339
53597,2017-03-01,12,87,346,433
53598,2017-03-01,13,54,269,323
53599,2017-03-01,14,46,215,261
53600,2017-03-01,15,67,282,349
53601,2017-03-01,16,53,573,626
53602,2017-03-01,17,78,1007,1085
53603,2017-03-01,18,60,911,971
53604,2017-03-01,19,49,551,600
53605,2017-03-01,20,48,377,425
53606,2017-03-01,21,25,269,294
53607,2017-03-01,22,26,162,188
53608,2017-03-01,23,10,70,80
53609,2017-03-02,0,10,33,43
53610,2017-03-02,1,8,6,14
53611,2017-03-02,2,3,6,9
53612,2017-03-02,3,1,1,2
53613,2017-03-02,4,2,10,12
53614,2017-03-02,5,1,62,63
53615,2017-03-02,6,4,247,251
53616,2017-03-02,7,25,702,727
53617,2017-03-02,8,42,1028,1070
53618,2017-03-02,9,26,438,464
53619,2017-03-02,10,25,184,209
53620,2017-03-02,11,46,234,280
53621,2017-03-02,12,31,296,327
53622,2017-03-02,13,52,281,333
53623,2017-03-02,14,59,233,292
53624,2017-03-02,15,61,325,386
53625,2017-03-02,16,58,494,552
53626,2017-03-02,17,97,996,1093
53627,2017-03-02,18,65,761,826
53628,2017-03-02,19,21,407,428
53629,2017-03-02,20,23,284,307
53630,2017-03-02,21,15,214,229
53631,2017-03-02,22,12,125,137
53632,2017-03-02,23,9,71,80
53633,2017-03-03,0,9,34,43
53634,2017-03-03,1,2,11,13
53635,2017-03-03,2,4,10,14
53636,2017-03-03,3,0,1,1
53637,2017-03-03,4,1,13,14
53638,2017-03-03,5,4,60,64
53639,2017-03-03,6,4,176,180
53640,2017-03-03,7,11,457,468
53641,2017-03-03,8,37,886,923
53642,2017-03-03,9,36,453,489
53643,2017-03-03,10,56,198,254
53644,2017-03-03,11,54,232,286
53645,2017-03-03,12,35,300,335
53646,2017-03-03,13,64,243,307
53647,2017-03-03,14,44,232,276
53648,2017-03-03,15,45,294,339
53649,2017-03-03,16,53,480,533
53650,2017-03-03,17,67,730,797
53651,2017-03-03,18,45,542,587
53652,2017-03-03,19,22,269,291
53653,2017-03-03,20,16,173,189
53654,2017-03-03,21,15,130,145
53655,2017-03-03,22,13,111,124
53656,2017-03-03,23,4,65,69
53657,2017-03-04,0,6,46,52
53658,2017-03-04,1,4,32,36
53659,2017-03-04,2,4,17,21
53660,2017-03-04,3,0,9,9
53661,2017-03-04,4,0,3,3
53662,2017-03-04,5,2,6,8
53663,2017-03-04,6,1,15,16
53664,2017-03-04,7,8,55,63
53665,2017-03-04,8,22,151,173
53666,2017-03-04,9,53,223,276
53667,2017-03-04,10,65,300,365
53668,2017-03-04,11,75,366,441
53669,2017-03-04,12,120,339,459
53670,2017-03-04,13,139,348,487
53671,2017-03-04,14,177,283,460
53672,2017-03-04,15,156,316,472
53673,2017-03-04,16,168,330,498
53674,2017-03-04,17,107,319,426
53675,2017-03-04,18,60,244,304
53676,2017-03-04,19,29,173,202
53677,2017-03-04,20,24,127,151
53678,2017-03-04,21,22,92,114
53679,2017-03-04,22,19,101,120
53680,2017-03-04,23,41,84,125
53681,2017-03-05,0,16,42,58
53682,2017-03-05,1,7,36,43
53683,2017-03-05,2,1,28,29
53684,2017-03-05,3,1,14,15
53685,2017-03-05,4,0,4,4
53686,2017-03-05,5,2,5,7
53687,2017-03-05,6,3,7,10
53688,2017-03-05,7,16,49,65
53689,2017-03-05,8,16,102,118
53690,2017-03-05,9,46,152,198
53691,2017-03-05,10,62,252,314
53692,2017-03-05,11,114,297,411
53693,2017-03-05,12,144,317,461
53694,2017-03-05,13,156,340,496
53695,2017-03-05,14,189,362,551
53696,2017-03-05,15,174,346,520
53697,2017-03-05,16,142,333,475
53698,2017-03-05,17,75,302,377
53699,2017-03-05,18,50,257,307
53700,2017-03-05,19,22,173,195
53701,2017-03-05,20,17,117,134
53702,2017-03-05,21,19,79,98
53703,2017-03-05,22,13,64,77
53704,2017-03-05,23,8,28,36
53705,2017-03-06,0,4,12,16
53706,2017-03-06,1,0,4,4
53707,2017-03-06,2,0,2,2
53708,2017-03-06,3,1,2,3
53709,2017-03-06,4,1,10,11
53710,2017-03-06,5,1,54,55
53711,2017-03-06,6,5,224,229
53712,2017-03-06,7,13,591,604
53713,2017-03-06,8,35,951,986
53714,2017-03-06,9,50,368,418
53715,2017-03-06,10,67,172,239
53716,2017-03-06,11,72,205,277
53717,2017-03-06,12,98,256,354
53718,2017-03-06,13,130,258,388
53719,2017-03-06,14,140,208,348
53720,2017-03-06,15,124,332,456
53721,2017-03-06,16,92,515,607
53722,2017-03-06,17,133,1083,1216
53723,2017-03-06,18,87,863,950
53724,2017-03-06,19,58,516,574
53725,2017-03-06,20,76,298,374
53726,2017-03-06,21,31,194,225
53727,2017-03-06,22,29,136,165
53728,2017-03-06,23,15,66,81
53729,2017-03-07,0,3,18,21
53730,2017-03-07,1,0,8,8
53731,2017-03-07,2,1,8,9
53732,2017-03-07,3,1,2,3
53733,2017-03-07,4,2,10,12
53734,2017-03-07,5,1,71,72
53735,2017-03-07,6,7,270,277
53736,2017-03-07,7,37,740,777
53737,2017-03-07,8,61,1103,1164
53738,2017-03-07,9,46,424,470
53739,2017-03-07,10,74,226,300
53740,2017-03-07,11,118,284,402
53741,2017-03-07,12,112,335,447
53742,2017-03-07,13,97,307,404
53743,2017-03-07,14,85,269,354
53744,2017-03-07,15,129,366,495
53745,2017-03-07,16,146,549,695
53746,2017-03-07,17,99,880,979
53747,2017-03-07,18,64,549,613
53748,2017-03-07,19,36,284,320
53749,2017-03-07,20,14,153,167
53750,2017-03-07,21,18,142,160
53751,2017-03-07,22,22,130,152
53752,2017-03-07,23,16,66,82
53753,2017-03-08,0,4,26,30
53754,2017-03-08,1,4,6,10
53755,2017-03-08,2,3,7,10
53756,2017-03-08,3,0,1,1
53757,2017-03-08,4,1,5,6
53758,2017-03-08,5,3,67,70
53759,2017-03-08,6,13,247,260
53760,2017-03-08,7,33,767,800
53761,2017-03-08,8,50,1100,1150
53762,2017-03-08,9,66,438,504
53763,2017-03-08,10,97,221,318
53764,2017-03-08,11,130,320,450
53765,2017-03-08,12,176,393,569
53766,2017-03-08,13,205,373,578
53767,2017-03-08,14,193,294,487
53768,2017-03-08,15,219,421,640
53769,2017-03-08,16,237,648,885
53770,2017-03-08,17,207,1158,1365
53771,2017-03-08,18,160,949,1109
53772,2017-03-08,19,92,546,638
53773,2017-03-08,20,64,366,430
53774,2017-03-08,21,82,282,364
53775,2017-03-08,22,36,162,198
53776,2017-03-08,23,17,81,98
53777,2017-03-09,0,17,39,56
53778,2017-03-09,1,4,17,21
53779,2017-03-09,2,4,3,7
53780,2017-03-09,3,1,4,5
53781,2017-03-09,4,0,12,12
53782,2017-03-09,5,4,73,77
53783,2017-03-09,6,6,291,297
53784,2017-03-09,7,32,836,868
53785,2017-03-09,8,72,1217,1289
53786,2017-03-09,9,122,482,604
53787,2017-03-09,10,141,250,391
53788,2017-03-09,11,155,329,484
53789,2017-03-09,12,153,441,594
53790,2017-03-09,13,243,414,657
53791,2017-03-09,14,282,358,640
53792,2017-03-09,15,289,457,746
53793,2017-03-09,16,289,689,978
53794,2017-03-09,17,322,1324,1646
53795,2017-03-09,18,162,1044,1206
53796,2017-03-09,19,92,581,673
53797,2017-03-09,20,82,372,454
53798,2017-03-09,21,58,294,352
53799,2017-03-09,22,60,168,228
53800,2017-03-09,23,33,86,119
53801,2017-03-10,0,11,41,52
53802,2017-03-10,1,10,16,26
53803,2017-03-10,2,5,11,16
53804,2017-03-10,3,3,3,6
53805,2017-03-10,4,3,7,10
53806,2017-03-10,5,4,64,68
53807,2017-03-10,6,8,205,213
53808,2017-03-10,7,20,605,625
53809,2017-03-10,8,49,821,870
53810,2017-03-10,9,11,140,151
53811,2017-03-10,10,7,59,66
53812,2017-03-10,11,14,123,137
53813,2017-03-10,12,32,226,258
53814,2017-03-10,13,42,239,281
53815,2017-03-10,14,59,242,301
53816,2017-03-10,15,65,298,363
53817,2017-03-10,16,65,427,492
53818,2017-03-10,17,52,804,856
53819,2017-03-10,18,39,487,526
53820,2017-03-10,19,17,229,246
53821,2017-03-10,20,22,136,158
53822,2017-03-10,21,13,106,119
53823,2017-03-10,22,7,80,87
53824,2017-03-10,23,6,65,71
53825,2017-03-11,0,8,40,48
53826,2017-03-11,1,3,23,26
53827,2017-03-11,2,4,23,27
53828,2017-03-11,3,2,9,11
53829,2017-03-11,4,0,4,4
53830,2017-03-11,5,1,22,23
53831,2017-03-11,6,10,37,47
53832,2017-03-11,7,28,140,168
53833,2017-03-11,8,44,194,238
53834,2017-03-11,9,67,245,312
53835,2017-03-11,10,81,322,403
53836,2017-03-11,11,107,348,455
53837,2017-03-11,12,113,340,453
53838,2017-03-11,13,103,322,425
53839,2017-03-11,14,104,271,375
53840,2017-03-11,15,132,302,434
53841,2017-03-11,16,113,279,392
53842,2017-03-11,17,153,272,425
53843,2017-03-11,18,43,209,252
53844,2017-03-11,19,28,172,200
53845,2017-03-11,20,15,108,123
53846,2017-03-11,21,20,106,126
53847,2017-03-11,22,9,73,82
53848,2017-03-11,23,2,63,65
53849,2017-03-12,0,6,36,42
53850,2017-03-12,1,5,29,34
53851,2017-03-12,3,3,45,48
53852,2017-03-12,4,1,10,11
53853,2017-03-12,5,0,7,7
53854,2017-03-12,6,1,5,6
53855,2017-03-12,7,3,32,35
53856,2017-03-12,8,7,52,59
53857,2017-03-12,9,14,106,120
53858,2017-03-12,10,42,197,239
53859,2017-03-12,11,75,274,349
53860,2017-03-12,12,108,330,438
53861,2017-03-12,13,126,274,400
53862,2017-03-12,14,168,339,507
53863,2017-03-12,15,184,300,484
53864,2017-03-12,16,169,290,459
53865,2017-03-12,17,143,326,469
53866,2017-03-12,18,100,261,361
53867,2017-03-12,19,50,165,215
53868,2017-03-12,20,28,104,132
53869,2017-03-12,21,23,74,97
53870,2017-03-12,22,11,55,66
53871,2017-03-12,23,6,34,40
53872,2017-03-13,0,1,26,27
53873,2017-03-13,1,0,13,13
53874,2017-03-13,2,0,2,2
53875,2017-03-13,3,0,1,1
53876,2017-03-13,4,1,5,6
53877,2017-03-13,5,1,61,62
53878,2017-03-13,6,3,172,175
53879,2017-03-13,7,5,455,460
53880,2017-03-13,8,18,821,839
53881,2017-03-13,9,35,397,432
53882,2017-03-13,10,47,151,198
53883,2017-03-13,11,41,157,198
53884,2017-03-13,12,69,215,284
53885,2017-03-13,13,82,206,288
53886,2017-03-13,14,104,210,314
53887,2017-03-13,15,130,273,403
53888,2017-03-13,16,123,457,580
53889,2017-03-13,17,73,836,909
53890,2017-03-13,18,65,670,735
53891,2017-03-13,19,23,259,282
53892,2017-03-13,20,15,129,144
53893,2017-03-13,21,6,55,61
53894,2017-03-13,22,6,34,40
53895,2017-03-13,23,0,16,16
53896,2017-03-14,0,1,2,3
53897,2017-03-14,1,0,4,4
53898,2017-03-14,2,1,0,1
53899,2017-03-14,4,0,1,1
53900,2017-03-14,5,0,2,2
53901,2017-03-14,6,0,6,6
53902,2017-03-14,7,0,16,16
53903,2017-03-14,8,2,26,28
53904,2017-03-14,9,4,46,50
53905,2017-03-14,10,7,68,75
53906,2017-03-14,11,8,85,93
53907,2017-03-14,12,9,62,71
53908,2017-03-14,13,9,71,80
53909,2017-03-14,14,4,63,67
53910,2017-03-14,15,18,81,99
53911,2017-03-14,16,12,129,141
53912,2017-03-14,17,10,229,239
53913,2017-03-14,18,15,237,252
53914,2017-03-14,19,5,151,156
53915,2017-03-14,20,2,80,82
53916,2017-03-14,21,2,57,59
53917,2017-03-14,22,1,39,40
53918,2017-03-14,23,1,17,18
53919,2017-03-15,0,0,8,8
53920,2017-03-15,1,0,3,3
53921,2017-03-15,2,0,3,3
53922,2017-03-15,4,0,3,3
53923,2017-03-15,5,0,29,29
53924,2017-03-15,6,0,118,118
53925,2017-03-15,7,2,244,246
53926,2017-03-15,8,2,432,434
53927,2017-03-15,9,9,241,250
53928,2017-03-15,10,1,120,121
53929,2017-03-15,11,3,86,89
53930,2017-03-15,12,8,97,105
53931,2017-03-15,13,8,97,105
53932,2017-03-15,14,8,69,77
53933,2017-03-15,15,7,110,117
53934,2017-03-15,16,9,228,237
53935,2017-03-15,17,14,460,474
53936,2017-03-15,18,8,401,409
53937,2017-03-15,19,3,216,219
53938,2017-03-15,20,4,135,139
53939,2017-03-15,21,4,95,99
53940,2017-03-15,22,0,51,51
53941,2017-03-15,23,0,23,23
53942,2017-03-16,0,2,4,6
53943,2017-03-16,1,2,7,9
53944,2017-03-16,2,3,5,8
53945,2017-03-16,3,0,2,2
53946,2017-03-16,4,1,3,4
53947,2017-03-16,5,2,36,38
53948,2017-03-16,6,1,147,148
53949,2017-03-16,7,5,331,336
53950,2017-03-16,8,14,630,644
53951,2017-03-16,9,14,300,314
53952,2017-03-16,10,14,119,133
53953,2017-03-16,11,11,105,116
53954,2017-03-16,12,25,137,162
53955,2017-03-16,13,25,151,176
53956,2017-03-16,14,28,154,182
53957,2017-03-16,15,33,202,235
53958,2017-03-16,16,43,353,396
53959,2017-03-16,17,58,730,788
53960,2017-03-16,18,34,590,624
53961,2017-03-16,19,28,304,332
53962,2017-03-16,20,10,190,200
53963,2017-03-16,21,20,149,169
53964,2017-03-16,22,3,108,111
53965,2017-03-16,23,5,41,46
53966,2017-03-17,0,3,24,27
53967,2017-03-17,1,0,7,7
53968,2017-03-17,2,1,5,6
53969,2017-03-17,3,1,3,4
53970,2017-03-17,4,0,9,9
53971,2017-03-17,5,0,50,50
53972,2017-03-17,6,2,145,147
53973,2017-03-17,7,5,372,377
53974,2017-03-17,8,27,740,767
53975,2017-03-17,9,27,376,403
53976,2017-03-17,10,47,181,228
53977,2017-03-17,11,67,180,247
53978,2017-03-17,12,95,284,379
53979,2017-03-17,13,120,278,398
53980,2017-03-17,14,136,236,372
53981,2017-03-17,15,143,342,485
53982,2017-03-17,16,146,490,636
53983,2017-03-17,17,161,818,979
53984,2017-03-17,18,82,583,665
53985,2017-03-17,19,27,339,366
53986,2017-03-17,20,21,195,216
53987,2017-03-17,21,27,142,169
53988,2017-03-17,22,11,135,146
53989,2017-03-17,23,11,111,122
53990,2017-03-18,0,9,57,66
53991,2017-03-18,1,4,34,38
53992,2017-03-18,2,9,33,42
53993,2017-03-18,3,2,15,17
53994,2017-03-18,4,1,7,8
53995,2017-03-18,5,1,6,7
53996,2017-03-18,6,3,27,30
53997,2017-03-18,7,6,64,70
53998,2017-03-18,8,15,131,146
53999,2017-03-18,9,58,202,260
54000,2017-03-18,10,141,282,423
54001,2017-03-18,11,218,349,567
54002,2017-03-18,12,319,412,731
54003,2017-03-18,13,426,437,863
54004,2017-03-18,14,557,399,956
54005,2017-03-18,15,579,469,1048
54006,2017-03-18,16,556,462,1018
54007,2017-03-18,17,416,432,848
54008,2017-03-18,18,275,342,617
54009,2017-03-18,19,72,146,218
54010,2017-03-18,20,29,116,145
54011,2017-03-18,21,15,73,88
54012,2017-03-18,22,4,19,23
54013,2017-03-18,23,2,13,15
54014,2017-03-19,0,3,21,24
54015,2017-03-19,1,4,12,16
54016,2017-03-19,2,1,18,19
54017,2017-03-19,3,0,4,4
54018,2017-03-19,4,2,3,5
54019,2017-03-19,5,2,2,4
54020,2017-03-19,6,1,4,5
54021,2017-03-19,7,7,19,26
54022,2017-03-19,8,15,56,71
54023,2017-03-19,9,49,132,181
54024,2017-03-19,10,90,231,321
54025,2017-03-19,11,116,289,405
54026,2017-03-19,12,181,329,510
54027,2017-03-19,13,209,345,554
54028,2017-03-19,14,254,402,656
54029,2017-03-19,15,221,384,605
54030,2017-03-19,16,244,343,587
54031,2017-03-19,17,204,338,542
54032,2017-03-19,18,134,291,425
54033,2017-03-19,19,64,197,261
54034,2017-03-19,20,40,127,167
54035,2017-03-19,21,44,97,141
54036,2017-03-19,22,32,74,106
54037,2017-03-19,23,13,41,54
54038,2017-03-20,0,6,17,23
54039,2017-03-20,1,2,7,9
54040,2017-03-20,2,0,4,4
54041,2017-03-20,3,1,3,4
54042,2017-03-20,4,1,4,5
54043,2017-03-20,5,5,58,63
54044,2017-03-20,6,7,218,225
54045,2017-03-20,7,25,558,583
54046,2017-03-20,8,51,870,921
54047,2017-03-20,9,70,395,465
54048,2017-03-20,10,120,151,271
54049,2017-03-20,11,136,186,322
54050,2017-03-20,12,170,293,463
54051,2017-03-20,13,174,289,463
54052,2017-03-20,14,186,247,433
54053,2017-03-20,15,190,338,528
54054,2017-03-20,16,174,519,693
54055,2017-03-20,17,194,1113,1307
54056,2017-03-20,18,122,936,1058
54057,2017-03-20,19,65,528,593
54058,2017-03-20,20,56,329,385
54059,2017-03-20,21,33,217,250
54060,2017-03-20,22,28,134,162
54061,2017-03-20,23,23,50,73
54062,2017-03-21,0,4,23,27
54063,2017-03-21,1,3,7,10
54064,2017-03-21,2,1,6,7
54065,2017-03-21,3,1,0,1
54066,2017-03-21,4,0,6,6
54067,2017-03-21,5,1,71,72
54068,2017-03-21,6,8,288,296
54069,2017-03-21,7,21,677,698
54070,2017-03-21,8,38,1134,1172
54071,2017-03-21,9,53,490,543
54072,2017-03-21,10,99,198,297
54073,2017-03-21,11,94,205,299
54074,2017-03-21,12,101,277,378
54075,2017-03-21,13,157,278,435
54076,2017-03-21,14,184,252,436
54077,2017-03-21,15,202,372,574
54078,2017-03-21,16,227,609,836
54079,2017-03-21,17,213,1215,1428
54080,2017-03-21,18,171,1078,1249
54081,2017-03-21,19,112,587,699
54082,2017-03-21,20,83,406,489
54083,2017-03-21,21,58,292,350
54084,2017-03-21,22,45,172,217
54085,2017-03-21,23,19,74,93
54086,2017-03-22,0,9,30,39
54087,2017-03-22,1,7,6,13
54088,2017-03-22,2,2,4,6
54089,2017-03-22,3,0,3,3
54090,2017-03-22,4,2,9,11
54091,2017-03-22,5,2,65,67
54092,2017-03-22,6,7,273,280
54093,2017-03-22,7,19,627,646
54094,2017-03-22,8,33,984,1017
54095,2017-03-22,9,45,443,488
54096,2017-03-22,10,44,195,239
54097,2017-03-22,11,64,218,282
54098,2017-03-22,12,51,285,336
54099,2017-03-22,13,55,266,321
54100,2017-03-22,14,83,207,290
54101,2017-03-22,15,114,304,418
54102,2017-03-22,16,75,477,552
54103,2017-03-22,17,110,954,1064
54104,2017-03-22,18,70,843,913
54105,2017-03-22,19,52,524,576
54106,2017-03-22,20,38,266,304
54107,2017-03-22,21,30,202,232
54108,2017-03-22,22,17,138,155
54109,2017-03-22,23,0,61,61
54110,2017-03-23,0,3,19,22
54111,2017-03-23,1,0,5,5
54112,2017-03-23,2,1,8,9
54113,2017-03-23,4,1,3,4
54114,2017-03-23,5,2,59,61
54115,2017-03-23,6,3,228,231
54116,2017-03-23,7,19,567,586
54117,2017-03-23,8,39,967,1006
54118,2017-03-23,9,23,472,495
54119,2017-03-23,10,46,173,219
54120,2017-03-23,11,67,229,296
54121,2017-03-23,12,63,274,337
54122,2017-03-23,13,71,273,344
54123,2017-03-23,14,96,248,344
54124,2017-03-23,15,117,348,465
54125,2017-03-23,16,134,529,663
54126,2017-03-23,17,152,1021,1173
54127,2017-03-23,18,116,855,971
54128,2017-03-23,19,68,493,561
54129,2017-03-23,20,32,311,343
54130,2017-03-23,21,23,234,257
54131,2017-03-23,22,17,136,153
54132,2017-03-23,23,6,63,69
54133,2017-03-24,0,12,25,37
54134,2017-03-24,1,0,9,9
54135,2017-03-24,2,0,7,7
54136,2017-03-24,3,2,4,6
54137,2017-03-24,4,1,5,6
54138,2017-03-24,5,0,52,52
54139,2017-03-24,6,6,202,208
54140,2017-03-24,7,26,533,559
54141,2017-03-24,8,53,903,956
54142,2017-03-24,9,46,432,478
54143,2017-03-24,10,10,80,90
54144,2017-03-24,11,10,71,81
54145,2017-03-24,12,71,242,313
54146,2017-03-24,13,129,332,461
54147,2017-03-24,14,190,274,464
54148,2017-03-24,15,200,412,612
54149,2017-03-24,16,209,629,838
54150,2017-03-24,17,253,1015,1268
54151,2017-03-24,18,211,772,983
54152,2017-03-24,19,146,484,630
54153,2017-03-24,20,86,270,356
54154,2017-03-24,21,71,199,270
54155,2017-03-24,22,59,162,221
54156,2017-03-24,23,52,129,181
54157,2017-03-25,0,38,97,135
54158,2017-03-25,1,21,76,97
54159,2017-03-25,2,15,45,60
54160,2017-03-25,3,11,22,33
54161,2017-03-25,4,8,7,15
54162,2017-03-25,5,7,9,16
54163,2017-03-25,6,19,30,49
54164,2017-03-25,7,32,94,126
54165,2017-03-25,8,90,221,311
54166,2017-03-25,9,267,355,622
54167,2017-03-25,10,447,458,905
54168,2017-03-25,11,721,585,1306
54169,2017-03-25,12,883,616,1499
54170,2017-03-25,13,1034,582,1616
54171,2017-03-25,14,979,577,1556
54172,2017-03-25,15,1030,595,1625
54173,2017-03-25,16,883,584,1467
54174,2017-03-25,17,808,528,1336
54175,2017-03-25,18,588,501,1089
54176,2017-03-25,19,390,371,761
54177,2017-03-25,20,259,272,531
54178,2017-03-25,21,180,216,396
54179,2017-03-25,22,188,177,365
54180,2017-03-25,23,126,148,274
54181,2017-03-26,0,68,86,154
54182,2017-03-26,1,24,61,85
54183,2017-03-26,2,6,55,61
54184,2017-03-26,3,14,17,31
54185,2017-03-26,4,5,6,11
54186,2017-03-26,5,3,4,7
54187,2017-03-26,6,9,14,23
54188,2017-03-26,7,27,43,70
54189,2017-03-26,8,86,130,216
54190,2017-03-26,9,148,185,333
54191,2017-03-26,10,176,281,457
54192,2017-03-26,11,244,327,571
54193,2017-03-26,12,261,373,634
54194,2017-03-26,13,271,391,662
54195,2017-03-26,14,232,331,563
54196,2017-03-26,15,254,359,613
54197,2017-03-26,16,195,337,532
54198,2017-03-26,17,155,364,519
54199,2017-03-26,18,91,275,366
54200,2017-03-26,19,63,197,260
54201,2017-03-26,20,38,119,157
54202,2017-03-26,21,29,106,135
54203,2017-03-26,22,34,70,104
54204,2017-03-26,23,19,37,56
54205,2017-03-27,0,12,25,37
54206,2017-03-27,1,1,7,8
54207,2017-03-27,2,2,1,3
54208,2017-03-27,4,2,6,8
54209,2017-03-27,5,5,46,51
54210,2017-03-27,6,4,230,234
54211,2017-03-27,7,19,520,539
54212,2017-03-27,8,47,838,885
54213,2017-03-27,9,47,392,439
54214,2017-03-27,10,83,181,264
54215,2017-03-27,11,123,219,342
54216,2017-03-27,12,135,308,443
54217,2017-03-27,13,196,311,507
54218,2017-03-27,14,293,283,576
54219,2017-03-27,15,339,400,739
54220,2017-03-27,16,296,632,928
54221,2017-03-27,17,322,1334,1656
54222,2017-03-27,18,286,1142,1428
54223,2017-03-27,19,262,735,997
54224,2017-03-27,20,149,461,610
54225,2017-03-27,21,83,273,356
54226,2017-03-27,22,65,143,208
54227,2017-03-27,23,34,75,109
54228,2017-03-28,0,23,32,55
54229,2017-03-28,1,11,11,22
54230,2017-03-28,2,8,6,14
54231,2017-03-28,3,6,3,9
54232,2017-03-28,4,1,7,8
54233,2017-03-28,5,3,69,72
54234,2017-03-28,6,17,296,313
54235,2017-03-28,7,43,790,833
54236,2017-03-28,8,52,967,1019
54237,2017-03-28,9,24,264,288
54238,2017-03-28,10,43,122,165
54239,2017-03-28,11,42,172,214
54240,2017-03-28,12,60,194,254
54241,2017-03-28,13,104,264,368
54242,2017-03-28,14,128,279,407
54243,2017-03-28,15,206,430,636
54244,2017-03-28,16,203,663,866
54245,2017-03-28,17,257,1334,1591
54246,2017-03-28,18,201,1111,1312
54247,2017-03-28,19,153,645,798
54248,2017-03-28,20,85,402,487
54249,2017-03-28,21,83,303,386
54250,2017-03-28,22,43,175,218
54251,2017-03-28,23,26,83,109
54252,2017-03-29,0,7,36,43
54253,2017-03-29,1,10,9,19
54254,2017-03-29,2,3,7,10
54255,2017-03-29,3,0,1,1
54256,2017-03-29,4,1,8,9
54257,2017-03-29,5,7,80,87
54258,2017-03-29,6,16,302,318
54259,2017-03-29,7,39,804,843
54260,2017-03-29,8,62,1169,1231
54261,2017-03-29,9,54,521,575
54262,2017-03-29,10,137,236,373
54263,2017-03-29,11,189,274,463
54264,2017-03-29,12,222,418,640
54265,2017-03-29,13,249,390,639
54266,2017-03-29,14,255,323,578
54267,2017-03-29,15,304,427,731
54268,2017-03-29,16,328,668,996
54269,2017-03-29,17,335,1354,1689
54270,2017-03-29,18,326,1094,1420
54271,2017-03-29,19,192,707,899
54272,2017-03-29,20,117,413,530
54273,2017-03-29,21,68,298,366
54274,2017-03-29,22,59,166,225
54275,2017-03-29,23,17,87,104
54276,2017-03-30,0,12,23,35
54277,2017-03-30,1,3,8,11
54278,2017-03-30,2,2,1,3
54279,2017-03-30,3,1,1,2
54280,2017-03-30,4,0,6,6
54281,2017-03-30,5,4,68,72
54282,2017-03-30,6,8,261,269
54283,2017-03-30,7,36,702,738
54284,2017-03-30,8,80,1090,1170
54285,2017-03-30,9,60,455,515
54286,2017-03-30,10,99,253,352
54287,2017-03-30,11,112,241,353
54288,2017-03-30,12,121,341,462
54289,2017-03-30,13,130,344,474
54290,2017-03-30,14,209,303,512
54291,2017-03-30,15,191,373,564
54292,2017-03-30,16,170,593,763
54293,2017-03-30,17,192,1137,1329
54294,2017-03-30,18,138,959,1097
54295,2017-03-30,19,85,507,592
54296,2017-03-30,20,70,363,433
54297,2017-03-30,21,46,243,289
54298,2017-03-30,22,31,149,180
54299,2017-03-30,23,19,84,103
54300,2017-03-31,0,6,29,35
54301,2017-03-31,1,4,7,11
54302,2017-03-31,2,1,5,6
54303,2017-03-31,4,0,8,8
54304,2017-03-31,5,0,38,38
54305,2017-03-31,6,2,118,120
54306,2017-03-31,7,4,118,122
54307,2017-03-31,8,18,261,279
54308,2017-03-31,9,8,122,130
54309,2017-03-31,10,6,31,37
54310,2017-03-31,11,1,39,40
54311,2017-03-31,12,9,44,53
54312,2017-03-31,13,12,92,104
54313,2017-03-31,14,34,148,182
54314,2017-03-31,15,32,163,195
54315,2017-03-31,16,64,347,411
54316,2017-03-31,17,69,694,763
54317,2017-03-31,18,73,542,615
54318,2017-03-31,19,9,135,144
54319,2017-03-31,20,15,139,154
54320,2017-03-31,21,13,112,125
54321,2017-03-31,22,26,102,128
54322,2017-03-31,23,15,78,93
54323,2017-04-01,0,14,49,63
54324,2017-04-01,1,10,35,45
54325,2017-04-01,2,10,17,27
54326,2017-04-01,3,5,14,19
54327,2017-04-01,4,2,3,5
54328,2017-04-01,5,2,7,9
54329,2017-04-01,6,9,41,50
54330,2017-04-01,7,27,95,122
54331,2017-04-01,8,64,166,230
54332,2017-04-01,9,181,307,488
54333,2017-04-01,10,273,442,715
54334,2017-04-01,11,366,496,862
54335,2017-04-01,12,426,508,934
54336,2017-04-01,13,478,485,963
54337,2017-04-01,14,516,511,1027
54338,2017-04-01,15,548,460,1008
54339,2017-04-01,16,517,515,1032
54340,2017-04-01,17,435,470,905
54341,2017-04-01,18,280,338,618
54342,2017-04-01,19,144,284,428
54343,2017-04-01,20,63,198,261
54344,2017-04-01,21,56,141,197
54345,2017-04-01,22,45,122,167
54346,2017-04-01,23,34,105,139
54347,2017-04-02,0,57,106,163
54348,2017-04-02,1,15,62,77
54349,2017-04-02,2,25,53,78
54350,2017-04-02,3,7,20,27
54351,2017-04-02,4,3,6,9
54352,2017-04-02,5,2,11,13
54353,2017-04-02,6,66,178,244
54354,2017-04-02,7,49,124,173
54355,2017-04-02,8,93,158,251
54356,2017-04-02,9,224,368,592
54357,2017-04-02,10,371,440,811
54358,2017-04-02,11,500,495,995
54359,2017-04-02,12,669,549,1218
54360,2017-04-02,13,715,542,1257
54361,2017-04-02,14,846,581,1427
54362,2017-04-02,15,775,567,1342
54363,2017-04-02,16,726,607,1333
54364,2017-04-02,17,630,579,1209
54365,2017-04-02,18,501,439,940
54366,2017-04-02,19,308,348,656
54367,2017-04-02,20,147,250,397
54368,2017-04-02,21,90,141,231
54369,2017-04-02,22,88,86,174
54370,2017-04-02,23,47,50,97
54371,2017-04-03,0,14,25,39
54372,2017-04-03,1,11,8,19
54373,2017-04-03,2,4,6,10
54374,2017-04-03,3,0,5,5
54375,2017-04-03,4,0,6,6
54376,2017-04-03,5,2,76,78
54377,2017-04-03,6,17,258,275
54378,2017-04-03,7,42,677,719
54379,2017-04-03,8,55,984,1039
54380,2017-04-03,9,95,464,559
54381,2017-04-03,10,147,326,473
54382,2017-04-03,11,221,316,537
54383,2017-04-03,12,204,417,621
54384,2017-04-03,13,199,329,528
54385,2017-04-03,14,237,282,519
54386,2017-04-03,15,267,402,669
54387,2017-04-03,16,331,642,973
54388,2017-04-03,17,280,1262,1542
54389,2017-04-03,18,215,950,1165
54390,2017-04-03,19,101,547,648
54391,2017-04-03,20,42,151,193
54392,2017-04-03,21,13,89,102
54393,2017-04-03,22,10,78,88
54394,2017-04-03,23,5,55,60
54395,2017-04-04,0,11,42,53
54396,2017-04-04,1,1,5,6
54397,2017-04-04,2,2,5,7
54398,2017-04-04,3,0,4,4
54399,2017-04-04,4,2,8,10
54400,2017-04-04,5,1,83,84
54401,2017-04-04,6,18,294,312
54402,2017-04-04,7,36,769,805
54403,2017-04-04,8,87,1143,1230
54404,2017-04-04,9,61,333,394
54405,2017-04-04,10,115,223,338
54406,2017-04-04,11,183,279,462
54407,2017-04-04,12,199,358,557
54408,2017-04-04,13,228,369,597
54409,2017-04-04,14,268,317,585
54410,2017-04-04,15,273,420,693
54411,2017-04-04,16,291,763,1054
54412,2017-04-04,17,347,1397,1744
54413,2017-04-04,18,272,1142,1414
54414,2017-04-04,19,228,698,926
54415,2017-04-04,20,155,464,619
54416,2017-04-04,21,80,351,431
54417,2017-04-04,22,38,204,242
54418,2017-04-04,23,25,74,99
54419,2017-04-05,0,15,34,49
54420,2017-04-05,1,8,16,24
54421,2017-04-05,2,4,6,10
54422,2017-04-05,3,2,3,5
54423,2017-04-05,4,2,6,8
54424,2017-04-05,5,3,97,100
54425,2017-04-05,6,19,319,338
54426,2017-04-05,7,51,944,995
54427,2017-04-05,8,97,1203,1300
54428,2017-04-05,9,131,512,643
54429,2017-04-05,10,146,263,409
54430,2017-04-05,11,210,290,500
54431,2017-04-05,12,238,420,658
54432,2017-04-05,13,283,410,693
54433,2017-04-05,14,323,357,680
54434,2017-04-05,15,274,458,732
54435,2017-04-05,16,321,719,1040
54436,2017-04-05,17,328,1384,1712
54437,2017-04-05,18,269,1187,1456
54438,2017-04-05,19,155,675,830
54439,2017-04-05,20,123,399,522
54440,2017-04-05,21,75,310,385
54441,2017-04-05,22,73,248,321
54442,2017-04-05,23,40,92,132
54443,2017-04-06,0,15,33,48
54444,2017-04-06,1,6,9,15
54445,2017-04-06,2,1,5,6
54446,2017-04-06,3,0,2,2
54447,2017-04-06,4,2,6,8
54448,2017-04-06,5,2,77,79
54449,2017-04-06,6,6,256,262
54450,2017-04-06,7,32,782,814
54451,2017-04-06,8,50,887,937
54452,2017-04-06,9,6,83,89
54453,2017-04-06,10,2,39,41
54454,2017-04-06,11,4,25,29
54455,2017-04-06,12,3,44,47
54456,2017-04-06,13,17,80,97
54457,2017-04-06,14,25,95,120
54458,2017-04-06,15,25,280,305
54459,2017-04-06,16,16,172,188
54460,2017-04-06,17,101,948,1049
54461,2017-04-06,18,118,866,984
54462,2017-04-06,19,44,332,376
54463,2017-04-06,20,27,284,311
54464,2017-04-06,21,25,228,253
54465,2017-04-06,22,21,150,171
54466,2017-04-06,23,35,87,122
54467,2017-04-07,0,9,38,47
54468,2017-04-07,1,7,17,24
54469,2017-04-07,2,1,6,7
54470,2017-04-07,3,1,6,7
54471,2017-04-07,4,1,5,6
54472,2017-04-07,5,2,71,73
54473,2017-04-07,6,10,211,221
54474,2017-04-07,7,20,490,510
54475,2017-04-07,8,41,915,956
54476,2017-04-07,9,79,475,554
54477,2017-04-07,10,64,203,267
54478,2017-04-07,11,87,221,308
54479,2017-04-07,12,73,280,353
54480,2017-04-07,13,93,292,385
54481,2017-04-07,14,80,249,329
54482,2017-04-07,15,75,320,395
54483,2017-04-07,16,92,529,621
54484,2017-04-07,17,83,813,896
54485,2017-04-07,18,62,592,654
54486,2017-04-07,19,44,376,420
54487,2017-04-07,20,23,189,212
54488,2017-04-07,21,19,123,142
54489,2017-04-07,22,12,105,117
54490,2017-04-07,23,17,74,91
54491,2017-04-08,0,15,68,83
54492,2017-04-08,1,5,42,47
54493,2017-04-08,2,7,27,34
54494,2017-04-08,3,8,16,24
54495,2017-04-08,4,2,5,7
54496,2017-04-08,5,4,11,15
54497,2017-04-08,6,13,23,36
54498,2017-04-08,7,32,81,113
54499,2017-04-08,8,59,176,235
54500,2017-04-08,9,129,319,448
54501,2017-04-08,10,276,423,699
54502,2017-04-08,11,377,471,848
54503,2017-04-08,12,586,567,1153
54504,2017-04-08,13,705,539,1244
54505,2017-04-08,14,727,543,1270
54506,2017-04-08,15,738,533,1271
54507,2017-04-08,16,702,491,1193
54508,2017-04-08,17,586,463,1049
54509,2017-04-08,18,485,464,949
54510,2017-04-08,19,267,360,627
54511,2017-04-08,20,149,232,381
54512,2017-04-08,21,114,169,283
54513,2017-04-08,22,133,138,271
54514,2017-04-08,23,94,129,223
54515,2017-04-09,0,28,113,141
54516,2017-04-09,1,25,70,95
54517,2017-04-09,2,16,58,74
54518,2017-04-09,3,7,24,31
54519,2017-04-09,4,4,7,11
54520,2017-04-09,5,8,8,16
54521,2017-04-09,6,10,20,30
54522,2017-04-09,7,25,71,96
54523,2017-04-09,8,71,148,219
54524,2017-04-09,9,242,261,503
54525,2017-04-09,10,481,441,922
54526,2017-04-09,11,612,497,1109
54527,2017-04-09,12,835,601,1436
54528,2017-04-09,13,858,695,1553
54529,2017-04-09,14,913,665,1578
54530,2017-04-09,15,864,673,1537
54531,2017-04-09,16,819,673,1492
54532,2017-04-09,17,689,650,1339
54533,2017-04-09,18,493,510,1003
54534,2017-04-09,19,376,402,778
54535,2017-04-09,20,272,266,538
54536,2017-04-09,21,142,212,354
54537,2017-04-09,22,97,99,196
54538,2017-04-09,23,29,51,80
54539,2017-04-10,0,18,19,37
54540,2017-04-10,1,7,8,15
54541,2017-04-10,2,4,0,4
54542,2017-04-10,3,1,3,4
54543,2017-04-10,4,0,6,6
54544,2017-04-10,5,2,80,82
54545,2017-04-10,6,9,295,304
54546,2017-04-10,7,36,761,797
54547,2017-04-10,8,85,970,1055
54548,2017-04-10,9,149,424,573
54549,2017-04-10,10,276,220,496
54550,2017-04-10,11,353,261,614
54551,2017-04-10,12,333,362,695
54552,2017-04-10,13,389,331,720
54553,2017-04-10,14,402,316,718
54554,2017-04-10,15,439,415,854
54555,2017-04-10,16,360,711,1071
54556,2017-04-10,17,400,1420,1820
54557,2017-04-10,18,362,1202,1564
54558,2017-04-10,19,256,659,915
54559,2017-04-10,20,144,382,526
54560,2017-04-10,21,120,284,404
54561,2017-04-10,22,96,225,321
54562,2017-04-10,23,41,106,147
54563,2017-04-11,0,44,44,88
54564,2017-04-11,1,6,11,17
54565,2017-04-11,2,5,7,12
54566,2017-04-11,3,1,2,3
54567,2017-04-11,4,1,8,9
54568,2017-04-11,5,5,98,103
54569,2017-04-11,6,19,341,360
54570,2017-04-11,7,55,909,964
54571,2017-04-11,8,128,1247,1375
54572,2017-04-11,9,172,492,664
54573,2017-04-11,10,287,264,551
54574,2017-04-11,11,325,324,649
54575,2017-04-11,12,392,394,786
54576,2017-04-11,13,409,397,806
54577,2017-04-11,14,439,314,753
54578,2017-04-11,15,370,449,819
54579,2017-04-11,16,389,686,1075
54580,2017-04-11,17,502,1388,1890
54581,2017-04-11,18,429,1211,1640
54582,2017-04-11,19,345,715,1060
54583,2017-04-11,20,191,475,666
54584,2017-04-11,21,178,362,540
54585,2017-04-11,22,157,286,443
54586,2017-04-11,23,7,88,95
54587,2017-04-12,0,0,32,32
54588,2017-04-12,1,10,13,23
54589,2017-04-12,2,19,8,27
54590,2017-04-12,3,9,11,20
54591,2017-04-12,4,2,10,12
54592,2017-04-12,5,7,91,98
54593,2017-04-12,6,18,351,369
54594,2017-04-12,7,54,885,939
54595,2017-04-12,8,109,1200,1309
54596,2017-04-12,9,176,456,632
54597,2017-04-12,10,129,206,335
54598,2017-04-12,11,218,284,502
54599,2017-04-12,12,265,366,631
54600,2017-04-12,13,233,382,615
54601,2017-04-12,14,297,315,612
54602,2017-04-12,15,299,432,731
54603,2017-04-12,16,335,761,1096
54604,2017-04-12,17,400,1435,1835
54605,2017-04-12,18,357,1142,1499
54606,2017-04-12,19,308,822,1130
54607,2017-04-12,20,177,488,665
54608,2017-04-12,21,131,311,442
54609,2017-04-12,22,101,252,353
54610,2017-04-12,23,78,99,177
54611,2017-04-13,0,35,38,73
54612,2017-04-13,1,10,19,29
54613,2017-04-13,2,0,17,17
54614,2017-04-13,3,6,5,11
54615,2017-04-13,4,6,8,14
54616,2017-04-13,5,1,90,91
54617,2017-04-13,6,14,293,307
54618,2017-04-13,7,51,890,941
54619,2017-04-13,8,132,1266,1398
54620,2017-04-13,9,175,501,676
54621,2017-04-13,10,255,287,542
54622,2017-04-13,11,347,310,657
54623,2017-04-13,12,374,417,791
54624,2017-04-13,13,384,389,773
54625,2017-04-13,14,423,355,778
54626,2017-04-13,15,390,469,859
54627,2017-04-13,16,466,760,1226
54628,2017-04-13,17,432,1426,1858
54629,2017-04-13,18,481,1150,1631
54630,2017-04-13,19,315,734,1049
54631,2017-04-13,20,225,472,697
54632,2017-04-13,21,170,331,501
54633,2017-04-13,22,114,237,351
54634,2017-04-13,23,53,111,164
54635,2017-04-14,0,31,49,80
54636,2017-04-14,1,8,22,30
54637,2017-04-14,2,12,9,21
54638,2017-04-14,3,1,2,3
54639,2017-04-14,4,9,6,15
54640,2017-04-14,5,4,63,67
54641,2017-04-14,6,20,225,245
54642,2017-04-14,7,57,700,757
54643,2017-04-14,8,98,1058,1156
54644,2017-04-14,9,242,527,769
54645,2017-04-14,10,344,293,637
54646,2017-04-14,11,478,393,871
54647,2017-04-14,12,573,418,991
54648,2017-04-14,13,548,502,1050
54649,2017-04-14,14,686,553,1239
54650,2017-04-14,15,642,614,1256
54651,2017-04-14,16,606,835,1441
54652,2017-04-14,17,601,1054,1655
54653,2017-04-14,18,435,771,1206
54654,2017-04-14,19,439,563,1002
54655,2017-04-14,20,275,325,600
54656,2017-04-14,21,178,213,391
54657,2017-04-14,22,134,203,337
54658,2017-04-14,23,103,109,212
54659,2017-04-15,0,80,95,175
54660,2017-04-15,1,46,61,107
54661,2017-04-15,2,11,37,48
54662,2017-04-15,3,13,20,33
54663,2017-04-15,4,8,9,17
54664,2017-04-15,5,3,22,25
54665,2017-04-15,6,12,48,60
54666,2017-04-15,7,47,94,141
54667,2017-04-15,8,154,192,346
54668,2017-04-15,9,266,329,595
54669,2017-04-15,10,553,398,951
54670,2017-04-15,11,700,513,1213
54671,2017-04-15,12,883,598,1481
54672,2017-04-15,13,956,530,1486
54673,2017-04-15,14,992,471,1463
54674,2017-04-15,15,1036,558,1594
54675,2017-04-15,16,984,553,1537
54676,2017-04-15,17,920,511,1431
54677,2017-04-15,18,765,453,1218
54678,2017-04-15,19,613,399,1012
54679,2017-04-15,20,457,275,732
54680,2017-04-15,21,349,244,593
54681,2017-04-15,22,199,143,342
54682,2017-04-15,23,120,170,290
54683,2017-04-16,0,107,116,223
54684,2017-04-16,1,69,55,124
54685,2017-04-16,2,34,62,96
54686,2017-04-16,3,24,18,42
54687,2017-04-16,4,7,11,18
54688,2017-04-16,5,20,16,36
54689,2017-04-16,6,49,33,82
54690,2017-04-16,7,54,69,123
54691,2017-04-16,8,141,169,310
54692,2017-04-16,9,345,254,599
54693,2017-04-16,10,486,408,894
54694,2017-04-16,11,643,456,1099
54695,2017-04-16,12,791,514,1305
54696,2017-04-16,13,659,475,1134
54697,2017-04-16,14,638,411,1049
54698,2017-04-16,15,687,391,1078
54699,2017-04-16,16,599,485,1084
54700,2017-04-16,17,578,450,1028
54701,2017-04-16,18,453,355,808
54702,2017-04-16,19,427,313,740
54703,2017-04-16,20,257,236,493
54704,2017-04-16,21,203,190,393
54705,2017-04-16,22,128,111,239
54706,2017-04-16,23,70,56,126
54707,2017-04-17,0,49,24,73
54708,2017-04-17,1,15,11,26
54709,2017-04-17,2,9,7,16
54710,2017-04-17,3,5,7,12
54711,2017-04-17,4,3,11,14
54712,2017-04-17,5,5,72,77
54713,2017-04-17,6,16,241,257
54714,2017-04-17,7,35,585,620
54715,2017-04-17,8,67,755,822
54716,2017-04-17,9,143,385,528
54717,2017-04-17,10,179,185,364
54718,2017-04-17,11,94,89,183
54719,2017-04-17,12,30,77,107
54720,2017-04-17,13,113,188,301
54721,2017-04-17,14,214,246,460
54722,2017-04-17,15,257,351,608
54723,2017-04-17,16,263,589,852
54724,2017-04-17,17,271,1281,1552
54725,2017-04-17,18,267,987,1254
54726,2017-04-17,19,219,661,880
54727,2017-04-17,20,160,405,565
54728,2017-04-17,21,103,270,373
54729,2017-04-17,22,81,155,236
54730,2017-04-17,23,35,62,97
54731,2017-04-18,0,19,36,55
54732,2017-04-18,1,6,13,19
54733,2017-04-18,2,1,8,9
54734,2017-04-18,3,6,4,10
54735,2017-04-18,4,0,14,14
54736,2017-04-18,5,3,67,70
54737,2017-04-18,6,31,352,383
54738,2017-04-18,7,35,896,931
54739,2017-04-18,8,66,1171,1237
54740,2017-04-18,9,117,478,595
54741,2017-04-18,10,201,253,454
54742,2017-04-18,11,209,287,496
54743,2017-04-18,12,286,368,654
54744,2017-04-18,13,308,370,678
54745,2017-04-18,14,330,302,632
54746,2017-04-18,15,317,422,739
54747,2017-04-18,16,328,744,1072
54748,2017-04-18,17,381,1607,1988
54749,2017-04-18,18,324,1233,1557
54750,2017-04-18,19,238,781,1019
54751,2017-04-18,20,88,438,526
54752,2017-04-18,21,59,261,320
54753,2017-04-18,22,36,170,206
54754,2017-04-18,23,17,71,88
54755,2017-04-19,0,10,33,43
54756,2017-04-19,1,2,6,8
54757,2017-04-19,2,2,5,7
54758,2017-04-19,3,3,4,7
54759,2017-04-19,4,0,9,9
54760,2017-04-19,5,4,85,89
54761,2017-04-19,6,15,259,274
54762,2017-04-19,7,32,738,770
54763,2017-04-19,8,88,1135,1223
54764,2017-04-19,9,112,538,650
54765,2017-04-19,10,103,237,340
54766,2017-04-19,11,175,294,469
54767,2017-04-19,12,171,370,541
54768,2017-04-19,13,189,327,516
54769,2017-04-19,14,180,295,475
54770,2017-04-19,15,188,407,595
54771,2017-04-19,16,206,645,851
54772,2017-04-19,17,258,1316,1574
54773,2017-04-19,18,186,1038,1224
54774,2017-04-19,19,157,597,754
54775,2017-04-19,20,105,428,533
54776,2017-04-19,21,51,292,343
54777,2017-04-19,22,56,247,303
54778,2017-04-19,23,10,85,95
54779,2017-04-20,0,6,43,49
54780,2017-04-20,1,2,12,14
54781,2017-04-20,2,3,4,7
54782,2017-04-20,3,1,4,5
54783,2017-04-20,4,2,7,9
54784,2017-04-20,5,8,77,85
54785,2017-04-20,6,24,317,341
54786,2017-04-20,7,49,793,842
54787,2017-04-20,8,44,529,573
54788,2017-04-20,9,84,386,470
54789,2017-04-20,10,136,246,382
54790,2017-04-20,11,198,280,478
54791,2017-04-20,12,278,398,676
54792,2017-04-20,13,300,395,695
54793,2017-04-20,14,297,316,613
54794,2017-04-20,15,343,459,802
54795,2017-04-20,16,299,754,1053
54796,2017-04-20,17,370,1345,1715
54797,2017-04-20,18,312,1098,1410
54798,2017-04-20,19,272,712,984
54799,2017-04-20,20,82,235,317
54800,2017-04-20,21,92,229,321
54801,2017-04-20,22,54,214,268
54802,2017-04-20,23,49,114,163
54803,2017-04-21,0,22,46,68
54804,2017-04-21,1,19,23,42
54805,2017-04-21,2,3,12,15
54806,2017-04-21,3,4,5,9
54807,2017-04-21,4,0,9,9
54808,2017-04-21,5,4,67,71
54809,2017-04-21,6,17,247,264
54810,2017-04-21,7,55,620,675
54811,2017-04-21,8,105,1009,1114
54812,2017-04-21,9,149,518,667
54813,2017-04-21,10,220,267,487
54814,2017-04-21,11,308,287,595
54815,2017-04-21,12,340,401,741
54816,2017-04-21,13,341,412,753
54817,2017-04-21,14,303,411,714
54818,2017-04-21,15,355,492,847
54819,2017-04-21,16,386,833,1219
54820,2017-04-21,17,414,1026,1440
54821,2017-04-21,18,341,914,1255
54822,2017-04-21,19,263,599,862
54823,2017-04-21,20,230,339,569
54824,2017-04-21,21,188,247,435
54825,2017-04-21,22,163,229,392
54826,2017-04-21,23,118,179,297
54827,2017-04-22,0,76,120,196
54828,2017-04-22,1,56,62,118
54829,2017-04-22,2,42,52,94
54830,2017-04-22,3,22,18,40
54831,2017-04-22,4,7,4,11
54832,2017-04-22,5,4,10,14
54833,2017-04-22,6,8,27,35
54834,2017-04-22,7,31,84,115
54835,2017-04-22,8,86,198,284
54836,2017-04-22,9,100,315,415
54837,2017-04-22,10,99,209,308
54838,2017-04-22,11,130,199,329
54839,2017-04-22,12,60,181,241
54840,2017-04-22,13,54,208,262
54841,2017-04-22,14,55,166,221
54842,2017-04-22,15,82,191,273
54843,2017-04-22,16,70,156,226
54844,2017-04-22,17,47,136,183
54845,2017-04-22,18,46,160,206
54846,2017-04-22,19,68,147,215
54847,2017-04-22,20,42,164,206
54848,2017-04-22,21,53,150,203
54849,2017-04-22,22,51,98,149
54850,2017-04-22,23,41,100,141
54851,2017-04-23,0,46,77,123
54852,2017-04-23,1,37,72,109
54853,2017-04-23,2,24,48,72
54854,2017-04-23,3,10,28,38
54855,2017-04-23,4,3,11,14
54856,2017-04-23,5,4,15,19
54857,2017-04-23,6,12,17,29
54858,2017-04-23,7,20,58,78
54859,2017-04-23,8,90,160,250
54860,2017-04-23,9,155,256,411
54861,2017-04-23,10,340,379,719
54862,2017-04-23,11,431,495,926
54863,2017-04-23,12,529,470,999
54864,2017-04-23,13,513,485,998
54865,2017-04-23,14,574,506,1080
54866,2017-04-23,15,515,503,1018
54867,2017-04-23,16,500,529,1029
54868,2017-04-23,17,385,469,854
54869,2017-04-23,18,257,393,650
54870,2017-04-23,19,179,335,514
54871,2017-04-23,20,111,192,303
54872,2017-04-23,21,81,169,250
54873,2017-04-23,22,61,110,171
54874,2017-04-23,23,24,64,88
54875,2017-04-24,0,7,24,31
54876,2017-04-24,1,4,12,16
54877,2017-04-24,2,2,1,3
54878,2017-04-24,3,2,4,6
54879,2017-04-24,4,0,4,4
54880,2017-04-24,5,3,70,73
54881,2017-04-24,6,10,213,223
54882,2017-04-24,7,18,573,591
54883,2017-04-24,8,44,724,768
54884,2017-04-24,9,31,212,243
54885,2017-04-24,10,46,167,213
54886,2017-04-24,11,72,202,274
54887,2017-04-24,12,46,216,262
54888,2017-04-24,13,46,144,190
54889,2017-04-24,14,25,77,102
54890,2017-04-24,15,24,129,153
54891,2017-04-24,16,24,228,252
54892,2017-04-24,17,59,584,643
54893,2017-04-24,18,42,630,672
54894,2017-04-24,19,27,368,395
54895,2017-04-24,20,14,223,237
54896,2017-04-24,21,15,135,150
54897,2017-04-24,22,15,115,130
54898,2017-04-24,23,5,48,53
54899,2017-04-25,0,5,13,18
54900,2017-04-25,1,4,9,13
54901,2017-04-25,2,1,5,6
54902,2017-04-25,3,1,1,2
54903,2017-04-25,4,1,8,9
54904,2017-04-25,5,4,68,72
54905,2017-04-25,6,5,292,297
54906,2017-04-25,7,16,607,623
54907,2017-04-25,8,34,911,945
54908,2017-04-25,9,47,449,496
54909,2017-04-25,10,45,169,214
54910,2017-04-25,11,28,106,134
54911,2017-04-25,12,20,158,178
54912,2017-04-25,13,14,114,128
54913,2017-04-25,14,24,127,151
54914,2017-04-25,15,31,245,276
54915,2017-04-25,16,62,493,555
54916,2017-04-25,17,97,1054,1151
54917,2017-04-25,18,99,945,1044
54918,2017-04-25,19,60,603,663
54919,2017-04-25,20,46,359,405
54920,2017-04-25,21,45,267,312
54921,2017-04-25,22,26,162,188
54922,2017-04-25,23,18,68,86
54923,2017-04-26,0,3,21,24
54924,2017-04-26,1,9,9,18
54925,2017-04-26,2,1,3,4
54926,2017-04-26,3,1,1,2
54927,2017-04-26,4,0,11,11
54928,2017-04-26,5,1,83,84
54929,2017-04-26,6,19,338,357
54930,2017-04-26,7,27,818,845
54931,2017-04-26,8,58,1093,1151
54932,2017-04-26,9,65,477,542
54933,2017-04-26,10,84,228,312
54934,2017-04-26,11,108,287,395
54935,2017-04-26,12,144,381,525
54936,2017-04-26,13,133,385,518
54937,2017-04-26,14,107,320,427
54938,2017-04-26,15,152,435,587
54939,2017-04-26,16,155,755,910
54940,2017-04-26,17,236,1368,1604
54941,2017-04-26,18,204,1126,1330
54942,2017-04-26,19,131,744,875
54943,2017-04-26,20,109,533,642
54944,2017-04-26,21,72,336,408
54945,2017-04-26,22,36,225,261
54946,2017-04-26,23,24,110,134
54947,2017-04-27,0,10,30,40
54948,2017-04-27,1,9,14,23
54949,2017-04-27,2,13,9,22
54950,2017-04-27,3,4,5,9
54951,2017-04-27,4,0,10,10
54952,2017-04-27,5,8,73,81
54953,2017-04-27,6,21,321,342
54954,2017-04-27,7,77,946,1023
54955,2017-04-27,8,121,1344,1465
54956,2017-04-27,9,115,611,726
54957,2017-04-27,10,138,312,450
54958,2017-04-27,11,176,263,439
54959,2017-04-27,12,199,367,566
54960,2017-04-27,13,189,381,570
54961,2017-04-27,14,239,352,591
54962,2017-04-27,15,249,480,729
54963,2017-04-27,16,248,743,991
54964,2017-04-27,17,305,1409,1714
54965,2017-04-27,18,290,1193,1483
54966,2017-04-27,19,207,712,919
54967,2017-04-27,20,147,482,629
54968,2017-04-27,21,112,366,478
54969,2017-04-27,22,67,237,304
54970,2017-04-27,23,46,137,183
54971,2017-04-28,0,20,67,87
54972,2017-04-28,1,8,38,46
54973,2017-04-28,2,10,25,35
54974,2017-04-28,3,1,6,7
54975,2017-04-28,4,1,12,13
54976,2017-04-28,5,5,80,85
54977,2017-04-28,6,20,290,310
54978,2017-04-28,7,50,769,819
54979,2017-04-28,8,114,1117,1231
54980,2017-04-28,9,130,540,670
54981,2017-04-28,10,204,298,502
54982,2017-04-28,11,305,357,662
54983,2017-04-28,12,347,474,821
54984,2017-04-28,13,341,417,758
54985,2017-04-28,14,331,394,725
54986,2017-04-28,15,368,554,922
54987,2017-04-28,16,350,828,1178
54988,2017-04-28,17,378,1250,1628
54989,2017-04-28,18,336,866,1202
54990,2017-04-28,19,308,584,892
54991,2017-04-28,20,198,415,613
54992,2017-04-28,21,183,295,478
54993,2017-04-28,22,146,273,419
54994,2017-04-28,23,82,205,287
54995,2017-04-29,0,94,150,244
54996,2017-04-29,1,77,78,155
54997,2017-04-29,2,29,40,69
54998,2017-04-29,3,16,30,46
54999,2017-04-29,4,3,11,14
55000,2017-04-29,5,13,25,38
55001,2017-04-29,6,23,54,77
55002,2017-04-29,7,77,159,236
55003,2017-04-29,8,150,262,412
55004,2017-04-29,9,283,420,703
55005,2017-04-29,10,390,551,941
55006,2017-04-29,11,552,530,1082
55007,2017-04-29,12,638,555,1193
55008,2017-04-29,13,639,456,1095
55009,2017-04-29,14,644,515,1159
55010,2017-04-29,15,640,555,1195
55011,2017-04-29,16,655,538,1193
55012,2017-04-29,17,515,476,991
55013,2017-04-29,18,419,465,884
55014,2017-04-29,19,385,389,774
55015,2017-04-29,20,327,303,630
55016,2017-04-29,21,186,260,446
55017,2017-04-29,22,201,222,423
55018,2017-04-29,23,198,214,412
55019,2017-04-30,0,87,136,223
55020,2017-04-30,1,57,84,141
55021,2017-04-30,2,50,86,136
55022,2017-04-30,3,24,31,55
55023,2017-04-30,4,22,10,32
55024,2017-04-30,5,14,20,34
55025,2017-04-30,6,30,37,67
55026,2017-04-30,7,47,90,137
55027,2017-04-30,8,148,196,344
55028,2017-04-30,9,258,302,560
55029,2017-04-30,10,432,411,843
55030,2017-04-30,11,599,518,1117
55031,2017-04-30,12,687,587,1274
55032,2017-04-30,13,685,601,1286
55033,2017-04-30,14,590,520,1110
55034,2017-04-30,15,517,514,1031
55035,2017-04-30,16,517,532,1049
55036,2017-04-30,17,508,535,1043
55037,2017-04-30,18,446,475,921
55038,2017-04-30,19,353,466,819
55039,2017-04-30,20,266,308,574
55040,2017-04-30,21,183,229,412
55041,2017-04-30,22,127,129,256
55042,2017-04-30,23,73,71,144
55043,2017-05-01,0,33,26,59
55044,2017-05-01,1,17,7,24
55045,2017-05-01,2,10,10,20
55046,2017-05-01,3,0,6,6
55047,2017-05-01,4,3,13,16
55048,2017-05-01,5,5,92,97
55049,2017-05-01,6,24,306,330
55050,2017-05-01,7,38,762,800
55051,2017-05-01,8,73,906,979
55052,2017-05-01,9,109,432,541
55053,2017-05-01,10,124,233,357
55054,2017-05-01,11,168,222,390
55055,2017-05-01,12,171,321,492
55056,2017-05-01,13,179,347,526
55057,2017-05-01,14,187,300,487
55058,2017-05-01,15,172,398,570
55059,2017-05-01,16,230,696,926
55060,2017-05-01,17,247,1373,1620
55061,2017-05-01,18,193,1043,1236
55062,2017-05-01,19,107,481,588
55063,2017-05-01,20,53,283,336
55064,2017-05-01,21,63,206,269
55065,2017-05-01,22,53,130,183
55066,2017-05-01,23,45,85,130
55067,2017-05-02,0,32,31,63
55068,2017-05-02,1,10,9,19
55069,2017-05-02,2,11,8,19
55070,2017-05-02,3,13,8,21
55071,2017-05-02,4,1,10,11
55072,2017-05-02,5,10,87,97
55073,2017-05-02,6,24,417,441
55074,2017-05-02,7,57,1053,1110
55075,2017-05-02,8,79,1200,1279
55076,2017-05-02,9,91,478,569
55077,2017-05-02,10,85,249,334
55078,2017-05-02,11,145,292,437
55079,2017-05-02,12,154,394,548
55080,2017-05-02,13,182,363,545
55081,2017-05-02,14,187,346,533
55082,2017-05-02,15,215,473,688
55083,2017-05-02,16,207,801,1008
55084,2017-05-02,17,270,1540,1810
55085,2017-05-02,18,224,1196,1420
55086,2017-05-02,19,166,720,886
55087,2017-05-02,20,124,487,611
55088,2017-05-02,21,111,317,428
55089,2017-05-02,22,89,202,291
55090,2017-05-02,23,29,113,142
55091,2017-05-03,0,19,46,65
55092,2017-05-03,1,18,14,32
55093,2017-05-03,2,10,18,28
55094,2017-05-03,3,1,7,8
55095,2017-05-03,4,2,10,12
55096,2017-05-03,5,4,98,102
55097,2017-05-03,6,27,372,399
55098,2017-05-03,7,59,1036,1095
55099,2017-05-03,8,98,1172,1270
55100,2017-05-03,9,108,526,634
55101,2017-05-03,10,115,273,388
55102,2017-05-03,11,122,310,432
55103,2017-05-03,12,169,395,564
55104,2017-05-03,13,175,363,538
55105,2017-05-03,14,164,282,446
55106,2017-05-03,15,156,400,556
55107,2017-05-03,16,241,791,1032
55108,2017-05-03,17,271,1442,1713
55109,2017-05-03,18,255,1144,1399
55110,2017-05-03,19,192,667,859
55111,2017-05-03,20,104,448,552
55112,2017-05-03,21,85,294,379
55113,2017-05-03,22,54,261,315
55114,2017-05-03,23,33,79,112
55115,2017-05-04,0,13,27,40
55116,2017-05-04,1,9,9,18
55117,2017-05-04,2,2,6,8
55118,2017-05-04,3,2,5,7
55119,2017-05-04,4,0,18,18
55120,2017-05-04,5,2,83,85
55121,2017-05-04,6,16,345,361
55122,2017-05-04,7,49,880,929
55123,2017-05-04,8,83,1216,1299
55124,2017-05-04,9,97,562,659
55125,2017-05-04,10,99,274,373
55126,2017-05-04,11,151,336,487
55127,2017-05-04,12,178,476,654
55128,2017-05-04,13,178,393,571
55129,2017-05-04,14,182,316,498
55130,2017-05-04,15,193,404,597
55131,2017-05-04,16,204,764,968
55132,2017-05-04,17,263,1309,1572
55133,2017-05-04,18,202,1040,1242
55134,2017-05-04,19,136,632,768
55135,2017-05-04,20,58,286,344
55136,2017-05-04,21,33,150,183
55137,2017-05-04,22,39,76,115
55138,2017-05-04,23,6,49,55
55139,2017-05-05,0,3,16,19
55140,2017-05-05,1,4,14,18
55141,2017-05-05,2,6,12,18
55142,2017-05-05,3,2,6,8
55143,2017-05-05,4,0,6,6
55144,2017-05-05,5,2,9,11
55145,2017-05-05,6,2,49,51
55146,2017-05-05,7,4,119,123
55147,2017-05-05,8,5,106,111
55148,2017-05-05,9,7,98,105
55149,2017-05-05,10,26,171,197
55150,2017-05-05,11,69,225,294
55151,2017-05-05,12,91,294,385
55152,2017-05-05,13,89,286,375
55153,2017-05-05,14,149,307,456
55154,2017-05-05,15,159,425,584
55155,2017-05-05,16,201,677,878
55156,2017-05-05,17,195,994,1189
55157,2017-05-05,18,136,751,887
55158,2017-05-05,19,125,527,652
55159,2017-05-05,20,103,304,407
55160,2017-05-05,21,90,189,279
55161,2017-05-05,22,21,72,93
55162,2017-05-05,23,22,95,117
55163,2017-05-06,0,40,87,127
55164,2017-05-06,1,15,58,73
55165,2017-05-06,2,20,51,71
55166,2017-05-06,3,17,30,47
55167,2017-05-06,4,5,9,14
55168,2017-05-06,5,0,7,7
55169,2017-05-06,6,9,38,47
55170,2017-05-06,7,21,108,129
55171,2017-05-06,8,63,200,263
55172,2017-05-06,9,93,318,411
55173,2017-05-06,10,115,303,418
55174,2017-05-06,11,83,238,321
55175,2017-05-06,12,87,241,328
55176,2017-05-06,13,126,272,398
55177,2017-05-06,14,181,293,474
55178,2017-05-06,15,219,338,557
55179,2017-05-06,16,190,361,551
55180,2017-05-06,17,107,204,311
55181,2017-05-06,18,72,181,253
55182,2017-05-06,19,83,198,281
55183,2017-05-06,20,62,169,231
55184,2017-05-06,21,48,141,189
55185,2017-05-06,22,45,121,166
55186,2017-05-06,23,66,107,173
55187,2017-05-07,0,29,85,114
55188,2017-05-07,1,16,51,67
55189,2017-05-07,2,9,32,41
55190,2017-05-07,3,5,15,20
55191,2017-05-07,4,0,8,8
55192,2017-05-07,5,2,6,8
55193,2017-05-07,6,6,28,34
55194,2017-05-07,7,18,61,79
55195,2017-05-07,8,68,165,233
55196,2017-05-07,9,139,272,411
55197,2017-05-07,10,220,382,602
55198,2017-05-07,11,303,477,780
55199,2017-05-07,12,351,528,879
55200,2017-05-07,13,369,506,875
55201,2017-05-07,14,451,498,949
55202,2017-05-07,15,420,500,920
55203,2017-05-07,16,357,474,831
55204,2017-05-07,17,338,502,840
55205,2017-05-07,18,170,425,595
55206,2017-05-07,19,147,274,421
55207,2017-05-07,20,122,226,348
55208,2017-05-07,21,119,174,293
55209,2017-05-07,22,73,73,146
55210,2017-05-07,23,67,50,117
55211,2017-05-08,0,39,20,59
55212,2017-05-08,1,5,10,15
55213,2017-05-08,2,6,3,9
55214,2017-05-08,3,0,1,1
55215,2017-05-08,4,3,15,18
55216,2017-05-08,5,6,74,80
55217,2017-05-08,6,11,297,308
55218,2017-05-08,7,31,730,761
55219,2017-05-08,8,70,964,1034
55220,2017-05-08,9,80,401,481
55221,2017-05-08,10,134,212,346
55222,2017-05-08,11,165,237,402
55223,2017-05-08,12,183,339,522
55224,2017-05-08,13,179,363,542
55225,2017-05-08,14,194,319,513
55226,2017-05-08,15,188,419,607
55227,2017-05-08,16,212,701,913
55228,2017-05-08,17,257,1455,1712
55229,2017-05-08,18,205,1044,1249
55230,2017-05-08,19,126,629,755
55231,2017-05-08,20,96,405,501
55232,2017-05-08,21,80,232,312
55233,2017-05-08,22,43,147,190
55234,2017-05-08,23,15,65,80
55235,2017-05-09,0,31,23,54
55236,2017-05-09,1,6,12,18
55237,2017-05-09,2,2,7,9
55238,2017-05-09,3,0,2,2
55239,2017-05-09,4,0,14,14
55240,2017-05-09,5,7,76,83
55241,2017-05-09,6,10,346,356
55242,2017-05-09,7,30,843,873
55243,2017-05-09,8,66,1225,1291
55244,2017-05-09,9,84,540,624
55245,2017-05-09,10,105,264,369
55246,2017-05-09,11,127,256,383
55247,2017-05-09,12,149,373,522
55248,2017-05-09,13,137,389,526
55249,2017-05-09,14,180,373,553
55250,2017-05-09,15,202,424,626
55251,2017-05-09,16,188,727,915
55252,2017-05-09,17,253,1435,1688
55253,2017-05-09,18,219,1088,1307
55254,2017-05-09,19,147,661,808
55255,2017-05-09,20,137,456,593
55256,2017-05-09,21,96,307,403
55257,2017-05-09,22,50,180,230
55258,2017-05-09,23,38,82,120
55259,2017-05-10,0,8,35,43
55260,2017-05-10,1,6,21,27
55261,2017-05-10,2,2,4,6
55262,2017-05-10,3,2,4,6
55263,2017-05-10,4,0,11,11
55264,2017-05-10,5,8,76,84
55265,2017-05-10,6,19,362,381
55266,2017-05-10,7,46,872,918
55267,2017-05-10,8,70,1182,1252
55268,2017-05-10,9,92,495,587
55269,2017-05-10,10,124,260,384
55270,2017-05-10,11,134,305,439
55271,2017-05-10,12,205,435,640
55272,2017-05-10,13,184,451,635
55273,2017-05-10,14,204,368,572
55274,2017-05-10,15,188,495,683
55275,2017-05-10,16,256,820,1076
55276,2017-05-10,17,352,1435,1787
55277,2017-05-10,18,280,1165,1445
55278,2017-05-10,19,225,729,954
55279,2017-05-10,20,137,418,555
55280,2017-05-10,21,83,341,424
55281,2017-05-10,22,100,357,457
55282,2017-05-10,23,33,128,161
55283,2017-05-11,0,13,41,54
55284,2017-05-11,1,11,14,25
55285,2017-05-11,2,6,12,18
55286,2017-05-11,3,4,6,10
55287,2017-05-11,4,1,7,8
55288,2017-05-11,5,4,76,80
55289,2017-05-11,6,14,324,338
55290,2017-05-11,7,37,626,663
55291,2017-05-11,8,12,202,214
55292,2017-05-11,9,5,73,78
55293,2017-05-11,10,6,44,50
55294,2017-05-11,11,4,42,46
55295,2017-05-11,12,7,50,57
55296,2017-05-11,13,6,45,51
55297,2017-05-11,14,8,48,56
55298,2017-05-11,15,8,117,125
55299,2017-05-11,16,8,150,158
55300,2017-05-11,17,15,319,334
55301,2017-05-11,18,20,253,273
55302,2017-05-11,19,23,277,300
55303,2017-05-11,20,33,224,257
55304,2017-05-11,21,43,179,222
55305,2017-05-11,22,17,115,132
55306,2017-05-11,23,15,83,98
55307,2017-05-12,0,8,33,41
55308,2017-05-12,1,20,25,45
55309,2017-05-12,2,5,21,26
55310,2017-05-12,3,2,0,2
55311,2017-05-12,4,2,18,20
55312,2017-05-12,5,2,69,71
55313,2017-05-12,6,6,293,299
55314,2017-05-12,7,27,673,700
55315,2017-05-12,8,58,956,1014
55316,2017-05-12,9,81,490,571
55317,2017-05-12,10,92,223,315
55318,2017-05-12,11,163,322,485
55319,2017-05-12,12,180,401,581
55320,2017-05-12,13,198,368,566
55321,2017-05-12,14,215,377,592
55322,2017-05-12,15,159,386,545
55323,2017-05-12,16,55,257,312
55324,2017-05-12,17,53,328,381
55325,2017-05-12,18,17,194,211
55326,2017-05-12,19,15,116,131
55327,2017-05-12,20,11,101,112
55328,2017-05-12,21,2,80,82
55329,2017-05-12,22,14,53,67
55330,2017-05-12,23,9,34,43
55331,2017-05-13,0,3,20,23
55332,2017-05-13,1,0,19,19
55333,2017-05-13,2,0,10,10
55334,2017-05-13,3,0,3,3
55335,2017-05-13,5,1,1,2
55336,2017-05-13,6,2,18,20
55337,2017-05-13,7,15,83,98
55338,2017-05-13,8,50,165,215
55339,2017-05-13,9,92,284,376
55340,2017-05-13,10,150,328,478
55341,2017-05-13,11,148,443,591
55342,2017-05-13,12,250,443,693
55343,2017-05-13,13,284,471,755
55344,2017-05-13,14,300,435,735
55345,2017-05-13,15,274,451,725
55346,2017-05-13,16,285,430,715
55347,2017-05-13,17,270,369,639
55348,2017-05-13,18,205,372,577
55349,2017-05-13,19,148,298,446
55350,2017-05-13,20,105,207,312
55351,2017-05-13,21,88,164,252
55352,2017-05-13,22,94,194,288
55353,2017-05-13,23,78,124,202
55354,2017-05-14,0,69,85,154
55355,2017-05-14,1,46,76,122
55356,2017-05-14,2,24,59,83
55357,2017-05-14,3,12,25,37
55358,2017-05-14,4,2,10,12
55359,2017-05-14,5,11,13,24
55360,2017-05-14,6,10,35,45
55361,2017-05-14,7,35,71,106
55362,2017-05-14,8,58,164,222
55363,2017-05-14,9,173,277,450
55364,2017-05-14,10,332,441,773
55365,2017-05-14,11,485,515,1000
55366,2017-05-14,12,626,590,1216
55367,2017-05-14,13,625,554,1179
55368,2017-05-14,14,666,568,1234
55369,2017-05-14,15,652,580,1232
55370,2017-05-14,16,541,613,1154
55371,2017-05-14,17,521,527,1048
55372,2017-05-14,18,413,491,904
55373,2017-05-14,19,314,378,692
55374,2017-05-14,20,235,256,491
55375,2017-05-14,21,166,179,345
55376,2017-05-14,22,96,132,228
55377,2017-05-14,23,48,65,113
55378,2017-05-15,0,23,37,60
55379,2017-05-15,1,13,12,25
55380,2017-05-15,2,12,3,15
55381,2017-05-15,3,2,4,6
55382,2017-05-15,4,1,14,15
55383,2017-05-15,5,6,80,86
55384,2017-05-15,6,22,339,361
55385,2017-05-15,7,36,771,807
55386,2017-05-15,8,63,912,975
55387,2017-05-15,9,96,452,548
55388,2017-05-15,10,146,187,333
55389,2017-05-15,11,211,255,466
55390,2017-05-15,12,254,347,601
55391,2017-05-15,13,244,378,622
55392,2017-05-15,14,269,321,590
55393,2017-05-15,15,305,449,754
55394,2017-05-15,16,284,786,1070
55395,2017-05-15,17,284,1389,1673
55396,2017-05-15,18,261,1128,1389
55397,2017-05-15,19,174,684,858
55398,2017-05-15,20,112,417,529
55399,2017-05-15,21,111,273,384
55400,2017-05-15,22,85,186,271
55401,2017-05-15,23,43,98,141
55402,2017-05-16,0,14,26,40
55403,2017-05-16,1,2,7,9
55404,2017-05-16,2,1,4,5
55405,2017-05-16,3,0,4,4
55406,2017-05-16,4,0,10,10
55407,2017-05-16,5,5,97,102
55408,2017-05-16,6,27,362,389
55409,2017-05-16,7,53,1003,1056
55410,2017-05-16,8,115,1252,1367
55411,2017-05-16,9,84,468,552
55412,2017-05-16,10,158,243,401
55413,2017-05-16,11,159,316,475
55414,2017-05-16,12,165,401,566
55415,2017-05-16,13,204,384,588
55416,2017-05-16,14,172,350,522
55417,2017-05-16,15,219,500,719
55418,2017-05-16,16,252,808,1060
55419,2017-05-16,17,312,1524,1836
55420,2017-05-16,18,266,1109,1375
55421,2017-05-16,19,196,727,923
55422,2017-05-16,20,167,524,691
55423,2017-05-16,21,139,345,484
55424,2017-05-16,22,71,211,282
55425,2017-05-16,23,45,136,181
55426,2017-05-17,0,19,33,52
55427,2017-05-17,1,12,7,19
55428,2017-05-17,2,7,12,19
55429,2017-05-17,3,0,1,1
55430,2017-05-17,4,5,10,15
55431,2017-05-17,5,7,96,103
55432,2017-05-17,6,22,402,424
55433,2017-05-17,7,55,948,1003
55434,2017-05-17,8,80,1173,1253
55435,2017-05-17,9,96,507,603
55436,2017-05-17,10,124,258,382
55437,2017-05-17,11,135,303,438
55438,2017-05-17,12,127,418,545
55439,2017-05-17,13,154,332,486
55440,2017-05-17,14,144,318,462
55441,2017-05-17,15,133,423,556
55442,2017-05-17,16,171,741,912
55443,2017-05-17,17,279,1291,1570
55444,2017-05-17,18,293,1111,1404
55445,2017-05-17,19,242,692,934
55446,2017-05-17,20,133,549,682
55447,2017-05-17,21,113,314,427
55448,2017-05-17,22,79,235,314
55449,2017-05-17,23,50,125,175
55450,2017-05-18,0,14,48,62
55451,2017-05-18,1,18,25,43
55452,2017-05-18,2,7,4,11
55453,2017-05-18,3,1,8,9
55454,2017-05-18,4,2,9,11
55455,2017-05-18,5,6,97,103
55456,2017-05-18,6,21,379,400
55457,2017-05-18,7,64,925,989
55458,2017-05-18,8,88,1158,1246
55459,2017-05-18,9,111,461,572
55460,2017-05-18,10,151,245,396
55461,2017-05-18,11,170,291,461
55462,2017-05-18,12,208,385,593
55463,2017-05-18,13,183,354,537
55464,2017-05-18,14,182,288,470
55465,2017-05-18,15,194,450,644
55466,2017-05-18,16,179,689,868
55467,2017-05-18,17,257,1303,1560
55468,2017-05-18,18,251,1060,1311
55469,2017-05-18,19,200,701,901
55470,2017-05-18,20,86,351,437
55471,2017-05-18,21,79,266,345
55472,2017-05-18,22,68,201,269
55473,2017-05-18,23,64,100,164
55474,2017-05-19,0,28,51,79
55475,2017-05-19,1,20,39,59
55476,2017-05-19,2,8,22,30
55477,2017-05-19,3,5,7,12
55478,2017-05-19,4,1,16,17
55479,2017-05-19,5,3,81,84
55480,2017-05-19,6,41,377,418
55481,2017-05-19,7,95,1010,1105
55482,2017-05-19,8,156,1232,1388
55483,2017-05-19,9,138,572,710
55484,2017-05-19,10,193,311,504
55485,2017-05-19,11,267,357,624
55486,2017-05-19,12,280,402,682
55487,2017-05-19,13,292,404,696
55488,2017-05-19,14,243,357,600
55489,2017-05-19,15,255,491,746
55490,2017-05-19,16,244,788,1032
55491,2017-05-19,17,306,1122,1428
55492,2017-05-19,18,232,795,1027
55493,2017-05-19,19,193,466,659
55494,2017-05-19,20,105,335,440
55495,2017-05-19,21,134,274,408
55496,2017-05-19,22,168,221,389
55497,2017-05-19,23,126,164,290
55498,2017-05-20,0,96,118,214
55499,2017-05-20,1,49,85,134
55500,2017-05-20,2,26,34,60
55501,2017-05-20,3,19,27,46
55502,2017-05-20,4,16,12,28
55503,2017-05-20,5,20,23,43
55504,2017-05-20,6,29,65,94
55505,2017-05-20,7,42,145,187
55506,2017-05-20,8,113,217,330
55507,2017-05-20,9,280,395,675
55508,2017-05-20,10,389,531,920
55509,2017-05-20,11,522,494,1016
55510,2017-05-20,12,539,528,1067
55511,2017-05-20,13,643,496,1139
55512,2017-05-20,14,707,508,1215
55513,2017-05-20,15,710,528,1238
55514,2017-05-20,16,693,486,1179
55515,2017-05-20,17,630,489,1119
55516,2017-05-20,18,471,472,943
55517,2017-05-20,19,330,350,680
55518,2017-05-20,20,269,282,551
55519,2017-05-20,21,165,196,361
55520,2017-05-20,22,153,197,350
55521,2017-05-20,23,78,123,201
55522,2017-05-21,0,61,85,146
55523,2017-05-21,1,47,66,113
55524,2017-05-21,2,32,58,90
55525,2017-05-21,3,28,26,54
55526,2017-05-21,4,8,17,25
55527,2017-05-21,5,5,13,18
55528,2017-05-21,6,12,32,44
55529,2017-05-21,7,43,103,146
55530,2017-05-21,8,110,209,319
55531,2017-05-21,9,179,304,483
55532,2017-05-21,10,301,384,685
55533,2017-05-21,11,402,456,858
55534,2017-05-21,12,437,542,979
55535,2017-05-21,13,541,522,1063
55536,2017-05-21,14,459,495,954
55537,2017-05-21,15,505,489,994
55538,2017-05-21,16,479,436,915
55539,2017-05-21,17,485,468,953
55540,2017-05-21,18,344,434,778
55541,2017-05-21,19,252,320,572
55542,2017-05-21,20,134,224,358
55543,2017-05-21,21,94,173,267
55544,2017-05-21,22,80,93,173
55545,2017-05-21,23,56,55,111
55546,2017-05-22,0,12,33,45
55547,2017-05-22,1,15,12,27
55548,2017-05-22,2,5,7,12
55549,2017-05-22,3,1,3,4
55550,2017-05-22,4,0,7,7
55551,2017-05-22,5,2,32,34
55552,2017-05-22,6,9,105,114
55553,2017-05-22,7,2,162,164
55554,2017-05-22,8,14,257,271
55555,2017-05-22,9,31,173,204
55556,2017-05-22,10,44,124,168
55557,2017-05-22,11,73,181,254
55558,2017-05-22,12,120,298,418
55559,2017-05-22,13,159,291,450
55560,2017-05-22,14,176,299,475
55561,2017-05-22,15,233,449,682
55562,2017-05-22,16,240,672,912
55563,2017-05-22,17,318,1235,1553
55564,2017-05-22,18,191,971,1162
55565,2017-05-22,19,165,648,813
55566,2017-05-22,20,140,429,569
55567,2017-05-22,21,99,298,397
55568,2017-05-22,22,91,154,245
55569,2017-05-22,23,40,86,126
55570,2017-05-23,0,18,31,49
55571,2017-05-23,1,3,8,11
55572,2017-05-23,2,1,4,5
55573,2017-05-23,3,1,3,4
55574,2017-05-23,4,3,12,15
55575,2017-05-23,5,10,92,102
55576,2017-05-23,6,27,376,403
55577,2017-05-23,7,36,929,965
55578,2017-05-23,8,89,1196,1285
55579,2017-05-23,9,90,474,564
55580,2017-05-23,10,119,221,340
55581,2017-05-23,11,165,238,403
55582,2017-05-23,12,162,359,521
55583,2017-05-23,13,179,319,498
55584,2017-05-23,14,184,294,478
55585,2017-05-23,15,223,415,638
55586,2017-05-23,16,224,719,943
55587,2017-05-23,17,257,1306,1563
55588,2017-05-23,18,111,655,766
55589,2017-05-23,19,57,271,328
55590,2017-05-23,20,34,124,158
55591,2017-05-23,21,30,163,193
55592,2017-05-23,22,27,159,186
55593,2017-05-23,23,30,71,101
55594,2017-05-24,0,28,25,53
55595,2017-05-24,1,12,11,23
55596,2017-05-24,2,1,4,5
55597,2017-05-24,3,1,1,2
55598,2017-05-24,4,1,13,14
55599,2017-05-24,5,7,74,81
55600,2017-05-24,6,17,336,353
55601,2017-05-24,7,47,791,838
55602,2017-05-24,8,59,1213,1272
55603,2017-05-24,9,85,496,581
55604,2017-05-24,10,114,267,381
55605,2017-05-24,11,165,299,464
55606,2017-05-24,12,164,403,567
55607,2017-05-24,13,212,363,575
55608,2017-05-24,14,188,304,492
55609,2017-05-24,15,184,397,581
55610,2017-05-24,16,167,710,877
55611,2017-05-24,17,223,1378,1601
55612,2017-05-24,18,192,1027,1219
55613,2017-05-24,19,150,588,738
55614,2017-05-24,20,114,398,512
55615,2017-05-24,21,86,331,417
55616,2017-05-24,22,45,205,250
55617,2017-05-24,23,18,27,45
55618,2017-05-25,0,5,13,18
55619,2017-05-25,1,3,2,5
55620,2017-05-25,2,0,4,4
55621,2017-05-25,4,1,3,4
55622,2017-05-25,5,6,41,47
55623,2017-05-25,6,1,119,120
55624,2017-05-25,7,6,196,202
55625,2017-05-25,8,16,462,478
55626,2017-05-25,9,23,279,302
55627,2017-05-25,10,50,205,255
55628,2017-05-25,11,74,261,335
55629,2017-05-25,12,82,364,446
55630,2017-05-25,13,131,367,498
55631,2017-05-25,14,148,288,436
55632,2017-05-25,15,154,430,584
55633,2017-05-25,16,188,706,894
55634,2017-05-25,17,115,784,899
55635,2017-05-25,18,17,140,157
55636,2017-05-25,19,25,208,233
55637,2017-05-25,20,27,239,266
55638,2017-05-25,21,40,196,236
55639,2017-05-25,22,36,150,186
55640,2017-05-25,23,19,89,108
55641,2017-05-26,0,22,39,61
55642,2017-05-26,1,8,19,27
55643,2017-05-26,2,5,16,21
55644,2017-05-26,3,6,8,14
55645,2017-05-26,4,3,20,23
55646,2017-05-26,5,4,58,62
55647,2017-05-26,6,19,249,268
55648,2017-05-26,7,62,660,722
55649,2017-05-26,8,124,1046,1170
55650,2017-05-26,9,142,484,626
55651,2017-05-26,10,218,275,493
55652,2017-05-26,11,273,349,622
55653,2017-05-26,12,313,451,764
55654,2017-05-26,13,357,479,836
55655,2017-05-26,14,416,591,1007
55656,2017-05-26,15,383,750,1133
55657,2017-05-26,16,384,832,1216
55658,2017-05-26,17,344,915,1259
55659,2017-05-26,18,319,644,963
55660,2017-05-26,19,273,474,747
55661,2017-05-26,20,197,332,529
55662,2017-05-26,21,168,307,475
55663,2017-05-26,22,119,220,339
55664,2017-05-26,23,62,149,211
55665,2017-05-27,0,48,106,154
55666,2017-05-27,1,29,57,86
55667,2017-05-27,2,18,51,69
55668,2017-05-27,3,11,19,30
55669,2017-05-27,4,5,13,18
55670,2017-05-27,5,10,16,26
55671,2017-05-27,6,8,44,52
55672,2017-05-27,7,41,73,114
55673,2017-05-27,8,107,194,301
55674,2017-05-27,9,239,313,552
55675,2017-05-27,10,425,362,787
55676,2017-05-27,11,440,363,803
55677,2017-05-27,12,594,393,987
55678,2017-05-27,13,664,392,1056
55679,2017-05-27,14,595,371,966
55680,2017-05-27,15,677,375,1052
55681,2017-05-27,16,448,279,727
55682,2017-05-27,17,468,269,737
55683,2017-05-27,18,424,298,722
55684,2017-05-27,19,436,315,751
55685,2017-05-27,20,297,225,522
55686,2017-05-27,21,264,166,430
55687,2017-05-27,22,171,140,311
55688,2017-05-27,23,110,109,219
55689,2017-05-28,0,80,84,164
55690,2017-05-28,1,44,60,104
55691,2017-05-28,2,30,27,57
55692,2017-05-28,3,17,22,39
55693,2017-05-28,4,4,9,13
55694,2017-05-28,5,7,8,15
55695,2017-05-28,6,16,33,49
55696,2017-05-28,7,33,82,115
55697,2017-05-28,8,151,146,297
55698,2017-05-28,9,338,257,595
55699,2017-05-28,10,473,382,855
55700,2017-05-28,11,660,423,1083
55701,2017-05-28,12,520,326,846
55702,2017-05-28,13,394,234,628
55703,2017-05-28,14,219,110,329
55704,2017-05-28,15,403,235,638
55705,2017-05-28,16,590,257,847
55706,2017-05-28,17,534,287,821
55707,2017-05-28,18,493,269,762
55708,2017-05-28,19,417,231,648
55709,2017-05-28,20,233,185,418
55710,2017-05-28,21,252,139,391
55711,2017-05-28,22,156,110,266
55712,2017-05-28,23,113,92,205
55713,2017-05-29,0,62,61,123
55714,2017-05-29,1,42,43,85
55715,2017-05-29,2,33,26,59
55716,2017-05-29,3,13,12,25
55717,2017-05-29,4,14,7,21
55718,2017-05-29,5,12,21,33
55719,2017-05-29,6,18,42,60
55720,2017-05-29,7,52,72,124
55721,2017-05-29,8,123,142,265
55722,2017-05-29,9,252,247,499
55723,2017-05-29,10,420,302,722
55724,2017-05-29,11,607,402,1009
55725,2017-05-29,12,663,471,1134
55726,2017-05-29,13,663,516,1179
55727,2017-05-29,14,670,519,1189
55728,2017-05-29,15,663,512,1175
55729,2017-05-29,16,604,491,1095
55730,2017-05-29,17,514,507,1021
55731,2017-05-29,18,469,473,942
55732,2017-05-29,19,389,427,816
55733,2017-05-29,20,324,288,612
55734,2017-05-29,21,202,189,391
55735,2017-05-29,22,103,134,237
55736,2017-05-29,23,53,55,108
55737,2017-05-30,0,26,30,56
55738,2017-05-30,1,8,18,26
55739,2017-05-30,2,7,9,16
55740,2017-05-30,3,3,5,8
55741,2017-05-30,4,1,10,11
55742,2017-05-30,5,4,81,85
55743,2017-05-30,6,17,314,331
55744,2017-05-30,7,29,687,716
55745,2017-05-30,8,67,874,941
55746,2017-05-30,9,71,401,472
55747,2017-05-30,10,103,148,251
55748,2017-05-30,11,139,180,319
55749,2017-05-30,12,164,301,465
55750,2017-05-30,13,184,290,474
55751,2017-05-30,14,242,287,529
55752,2017-05-30,15,178,413,591
55753,2017-05-30,16,184,648,832
55754,2017-05-30,17,313,1319,1632
55755,2017-05-30,18,200,969,1169
55756,2017-05-30,19,170,626,796
55757,2017-05-30,20,57,221,278
55758,2017-05-30,21,49,129,178
55759,2017-05-30,22,17,61,78
55760,2017-05-30,23,12,37,49
55761,2017-05-31,0,14,23,37
55762,2017-05-31,1,2,15,17
55763,2017-05-31,2,0,3,3
55764,2017-05-31,3,2,6,8
55765,2017-05-31,4,2,7,9
55766,2017-05-31,5,9,106,115
55767,2017-05-31,6,12,339,351
55768,2017-05-31,7,40,896,936
55769,2017-05-31,8,99,1227,1326
55770,2017-05-31,9,85,529,614
55771,2017-05-31,10,152,246,398
55772,2017-05-31,11,167,303,470
55773,2017-05-31,12,213,382,595
55774,2017-05-31,13,170,339,509
55775,2017-05-31,14,224,340,564
55776,2017-05-31,15,221,432,653
55777,2017-05-31,16,223,783,1006
55778,2017-05-31,17,214,984,1198
55779,2017-05-31,18,134,732,866
55780,2017-05-31,19,237,696,933
55781,2017-05-31,20,189,469,658
55782,2017-05-31,21,124,327,451
55783,2017-05-31,22,96,221,317
55784,2017-05-31,23,24,114,138
55785,2017-06-01,0,15,37,52
55786,2017-06-01,1,18,17,35
55787,2017-06-01,2,1,14,15
55788,2017-06-01,3,7,5,12
55789,2017-06-01,4,5,8,13
55790,2017-06-01,5,8,110,118
55791,2017-06-01,6,23,343,366
55792,2017-06-01,7,49,884,933
55793,2017-06-01,8,93,1131,1224
55794,2017-06-01,9,79,466,545
55795,2017-06-01,10,193,238,431
55796,2017-06-01,11,174,279,453
55797,2017-06-01,12,194,410,604
55798,2017-06-01,13,205,396,601
55799,2017-06-01,14,252,293,545
55800,2017-06-01,15,271,431,702
55801,2017-06-01,16,233,791,1024
55802,2017-06-01,17,320,1475,1795
55803,2017-06-01,18,268,1120,1388
55804,2017-06-01,19,227,787,1014
55805,2017-06-01,20,180,587,767
55806,2017-06-01,21,100,376,476
55807,2017-06-01,22,79,220,299
55808,2017-06-01,23,72,170,242
55809,2017-06-02,0,27,63,90
55810,2017-06-02,1,12,19,31
55811,2017-06-02,2,3,23,26
55812,2017-06-02,3,0,3,3
55813,2017-06-02,4,3,11,14
55814,2017-06-02,5,4,81,85
55815,2017-06-02,6,17,306,323
55816,2017-06-02,7,63,786,849
55817,2017-06-02,8,107,1137,1244
55818,2017-06-02,9,140,497,637
55819,2017-06-02,10,223,298,521
55820,2017-06-02,11,216,294,510
55821,2017-06-02,12,299,452,751
55822,2017-06-02,13,264,428,692
55823,2017-06-02,14,261,400,661
55824,2017-06-02,15,286,561,847
55825,2017-06-02,16,289,859,1148
55826,2017-06-02,17,367,1314,1681
55827,2017-06-02,18,325,952,1277
55828,2017-06-02,19,264,612,876
55829,2017-06-02,20,230,424,654
55830,2017-06-02,21,175,327,502
55831,2017-06-02,22,143,281,424
55832,2017-06-02,23,79,184,263
55833,2017-06-03,0,69,119,188
55834,2017-06-03,1,30,82,112
55835,2017-06-03,2,26,53,79
55836,2017-06-03,3,8,21,29
55837,2017-06-03,4,4,11,15
55838,2017-06-03,5,11,32,43
55839,2017-06-03,6,12,66,78
55840,2017-06-03,7,39,136,175
55841,2017-06-03,8,119,274,393
55842,2017-06-03,9,241,428,669
55843,2017-06-03,10,350,538,888
55844,2017-06-03,11,489,594,1083
55845,2017-06-03,12,520,563,1083
55846,2017-06-03,13,597,608,1205
55847,2017-06-03,14,608,559,1167
55848,2017-06-03,15,600,476,1076
55849,2017-06-03,16,527,480,1007
55850,2017-06-03,17,531,484,1015
55851,2017-06-03,18,532,466,998
55852,2017-06-03,19,472,421,893
55853,2017-06-03,20,322,333,655
55854,2017-06-03,21,166,236,402
55855,2017-06-03,22,150,210,360
55856,2017-06-03,23,89,194,283
55857,2017-06-04,0,72,130,202
55858,2017-06-04,1,64,75,139
55859,2017-06-04,2,30,71,101
55860,2017-06-04,3,15,31,46
55861,2017-06-04,4,6,10,16
55862,2017-06-04,5,14,21,35
55863,2017-06-04,6,30,47,77
55864,2017-06-04,7,48,101,149
55865,2017-06-04,8,123,247,370
55866,2017-06-04,9,215,307,522
55867,2017-06-04,10,379,450,829
55868,2017-06-04,11,518,519,1037
55869,2017-06-04,12,553,530,1083
55870,2017-06-04,13,494,556,1050
55871,2017-06-04,14,555,547,1102
55872,2017-06-04,15,476,503,979
55873,2017-06-04,16,483,470,953
55874,2017-06-04,17,417,516,933
55875,2017-06-04,18,397,474,871
55876,2017-06-04,19,298,436,734
55877,2017-06-04,20,227,333,560
55878,2017-06-04,21,191,227,418
55879,2017-06-04,22,143,146,289
55880,2017-06-04,23,57,79,136
55881,2017-06-05,0,15,34,49
55882,2017-06-05,1,14,14,28
55883,2017-06-05,2,1,3,4
55884,2017-06-05,3,2,3,5
55885,2017-06-05,4,3,8,11
55886,2017-06-05,5,5,93,98
55887,2017-06-05,6,17,322,339
55888,2017-06-05,7,37,797,834
55889,2017-06-05,8,60,994,1054
55890,2017-06-05,9,78,423,501
55891,2017-06-05,10,99,139,238
55892,2017-06-05,11,136,176,312
55893,2017-06-05,12,111,214,325
55894,2017-06-05,13,128,224,352
55895,2017-06-05,14,114,203,317
55896,2017-06-05,15,139,267,406
55897,2017-06-05,16,192,670,862
55898,2017-06-05,17,235,1343,1578
55899,2017-06-05,18,191,1081,1272
55900,2017-06-05,19,152,694,846
55901,2017-06-05,20,102,399,501
55902,2017-06-05,21,89,285,374
55903,2017-06-05,22,70,166,236
55904,2017-06-05,23,36,62,98
55905,2017-06-06,0,15,33,48
55906,2017-06-06,1,4,12,16
55907,2017-06-06,2,4,9,13
55908,2017-06-06,4,2,12,14
55909,2017-06-06,5,8,106,114
55910,2017-06-06,6,16,426,442
55911,2017-06-06,7,70,1019,1089
55912,2017-06-06,8,98,1213,1311
55913,2017-06-06,9,124,508,632
55914,2017-06-06,10,151,257,408
55915,2017-06-06,11,221,296,517
55916,2017-06-06,12,212,372,584
55917,2017-06-06,13,216,363,579
55918,2017-06-06,14,237,366,603
55919,2017-06-06,15,268,447,715
55920,2017-06-06,16,264,740,1004
55921,2017-06-06,17,293,1550,1843
55922,2017-06-06,18,272,1210,1482
55923,2017-06-06,19,234,787,1021
55924,2017-06-06,20,182,593,775
55925,2017-06-06,21,117,379,496
55926,2017-06-06,22,73,200,273
55927,2017-06-06,23,44,115,159
55928,2017-06-07,0,22,54,76
55929,2017-06-07,1,4,16,20
55930,2017-06-07,2,5,9,14
55931,2017-06-07,3,5,6,11
55932,2017-06-07,4,2,15,17
55933,2017-06-07,5,17,104,121
55934,2017-06-07,6,17,348,365
55935,2017-06-07,7,41,982,1023
55936,2017-06-07,8,78,1230,1308
55937,2017-06-07,9,67,493,560
55938,2017-06-07,10,119,238,357
55939,2017-06-07,11,126,280,406
55940,2017-06-07,12,140,379,519
55941,2017-06-07,13,168,353,521
55942,2017-06-07,14,180,346,526
55943,2017-06-07,15,149,413,562
55944,2017-06-07,16,198,765,963
55945,2017-06-07,17,260,1474,1734
55946,2017-06-07,18,219,1110,1329
55947,2017-06-07,19,131,671,802
55948,2017-06-07,20,138,466,604
55949,2017-06-07,21,69,283,352
55950,2017-06-07,22,52,199,251
55951,2017-06-07,23,16,104,120
55952,2017-06-08,0,16,59,75
55953,2017-06-08,1,14,15,29
55954,2017-06-08,2,9,6,15
55955,2017-06-08,3,1,8,9
55956,2017-06-08,4,1,15,16
55957,2017-06-08,5,5,91,96
55958,2017-06-08,6,21,367,388
55959,2017-06-08,7,42,964,1006
55960,2017-06-08,8,96,1242,1338
55961,2017-06-08,9,94,496,590
55962,2017-06-08,10,154,220,374
55963,2017-06-08,11,174,264,438
55964,2017-06-08,12,209,367,576
55965,2017-06-08,13,171,375,546
55966,2017-06-08,14,173,326,499
55967,2017-06-08,15,256,474,730
55968,2017-06-08,16,260,745,1005
55969,2017-06-08,17,328,1392,1720
55970,2017-06-08,18,366,1192,1558
55971,2017-06-08,19,282,682,964
55972,2017-06-08,20,229,552,781
55973,2017-06-08,21,159,403,562
55974,2017-06-08,22,114,313,427
55975,2017-06-08,23,60,150,210
55976,2017-06-09,0,31,53,84
55977,2017-06-09,1,8,27,35
55978,2017-06-09,2,9,23,32
55979,2017-06-09,3,0,8,8
55980,2017-06-09,4,2,13,15
55981,2017-06-09,5,11,91,102
55982,2017-06-09,6,19,298,317
55983,2017-06-09,7,58,787,845
55984,2017-06-09,8,95,1147,1242
55985,2017-06-09,9,134,506,640
55986,2017-06-09,10,201,280,481
55987,2017-06-09,11,292,358,650
55988,2017-06-09,12,327,463,790
55989,2017-06-09,13,357,466,823
55990,2017-06-09,14,368,462,830
55991,2017-06-09,15,391,552,943
55992,2017-06-09,16,357,842,1199
55993,2017-06-09,17,379,1259,1638
55994,2017-06-09,18,298,876,1174
55995,2017-06-09,19,285,552,837
55996,2017-06-09,20,223,426,649
55997,2017-06-09,21,187,323,510
55998,2017-06-09,22,158,279,437
55999,2017-06-09,23,96,193,289
56000,2017-06-10,0,127,146,273
56001,2017-06-10,1,64,81,145
56002,2017-06-10,2,49,56,105
56003,2017-06-10,3,9,21,30
56004,2017-06-10,4,6,15,21
56005,2017-06-10,5,12,24,36
56006,2017-06-10,6,31,91,122
56007,2017-06-10,7,53,159,212
56008,2017-06-10,8,132,286,418
56009,2017-06-10,9,276,412,688
56010,2017-06-10,10,492,499,991
56011,2017-06-10,11,555,604,1159
56012,2017-06-10,12,601,588,1189
56013,2017-06-10,13,656,516,1172
56014,2017-06-10,14,668,485,1153
56015,2017-06-10,15,661,568,1229
56016,2017-06-10,16,502,436,938
56017,2017-06-10,17,519,372,891
56018,2017-06-10,18,417,401,818
56019,2017-06-10,19,422,444,866
56020,2017-06-10,20,430,332,762
56021,2017-06-10,21,289,319,608
56022,2017-06-10,22,219,238,457
56023,2017-06-10,23,169,221,390
56024,2017-06-11,0,108,148,256
56025,2017-06-11,1,68,87,155
56026,2017-06-11,2,39,67,106
56027,2017-06-11,3,18,28,46
56028,2017-06-11,4,2,6,8
56029,2017-06-11,5,8,13,21
56030,2017-06-11,6,17,34,51
56031,2017-06-11,7,47,91,138
56032,2017-06-11,8,94,199,293
56033,2017-06-11,9,243,349,592
56034,2017-06-11,10,317,419,736
56035,2017-06-11,11,391,472,863
56036,2017-06-11,12,419,545,964
56037,2017-06-11,13,498,523,1021
56038,2017-06-11,14,460,506,966
56039,2017-06-11,15,397,480,877
56040,2017-06-11,16,397,444,841
56041,2017-06-11,17,368,495,863
56042,2017-06-11,18,355,426,781
56043,2017-06-11,19,320,409,729
56044,2017-06-11,20,291,381,672
56045,2017-06-11,21,193,224,417
56046,2017-06-11,22,118,150,268
56047,2017-06-11,23,78,89,167
56048,2017-06-12,0,31,30,61
56049,2017-06-12,1,24,13,37
56050,2017-06-12,2,4,6,10
56051,2017-06-12,3,6,8,14
56052,2017-06-12,4,3,12,15
56053,2017-06-12,5,6,97,103
56054,2017-06-12,6,24,335,359
56055,2017-06-12,7,66,837,903
56056,2017-06-12,8,94,1002,1096
56057,2017-06-12,9,103,418,521
56058,2017-06-12,10,129,240,369
56059,2017-06-12,11,165,239,404
56060,2017-06-12,12,190,288,478
56061,2017-06-12,13,188,289,477
56062,2017-06-12,14,210,264,474
56063,2017-06-12,15,199,378,577
56064,2017-06-12,16,213,705,918
56065,2017-06-12,17,254,1345,1599
56066,2017-06-12,18,246,1042,1288
56067,2017-06-12,19,199,669,868
56068,2017-06-12,20,208,504,712
56069,2017-06-12,21,155,352,507
56070,2017-06-12,22,111,206,317
56071,2017-06-12,23,72,123,195
56072,2017-06-13,0,35,50,85
56073,2017-06-13,1,25,11,36
56074,2017-06-13,2,3,11,14
56075,2017-06-13,3,4,3,7
56076,2017-06-13,4,1,13,14
56077,2017-06-13,5,10,107,117
56078,2017-06-13,6,23,423,446
56079,2017-06-13,7,53,1015,1068
56080,2017-06-13,8,88,1128,1216
56081,2017-06-13,9,89,459,548
56082,2017-06-13,10,128,210,338
56083,2017-06-13,11,163,267,430
56084,2017-06-13,12,175,292,467
56085,2017-06-13,13,162,290,452
56086,2017-06-13,14,143,280,423
56087,2017-06-13,15,152,350,502
56088,2017-06-13,16,149,626,775
56089,2017-06-13,17,245,1322,1567
56090,2017-06-13,18,273,1108,1381
56091,2017-06-13,19,232,677,909
56092,2017-06-13,20,189,482,671
56093,2017-06-13,21,145,362,507
56094,2017-06-13,22,113,288,401
56095,2017-06-13,23,36,124,160
56096,2017-06-14,0,32,32,64
56097,2017-06-14,1,14,20,34
56098,2017-06-14,2,4,13,17
56099,2017-06-14,3,2,7,9
56100,2017-06-14,4,3,15,18
56101,2017-06-14,5,14,102,116
56102,2017-06-14,6,18,385,403
56103,2017-06-14,7,46,994,1040
56104,2017-06-14,8,87,1163,1250
56105,2017-06-14,9,123,471,594
56106,2017-06-14,10,86,197,283
56107,2017-06-14,11,155,283,438
56108,2017-06-14,12,191,401,592
56109,2017-06-14,13,167,302,469
56110,2017-06-14,14,185,314,499
56111,2017-06-14,15,152,427,579
56112,2017-06-14,16,197,706,903
56113,2017-06-14,17,286,1312,1598
56114,2017-06-14,18,269,1168,1437
56115,2017-06-14,19,283,756,1039
56116,2017-06-14,20,200,550,750
56117,2017-06-14,21,134,402,536
56118,2017-06-14,22,121,246,367
56119,2017-06-14,23,51,121,172
56120,2017-06-15,0,31,43,74
56121,2017-06-15,1,12,23,35
56122,2017-06-15,2,7,12,19
56123,2017-06-15,3,2,7,9
56124,2017-06-15,4,3,14,17
56125,2017-06-15,5,14,101,115
56126,2017-06-15,6,20,378,398
56127,2017-06-15,7,48,926,974
56128,2017-06-15,8,94,1131,1225
56129,2017-06-15,9,109,499,608
56130,2017-06-15,10,174,252,426
56131,2017-06-15,11,177,275,452
56132,2017-06-15,12,213,378,591
56133,2017-06-15,13,238,351,589
56134,2017-06-15,14,244,326,570
56135,2017-06-15,15,260,424,684
56136,2017-06-15,16,308,691,999
56137,2017-06-15,17,354,1358,1712
56138,2017-06-15,18,316,1156,1472
56139,2017-06-15,19,273,697,970
56140,2017-06-15,20,209,494,703
56141,2017-06-15,21,151,414,565
56142,2017-06-15,22,133,303,436
56143,2017-06-15,23,57,142,199
56144,2017-06-16,0,26,73,99
56145,2017-06-16,1,11,30,41
56146,2017-06-16,2,8,13,21
56147,2017-06-16,3,8,3,11
56148,2017-06-16,4,6,11,17
56149,2017-06-16,5,9,99,108
56150,2017-06-16,6,21,323,344
56151,2017-06-16,7,56,754,810
56152,2017-06-16,8,107,1099,1206
56153,2017-06-16,9,163,571,734
56154,2017-06-16,10,201,263,464
56155,2017-06-16,11,265,307,572
56156,2017-06-16,12,224,408,632
56157,2017-06-16,13,221,437,658
56158,2017-06-16,14,227,361,588
56159,2017-06-16,15,279,468,747
56160,2017-06-16,16,320,749,1069
56161,2017-06-16,17,318,1217,1535
56162,2017-06-16,18,265,854,1119
56163,2017-06-16,19,216,513,729
56164,2017-06-16,20,176,278,454
56165,2017-06-16,21,91,158,249
56166,2017-06-16,22,37,80,117
56167,2017-06-16,23,30,110,140
56168,2017-06-17,0,21,94,115
56169,2017-06-17,1,30,72,102
56170,2017-06-17,2,25,46,71
56171,2017-06-17,3,21,22,43
56172,2017-06-17,4,5,9,14
56173,2017-06-17,5,18,19,37
56174,2017-06-17,6,8,33,41
56175,2017-06-17,7,37,128,165
56176,2017-06-17,8,108,269,377
56177,2017-06-17,9,212,401,613
56178,2017-06-17,10,336,470,806
56179,2017-06-17,11,417,501,918
56180,2017-06-17,12,481,589,1070
56181,2017-06-17,13,516,502,1018
56182,2017-06-17,14,599,495,1094
56183,2017-06-17,15,587,472,1059
56184,2017-06-17,16,512,471,983
56185,2017-06-17,17,533,477,1010
56186,2017-06-17,18,423,461,884
56187,2017-06-17,19,384,432,816
56188,2017-06-17,20,360,330,690
56189,2017-06-17,21,264,266,530
56190,2017-06-17,22,184,257,441
56191,2017-06-17,23,123,166,289
56192,2017-06-18,0,96,122,218
56193,2017-06-18,1,58,92,150
56194,2017-06-18,2,69,75,144
56195,2017-06-18,3,20,43,63
56196,2017-06-18,4,9,11,20
56197,2017-06-18,5,9,13,22
56198,2017-06-18,6,9,30,39
56199,2017-06-18,7,47,95,142
56200,2017-06-18,8,76,189,265
56201,2017-06-18,9,234,305,539
56202,2017-06-18,10,316,435,751
56203,2017-06-18,11,523,464,987
56204,2017-06-18,12,505,465,970
56205,2017-06-18,13,417,436,853
56206,2017-06-18,14,403,424,827
56207,2017-06-18,15,429,422,851
56208,2017-06-18,16,314,439,753
56209,2017-06-18,17,368,421,789
56210,2017-06-18,18,293,421,714
56211,2017-06-18,19,279,376,655
56212,2017-06-18,20,286,302,588
56213,2017-06-18,21,194,219,413
56214,2017-06-18,22,108,151,259
56215,2017-06-18,23,68,78,146
56216,2017-06-19,0,26,38,64
56217,2017-06-19,1,11,11,22
56218,2017-06-19,2,7,11,18
56219,2017-06-19,3,5,4,9
56220,2017-06-19,4,2,9,11
56221,2017-06-19,5,10,114,124
56222,2017-06-19,6,19,362,381
56223,2017-06-19,7,51,766,817
56224,2017-06-19,8,86,915,1001
56225,2017-06-19,9,103,388,491
56226,2017-06-19,10,195,224,419
56227,2017-06-19,11,196,258,454
56228,2017-06-19,12,253,333,586
56229,2017-06-19,13,233,335,568
56230,2017-06-19,14,236,300,536
56231,2017-06-19,15,116,314,430
56232,2017-06-19,16,58,206,264
56233,2017-06-19,17,76,488,564
56234,2017-06-19,18,130,611,741
56235,2017-06-19,19,107,558,665
56236,2017-06-19,20,169,379,548
56237,2017-06-19,21,112,259,371
56238,2017-06-19,22,59,169,228
56239,2017-06-19,23,34,73,107
56240,2017-06-20,0,19,24,43
56241,2017-06-20,1,5,15,20
56242,2017-06-20,2,6,10,16
56243,2017-06-20,3,3,0,3
56244,2017-06-20,4,0,12,12
56245,2017-06-20,5,7,127,134
56246,2017-06-20,6,23,421,444
56247,2017-06-20,7,51,1039,1090
56248,2017-06-20,8,80,1163,1243
56249,2017-06-20,9,124,425,549
56250,2017-06-20,10,172,252,424
56251,2017-06-20,11,240,306,546
56252,2017-06-20,12,189,407,596
56253,2017-06-20,13,219,350,569
56254,2017-06-20,14,212,277,489
56255,2017-06-20,15,178,421,599
56256,2017-06-20,16,210,774,984
56257,2017-06-20,17,314,1420,1734
56258,2017-06-20,18,286,1220,1506
56259,2017-06-20,19,277,753,1030
56260,2017-06-20,20,204,574,778
56261,2017-06-20,21,187,437,624
56262,2017-06-20,22,120,245,365
56263,2017-06-20,23,47,129,176
56264,2017-06-21,0,26,56,82
56265,2017-06-21,1,10,18,28
56266,2017-06-21,2,1,10,11
56267,2017-06-21,3,1,4,5
56268,2017-06-21,4,2,16,18
56269,2017-06-21,5,12,125,137
56270,2017-06-21,6,29,404,433
56271,2017-06-21,7,57,943,1000
56272,2017-06-21,8,99,1250,1349
56273,2017-06-21,9,102,483,585
56274,2017-06-21,10,188,252,440
56275,2017-06-21,11,180,306,486
56276,2017-06-21,12,173,413,586
56277,2017-06-21,13,176,415,591
56278,2017-06-21,14,204,347,551
56279,2017-06-21,15,154,412,566
56280,2017-06-21,16,225,742,967
56281,2017-06-21,17,287,1414,1701
56282,2017-06-21,18,261,1221,1482
56283,2017-06-21,19,233,774,1007
56284,2017-06-21,20,216,616,832
56285,2017-06-21,21,151,427,578
56286,2017-06-21,22,93,270,363
56287,2017-06-21,23,88,124,212
56288,2017-06-22,0,41,60,101
56289,2017-06-22,1,10,19,29
56290,2017-06-22,2,16,9,25
56291,2017-06-22,3,11,3,14
56292,2017-06-22,4,7,8,15
56293,2017-06-22,5,14,100,114
56294,2017-06-22,6,33,407,440
56295,2017-06-22,7,63,893,956
56296,2017-06-22,8,115,1159,1274
56297,2017-06-22,9,113,513,626
56298,2017-06-22,10,161,231,392
56299,2017-06-22,11,176,298,474
56300,2017-06-22,12,191,424,615
56301,2017-06-22,13,197,382,579
56302,2017-06-22,14,248,325,573
56303,2017-06-22,15,198,412,610
56304,2017-06-22,16,254,670,924
56305,2017-06-22,17,268,1314,1582
56306,2017-06-22,18,235,1133,1368
56307,2017-06-22,19,243,693,936
56308,2017-06-22,20,194,518,712
56309,2017-06-22,21,137,391,528
56310,2017-06-22,22,112,272,384
56311,2017-06-22,23,89,138,227
56312,2017-06-23,0,40,64,104
56313,2017-06-23,1,48,36,84
56314,2017-06-23,2,9,20,29
56315,2017-06-23,3,1,6,7
56316,2017-06-23,4,2,12,14
56317,2017-06-23,5,6,88,94
56318,2017-06-23,6,3,114,117
56319,2017-06-23,7,17,452,469
56320,2017-06-23,8,97,1073,1170
56321,2017-06-23,9,128,633,761
56322,2017-06-23,10,130,269,399
56323,2017-06-23,11,181,305,486
56324,2017-06-23,12,225,425,650
56325,2017-06-23,13,209,392,601
56326,2017-06-23,14,274,360,634
56327,2017-06-23,15,258,484,742
56328,2017-06-23,16,217,598,815
56329,2017-06-23,17,285,1250,1535
56330,2017-06-23,18,251,834,1085
56331,2017-06-23,19,261,597,858
56332,2017-06-23,20,260,432,692
56333,2017-06-23,21,165,303,468
56334,2017-06-23,22,119,267,386
56335,2017-06-23,23,99,217,316
56336,2017-06-24,0,94,128,222
56337,2017-06-24,1,35,91,126
56338,2017-06-24,2,20,22,42
56339,2017-06-24,3,10,16,26
56340,2017-06-24,4,3,6,9
56341,2017-06-24,5,6,20,26
56342,2017-06-24,6,19,51,70
56343,2017-06-24,7,47,149,196
56344,2017-06-24,8,151,301,452
56345,2017-06-24,9,260,458,718
56346,2017-06-24,10,382,496,878
56347,2017-06-24,11,447,558,1005
56348,2017-06-24,12,532,541,1073
56349,2017-06-24,13,583,519,1102
56350,2017-06-24,14,617,553,1170
56351,2017-06-24,15,630,551,1181
56352,2017-06-24,16,519,478,997
56353,2017-06-24,17,580,487,1067
56354,2017-06-24,18,420,490,910
56355,2017-06-24,19,423,432,855
56356,2017-06-24,20,442,357,799
56357,2017-06-24,21,322,278,600
56358,2017-06-24,22,203,227,430
56359,2017-06-24,23,168,196,364
56360,2017-06-25,0,141,122,263
56361,2017-06-25,1,82,117,199
56362,2017-06-25,2,34,67,101
56363,2017-06-25,3,24,30,54
56364,2017-06-25,4,13,10,23
56365,2017-06-25,5,14,18,32
56366,2017-06-25,6,24,45,69
56367,2017-06-25,7,54,104,158
56368,2017-06-25,8,110,215,325
56369,2017-06-25,9,197,333,530
56370,2017-06-25,10,362,480,842
56371,2017-06-25,11,403,512,915
56372,2017-06-25,12,557,579,1136
56373,2017-06-25,13,590,592,1182
56374,2017-06-25,14,615,524,1139
56375,2017-06-25,15,558,553,1111
56376,2017-06-25,16,511,578,1089
56377,2017-06-25,17,508,487,995
56378,2017-06-25,18,457,482,939
56379,2017-06-25,19,355,451,806
56380,2017-06-25,20,362,373,735
56381,2017-06-25,21,217,267,484
56382,2017-06-25,22,126,161,287
56383,2017-06-25,23,87,114,201
56384,2017-06-26,0,33,50,83
56385,2017-06-26,1,22,13,35
56386,2017-06-26,2,3,4,7
56387,2017-06-26,3,5,7,12
56388,2017-06-26,4,0,11,11
56389,2017-06-26,5,6,108,114
56390,2017-06-26,6,21,348,369
56391,2017-06-26,7,37,906,943
56392,2017-06-26,8,83,1059,1142
56393,2017-06-26,9,129,397,526
56394,2017-06-26,10,184,226,410
56395,2017-06-26,11,220,319,539
56396,2017-06-26,12,253,388,641
56397,2017-06-26,13,275,385,660
56398,2017-06-26,14,290,360,650
56399,2017-06-26,15,293,462,755
56400,2017-06-26,16,356,774,1130
56401,2017-06-26,17,370,1464,1834
56402,2017-06-26,18,360,1176,1536
56403,2017-06-26,19,299,805,1104
56404,2017-06-26,20,254,508,762
56405,2017-06-26,21,156,365,521
56406,2017-06-26,22,99,267,366
56407,2017-06-26,23,92,148,240
56408,2017-06-27,0,64,51,115
56409,2017-06-27,1,8,12,20
56410,2017-06-27,2,5,11,16
56411,2017-06-27,3,0,2,2
56412,2017-06-27,4,0,14,14
56413,2017-06-27,5,13,123,136
56414,2017-06-27,6,25,413,438
56415,2017-06-27,7,43,995,1038
56416,2017-06-27,8,136,1452,1588
56417,2017-06-27,9,172,591,763
56418,2017-06-27,10,181,286,467
56419,2017-06-27,11,233,334,567
56420,2017-06-27,12,238,390,628
56421,2017-06-27,13,224,385,609
56422,2017-06-27,14,276,325,601
56423,2017-06-27,15,223,403,626
56424,2017-06-27,16,314,754,1068
56425,2017-06-27,17,347,1532,1879
56426,2017-06-27,18,278,1214,1492
56427,2017-06-27,19,216,790,1006
56428,2017-06-27,20,204,587,791
56429,2017-06-27,21,160,362,522
56430,2017-06-27,22,115,315,430
56431,2017-06-27,23,56,142,198
56432,2017-06-28,0,13,72,85
56433,2017-06-28,1,9,16,25
56434,2017-06-28,2,1,12,13
56435,2017-06-28,3,2,2,4
56436,2017-06-28,4,2,11,13
56437,2017-06-28,5,5,123,128
56438,2017-06-28,6,23,381,404
56439,2017-06-28,7,53,1015,1068
56440,2017-06-28,8,114,1297,1411
56441,2017-06-28,9,123,508,631
56442,2017-06-28,10,158,229,387
56443,2017-06-28,11,204,314,518
56444,2017-06-28,12,192,421,613
56445,2017-06-28,13,219,386,605
56446,2017-06-28,14,256,358,614
56447,2017-06-28,15,271,419,690
56448,2017-06-28,16,295,786,1081
56449,2017-06-28,17,361,1495,1856
56450,2017-06-28,18,320,1248,1568
56451,2017-06-28,19,237,781,1018
56452,2017-06-28,20,270,612,882
56453,2017-06-28,21,150,485,635
56454,2017-06-28,22,95,351,446
56455,2017-06-28,23,43,155,198
56456,2017-06-29,0,21,54,75
56457,2017-06-29,1,9,21,30
56458,2017-06-29,2,1,12,13
56459,2017-06-29,3,2,4,6
56460,2017-06-29,4,1,8,9
56461,2017-06-29,5,11,116,127
56462,2017-06-29,6,20,395,415
56463,2017-06-29,7,61,937,998
56464,2017-06-29,8,97,1262,1359
56465,2017-06-29,9,117,489,606
56466,2017-06-29,10,157,244,401
56467,2017-06-29,11,223,267,490
56468,2017-06-29,12,213,374,587
56469,2017-06-29,13,210,385,595
56470,2017-06-29,14,211,356,567
56471,2017-06-29,15,220,469,689
56472,2017-06-29,16,220,749,969
56473,2017-06-29,17,264,1317,1581
56474,2017-06-29,18,273,1156,1429
56475,2017-06-29,19,267,787,1054
56476,2017-06-29,20,227,608,835
56477,2017-06-29,21,175,351,526
56478,2017-06-29,22,116,259,375
56479,2017-06-29,23,50,156,206
56480,2017-06-30,0,48,58,106
56481,2017-06-30,1,19,35,54
56482,2017-06-30,2,10,31,41
56483,2017-06-30,3,9,6,15
56484,2017-06-30,4,4,13,17
56485,2017-06-30,5,9,95,104
56486,2017-06-30,6,19,340,359
56487,2017-06-30,7,72,760,832
56488,2017-06-30,8,128,1189,1317
56489,2017-06-30,9,148,531,679
56490,2017-06-30,10,193,329,522
56491,2017-06-30,11,266,354,620
56492,2017-06-30,12,239,452,691
56493,2017-06-30,13,275,409,684
56494,2017-06-30,14,248,422,670
56495,2017-06-30,15,268,567,835
56496,2017-06-30,16,308,807,1115
56497,2017-06-30,17,309,1085,1394
56498,2017-06-30,18,271,772,1043
56499,2017-06-30,19,265,603,868
56500,2017-06-30,20,246,412,658
56501,2017-06-30,21,187,289,476
56502,2017-06-30,22,155,236,391
56503,2017-06-30,23,87,174,261
56504,2017-07-01,0,70,119,189
56505,2017-07-01,1,59,62,121
56506,2017-07-01,2,48,36,84
56507,2017-07-01,3,12,24,36
56508,2017-07-01,4,13,5,18
56509,2017-07-01,5,6,32,38
56510,2017-07-01,6,24,52,76
56511,2017-07-01,7,42,125,167
56512,2017-07-01,8,90,254,344
56513,2017-07-01,9,202,359,561
56514,2017-07-01,10,342,438,780
56515,2017-07-01,11,464,466,930
56516,2017-07-01,12,477,461,938
56517,2017-07-01,13,464,478,942
56518,2017-07-01,14,460,368,828
56519,2017-07-01,15,353,371,724
56520,2017-07-01,16,282,216,498
56521,2017-07-01,17,439,313,752
56522,2017-07-01,18,379,355,734
56523,2017-07-01,19,457,333,790
56524,2017-07-01,20,359,282,641
56525,2017-07-01,21,308,247,555
56526,2017-07-01,22,200,166,366
56527,2017-07-01,23,143,149,292
56528,2017-07-02,0,67,109,176
56529,2017-07-02,1,84,83,167
56530,2017-07-02,2,48,50,98
56531,2017-07-02,3,20,27,47
56532,2017-07-02,4,6,6,12
56533,2017-07-02,5,11,18,29
56534,2017-07-02,6,31,48,79
56535,2017-07-02,7,66,107,173
56536,2017-07-02,8,151,191,342
56537,2017-07-02,9,275,293,568
56538,2017-07-02,10,422,374,796
56539,2017-07-02,11,527,410,937
56540,2017-07-02,12,574,454,1028
56541,2017-07-02,13,620,450,1070
56542,2017-07-02,14,693,442,1135
56543,2017-07-02,15,720,394,1114
56544,2017-07-02,16,622,408,1030
56545,2017-07-02,17,590,400,990
56546,2017-07-02,18,500,387,887
56547,2017-07-02,19,550,375,925
56548,2017-07-02,20,456,331,787
56549,2017-07-02,21,365,210,575
56550,2017-07-02,22,217,161,378
56551,2017-07-02,23,134,103,237
56552,2017-07-03,0,71,43,114
56553,2017-07-03,1,37,35,72
56554,2017-07-03,2,22,22,44
56555,2017-07-03,3,4,2,6
56556,2017-07-03,4,2,13,15
56557,2017-07-03,5,7,66,73
56558,2017-07-03,6,24,208,232
56559,2017-07-03,7,64,456,520
56560,2017-07-03,8,133,601,734
56561,2017-07-03,9,282,412,694
56562,2017-07-03,10,423,361,784
56563,2017-07-03,11,533,364,897
56564,2017-07-03,12,540,445,985
56565,2017-07-03,13,492,459,951
56566,2017-07-03,14,621,502,1123
56567,2017-07-03,15,561,622,1183
56568,2017-07-03,16,544,664,1208
56569,2017-07-03,17,533,738,1271
56570,2017-07-03,18,481,613,1094
56571,2017-07-03,19,517,487,1004
56572,2017-07-03,20,416,439,855
56573,2017-07-03,21,349,326,675
56574,2017-07-03,22,206,232,438
56575,2017-07-03,23,158,157,315
56576,2017-07-04,0,111,119,230
56577,2017-07-04,1,46,87,133
56578,2017-07-04,2,37,53,90
56579,2017-07-04,3,23,19,42
56580,2017-07-04,4,5,6,11
56581,2017-07-04,5,15,27,42
56582,2017-07-04,6,27,64,91
56583,2017-07-04,7,65,119,184
56584,2017-07-04,8,139,212,351
56585,2017-07-04,9,323,339,662
56586,2017-07-04,10,446,474,920
56587,2017-07-04,11,565,454,1019
56588,2017-07-04,12,614,461,1075
56589,2017-07-04,13,696,464,1160
56590,2017-07-04,14,779,498,1277
56591,2017-07-04,15,710,449,1159
56592,2017-07-04,16,556,399,955
56593,2017-07-04,17,524,328,852
56594,2017-07-04,18,588,379,967
56595,2017-07-04,19,706,401,1107
56596,2017-07-04,20,557,408,965
56597,2017-07-04,21,565,496,1061
56598,2017-07-04,22,418,417,835
56599,2017-07-04,23,92,117,209
56600,2017-07-05,0,57,49,106
56601,2017-07-05,1,16,20,36
56602,2017-07-05,2,13,17,30
56603,2017-07-05,3,6,4,10
56604,2017-07-05,4,5,11,16
56605,2017-07-05,5,11,82,93
56606,2017-07-05,6,18,288,306
56607,2017-07-05,7,49,628,677
56608,2017-07-05,8,86,890,976
56609,2017-07-05,9,116,306,422
56610,2017-07-05,10,127,135,262
56611,2017-07-05,11,240,222,462
56612,2017-07-05,12,251,355,606
56613,2017-07-05,13,314,315,629
56614,2017-07-05,14,296,290,586
56615,2017-07-05,15,315,402,717
56616,2017-07-05,16,307,695,1002
56617,2017-07-05,17,298,1242,1540
56618,2017-07-05,18,246,1004,1250
56619,2017-07-05,19,57,224,281
56620,2017-07-05,20,32,134,166
56621,2017-07-05,21,29,140,169
56622,2017-07-05,22,40,113,153
56623,2017-07-05,23,30,62,92
56624,2017-07-06,0,18,30,48
56625,2017-07-06,1,8,8,16
56626,2017-07-06,2,5,11,16
56627,2017-07-06,3,2,3,5
56628,2017-07-06,4,1,4,5
56629,2017-07-06,5,4,26,30
56630,2017-07-06,6,6,86,92
56631,2017-07-06,7,9,122,131
56632,2017-07-06,8,9,263,272
56633,2017-07-06,9,26,135,161
56634,2017-07-06,10,39,55,94
56635,2017-07-06,11,31,83,114
56636,2017-07-06,12,66,190,256
56637,2017-07-06,13,75,228,303
56638,2017-07-06,14,118,293,411
56639,2017-07-06,15,100,290,390
56640,2017-07-06,16,132,574,706
56641,2017-07-06,17,193,1062,1255
56642,2017-07-06,18,161,969,1130
56643,2017-07-06,19,170,655,825
56644,2017-07-06,20,99,360,459
56645,2017-07-06,21,53,191,244
56646,2017-07-06,22,78,177,255
56647,2017-07-06,23,29,109,138
56648,2017-07-07,0,20,50,70
56649,2017-07-07,1,11,20,31
56650,2017-07-07,2,7,18,25
56651,2017-07-07,3,1,2,3
56652,2017-07-07,4,0,12,12
56653,2017-07-07,5,7,81,88
56654,2017-07-07,6,22,269,291
56655,2017-07-07,7,51,646,697
56656,2017-07-07,8,98,1112,1210
56657,2017-07-07,9,149,511,660
56658,2017-07-07,10,200,243,443
56659,2017-07-07,11,244,313,557
56660,2017-07-07,12,298,487,785
56661,2017-07-07,13,361,431,792
56662,2017-07-07,14,366,429,795
56663,2017-07-07,15,295,504,799
56664,2017-07-07,16,312,760,1072
56665,2017-07-07,17,331,1271,1602
56666,2017-07-07,18,287,915,1202
56667,2017-07-07,19,267,698,965
56668,2017-07-07,20,205,459,664
56669,2017-07-07,21,174,306,480
56670,2017-07-07,22,167,265,432
56671,2017-07-07,23,104,200,304
56672,2017-07-08,0,75,152,227
56673,2017-07-08,1,39,70,109
56674,2017-07-08,2,27,48,75
56675,2017-07-08,3,10,18,28
56676,2017-07-08,4,7,7,14
56677,2017-07-08,5,11,18,29
56678,2017-07-08,6,19,65,84
56679,2017-07-08,7,38,161,199
56680,2017-07-08,8,98,316,414
56681,2017-07-08,9,300,487,787
56682,2017-07-08,10,418,531,949
56683,2017-07-08,11,488,620,1108
56684,2017-07-08,12,638,590,1228
56685,2017-07-08,13,682,593,1275
56686,2017-07-08,14,600,598,1198
56687,2017-07-08,15,610,572,1182
56688,2017-07-08,16,577,528,1105
56689,2017-07-08,17,602,475,1077
56690,2017-07-08,18,521,503,1024
56691,2017-07-08,19,524,505,1029
56692,2017-07-08,20,401,425,826
56693,2017-07-08,21,348,340,688
56694,2017-07-08,22,240,246,486
56695,2017-07-08,23,194,175,369
56696,2017-07-09,0,100,143,243
56697,2017-07-09,1,70,85,155
56698,2017-07-09,2,43,54,97
56699,2017-07-09,3,17,37,54
56700,2017-07-09,4,17,12,29
56701,2017-07-09,5,9,19,28
56702,2017-07-09,6,29,46,75
56703,2017-07-09,7,78,98,176
56704,2017-07-09,8,161,240,401
56705,2017-07-09,9,357,374,731
56706,2017-07-09,10,500,518,1018
56707,2017-07-09,11,558,568,1126
56708,2017-07-09,12,622,594,1216
56709,2017-07-09,13,632,608,1240
56710,2017-07-09,14,712,593,1305
56711,2017-07-09,15,654,568,1222
56712,2017-07-09,16,624,599,1223
56713,2017-07-09,17,556,633,1189
56714,2017-07-09,18,482,603,1085
56715,2017-07-09,19,434,457,891
56716,2017-07-09,20,337,365,702
56717,2017-07-09,21,267,271,538
56718,2017-07-09,22,201,164,365
56719,2017-07-09,23,89,98,187
56720,2017-07-10,0,44,49,93
56721,2017-07-10,1,15,17,32
56722,2017-07-10,2,10,19,29
56723,2017-07-10,3,3,6,9
56724,2017-07-10,4,7,10,17
56725,2017-07-10,5,17,95,112
56726,2017-07-10,6,30,363,393
56727,2017-07-10,7,69,818,887
56728,2017-07-10,8,109,1017,1126
56729,2017-07-10,9,114,384,498
56730,2017-07-10,10,148,221,369
56731,2017-07-10,11,239,249,488
56732,2017-07-10,12,176,335,511
56733,2017-07-10,13,168,349,517
56734,2017-07-10,14,231,315,546
56735,2017-07-10,15,240,392,632
56736,2017-07-10,16,276,695,971
56737,2017-07-10,17,327,1360,1687
56738,2017-07-10,18,237,1132,1369
56739,2017-07-10,19,238,777,1015
56740,2017-07-10,20,221,550,771
56741,2017-07-10,21,148,339,487
56742,2017-07-10,22,83,190,273
56743,2017-07-10,23,2,83,85
56744,2017-07-11,0,0,27,27
56745,2017-07-11,1,0,12,12
56746,2017-07-11,2,4,8,12
56747,2017-07-11,3,3,4,7
56748,2017-07-11,4,0,18,18
56749,2017-07-11,5,15,107,122
56750,2017-07-11,6,40,417,457
56751,2017-07-11,7,90,974,1064
56752,2017-07-11,8,125,1249,1374
56753,2017-07-11,9,144,480,624
56754,2017-07-11,10,187,271,458
56755,2017-07-11,11,195,256,451
56756,2017-07-11,12,194,384,578
56757,2017-07-11,13,175,329,504
56758,2017-07-11,14,198,303,501
56759,2017-07-11,15,212,402,614
56760,2017-07-11,16,231,692,923
56761,2017-07-11,17,311,1424,1735
56762,2017-07-11,18,283,1160,1443
56763,2017-07-11,19,218,747,965
56764,2017-07-11,20,218,512,730
56765,2017-07-11,21,161,369,530
56766,2017-07-11,22,121,228,349
56767,2017-07-11,23,72,106,178
56768,2017-07-12,0,36,43,79
56769,2017-07-12,1,8,10,18
56770,2017-07-12,2,2,12,14
56771,2017-07-12,3,3,4,7
56772,2017-07-12,4,0,15,15
56773,2017-07-12,5,14,114,128
56774,2017-07-12,6,46,405,451
56775,2017-07-12,7,84,971,1055
56776,2017-07-12,8,125,1114,1239
56777,2017-07-12,9,124,504,628
56778,2017-07-12,10,174,259,433
56779,2017-07-12,11,201,273,474
56780,2017-07-12,12,221,328,549
56781,2017-07-12,13,218,329,547
56782,2017-07-12,14,217,308,525
56783,2017-07-12,15,212,413,625
56784,2017-07-12,16,268,704,972
56785,2017-07-12,17,335,1312,1647
56786,2017-07-12,18,220,1128,1348
56787,2017-07-12,19,180,717,897
56788,2017-07-12,20,221,560,781
56789,2017-07-12,21,143,377,520
56790,2017-07-12,22,107,238,345
56791,2017-07-12,23,61,127,188
56792,2017-07-13,0,40,52,92
56793,2017-07-13,1,11,24,35
56794,2017-07-13,2,5,10,15
56795,2017-07-13,3,2,2,4
56796,2017-07-13,4,4,14,18
56797,2017-07-13,5,14,110,124
56798,2017-07-13,6,27,400,427
56799,2017-07-13,7,54,945,999
56800,2017-07-13,8,94,1097,1191
56801,2017-07-13,9,112,424,536
56802,2017-07-13,10,127,232,359
56803,2017-07-13,11,183,253,436
56804,2017-07-13,12,221,307,528
56805,2017-07-13,13,186,294,480
56806,2017-07-13,14,190,281,471
56807,2017-07-13,15,212,359,571
56808,2017-07-13,16,204,637,841
56809,2017-07-13,17,289,1161,1450
56810,2017-07-13,18,232,1032,1264
56811,2017-07-13,19,242,704,946
56812,2017-07-13,20,214,521,735
56813,2017-07-13,21,142,363,505
56814,2017-07-13,22,118,283,401
56815,2017-07-13,23,89,140,229
56816,2017-07-14,0,48,47,95
56817,2017-07-14,1,34,24,58
56818,2017-07-14,2,14,20,34
56819,2017-07-14,3,3,6,9
56820,2017-07-14,4,6,12,18
56821,2017-07-14,5,13,93,106
56822,2017-07-14,6,23,339,362
56823,2017-07-14,7,52,770,822
56824,2017-07-14,8,95,1066,1161
56825,2017-07-14,9,112,436,548
56826,2017-07-14,10,185,239,424
56827,2017-07-14,11,211,268,479
56828,2017-07-14,12,246,367,613
56829,2017-07-14,13,237,365,602
56830,2017-07-14,14,215,304,519
56831,2017-07-14,15,260,458,718
56832,2017-07-14,16,146,470,616
56833,2017-07-14,17,162,475,637
56834,2017-07-14,18,93,324,417
56835,2017-07-14,19,116,383,499
56836,2017-07-14,20,178,339,517
56837,2017-07-14,21,159,272,431
56838,2017-07-14,22,137,215,352
56839,2017-07-14,23,92,182,274
56840,2017-07-15,0,64,149,213
56841,2017-07-15,1,40,97,137
56842,2017-07-15,2,30,56,86
56843,2017-07-15,3,18,30,48
56844,2017-07-15,4,7,17,24
56845,2017-07-15,5,6,18,24
56846,2017-07-15,6,26,53,79
56847,2017-07-15,7,54,156,210
56848,2017-07-15,8,123,287,410
56849,2017-07-15,9,241,412,653
56850,2017-07-15,10,379,538,917
56851,2017-07-15,11,494,543,1037
56852,2017-07-15,12,542,578,1120
56853,2017-07-15,13,543,537,1080
56854,2017-07-15,14,576,545,1121
56855,2017-07-15,15,581,468,1049
56856,2017-07-15,16,631,541,1172
56857,2017-07-15,17,578,483,1061
56858,2017-07-15,18,512,469,981
56859,2017-07-15,19,508,413,921
56860,2017-07-15,20,431,351,782
56861,2017-07-15,21,308,274,582
56862,2017-07-15,22,214,196,410
56863,2017-07-15,23,165,182,347
56864,2017-07-16,0,94,176,270
56865,2017-07-16,1,65,102,167
56866,2017-07-16,2,39,63,102
56867,2017-07-16,3,29,43,72
56868,2017-07-16,4,10,16,26
56869,2017-07-16,5,7,20,27
56870,2017-07-16,6,22,47,69
56871,2017-07-16,7,52,94,146
56872,2017-07-16,8,151,231,382
56873,2017-07-16,9,249,342,591
56874,2017-07-16,10,431,443,874
56875,2017-07-16,11,479,493,972
56876,2017-07-16,12,493,565,1058
56877,2017-07-16,13,578,545,1123
56878,2017-07-16,14,571,519,1090
56879,2017-07-16,15,531,566,1097
56880,2017-07-16,16,535,518,1053
56881,2017-07-16,17,471,515,986
56882,2017-07-16,18,418,482,900
56883,2017-07-16,19,386,452,838
56884,2017-07-16,20,406,360,766
56885,2017-07-16,21,192,223,415
56886,2017-07-16,22,158,219,377
56887,2017-07-16,23,75,103,178
56888,2017-07-17,0,33,33,66
56889,2017-07-17,1,20,17,37
56890,2017-07-17,2,11,10,21
56891,2017-07-17,3,0,5,5
56892,2017-07-17,4,3,10,13
56893,2017-07-17,5,8,112,120
56894,2017-07-17,6,41,372,413
56895,2017-07-17,7,39,856,895
56896,2017-07-17,8,102,981,1083
56897,2017-07-17,9,149,406,555
56898,2017-07-17,10,217,185,402
56899,2017-07-17,11,217,235,452
56900,2017-07-17,12,220,304,524
56901,2017-07-17,13,182,275,457
56902,2017-07-17,14,143,155,298
56903,2017-07-17,15,155,309,464
56904,2017-07-17,16,211,717,928
56905,2017-07-17,17,310,1337,1647
56906,2017-07-17,18,251,1001,1252
56907,2017-07-17,19,245,786,1031
56908,2017-07-17,20,244,551,795
56909,2017-07-17,21,191,349,540
56910,2017-07-17,22,131,188,319
56911,2017-07-17,23,69,92,161
56912,2017-07-18,0,24,40,64
56913,2017-07-18,1,11,14,25
56914,2017-07-18,2,13,8,21
56915,2017-07-18,3,1,5,6
56916,2017-07-18,4,3,14,17
56917,2017-07-18,5,10,124,134
56918,2017-07-18,6,37,416,453
56919,2017-07-18,7,73,1002,1075
56920,2017-07-18,8,98,1211,1309
56921,2017-07-18,9,116,419,535
56922,2017-07-18,10,205,219,424
56923,2017-07-18,11,228,252,480
56924,2017-07-18,12,195,351,546
56925,2017-07-18,13,202,316,518
56926,2017-07-18,14,199,256,455
56927,2017-07-18,15,229,380,609
56928,2017-07-18,16,254,639,893
56929,2017-07-18,17,154,1007,1161
56930,2017-07-18,18,224,1063,1287
56931,2017-07-18,19,243,816,1059
56932,2017-07-18,20,243,547,790
56933,2017-07-18,21,155,394,549
56934,2017-07-18,22,77,238,315
56935,2017-07-18,23,68,126,194
56936,2017-07-19,0,18,45,63
56937,2017-07-19,1,16,11,27
56938,2017-07-19,2,3,10,13
56939,2017-07-19,3,5,1,6
56940,2017-07-19,4,0,16,16
56941,2017-07-19,5,11,125,136
56942,2017-07-19,6,23,410,433
56943,2017-07-19,7,69,958,1027
56944,2017-07-19,8,85,1241,1326
56945,2017-07-19,9,110,469,579
56946,2017-07-19,10,149,230,379
56947,2017-07-19,11,134,257,391
56948,2017-07-19,12,152,363,515
56949,2017-07-19,13,141,352,493
56950,2017-07-19,14,163,305,468
56951,2017-07-19,15,141,373,514
56952,2017-07-19,16,206,680,886
56953,2017-07-19,17,285,1299,1584
56954,2017-07-19,18,247,1135,1382
56955,2017-07-19,19,255,780,1035
56956,2017-07-19,20,241,590,831
56957,2017-07-19,21,159,389,548
56958,2017-07-19,22,104,235,339
56959,2017-07-19,23,44,131,175
56960,2017-07-20,0,29,72,101
56961,2017-07-20,1,5,14,19
56962,2017-07-20,2,3,16,19
56963,2017-07-20,3,5,9,14
56964,2017-07-20,4,4,15,19
56965,2017-07-20,5,19,98,117
56966,2017-07-20,6,20,370,390
56967,2017-07-20,7,49,907,956
56968,2017-07-20,8,101,1123,1224
56969,2017-07-20,9,126,467,593
56970,2017-07-20,10,154,226,380
56971,2017-07-20,11,192,231,423
56972,2017-07-20,12,196,308,504
56973,2017-07-20,13,157,298,455
56974,2017-07-20,14,168,298,466
56975,2017-07-20,15,162,372,534
56976,2017-07-20,16,202,647,849
56977,2017-07-20,17,273,1217,1490
56978,2017-07-20,18,253,1028,1281
56979,2017-07-20,19,235,698,933
56980,2017-07-20,20,215,530,745
56981,2017-07-20,21,180,397,577
56982,2017-07-20,22,104,258,362
56983,2017-07-20,23,58,163,221
56984,2017-07-21,0,28,88,116
56985,2017-07-21,1,28,25,53
56986,2017-07-21,2,13,11,24
56987,2017-07-21,3,4,9,13
56988,2017-07-21,4,2,15,17
56989,2017-07-21,5,10,88,98
56990,2017-07-21,6,32,360,392
56991,2017-07-21,7,64,759,823
56992,2017-07-21,8,103,1042,1145
56993,2017-07-21,9,141,449,590
56994,2017-07-21,10,193,265,458
56995,2017-07-21,11,222,302,524
56996,2017-07-21,12,248,368,616
56997,2017-07-21,13,251,352,603
56998,2017-07-21,14,238,360,598
56999,2017-07-21,15,271,485,756
57000,2017-07-21,16,284,741,1025
57001,2017-07-21,17,324,1036,1360
57002,2017-07-21,18,336,792,1128
57003,2017-07-21,19,289,547,836
57004,2017-07-21,20,259,384,643
57005,2017-07-21,21,220,256,476
57006,2017-07-21,22,137,213,350
57007,2017-07-21,23,97,197,294
57008,2017-07-22,0,43,140,183
57009,2017-07-22,1,39,88,127
57010,2017-07-22,2,43,61,104
57011,2017-07-22,3,15,19,34
57012,2017-07-22,4,5,19,24
57013,2017-07-22,5,12,27,39
57014,2017-07-22,6,21,63,84
57015,2017-07-22,7,62,148,210
57016,2017-07-22,8,136,256,392
57017,2017-07-22,9,273,415,688
57018,2017-07-22,10,369,476,845
57019,2017-07-22,11,429,543,972
57020,2017-07-22,12,490,528,1018
57021,2017-07-22,13,455,478,933
57022,2017-07-22,14,309,306,615
57023,2017-07-22,15,275,256,531
57024,2017-07-22,16,449,407,856
57025,2017-07-22,17,394,343,737
57026,2017-07-22,18,124,146,270
57027,2017-07-22,19,161,138,299
57028,2017-07-22,20,217,205,422
57029,2017-07-22,21,125,179,304
57030,2017-07-22,22,63,104,167
57031,2017-07-22,23,57,112,169
57032,2017-07-23,0,33,114,147
57033,2017-07-23,1,35,70,105
57034,2017-07-23,2,18,53,71
57035,2017-07-23,3,7,31,38
57036,2017-07-23,4,3,9,12
57037,2017-07-23,5,6,12,18
57038,2017-07-23,6,16,54,70
57039,2017-07-23,7,63,103,166
57040,2017-07-23,8,113,207,320
57041,2017-07-23,9,268,361,629
57042,2017-07-23,10,415,499,914
57043,2017-07-23,11,469,482,951
57044,2017-07-23,12,534,560,1094
57045,2017-07-23,13,488,505,993
57046,2017-07-23,14,454,422,876
57047,2017-07-23,15,510,475,985
57048,2017-07-23,16,356,392,748
57049,2017-07-23,17,359,509,868
57050,2017-07-23,18,166,269,435
57051,2017-07-23,19,190,305,495
57052,2017-07-23,20,224,298,522
57053,2017-07-23,21,161,168,329
57054,2017-07-23,22,83,158,241
57055,2017-07-23,23,6,15,21
57056,2017-07-24,0,11,23,34
57057,2017-07-24,1,13,8,21
57058,2017-07-24,2,11,6,17
57059,2017-07-24,3,1,2,3
57060,2017-07-24,4,3,13,16
57061,2017-07-24,5,16,87,103
57062,2017-07-24,6,22,318,340
57063,2017-07-24,7,80,737,817
57064,2017-07-24,8,90,1013,1103
57065,2017-07-24,9,155,446,601
57066,2017-07-24,10,203,210,413
57067,2017-07-24,11,184,274,458
57068,2017-07-24,12,215,325,540
57069,2017-07-24,13,225,291,516
57070,2017-07-24,14,272,289,561
57071,2017-07-24,15,259,361,620
57072,2017-07-24,16,287,708,995
57073,2017-07-24,17,292,1186,1478
57074,2017-07-24,18,233,1049,1282
57075,2017-07-24,19,240,730,970
57076,2017-07-24,20,201,524,725
57077,2017-07-24,21,126,344,470
57078,2017-07-24,22,100,196,296
57079,2017-07-24,23,50,88,138
57080,2017-07-25,0,31,55,86
57081,2017-07-25,1,24,16,40
57082,2017-07-25,2,4,7,11
57083,2017-07-25,3,10,0,10
57084,2017-07-25,4,3,19,22
57085,2017-07-25,5,11,110,121
57086,2017-07-25,6,28,428,456
57087,2017-07-25,7,68,981,1049
57088,2017-07-25,8,95,1175,1270
57089,2017-07-25,9,138,542,680
57090,2017-07-25,10,214,219,433
57091,2017-07-25,11,177,292,469
57092,2017-07-25,12,203,416,619
57093,2017-07-25,13,294,368,662
57094,2017-07-25,14,302,310,612
57095,2017-07-25,15,313,432,745
57096,2017-07-25,16,309,743,1052
57097,2017-07-25,17,400,1466,1866
57098,2017-07-25,18,308,1359,1667
57099,2017-07-25,19,306,810,1116
57100,2017-07-25,20,221,582,803
57101,2017-07-25,21,149,434,583
57102,2017-07-25,22,116,288,404
57103,2017-07-25,23,64,132,196
57104,2017-07-26,0,47,50,97
57105,2017-07-26,1,19,29,48
57106,2017-07-26,2,13,15,28
57107,2017-07-26,3,2,1,3
57108,2017-07-26,4,4,13,17
57109,2017-07-26,5,9,130,139
57110,2017-07-26,6,40,435,475
57111,2017-07-26,7,75,1031,1106
57112,2017-07-26,8,107,1242,1349
57113,2017-07-26,9,165,569,734
57114,2017-07-26,10,190,268,458
57115,2017-07-26,11,253,340,593
57116,2017-07-26,12,271,439,710
57117,2017-07-26,13,235,411,646
57118,2017-07-26,14,249,380,629
57119,2017-07-26,15,310,424,734
57120,2017-07-26,16,308,761,1069
57121,2017-07-26,17,371,1495,1866
57122,2017-07-26,18,358,1282,1640
57123,2017-07-26,19,284,793,1077
57124,2017-07-26,20,235,616,851
57125,2017-07-26,21,184,413,597
57126,2017-07-26,22,141,313,454
57127,2017-07-26,23,83,145,228
57128,2017-07-27,0,44,74,118
57129,2017-07-27,1,27,25,52
57130,2017-07-27,2,19,12,31
57131,2017-07-27,3,1,1,2
57132,2017-07-27,4,6,10,16
57133,2017-07-27,5,14,107,121
57134,2017-07-27,6,21,385,406
57135,2017-07-27,7,82,890,972
57136,2017-07-27,8,122,1253,1375
57137,2017-07-27,9,137,531,668
57138,2017-07-27,10,186,261,447
57139,2017-07-27,11,249,329,578
57140,2017-07-27,12,260,382,642
57141,2017-07-27,13,259,381,640
57142,2017-07-27,14,292,352,644
57143,2017-07-27,15,310,461,771
57144,2017-07-27,16,331,714,1045
57145,2017-07-27,17,394,1345,1739
57146,2017-07-27,18,330,1185,1515
57147,2017-07-27,19,287,760,1047
57148,2017-07-27,20,223,540,763
57149,2017-07-27,21,149,318,467
57150,2017-07-27,22,112,254,366
57151,2017-07-27,23,78,147,225
57152,2017-07-28,0,31,67,98
57153,2017-07-28,1,22,31,53
57154,2017-07-28,2,20,35,55
57155,2017-07-28,3,3,5,8
57156,2017-07-28,4,5,15,20
57157,2017-07-28,5,12,77,89
57158,2017-07-28,6,35,311,346
57159,2017-07-28,7,59,766,825
57160,2017-07-28,8,97,1101,1198
57161,2017-07-28,9,148,509,657
57162,2017-07-28,10,165,232,397
57163,2017-07-28,11,133,197,330
57164,2017-07-28,12,42,63,105
57165,2017-07-28,13,55,91,146
57166,2017-07-28,14,84,230,314
57167,2017-07-28,15,24,67,91
57168,2017-07-28,16,14,68,82
57169,2017-07-28,17,32,178,210
57170,2017-07-28,18,28,154,182
57171,2017-07-28,19,40,152,192
57172,2017-07-28,20,26,142,168
57173,2017-07-28,21,33,58,91
57174,2017-07-28,22,15,26,41
57175,2017-07-28,23,6,22,28
57176,2017-07-29,0,2,8,10
57177,2017-07-29,1,0,5,5
57178,2017-07-29,2,5,32,37
57179,2017-07-29,3,6,17,23
57180,2017-07-29,4,4,7,11
57181,2017-07-29,5,7,14,21
57182,2017-07-29,6,9,47,56
57183,2017-07-29,7,34,102,136
57184,2017-07-29,8,69,179,248
57185,2017-07-29,9,113,331,444
57186,2017-07-29,10,180,440,620
57187,2017-07-29,11,288,470,758
57188,2017-07-29,12,335,447,782
57189,2017-07-29,13,185,311,496
57190,2017-07-29,14,302,298,600
57191,2017-07-29,15,269,351,620
57192,2017-07-29,16,255,329,584
57193,2017-07-29,17,367,457,824
57194,2017-07-29,18,395,410,805
57195,2017-07-29,19,327,399,726
57196,2017-07-29,20,318,356,674
57197,2017-07-29,21,223,259,482
57198,2017-07-29,22,230,230,460
57199,2017-07-29,23,156,187,343
57200,2017-07-30,0,85,141,226
57201,2017-07-30,1,49,124,173
57202,2017-07-30,2,52,60,112
57203,2017-07-30,3,30,45,75
57204,2017-07-30,4,6,15,21
57205,2017-07-30,5,17,22,39
57206,2017-07-30,6,36,41,77
57207,2017-07-30,7,61,101,162
57208,2017-07-30,8,123,255,378
57209,2017-07-30,9,296,367,663
57210,2017-07-30,10,447,518,965
57211,2017-07-30,11,676,603,1279
57212,2017-07-30,12,695,718,1413
57213,2017-07-30,13,748,644,1392
57214,2017-07-30,14,721,618,1339
57215,2017-07-30,15,723,541,1264
57216,2017-07-30,16,695,603,1298
57217,2017-07-30,17,647,602,1249
57218,2017-07-30,18,473,549,1022
57219,2017-07-30,19,444,467,911
57220,2017-07-30,20,357,377,734
57221,2017-07-30,21,207,226,433
57222,2017-07-30,22,146,233,379
57223,2017-07-30,23,54,101,155
57224,2017-07-31,0,24,42,66
57225,2017-07-31,1,14,14,28
57226,2017-07-31,2,5,6,11
57227,2017-07-31,3,0,3,3
57228,2017-07-31,4,3,15,18
57229,2017-07-31,5,3,93,96
57230,2017-07-31,6,11,335,346
57231,2017-07-31,7,44,811,855
57232,2017-07-31,8,87,937,1024
57233,2017-07-31,9,164,458,622
57234,2017-07-31,10,248,224,472
57235,2017-07-31,11,278,290,568
57236,2017-07-31,12,313,394,707
57237,2017-07-31,13,317,329,646
57238,2017-07-31,14,265,306,571
57239,2017-07-31,15,327,387,714
57240,2017-07-31,16,361,716,1077
57241,2017-07-31,17,432,1390,1822
57242,2017-07-31,18,312,1128,1440
57243,2017-07-31,19,267,825,1092
57244,2017-07-31,20,267,495,762
57245,2017-07-31,21,186,336,522
57246,2017-07-31,22,108,216,324
57247,2017-07-31,23,58,90,148
57248,2017-08-01,0,33,36,69
57249,2017-08-01,1,3,21,24
57250,2017-08-01,2,0,8,8
57251,2017-08-01,3,0,4,4
57252,2017-08-01,4,4,18,22
57253,2017-08-01,5,14,113,127
57254,2017-08-01,6,32,403,435
57255,2017-08-01,7,55,937,992
57256,2017-08-01,8,127,1226,1353
57257,2017-08-01,9,135,528,663
57258,2017-08-01,10,159,242,401
57259,2017-08-01,11,179,316,495
57260,2017-08-01,12,210,378,588
57261,2017-08-01,13,191,341,532
57262,2017-08-01,14,229,298,527
57263,2017-08-01,15,266,412,678
57264,2017-08-01,16,267,754,1021
57265,2017-08-01,17,166,845,1011
57266,2017-08-01,18,130,718,848
57267,2017-08-01,19,208,700,908
57268,2017-08-01,20,196,552,748
57269,2017-08-01,21,122,337,459
57270,2017-08-01,22,101,207,308
57271,2017-08-01,23,78,101,179
57272,2017-08-02,0,37,41,78
57273,2017-08-02,1,19,19,38
57274,2017-08-02,2,13,24,37
57275,2017-08-02,3,0,6,6
57276,2017-08-02,4,4,20,24
57277,2017-08-02,5,14,114,128
57278,2017-08-02,6,28,406,434
57279,2017-08-02,7,69,922,991
57280,2017-08-02,8,91,1245,1336
57281,2017-08-02,9,123,538,661
57282,2017-08-02,10,171,229,400
57283,2017-08-02,11,185,297,482
57284,2017-08-02,12,229,363,592
57285,2017-08-02,13,212,348,560
57286,2017-08-02,14,300,296,596
57287,2017-08-02,15,233,397,630
57288,2017-08-02,16,248,729,977
57289,2017-08-02,17,314,1415,1729
57290,2017-08-02,18,268,1167,1435
57291,2017-08-02,19,270,770,1040
57292,2017-08-02,20,201,566,767
57293,2017-08-02,21,147,405,552
57294,2017-08-02,22,103,282,385
57295,2017-08-02,23,51,147,198
57296,2017-08-03,0,46,68,114
57297,2017-08-03,1,16,29,45
57298,2017-08-03,2,8,18,26
57299,2017-08-03,3,1,4,5
57300,2017-08-03,4,1,11,12
57301,2017-08-03,5,14,111,125
57302,2017-08-03,6,34,374,408
57303,2017-08-03,7,58,897,955
57304,2017-08-03,8,85,1211,1296
57305,2017-08-03,9,112,504,616
57306,2017-08-03,10,173,236,409
57307,2017-08-03,11,204,293,497
57308,2017-08-03,12,218,425,643
57309,2017-08-03,13,229,342,571
57310,2017-08-03,14,232,322,554
57311,2017-08-03,15,297,439,736
57312,2017-08-03,16,280,701,981
57313,2017-08-03,17,328,1350,1678
57314,2017-08-03,18,175,710,885
57315,2017-08-03,19,133,506,639
57316,2017-08-03,20,171,413,584
57317,2017-08-03,21,132,325,457
57318,2017-08-03,22,105,235,340
57319,2017-08-03,23,73,146,219
57320,2017-08-04,0,49,63,112
57321,2017-08-04,1,10,34,44
57322,2017-08-04,2,18,26,44
57323,2017-08-04,3,7,6,13
57324,2017-08-04,4,6,17,23
57325,2017-08-04,5,13,94,107
57326,2017-08-04,6,21,307,328
57327,2017-08-04,7,51,721,772
57328,2017-08-04,8,110,1118,1228
57329,2017-08-04,9,177,503,680
57330,2017-08-04,10,235,307,542
57331,2017-08-04,11,312,357,669
57332,2017-08-04,12,294,453,747
57333,2017-08-04,13,263,429,692
57334,2017-08-04,14,308,400,708
57335,2017-08-04,15,329,535,864
57336,2017-08-04,16,349,834,1183
57337,2017-08-04,17,362,1093,1455
57338,2017-08-04,18,344,863,1207
57339,2017-08-04,19,295,635,930
57340,2017-08-04,20,276,440,716
57341,2017-08-04,21,210,291,501
57342,2017-08-04,22,161,241,402
57343,2017-08-04,23,116,203,319
57344,2017-08-05,0,69,137,206
57345,2017-08-05,1,30,67,97
57346,2017-08-05,2,35,57,92
57347,2017-08-05,3,8,31,39
57348,2017-08-05,4,4,7,11
57349,2017-08-05,5,11,18,29
57350,2017-08-05,6,11,66,77
57351,2017-08-05,7,55,137,192
57352,2017-08-05,8,104,257,361
57353,2017-08-05,9,237,392,629
57354,2017-08-05,10,442,530,972
57355,2017-08-05,11,544,598,1142
57356,2017-08-05,12,665,631,1296
57357,2017-08-05,13,702,637,1339
57358,2017-08-05,14,827,633,1460
57359,2017-08-05,15,844,575,1419
57360,2017-08-05,16,756,573,1329
57361,2017-08-05,17,706,582,1288
57362,2017-08-05,18,539,555,1094
57363,2017-08-05,19,566,419,985
57364,2017-08-05,20,483,358,841
57365,2017-08-05,21,318,300,618
57366,2017-08-05,22,231,222,453
57367,2017-08-05,23,167,204,371
57368,2017-08-06,0,87,132,219
57369,2017-08-06,1,53,97,150
57370,2017-08-06,2,41,61,102
57371,2017-08-06,3,21,31,52
57372,2017-08-06,4,14,8,22
57373,2017-08-06,5,11,5,16
57374,2017-08-06,6,17,35,52
57375,2017-08-06,7,56,79,135
57376,2017-08-06,8,92,179,271
57377,2017-08-06,9,267,307,574
57378,2017-08-06,10,414,425,839
57379,2017-08-06,11,570,554,1124
57380,2017-08-06,12,656,559,1215
57381,2017-08-06,13,619,563,1182
57382,2017-08-06,14,693,545,1238
57383,2017-08-06,15,759,581,1340
57384,2017-08-06,16,645,596,1241
57385,2017-08-06,17,526,569,1095
57386,2017-08-06,18,486,513,999
57387,2017-08-06,19,422,406,828
57388,2017-08-06,20,316,290,606
57389,2017-08-06,21,208,179,387
57390,2017-08-06,22,135,178,313
57391,2017-08-06,23,64,92,156
57392,2017-08-07,0,43,51,94
57393,2017-08-07,1,14,17,31
57394,2017-08-07,2,2,4,6
57395,2017-08-07,3,2,7,9
57396,2017-08-07,4,2,13,15
57397,2017-08-07,5,8,51,59
57398,2017-08-07,6,7,169,176
57399,2017-08-07,7,9,239,248
57400,2017-08-07,8,35,488,523
57401,2017-08-07,9,49,316,365
57402,2017-08-07,10,29,64,93
57403,2017-08-07,11,23,45,68
57404,2017-08-07,12,10,36,46
57405,2017-08-07,13,13,29,42
57406,2017-08-07,14,13,38,51
57407,2017-08-07,15,45,123,168
57408,2017-08-07,16,99,472,571
57409,2017-08-07,17,134,940,1074
57410,2017-08-07,18,106,604,710
57411,2017-08-07,19,72,417,489
57412,2017-08-07,20,64,331,395
57413,2017-08-07,21,68,256,324
57414,2017-08-07,22,46,191,237
57415,2017-08-07,23,33,67,100
57416,2017-08-08,0,19,31,50
57417,2017-08-08,1,4,8,12
57418,2017-08-08,2,3,7,10
57419,2017-08-08,3,1,1,2
57420,2017-08-08,4,2,14,16
57421,2017-08-08,5,4,97,101
57422,2017-08-08,6,10,337,347
57423,2017-08-08,7,33,844,877
57424,2017-08-08,8,77,1238,1315
57425,2017-08-08,9,83,516,599
57426,2017-08-08,10,217,277,494
57427,2017-08-08,11,236,298,534
57428,2017-08-08,12,263,371,634
57429,2017-08-08,13,304,363,667
57430,2017-08-08,14,271,335,606
57431,2017-08-08,15,364,426,790
57432,2017-08-08,16,363,773,1136
57433,2017-08-08,17,403,1509,1912
57434,2017-08-08,18,350,1277,1627
57435,2017-08-08,19,261,769,1030
57436,2017-08-08,20,221,570,791
57437,2017-08-08,21,184,382,566
57438,2017-08-08,22,146,288,434
57439,2017-08-08,23,65,123,188
57440,2017-08-09,0,65,43,108
57441,2017-08-09,1,13,12,25
57442,2017-08-09,2,3,7,10
57443,2017-08-09,3,2,5,7
57444,2017-08-09,4,1,14,15
57445,2017-08-09,5,4,112,116
57446,2017-08-09,6,30,360,390
57447,2017-08-09,7,46,926,972
57448,2017-08-09,8,102,1242,1344
57449,2017-08-09,9,130,555,685
57450,2017-08-09,10,251,250,501
57451,2017-08-09,11,266,290,556
57452,2017-08-09,12,269,398,667
57453,2017-08-09,13,291,381,672
57454,2017-08-09,14,301,344,645
57455,2017-08-09,15,307,422,729
57456,2017-08-09,16,332,816,1148
57457,2017-08-09,17,363,1518,1881
57458,2017-08-09,18,327,1155,1482
57459,2017-08-09,19,280,791,1071
57460,2017-08-09,20,215,570,785
57461,2017-08-09,21,167,387,554
57462,2017-08-09,22,127,265,392
57463,2017-08-09,23,53,153,206
57464,2017-08-10,0,45,52,97
57465,2017-08-10,1,9,15,24
57466,2017-08-10,2,5,14,19
57467,2017-08-10,3,9,3,12
57468,2017-08-10,4,4,11,15
57469,2017-08-10,5,9,96,105
57470,2017-08-10,6,18,334,352
57471,2017-08-10,7,49,875,924
57472,2017-08-10,8,108,1303,1411
57473,2017-08-10,9,138,536,674
57474,2017-08-10,10,224,271,495
57475,2017-08-10,11,234,307,541
57476,2017-08-10,12,215,459,674
57477,2017-08-10,13,324,377,701
57478,2017-08-10,14,288,326,614
57479,2017-08-10,15,290,446,736
57480,2017-08-10,16,320,783,1103
57481,2017-08-10,17,418,1391,1809
57482,2017-08-10,18,428,1161,1589
57483,2017-08-10,19,330,723,1053
57484,2017-08-10,20,232,466,698
57485,2017-08-10,21,171,353,524
57486,2017-08-10,22,125,284,409
57487,2017-08-10,23,60,136,196
57488,2017-08-11,0,44,70,114
57489,2017-08-11,1,31,36,67
57490,2017-08-11,2,7,16,23
57491,2017-08-11,3,3,7,10
57492,2017-08-11,4,2,8,10
57493,2017-08-11,5,3,92,95
57494,2017-08-11,6,13,299,312
57495,2017-08-11,7,40,729,769
57496,2017-08-11,8,99,1181,1280
57497,2017-08-11,9,135,603,738
57498,2017-08-11,10,197,298,495
57499,2017-08-11,11,246,411,657
57500,2017-08-11,12,300,453,753
57501,2017-08-11,13,306,488,794
57502,2017-08-11,14,322,430,752
57503,2017-08-11,15,346,533,879
57504,2017-08-11,16,418,824,1242
57505,2017-08-11,17,391,1131,1522
57506,2017-08-11,18,285,798,1083
57507,2017-08-11,19,93,294,387
57508,2017-08-11,20,40,77,117
57509,2017-08-11,21,34,111,145
57510,2017-08-11,22,6,39,45
57511,2017-08-11,23,20,78,98
57512,2017-08-12,0,22,65,87
57513,2017-08-12,1,10,68,78
57514,2017-08-12,2,12,36,48
57515,2017-08-12,3,6,14,20
57516,2017-08-12,4,2,8,10
57517,2017-08-12,5,9,18,27
57518,2017-08-12,6,22,53,75
57519,2017-08-12,7,39,139,178
57520,2017-08-12,8,136,223,359
57521,2017-08-12,9,189,356,545
57522,2017-08-12,10,287,414,701
57523,2017-08-12,11,423,522,945
57524,2017-08-12,12,435,515,950
57525,2017-08-12,13,543,496,1039
57526,2017-08-12,14,601,519,1120
57527,2017-08-12,15,614,530,1144
57528,2017-08-12,16,605,483,1088
57529,2017-08-12,17,612,470,1082
57530,2017-08-12,18,423,440,863
57531,2017-08-12,19,301,366,667
57532,2017-08-12,20,44,58,102
57533,2017-08-12,21,64,146,210
57534,2017-08-12,22,58,129,187
57535,2017-08-12,23,59,102,161
57536,2017-08-13,0,33,105,138
57537,2017-08-13,1,35,63,98
57538,2017-08-13,2,24,46,70
57539,2017-08-13,3,7,27,34
57540,2017-08-13,4,5,12,17
57541,2017-08-13,5,8,18,26
57542,2017-08-13,6,22,42,64
57543,2017-08-13,7,35,111,146
57544,2017-08-13,8,85,200,285
57545,2017-08-13,9,292,331,623
57546,2017-08-13,10,428,437,865
57547,2017-08-13,11,532,502,1034
57548,2017-08-13,12,658,616,1274
57549,2017-08-13,13,613,626,1239
57550,2017-08-13,14,662,580,1242
57551,2017-08-13,15,584,571,1155
57552,2017-08-13,16,621,569,1190
57553,2017-08-13,17,546,565,1111
57554,2017-08-13,18,393,559,952
57555,2017-08-13,19,448,461,909
57556,2017-08-13,20,303,400,703
57557,2017-08-13,21,222,216,438
57558,2017-08-13,22,179,211,390
57559,2017-08-13,23,53,85,138
57560,2017-08-14,0,34,30,64
57561,2017-08-14,1,13,19,32
57562,2017-08-14,2,5,9,14
57563,2017-08-14,3,1,5,6
57564,2017-08-14,4,1,9,10
57565,2017-08-14,5,6,73,79
57566,2017-08-14,6,10,324,334
57567,2017-08-14,7,52,726,778
57568,2017-08-14,8,88,1012,1100
57569,2017-08-14,9,169,476,645
57570,2017-08-14,10,205,251,456
57571,2017-08-14,11,255,318,573
57572,2017-08-14,12,331,395,726
57573,2017-08-14,13,281,317,598
57574,2017-08-14,14,287,304,591
57575,2017-08-14,15,302,423,725
57576,2017-08-14,16,318,742,1060
57577,2017-08-14,17,311,1282,1593
57578,2017-08-14,18,266,1035,1301
57579,2017-08-14,19,258,663,921
57580,2017-08-14,20,162,452,614
57581,2017-08-14,21,187,308,495
57582,2017-08-14,22,124,180,304
57583,2017-08-14,23,53,106,159
57584,2017-08-15,0,38,38,76
57585,2017-08-15,1,20,14,34
57586,2017-08-15,2,10,11,21
57587,2017-08-15,3,4,4,8
57588,2017-08-15,4,12,10,22
57589,2017-08-15,5,6,100,106
57590,2017-08-15,6,17,358,375
57591,2017-08-15,7,35,691,726
57592,2017-08-15,8,28,539,567
57593,2017-08-15,9,28,149,177
57594,2017-08-15,10,15,67,82
57595,2017-08-15,11,16,77,93
57596,2017-08-15,12,24,121,145
57597,2017-08-15,13,85,233,318
57598,2017-08-15,14,132,269,401
57599,2017-08-15,15,181,369,550
57600,2017-08-15,16,214,734,948
57601,2017-08-15,17,255,1212,1467
57602,2017-08-15,18,204,1052,1256
57603,2017-08-15,19,192,713,905
57604,2017-08-15,20,173,494,667
57605,2017-08-15,21,115,384,499
57606,2017-08-15,22,77,274,351
57607,2017-08-15,23,36,122,158
57608,2017-08-16,0,10,51,61
57609,2017-08-16,1,7,21,28
57610,2017-08-16,2,4,16,20
57611,2017-08-16,3,5,3,8
57612,2017-08-16,4,3,10,13
57613,2017-08-16,5,10,104,114
57614,2017-08-16,6,17,376,393
57615,2017-08-16,7,62,831,893
57616,2017-08-16,8,94,1225,1319
57617,2017-08-16,9,132,495,627
57618,2017-08-16,10,177,287,464
57619,2017-08-16,11,212,316,528
57620,2017-08-16,12,249,464,713
57621,2017-08-16,13,231,398,629
57622,2017-08-16,14,184,309,493
57623,2017-08-16,15,236,389,625
57624,2017-08-16,16,230,749,979
57625,2017-08-16,17,259,1317,1576
57626,2017-08-16,18,277,1160,1437
57627,2017-08-16,19,235,757,992
57628,2017-08-16,20,154,506,660
57629,2017-08-16,21,124,357,481
57630,2017-08-16,22,95,227,322
57631,2017-08-16,23,70,129,199
57632,2017-08-17,0,15,38,53
57633,2017-08-17,1,11,19,30
57634,2017-08-17,2,5,8,13
57635,2017-08-17,3,1,1,2
57636,2017-08-17,4,4,14,18
57637,2017-08-17,5,15,101,116
57638,2017-08-17,6,15,354,369
57639,2017-08-17,7,51,856,907
57640,2017-08-17,8,88,1166,1254
57641,2017-08-17,9,91,511,602
57642,2017-08-17,10,157,243,400
57643,2017-08-17,11,202,315,517
57644,2017-08-17,12,223,428,651
57645,2017-08-17,13,204,350,554
57646,2017-08-17,14,228,292,520
57647,2017-08-17,15,222,381,603
57648,2017-08-17,16,267,667,934
57649,2017-08-17,17,281,1318,1599
57650,2017-08-17,18,265,1130,1395
57651,2017-08-17,19,242,761,1003
57652,2017-08-17,20,209,524,733
57653,2017-08-17,21,142,314,456
57654,2017-08-17,22,102,244,346
57655,2017-08-17,23,53,170,223
57656,2017-08-18,0,19,67,86
57657,2017-08-18,1,15,41,56
57658,2017-08-18,2,11,28,39
57659,2017-08-18,3,1,7,8
57660,2017-08-18,4,8,12,20
57661,2017-08-18,5,5,84,89
57662,2017-08-18,6,16,292,308
57663,2017-08-18,7,49,699,748
57664,2017-08-18,8,73,1030,1103
57665,2017-08-18,9,128,551,679
57666,2017-08-18,10,223,270,493
57667,2017-08-18,11,240,339,579
57668,2017-08-18,12,253,440,693
57669,2017-08-18,13,249,464,713
57670,2017-08-18,14,270,393,663
57671,2017-08-18,15,249,480,729
57672,2017-08-18,16,287,733,1020
57673,2017-08-18,17,288,946,1234
57674,2017-08-18,18,70,232,302
57675,2017-08-18,19,116,411,527
57676,2017-08-18,20,137,295,432
57677,2017-08-18,21,117,241,358
57678,2017-08-18,22,102,189,291
57679,2017-08-18,23,71,160,231
57680,2017-08-19,0,38,98,136
57681,2017-08-19,1,27,64,91
57682,2017-08-19,2,25,56,81
57683,2017-08-19,3,23,17,40
57684,2017-08-19,4,7,10,17
57685,2017-08-19,5,4,25,29
57686,2017-08-19,6,18,69,87
57687,2017-08-19,7,55,150,205
57688,2017-08-19,8,113,267,380
57689,2017-08-19,9,250,455,705
57690,2017-08-19,10,397,538,935
57691,2017-08-19,11,446,592,1038
57692,2017-08-19,12,508,530,1038
57693,2017-08-19,13,527,567,1094
57694,2017-08-19,14,516,589,1105
57695,2017-08-19,15,499,485,984
57696,2017-08-19,16,520,490,1010
57697,2017-08-19,17,473,485,958
57698,2017-08-19,18,489,419,908
57699,2017-08-19,19,419,398,817
57700,2017-08-19,20,327,334,661
57701,2017-08-19,21,211,265,476
57702,2017-08-19,22,153,171,324
57703,2017-08-19,23,120,196,316
57704,2017-08-20,0,74,121,195
57705,2017-08-20,1,77,104,181
57706,2017-08-20,2,30,59,89
57707,2017-08-20,3,22,27,49
57708,2017-08-20,4,5,8,13
57709,2017-08-20,5,5,16,21
57710,2017-08-20,6,31,36,67
57711,2017-08-20,7,59,90,149
57712,2017-08-20,8,123,205,328
57713,2017-08-20,9,192,329,521
57714,2017-08-20,10,365,470,835
57715,2017-08-20,11,461,573,1034
57716,2017-08-20,12,520,535,1055
57717,2017-08-20,13,496,592,1088
57718,2017-08-20,14,491,595,1086
57719,2017-08-20,15,487,531,1018
57720,2017-08-20,16,424,567,991
57721,2017-08-20,17,366,545,911
57722,2017-08-20,18,401,507,908
57723,2017-08-20,19,298,445,743
57724,2017-08-20,20,210,356,566
57725,2017-08-20,21,176,180,356
57726,2017-08-20,22,129,176,305
57727,2017-08-20,23,66,64,130
57728,2017-08-21,0,32,25,57
57729,2017-08-21,1,10,11,21
57730,2017-08-21,2,12,7,19
57731,2017-08-21,3,4,0,4
57732,2017-08-21,4,1,11,12
57733,2017-08-21,5,4,78,82
57734,2017-08-21,6,9,293,302
57735,2017-08-21,7,32,736,768
57736,2017-08-21,8,70,979,1049
57737,2017-08-21,9,119,452,571
57738,2017-08-21,10,170,250,420
57739,2017-08-21,11,212,274,486
57740,2017-08-21,12,236,384,620
57741,2017-08-21,13,236,395,631
57742,2017-08-21,14,231,358,589
57743,2017-08-21,15,162,359,521
57744,2017-08-21,16,217,601,818
57745,2017-08-21,17,305,1156,1461
57746,2017-08-21,18,310,1087,1397
57747,2017-08-21,19,260,740,1000
57748,2017-08-21,20,203,474,677
57749,2017-08-21,21,138,259,397
57750,2017-08-21,22,93,165,258
57751,2017-08-21,23,30,81,111
57752,2017-08-22,0,17,32,49
57753,2017-08-22,1,35,15,50
57754,2017-08-22,2,5,10,15
57755,2017-08-22,3,3,4,7
57756,2017-08-22,4,2,16,18
57757,2017-08-22,5,9,96,105
57758,2017-08-22,6,12,368,380
57759,2017-08-22,7,51,894,945
57760,2017-08-22,8,76,1175,1251
57761,2017-08-22,9,117,456,573
57762,2017-08-22,10,157,227,384
57763,2017-08-22,11,185,263,448
57764,2017-08-22,12,166,353,519
57765,2017-08-22,13,154,310,464
57766,2017-08-22,14,180,299,479
57767,2017-08-22,15,178,352,530
57768,2017-08-22,16,176,662,838
57769,2017-08-22,17,265,1311,1576
57770,2017-08-22,18,224,1121,1345
57771,2017-08-22,19,212,773,985
57772,2017-08-22,20,188,544,732
57773,2017-08-22,21,119,348,467
57774,2017-08-22,22,122,200,322
57775,2017-08-22,23,34,86,120
57776,2017-08-23,0,31,51,82
57777,2017-08-23,1,13,26,39
57778,2017-08-23,2,5,18,23
57779,2017-08-23,3,0,12,12
57780,2017-08-23,4,1,17,18
57781,2017-08-23,5,6,112,118
57782,2017-08-23,6,18,396,414
57783,2017-08-23,7,55,944,999
57784,2017-08-23,8,104,1164,1268
57785,2017-08-23,9,110,487,597
57786,2017-08-23,10,155,257,412
57787,2017-08-23,11,189,314,503
57788,2017-08-23,12,194,407,601
57789,2017-08-23,13,231,347,578
57790,2017-08-23,14,228,327,555
57791,2017-08-23,15,283,432,715
57792,2017-08-23,16,269,776,1045
57793,2017-08-23,17,373,1391,1764
57794,2017-08-23,18,278,1229,1507
57795,2017-08-23,19,236,852,1088
57796,2017-08-23,20,171,538,709
57797,2017-08-23,21,147,363,510
57798,2017-08-23,22,91,236,327
57799,2017-08-23,23,54,122,176
57800,2017-08-24,0,20,52,72
57801,2017-08-24,1,12,19,31
57802,2017-08-24,2,6,10,16
57803,2017-08-24,3,7,5,12
57804,2017-08-24,4,4,16,20
57805,2017-08-24,5,1,88,89
57806,2017-08-24,6,14,346,360
57807,2017-08-24,7,58,845,903
57808,2017-08-24,8,84,1205,1289
57809,2017-08-24,9,101,525,626
57810,2017-08-24,10,173,256,429
57811,2017-08-24,11,226,321,547
57812,2017-08-24,12,251,455,706
57813,2017-08-24,13,243,413,656
57814,2017-08-24,14,257,409,666
57815,2017-08-24,15,255,440,695
57816,2017-08-24,16,250,768,1018
57817,2017-08-24,17,311,1422,1733
57818,2017-08-24,18,269,1191,1460
57819,2017-08-24,19,236,794,1030
57820,2017-08-24,20,189,567,756
57821,2017-08-24,21,121,376,497
57822,2017-08-24,22,91,240,331
57823,2017-08-24,23,62,128,190
57824,2017-08-25,0,22,71,93
57825,2017-08-25,1,19,22,41
57826,2017-08-25,2,12,19,31
57827,2017-08-25,3,1,2,3
57828,2017-08-25,4,0,14,14
57829,2017-08-25,5,1,81,82
57830,2017-08-25,6,11,323,334
57831,2017-08-25,7,53,770,823
57832,2017-08-25,8,83,1200,1283
57833,2017-08-25,9,112,534,646
57834,2017-08-25,10,203,339,542
57835,2017-08-25,11,236,399,635
57836,2017-08-25,12,270,495,765
57837,2017-08-25,13,315,510,825
57838,2017-08-25,14,317,456,773
57839,2017-08-25,15,299,574,873
57840,2017-08-25,16,379,918,1297
57841,2017-08-25,17,436,1291,1727
57842,2017-08-25,18,328,977,1305
57843,2017-08-25,19,271,630,901
57844,2017-08-25,20,199,480,679
57845,2017-08-25,21,154,331,485
57846,2017-08-25,22,144,320,464
57847,2017-08-25,23,92,168,260
57848,2017-08-26,0,84,122,206
57849,2017-08-26,1,36,95,131
57850,2017-08-26,2,41,60,101
57851,2017-08-26,3,8,24,32
57852,2017-08-26,4,6,7,13
57853,2017-08-26,5,5,22,27
57854,2017-08-26,6,5,68,73
57855,2017-08-26,7,38,130,168
57856,2017-08-26,8,105,283,388
57857,2017-08-26,9,214,454,668
57858,2017-08-26,10,409,548,957
57859,2017-08-26,11,537,601,1138
57860,2017-08-26,12,603,622,1225
57861,2017-08-26,13,578,544,1122
57862,2017-08-26,14,591,608,1199
57863,2017-08-26,15,712,659,1371
57864,2017-08-26,16,527,604,1131
57865,2017-08-26,17,543,604,1147
57866,2017-08-26,18,502,546,1048
57867,2017-08-26,19,392,514,906
57868,2017-08-26,20,265,359,624
57869,2017-08-26,21,164,268,432
57870,2017-08-26,22,99,220,319
57871,2017-08-26,23,82,165,247
57872,2017-08-27,0,33,111,144
57873,2017-08-27,1,105,170,275
57874,2017-08-27,2,28,87,115
57875,2017-08-27,3,12,28,40
57876,2017-08-27,4,11,17,28
57877,2017-08-27,5,9,16,25
57878,2017-08-27,6,8,29,37
57879,2017-08-27,7,42,99,141
57880,2017-08-27,8,104,223,327
57881,2017-08-27,9,211,322,533
57882,2017-08-27,10,373,465,838
57883,2017-08-27,11,497,566,1063
57884,2017-08-27,12,500,643,1143
57885,2017-08-27,13,575,595,1170
57886,2017-08-27,14,584,597,1181
57887,2017-08-27,15,595,566,1161
57888,2017-08-27,16,471,565,1036
57889,2017-08-27,17,472,642,1114
57890,2017-08-27,18,371,520,891
57891,2017-08-27,19,321,510,831
57892,2017-08-27,20,193,378,571
57893,2017-08-27,21,103,170,273
57894,2017-08-27,22,75,189,264
57895,2017-08-27,23,49,103,152
57896,2017-08-28,0,29,36,65
57897,2017-08-28,1,10,14,24
57898,2017-08-28,2,4,8,12
57899,2017-08-28,3,5,5,10
57900,2017-08-28,4,2,10,12
57901,2017-08-28,5,5,87,92
57902,2017-08-28,6,17,343,360
57903,2017-08-28,7,39,820,859
57904,2017-08-28,8,67,1014,1081
57905,2017-08-28,9,110,471,581
57906,2017-08-28,10,181,277,458
57907,2017-08-28,11,227,286,513
57908,2017-08-28,12,200,418,618
57909,2017-08-28,13,234,399,633
57910,2017-08-28,14,244,390,634
57911,2017-08-28,15,200,447,647
57912,2017-08-28,16,285,822,1107
57913,2017-08-28,17,310,1520,1830
57914,2017-08-28,18,287,1219,1506
57915,2017-08-28,19,194,720,914
57916,2017-08-28,20,104,426,530
57917,2017-08-28,21,68,265,333
57918,2017-08-28,22,47,175,222
57919,2017-08-28,23,15,72,87
57920,2017-08-29,0,13,50,63
57921,2017-08-29,1,11,21,32
57922,2017-08-29,2,4,10,14
57923,2017-08-29,3,0,3,3
57924,2017-08-29,4,2,10,12
57925,2017-08-29,5,1,29,30
57926,2017-08-29,6,2,120,122
57927,2017-08-29,7,10,282,292
57928,2017-08-29,8,17,478,495
57929,2017-08-29,9,30,251,281
57930,2017-08-29,10,31,84,115
57931,2017-08-29,11,40,62,102
57932,2017-08-29,12,22,81,103
57933,2017-08-29,13,15,62,77
57934,2017-08-29,14,11,52,63
57935,2017-08-29,15,16,76,92
57936,2017-08-29,16,21,170,191
57937,2017-08-29,17,44,431,475
57938,2017-08-29,18,61,606,667
57939,2017-08-29,19,47,405,452
57940,2017-08-29,20,50,313,363
57941,2017-08-29,21,47,204,251
57942,2017-08-29,22,41,158,199
57943,2017-08-29,23,26,100,126
57944,2017-08-30,0,27,47,74
57945,2017-08-30,1,6,25,31
57946,2017-08-30,2,2,15,17
57947,2017-08-30,3,4,11,15
57948,2017-08-30,4,1,21,22
57949,2017-08-30,5,3,92,95
57950,2017-08-30,6,15,375,390
57951,2017-08-30,7,41,992,1033
57952,2017-08-30,8,102,1349,1451
57953,2017-08-30,9,118,599,717
57954,2017-08-30,10,130,317,447
57955,2017-08-30,11,194,356,550
57956,2017-08-30,12,149,495,644
57957,2017-08-30,13,207,437,644
57958,2017-08-30,14,206,409,615
57959,2017-08-30,15,242,525,767
57960,2017-08-30,16,269,787,1056
57961,2017-08-30,17,316,1470,1786
57962,2017-08-30,18,267,1310,1577
57963,2017-08-30,19,206,905,1111
57964,2017-08-30,20,161,557,718
57965,2017-08-30,21,99,383,482
57966,2017-08-30,22,77,243,320
57967,2017-08-30,23,41,110,151
57968,2017-08-31,0,38,49,87
57969,2017-08-31,1,9,20,29
57970,2017-08-31,2,6,7,13
57971,2017-08-31,3,5,4,9
57972,2017-08-31,4,5,13,18
57973,2017-08-31,5,6,103,109
57974,2017-08-31,6,19,352,371
57975,2017-08-31,7,57,921,978
57976,2017-08-31,8,91,1310,1401
57977,2017-08-31,9,86,555,641
57978,2017-08-31,10,124,296,420
57979,2017-08-31,11,185,321,506
57980,2017-08-31,12,165,412,577
57981,2017-08-31,13,200,417,617
57982,2017-08-31,14,201,422,623
57983,2017-08-31,15,220,473,693
57984,2017-08-31,16,270,756,1026
57985,2017-08-31,17,336,1401,1737
57986,2017-08-31,18,261,1284,1545
57987,2017-08-31,19,187,792,979
57988,2017-08-31,20,128,516,644
57989,2017-08-31,21,88,307,395
57990,2017-08-31,22,59,261,320
57991,2017-08-31,23,34,138,172
57992,2017-09-01,0,27,67,94
57993,2017-09-01,1,12,34,46
57994,2017-09-01,2,9,20,29
57995,2017-09-01,3,4,9,13
57996,2017-09-01,4,1,11,12
57997,2017-09-01,5,6,94,100
57998,2017-09-01,6,14,268,282
57999,2017-09-01,7,37,719,756
58000,2017-09-01,8,54,1145,1199
58001,2017-09-01,9,115,578,693
58002,2017-09-01,10,163,288,451
58003,2017-09-01,11,220,370,590
58004,2017-09-01,12,288,513,801
58005,2017-09-01,13,222,517,739
58006,2017-09-01,14,294,563,857
58007,2017-09-01,15,332,774,1106
58008,2017-09-01,16,370,875,1245
58009,2017-09-01,17,316,988,1304
58010,2017-09-01,18,290,733,1023
58011,2017-09-01,19,229,464,693
58012,2017-09-01,20,136,289,425
58013,2017-09-01,21,100,213,313
58014,2017-09-01,22,75,159,234
58015,2017-09-01,23,44,124,168
58016,2017-09-02,0,36,101,137
58017,2017-09-02,1,40,51,91
58018,2017-09-02,2,19,47,66
58019,2017-09-02,3,9,24,33
58020,2017-09-02,4,0,4,4
58021,2017-09-02,5,2,10,12
58022,2017-09-02,6,1,13,14
58023,2017-09-02,7,9,47,56
58024,2017-09-02,8,26,82,108
58025,2017-09-02,9,9,83,92
58026,2017-09-02,10,14,96,110
58027,2017-09-02,11,19,104,123
58028,2017-09-02,12,55,194,249
58029,2017-09-02,13,72,199,271
58030,2017-09-02,14,50,134,184
58031,2017-09-02,15,66,152,218
58032,2017-09-02,16,113,233,346
58033,2017-09-02,17,155,240,395
58034,2017-09-02,18,152,260,412
58035,2017-09-02,19,136,245,381
58036,2017-09-02,20,106,155,261
58037,2017-09-02,21,102,144,246
58038,2017-09-02,22,69,115,184
58039,2017-09-02,23,60,120,180
58040,2017-09-03,0,36,72,108
58041,2017-09-03,1,33,46,79
58042,2017-09-03,2,26,26,52
58043,2017-09-03,3,6,16,22
58044,2017-09-03,4,4,3,7
58045,2017-09-03,5,4,13,17
58046,2017-09-03,6,8,32,40
58047,2017-09-03,7,19,73,92
58048,2017-09-03,8,110,156,266
58049,2017-09-03,9,270,268,538
58050,2017-09-03,10,440,407,847
58051,2017-09-03,11,553,545,1098
58052,2017-09-03,12,743,512,1255
58053,2017-09-03,13,784,570,1354
58054,2017-09-03,14,900,551,1451
58055,2017-09-03,15,852,508,1360
58056,2017-09-03,16,833,474,1307
58057,2017-09-03,17,809,442,1251
58058,2017-09-03,18,711,470,1181
58059,2017-09-03,19,584,416,1000
58060,2017-09-03,20,382,297,679
58061,2017-09-03,21,338,259,597
58062,2017-09-03,22,262,185,447
58063,2017-09-03,23,151,167,318
58064,2017-09-04,0,103,95,198
58065,2017-09-04,1,43,56,99
58066,2017-09-04,2,24,46,70
58067,2017-09-04,3,10,23,33
58068,2017-09-04,4,4,11,15
58069,2017-09-04,5,4,19,23
58070,2017-09-04,6,14,26,40
58071,2017-09-04,7,18,81,99
58072,2017-09-04,8,74,189,263
58073,2017-09-04,9,269,342,611
58074,2017-09-04,10,418,455,873
58075,2017-09-04,11,590,544,1134
58076,2017-09-04,12,624,590,1214
58077,2017-09-04,13,657,636,1293
58078,2017-09-04,14,668,592,1260
58079,2017-09-04,15,581,585,1166
58080,2017-09-04,16,571,593,1164
58081,2017-09-04,17,532,574,1106
58082,2017-09-04,18,453,574,1027
58083,2017-09-04,19,287,446,733
58084,2017-09-04,20,217,306,523
58085,2017-09-04,21,128,189,317
58086,2017-09-04,22,97,115,212
58087,2017-09-04,23,43,58,101
58088,2017-09-05,0,24,31,55
58089,2017-09-05,1,6,8,14
58090,2017-09-05,2,4,6,10
58091,2017-09-05,3,1,6,7
58092,2017-09-05,4,0,14,14
58093,2017-09-05,5,2,94,96
58094,2017-09-05,6,12,330,342
58095,2017-09-05,7,49,930,979
58096,2017-09-05,8,62,1141,1203
58097,2017-09-05,9,90,478,568
58098,2017-09-05,10,159,272,431
58099,2017-09-05,11,154,304,458
58100,2017-09-05,12,204,404,608
58101,2017-09-05,13,179,367,546
58102,2017-09-05,14,199,313,512
58103,2017-09-05,15,167,411,578
58104,2017-09-05,16,234,807,1041
58105,2017-09-05,17,234,1485,1719
58106,2017-09-05,18,133,880,1013
58107,2017-09-05,19,21,219,240
58108,2017-09-05,20,37,280,317
58109,2017-09-05,21,48,283,331
58110,2017-09-05,22,34,145,179
58111,2017-09-05,23,16,82,98
58112,2017-09-06,0,13,44,57
58113,2017-09-06,1,4,9,13
58114,2017-09-06,2,3,2,5
58115,2017-09-06,3,3,4,7
58116,2017-09-06,4,1,13,14
58117,2017-09-06,5,2,94,96
58118,2017-09-06,6,5,379,384
58119,2017-09-06,7,38,920,958
58120,2017-09-06,8,67,1237,1304
58121,2017-09-06,9,52,486,538
58122,2017-09-06,10,44,212,256
58123,2017-09-06,11,33,96,129
58124,2017-09-06,12,12,86,98
58125,2017-09-06,13,8,85,93
58126,2017-09-06,14,16,87,103
58127,2017-09-06,15,3,79,82
58128,2017-09-06,16,7,210,217
58129,2017-09-06,17,43,432,475
58130,2017-09-06,18,22,394,416
58131,2017-09-06,19,25,265,290
58132,2017-09-06,20,14,136,150
58133,2017-09-06,21,10,110,120
58134,2017-09-06,22,10,111,121
58135,2017-09-06,23,8,62,70
58136,2017-09-07,0,2,34,36
58137,2017-09-07,1,8,23,31
58138,2017-09-07,2,1,11,12
58139,2017-09-07,3,2,3,5
58140,2017-09-07,4,1,17,18
58141,2017-09-07,5,0,120,120
58142,2017-09-07,6,10,396,406
58143,2017-09-07,7,42,1041,1083
58144,2017-09-07,8,59,1238,1297
58145,2017-09-07,9,77,554,631
58146,2017-09-07,10,87,311,398
58147,2017-09-07,11,146,363,509
58148,2017-09-07,12,163,481,644
58149,2017-09-07,13,165,434,599
58150,2017-09-07,14,146,385,531
58151,2017-09-07,15,187,478,665
58152,2017-09-07,16,187,833,1020
58153,2017-09-07,17,269,1523,1792
58154,2017-09-07,18,230,1328,1558
58155,2017-09-07,19,174,849,1023
58156,2017-09-07,20,95,535,630
58157,2017-09-07,21,110,342,452
58158,2017-09-07,22,79,311,390
58159,2017-09-07,23,48,149,197
58160,2017-09-08,0,33,80,113
58161,2017-09-08,1,10,34,44
58162,2017-09-08,2,11,20,31
58163,2017-09-08,3,0,4,4
58164,2017-09-08,4,3,6,9
58165,2017-09-08,5,3,90,93
58166,2017-09-08,6,6,366,372
58167,2017-09-08,7,38,880,918
58168,2017-09-08,8,103,1392,1495
58169,2017-09-08,9,73,579,652
58170,2017-09-08,10,152,351,503
58171,2017-09-08,11,190,418,608
58172,2017-09-08,12,209,482,691
58173,2017-09-08,13,251,516,767
58174,2017-09-08,14,290,452,742
58175,2017-09-08,15,305,571,876
58176,2017-09-08,16,302,861,1163
58177,2017-09-08,17,310,1380,1690
58178,2017-09-08,18,279,1101,1380
58179,2017-09-08,19,215,665,880
58180,2017-09-08,20,143,414,557
58181,2017-09-08,21,139,342,481
58182,2017-09-08,22,112,248,360
58183,2017-09-08,23,63,193,256
58184,2017-09-09,0,42,137,179
58185,2017-09-09,1,29,89,118
58186,2017-09-09,2,42,76,118
58187,2017-09-09,3,7,24,31
58188,2017-09-09,4,5,6,11
58189,2017-09-09,5,2,31,33
58190,2017-09-09,6,6,52,58
58191,2017-09-09,7,31,119,150
58192,2017-09-09,8,62,293,355
58193,2017-09-09,9,158,487,645
58194,2017-09-09,10,339,608,947
58195,2017-09-09,11,476,571,1047
58196,2017-09-09,12,505,694,1199
58197,2017-09-09,13,549,669,1218
58198,2017-09-09,14,651,657,1308
58199,2017-09-09,15,670,654,1324
58200,2017-09-09,16,595,648,1243
58201,2017-09-09,17,625,639,1264
58202,2017-09-09,18,481,631,1112
58203,2017-09-09,19,411,495,906
58204,2017-09-09,20,231,304,535
58205,2017-09-09,21,132,284,416
58206,2017-09-09,22,94,192,286
58207,2017-09-09,23,65,185,250
58208,2017-09-10,0,38,149,187
58209,2017-09-10,1,35,94,129
58210,2017-09-10,2,14,77,91
58211,2017-09-10,3,7,36,43
58212,2017-09-10,4,4,8,12
58213,2017-09-10,5,11,28,39
58214,2017-09-10,6,18,48,66
58215,2017-09-10,7,42,86,128
58216,2017-09-10,8,85,233,318
58217,2017-09-10,9,180,380,560
58218,2017-09-10,10,333,513,846
58219,2017-09-10,11,422,598,1020
58220,2017-09-10,12,500,693,1193
58221,2017-09-10,13,476,627,1103
58222,2017-09-10,14,456,594,1050
58223,2017-09-10,15,559,612,1171
58224,2017-09-10,16,495,681,1176
58225,2017-09-10,17,458,602,1060
58226,2017-09-10,18,324,553,877
58227,2017-09-10,19,296,477,773
58228,2017-09-10,20,153,337,490
58229,2017-09-10,21,139,190,329
58230,2017-09-10,22,84,134,218
58231,2017-09-10,23,53,69,122
58232,2017-09-11,0,34,34,68
58233,2017-09-11,1,10,14,24
58234,2017-09-11,2,2,7,9
58235,2017-09-11,3,3,2,5
58236,2017-09-11,4,2,7,9
58237,2017-09-11,5,8,87,95
58238,2017-09-11,6,10,373,383
58239,2017-09-11,7,55,850,905
58240,2017-09-11,8,87,1180,1267
58241,2017-09-11,9,86,440,526
58242,2017-09-11,10,133,225,358
58243,2017-09-11,11,185,287,472
58244,2017-09-11,12,175,394,569
58245,2017-09-11,13,241,348,589
58246,2017-09-11,14,276,331,607
58247,2017-09-11,15,273,449,722
58248,2017-09-11,16,264,805,1069
58249,2017-09-11,17,340,1509,1849
58250,2017-09-11,18,281,1253,1534
58251,2017-09-11,19,200,764,964
58252,2017-09-11,20,109,485,594
58253,2017-09-11,21,90,304,394
58254,2017-09-11,22,70,181,251
58255,2017-09-11,23,46,89,135
58256,2017-09-12,0,22,41,63
58257,2017-09-12,1,12,18,30
58258,2017-09-12,2,11,11,22
58259,2017-09-12,3,2,2,4
58260,2017-09-12,4,2,21,23
58261,2017-09-12,5,6,113,119
58262,2017-09-12,6,15,406,421
58263,2017-09-12,7,53,1039,1092
58264,2017-09-12,8,83,1511,1594
58265,2017-09-12,9,82,524,606
58266,2017-09-12,10,131,292,423
58267,2017-09-12,11,161,295,456
58268,2017-09-12,12,189,432,621
58269,2017-09-12,13,186,370,556
58270,2017-09-12,14,203,343,546
58271,2017-09-12,15,206,468,674
58272,2017-09-12,16,216,811,1027
58273,2017-09-12,17,318,1624,1942
58274,2017-09-12,18,313,1378,1691
58275,2017-09-12,19,200,858,1058
58276,2017-09-12,20,128,485,613
58277,2017-09-12,21,89,377,466
58278,2017-09-12,22,80,232,312
58279,2017-09-12,23,33,104,137
58280,2017-09-13,0,12,51,63
58281,2017-09-13,1,4,19,23
58282,2017-09-13,2,2,10,12
58283,2017-09-13,3,2,3,5
58284,2017-09-13,4,1,9,10
58285,2017-09-13,5,4,104,108
58286,2017-09-13,6,10,222,232
58287,2017-09-13,7,27,503,530
58288,2017-09-13,8,48,795,843
58289,2017-09-13,9,63,488,551
58290,2017-09-13,10,98,253,351
58291,2017-09-13,11,133,282,415
58292,2017-09-13,12,173,403,576
58293,2017-09-13,13,152,396,548
58294,2017-09-13,14,160,305,465
58295,2017-09-13,15,154,420,574
58296,2017-09-13,16,180,816,996
58297,2017-09-13,17,264,1517,1781
58298,2017-09-13,18,233,1159,1392
58299,2017-09-13,19,145,787,932
58300,2017-09-13,20,89,550,639
58301,2017-09-13,21,72,368,440
58302,2017-09-13,22,60,234,294
58303,2017-09-13,23,28,110,138
58304,2017-09-14,0,8,50,58
58305,2017-09-14,1,9,13,22
58306,2017-09-14,2,8,11,19
58307,2017-09-14,3,0,6,6
58308,2017-09-14,4,1,14,15
58309,2017-09-14,5,1,92,93
58310,2017-09-14,6,18,350,368
58311,2017-09-14,7,34,916,950
58312,2017-09-14,8,91,1380,1471
58313,2017-09-14,9,70,583,653
58314,2017-09-14,10,112,292,404
58315,2017-09-14,11,132,310,442
58316,2017-09-14,12,164,396,560
58317,2017-09-14,13,175,428,603
58318,2017-09-14,14,177,417,594
58319,2017-09-14,15,212,468,680
58320,2017-09-14,16,221,823,1044
58321,2017-09-14,17,238,1496,1734
58322,2017-09-14,18,190,1151,1341
58323,2017-09-14,19,141,671,812
58324,2017-09-14,20,117,473,590
58325,2017-09-14,21,79,345,424
58326,2017-09-14,22,40,172,212
58327,2017-09-14,23,17,103,120
58328,2017-09-15,0,12,60,72
58329,2017-09-15,1,5,28,33
58330,2017-09-15,2,5,20,25
58331,2017-09-15,3,6,1,7
58332,2017-09-15,4,5,13,18
58333,2017-09-15,5,5,92,97
58334,2017-09-15,6,25,305,330
58335,2017-09-15,7,55,817,872
58336,2017-09-15,8,92,1320,1412
58337,2017-09-15,9,98,541,639
58338,2017-09-15,10,151,275,426
58339,2017-09-15,11,227,338,565
58340,2017-09-15,12,247,533,780
58341,2017-09-15,13,265,455,720
58342,2017-09-15,14,269,479,748
58343,2017-09-15,15,283,610,893
58344,2017-09-15,16,278,947,1225
58345,2017-09-15,17,328,1366,1694
58346,2017-09-15,18,316,1111,1427
58347,2017-09-15,19,259,673,932
58348,2017-09-15,20,159,399,558
58349,2017-09-15,21,121,293,414
58350,2017-09-15,22,111,267,378
58351,2017-09-15,23,97,240,337
58352,2017-09-16,0,76,135,211
58353,2017-09-16,1,39,116,155
58354,2017-09-16,2,16,57,73
58355,2017-09-16,3,7,32,39
58356,2017-09-16,4,4,12,16
58357,2017-09-16,5,13,15,28
58358,2017-09-16,6,24,36,60
58359,2017-09-16,7,30,155,185
58360,2017-09-16,8,94,348,442
58361,2017-09-16,9,226,497,723
58362,2017-09-16,10,371,603,974
58363,2017-09-16,11,474,673,1147
58364,2017-09-16,12,599,765,1364
58365,2017-09-16,13,587,744,1331
58366,2017-09-16,14,607,642,1249
58367,2017-09-16,15,597,612,1209
58368,2017-09-16,16,694,651,1345
58369,2017-09-16,17,613,569,1182
58370,2017-09-16,18,455,600,1055
58371,2017-09-16,19,338,509,847
58372,2017-09-16,20,255,300,555
58373,2017-09-16,21,197,235,432
58374,2017-09-16,22,172,221,393
58375,2017-09-16,23,97,180,277
58376,2017-09-17,0,66,172,238
58377,2017-09-17,1,30,111,141
58378,2017-09-17,2,32,61,93
58379,2017-09-17,3,13,42,55
58380,2017-09-17,4,6,9,15
58381,2017-09-17,5,13,20,33
58382,2017-09-17,6,45,106,151
58383,2017-09-17,7,56,126,182
58384,2017-09-17,8,142,221,363
58385,2017-09-17,9,260,373,633
58386,2017-09-17,10,403,548,951
58387,2017-09-17,11,501,590,1091
58388,2017-09-17,12,478,559,1037
58389,2017-09-17,13,486,630,1116
58390,2017-09-17,14,485,564,1049
58391,2017-09-17,15,460,553,1013
58392,2017-09-17,16,485,621,1106
58393,2017-09-17,17,496,604,1100
58394,2017-09-17,18,330,582,912
58395,2017-09-17,19,266,458,724
58396,2017-09-17,20,140,299,439
58397,2017-09-17,21,107,207,314
58398,2017-09-17,22,87,165,252
58399,2017-09-17,23,43,113,156
58400,2017-09-18,0,30,41,71
58401,2017-09-18,1,19,13,32
58402,2017-09-18,2,3,10,13
58403,2017-09-18,3,1,3,4
58404,2017-09-18,4,2,15,17
58405,2017-09-18,5,5,108,113
58406,2017-09-18,6,15,340,355
58407,2017-09-18,7,44,854,898
58408,2017-09-18,8,71,1048,1119
58409,2017-09-18,9,77,470,547
58410,2017-09-18,10,164,229,393
58411,2017-09-18,11,177,284,461
58412,2017-09-18,12,219,378,597
58413,2017-09-18,13,225,365,590
58414,2017-09-18,14,215,336,551
58415,2017-09-18,15,198,421,619
58416,2017-09-18,16,215,779,994
58417,2017-09-18,17,284,1549,1833
58418,2017-09-18,18,198,1248,1446
58419,2017-09-18,19,178,793,971
58420,2017-09-18,20,136,481,617
58421,2017-09-18,21,72,327,399
58422,2017-09-18,22,49,199,248
58423,2017-09-18,23,35,111,146
58424,2017-09-19,0,7,33,40
58425,2017-09-19,1,5,4,9
58426,2017-09-19,2,3,14,17
58427,2017-09-19,3,0,6,6
58428,2017-09-19,4,6,17,23
58429,2017-09-19,5,6,111,117
58430,2017-09-19,6,22,400,422
58431,2017-09-19,7,44,1101,1145
58432,2017-09-19,8,84,1333,1417
58433,2017-09-19,9,78,511,589
58434,2017-09-19,10,110,253,363
58435,2017-09-19,11,132,323,455
58436,2017-09-19,12,161,449,610
58437,2017-09-19,13,153,399,552
58438,2017-09-19,14,180,362,542
58439,2017-09-19,15,194,535,729
58440,2017-09-19,16,218,847,1065
58441,2017-09-19,17,322,1639,1961
58442,2017-09-19,18,248,1295,1543
58443,2017-09-19,19,197,786,983
58444,2017-09-19,20,89,493,582
58445,2017-09-19,21,79,396,475
58446,2017-09-19,22,55,210,265
58447,2017-09-19,23,34,99,133
58448,2017-09-20,0,15,51,66
58449,2017-09-20,1,6,25,31
58450,2017-09-20,2,3,15,18
58451,2017-09-20,3,6,2,8
58452,2017-09-20,4,2,9,11
58453,2017-09-20,5,6,110,116
58454,2017-09-20,6,12,419,431
58455,2017-09-20,7,45,1065,1110
58456,2017-09-20,8,105,1291,1396
58457,2017-09-20,9,97,510,607
58458,2017-09-20,10,118,257,375
58459,2017-09-20,11,147,321,468
58460,2017-09-20,12,140,467,607
58461,2017-09-20,13,162,420,582
58462,2017-09-20,14,157,371,528
58463,2017-09-20,15,179,488,667
58464,2017-09-20,16,188,816,1004
58465,2017-09-20,17,265,1524,1789
58466,2017-09-20,18,237,1229,1466
58467,2017-09-20,19,156,802,958
58468,2017-09-20,20,115,461,576
58469,2017-09-20,21,77,316,393
58470,2017-09-20,22,69,257,326
58471,2017-09-20,23,47,138,185
58472,2017-09-21,0,21,47,68
58473,2017-09-21,1,11,17,28
58474,2017-09-21,2,1,11,12
58475,2017-09-21,3,3,6,9
58476,2017-09-21,4,1,18,19
58477,2017-09-21,5,7,102,109
58478,2017-09-21,6,15,374,389
58479,2017-09-21,7,43,977,1020
58480,2017-09-21,8,60,1305,1365
58481,2017-09-21,9,78,507,585
58482,2017-09-21,10,98,258,356
58483,2017-09-21,11,140,322,462
58484,2017-09-21,12,155,396,551
58485,2017-09-21,13,144,390,534
58486,2017-09-21,14,156,353,509
58487,2017-09-21,15,173,510,683
58488,2017-09-21,16,199,786,985
58489,2017-09-21,17,321,1468,1789
58490,2017-09-21,18,251,1253,1504
58491,2017-09-21,19,187,690,877
58492,2017-09-21,20,100,539,639
58493,2017-09-21,21,77,384,461
58494,2017-09-21,22,60,261,321
58495,2017-09-21,23,35,169,204
58496,2017-09-22,0,35,80,115
58497,2017-09-22,1,25,45,70
58498,2017-09-22,2,7,18,25
58499,2017-09-22,3,6,17,23
58500,2017-09-22,4,3,13,16
58501,2017-09-22,5,7,86,93
58502,2017-09-22,6,13,315,328
58503,2017-09-22,7,53,830,883
58504,2017-09-22,8,81,1143,1224
58505,2017-09-22,9,85,516,601
58506,2017-09-22,10,195,282,477
58507,2017-09-22,11,221,397,618
58508,2017-09-22,12,265,523,788
58509,2017-09-22,13,243,517,760
58510,2017-09-22,14,258,450,708
58511,2017-09-22,15,282,553,835
58512,2017-09-22,16,297,890,1187
58513,2017-09-22,17,286,1286,1572
58514,2017-09-22,18,258,989,1247
58515,2017-09-22,19,186,648,834
58516,2017-09-22,20,129,389,518
58517,2017-09-22,21,134,304,438
58518,2017-09-22,22,128,247,375
58519,2017-09-22,23,102,199,301
58520,2017-09-23,0,52,124,176
58521,2017-09-23,1,45,84,129
58522,2017-09-23,2,23,65,88
58523,2017-09-23,3,11,35,46
58524,2017-09-23,4,5,14,19
58525,2017-09-23,5,5,27,32
58526,2017-09-23,6,16,64,80
58527,2017-09-23,7,31,142,173
58528,2017-09-23,8,102,298,400
58529,2017-09-23,9,229,453,682
58530,2017-09-23,10,333,552,885
58531,2017-09-23,11,418,587,1005
58532,2017-09-23,12,507,632,1139
58533,2017-09-23,13,462,616,1078
58534,2017-09-23,14,514,552,1066
58535,2017-09-23,15,462,615,1077
58536,2017-09-23,16,460,569,1029
58537,2017-09-23,17,449,574,1023
58538,2017-09-23,18,416,549,965
58539,2017-09-23,19,350,472,822
58540,2017-09-23,20,169,310,479
58541,2017-09-23,21,161,267,428
58542,2017-09-23,22,103,281,384
58543,2017-09-23,23,72,200,272
58544,2017-09-24,0,81,188,269
58545,2017-09-24,1,79,97,176
58546,2017-09-24,2,42,80,122
58547,2017-09-24,3,21,39,60
58548,2017-09-24,4,7,15,22
58549,2017-09-24,5,4,9,13
58550,2017-09-24,6,9,44,53
58551,2017-09-24,7,30,95,125
58552,2017-09-24,8,89,212,301
58553,2017-09-24,9,209,382,591
58554,2017-09-24,10,345,485,830
58555,2017-09-24,11,420,491,911
58556,2017-09-24,12,480,652,1132
58557,2017-09-24,13,432,537,969
58558,2017-09-24,14,453,552,1005
58559,2017-09-24,15,409,500,909
58560,2017-09-24,16,455,583,1038
58561,2017-09-24,17,381,517,898
58562,2017-09-24,18,336,497,833
58563,2017-09-24,19,243,422,665
58564,2017-09-24,20,150,272,422
58565,2017-09-24,21,103,229,332
58566,2017-09-24,22,51,133,184
58567,2017-09-24,23,33,77,110
58568,2017-09-25,0,25,44,69
58569,2017-09-25,1,16,26,42
58570,2017-09-25,2,16,12,28
58571,2017-09-25,3,4,4,8
58572,2017-09-25,4,3,18,21
58573,2017-09-25,5,2,92,94
58574,2017-09-25,6,12,378,390
58575,2017-09-25,7,51,847,898
58576,2017-09-25,8,73,1042,1115
58577,2017-09-25,9,62,438,500
58578,2017-09-25,10,130,226,356
58579,2017-09-25,11,169,279,448
58580,2017-09-25,12,184,365,549
58581,2017-09-25,13,148,360,508
58582,2017-09-25,14,179,345,524
58583,2017-09-25,15,217,442,659
58584,2017-09-25,16,214,765,979
58585,2017-09-25,17,226,1440,1666
58586,2017-09-25,18,209,1269,1478
58587,2017-09-25,19,136,765,901
58588,2017-09-25,20,95,474,569
58589,2017-09-25,21,89,322,411
58590,2017-09-25,22,78,169,247
58591,2017-09-25,23,50,140,190
58592,2017-09-26,0,16,46,62
58593,2017-09-26,1,8,13,21
58594,2017-09-26,2,4,7,11
58595,2017-09-26,3,2,1,3
58596,2017-09-26,4,6,25,31
58597,2017-09-26,5,8,114,122
58598,2017-09-26,6,14,414,428
58599,2017-09-26,7,51,1056,1107
58600,2017-09-26,8,84,1376,1460
58601,2017-09-26,9,73,514,587
58602,2017-09-26,10,105,235,340
58603,2017-09-26,11,112,316,428
58604,2017-09-26,12,126,416,542
58605,2017-09-26,13,133,404,537
58606,2017-09-26,14,140,380,520
58607,2017-09-26,15,135,471,606
58608,2017-09-26,16,178,781,959
58609,2017-09-26,17,233,1560,1793
58610,2017-09-26,18,195,1281,1476
58611,2017-09-26,19,130,775,905
58612,2017-09-26,20,91,543,634
58613,2017-09-26,21,109,352,461
58614,2017-09-26,22,62,215,277
58615,2017-09-26,23,24,120,144
58616,2017-09-27,0,8,68,76
58617,2017-09-27,1,17,12,29
58618,2017-09-27,2,5,13,18
58619,2017-09-27,3,1,4,5
58620,2017-09-27,4,1,16,17
58621,2017-09-27,5,0,132,132
58622,2017-09-27,6,17,443,460
58623,2017-09-27,7,50,1061,1111
58624,2017-09-27,8,81,1329,1410
58625,2017-09-27,9,73,494,567
58626,2017-09-27,10,76,258,334
58627,2017-09-27,11,121,307,428
58628,2017-09-27,12,125,425,550
58629,2017-09-27,13,131,404,535
58630,2017-09-27,14,160,330,490
58631,2017-09-27,15,142,461,603
58632,2017-09-27,16,148,730,878
58633,2017-09-27,17,208,1424,1632
58634,2017-09-27,18,183,1249,1432
58635,2017-09-27,19,162,772,934
58636,2017-09-27,20,114,520,634
58637,2017-09-27,21,118,389,507
58638,2017-09-27,22,72,236,308
58639,2017-09-27,23,50,140,190
58640,2017-09-28,0,12,50,62
58641,2017-09-28,1,13,25,38
58642,2017-09-28,2,3,16,19
58643,2017-09-28,3,2,2,4
58644,2017-09-28,4,1,14,15
58645,2017-09-28,5,4,96,100
58646,2017-09-28,6,18,385,403
58647,2017-09-28,7,40,1006,1046
58648,2017-09-28,8,103,1280,1383
58649,2017-09-28,9,72,600,672
58650,2017-09-28,10,110,300,410
58651,2017-09-28,11,129,345,474
58652,2017-09-28,12,124,453,577
58653,2017-09-28,13,170,437,607
58654,2017-09-28,14,196,388,584
58655,2017-09-28,15,227,491,718
58656,2017-09-28,16,226,855,1081
58657,2017-09-28,17,266,1519,1785
58658,2017-09-28,18,258,1328,1586
58659,2017-09-28,19,167,851,1018
58660,2017-09-28,20,124,512,636
58661,2017-09-28,21,111,426,537
58662,2017-09-28,22,96,305,401
58663,2017-09-28,23,54,163,217
58664,2017-09-29,0,22,86,108
58665,2017-09-29,1,21,25,46
58666,2017-09-29,2,6,25,31
58667,2017-09-29,3,7,7,14
58668,2017-09-29,4,1,22,23
58669,2017-09-29,5,3,97,100
58670,2017-09-29,6,13,343,356
58671,2017-09-29,7,39,885,924
58672,2017-09-29,8,88,1292,1380
58673,2017-09-29,9,119,620,739
58674,2017-09-29,10,167,311,478
58675,2017-09-29,11,248,374,622
58676,2017-09-29,12,229,495,724
58677,2017-09-29,13,267,547,814
58678,2017-09-29,14,273,481,754
58679,2017-09-29,15,333,631,964
58680,2017-09-29,16,310,903,1213
58681,2017-09-29,17,322,1379,1701
58682,2017-09-29,18,261,1005,1266
58683,2017-09-29,19,162,585,747
58684,2017-09-29,20,167,319,486
58685,2017-09-29,21,122,295,417
58686,2017-09-29,22,94,261,355
58687,2017-09-29,23,72,196,268
58688,2017-09-30,0,55,129,184
58689,2017-09-30,1,42,96,138
58690,2017-09-30,2,29,63,92
58691,2017-09-30,3,10,28,38
58692,2017-09-30,4,11,5,16
58693,2017-09-30,5,1,16,17
58694,2017-09-30,6,11,47,58
58695,2017-09-30,7,38,141,179
58696,2017-09-30,8,88,305,393
58697,2017-09-30,9,185,450,635
58698,2017-09-30,10,327,619,946
58699,2017-09-30,11,422,630,1052
58700,2017-09-30,12,511,641,1152
58701,2017-09-30,13,491,654,1145
58702,2017-09-30,14,491,639,1130
58703,2017-09-30,15,559,602,1161
58704,2017-09-30,16,511,574,1085
58705,2017-09-30,17,429,560,989
58706,2017-09-30,18,297,528,825
58707,2017-09-30,19,215,368,583
58708,2017-09-30,20,129,249,378
58709,2017-09-30,21,100,208,308
58710,2017-09-30,22,99,187,286
58711,2017-09-30,23,79,148,227
58712,2017-10-01,0,56,116,172
58713,2017-10-01,1,45,93,138
58714,2017-10-01,2,22,48,70
58715,2017-10-01,3,11,44,55
58716,2017-10-01,4,7,10,17
58717,2017-10-01,5,5,23,28
58718,2017-10-01,6,7,29,36
58719,2017-10-01,7,10,87,97
58720,2017-10-01,8,65,205,270
58721,2017-10-01,9,167,358,525
58722,2017-10-01,10,254,482,736
58723,2017-10-01,11,372,538,910
58724,2017-10-01,12,462,629,1091
58725,2017-10-01,13,450,602,1052
58726,2017-10-01,14,496,610,1106
58727,2017-10-01,15,470,613,1083
58728,2017-10-01,16,451,675,1126
58729,2017-10-01,17,418,582,1000
58730,2017-10-01,18,327,634,961
58731,2017-10-01,19,159,446,605
58732,2017-10-01,20,117,268,385
58733,2017-10-01,21,93,173,266
58734,2017-10-01,22,49,116,165
58735,2017-10-01,23,30,74,104
58736,2017-10-02,0,26,36,62
58737,2017-10-02,1,7,10,17
58738,2017-10-02,2,1,10,11
58739,2017-10-02,3,3,4,7
58740,2017-10-02,4,2,16,18
58741,2017-10-02,5,2,101,103
58742,2017-10-02,6,10,355,365
58743,2017-10-02,7,38,857,895
58744,2017-10-02,8,80,1186,1266
58745,2017-10-02,9,86,498,584
58746,2017-10-02,10,128,224,352
58747,2017-10-02,11,148,307,455
58748,2017-10-02,12,132,394,526
58749,2017-10-02,13,180,439,619
58750,2017-10-02,14,186,353,539
58751,2017-10-02,15,160,494,654
58752,2017-10-02,16,235,847,1082
58753,2017-10-02,17,239,1571,1810
58754,2017-10-02,18,162,1192,1354
58755,2017-10-02,19,115,728,843
58756,2017-10-02,20,68,434,502
58757,2017-10-02,21,38,285,323
58758,2017-10-02,22,33,167,200
58759,2017-10-02,23,16,96,112
58760,2017-10-03,0,16,41,57
58761,2017-10-03,1,2,11,13
58762,2017-10-03,2,1,8,9
58763,2017-10-03,3,1,5,6
58764,2017-10-03,4,2,18,20
58765,2017-10-03,5,5,113,118
58766,2017-10-03,6,6,399,405
58767,2017-10-03,7,46,1040,1086
58768,2017-10-03,8,80,1394,1474
58769,2017-10-03,9,84,588,672
58770,2017-10-03,10,82,252,334
58771,2017-10-03,11,114,331,445
58772,2017-10-03,12,153,465,618
58773,2017-10-03,13,165,445,610
58774,2017-10-03,14,134,360,494
58775,2017-10-03,15,188,494,682
58776,2017-10-03,16,193,855,1048
58777,2017-10-03,17,278,1532,1810
58778,2017-10-03,18,198,1242,1440
58779,2017-10-03,19,121,735,856
58780,2017-10-03,20,103,422,525
58781,2017-10-03,21,53,322,375
58782,2017-10-03,22,51,204,255
58783,2017-10-03,23,11,121,132
58784,2017-10-04,0,6,34,40
58785,2017-10-04,1,11,26,37
58786,2017-10-04,2,4,11,15
58787,2017-10-04,3,1,2,3
58788,2017-10-04,4,5,11,16
58789,2017-10-04,5,8,128,136
58790,2017-10-04,6,15,415,430
58791,2017-10-04,7,44,987,1031
58792,2017-10-04,8,76,1352,1428
58793,2017-10-04,9,90,556,646
58794,2017-10-04,10,112,292,404
58795,2017-10-04,11,131,343,474
58796,2017-10-04,12,152,471,623
58797,2017-10-04,13,144,408,552
58798,2017-10-04,14,152,353,505
58799,2017-10-04,15,168,496,664
58800,2017-10-04,16,185,872,1057
58801,2017-10-04,17,246,1547,1793
58802,2017-10-04,18,202,1305,1507
58803,2017-10-04,19,118,796,914
58804,2017-10-04,20,80,491,571
58805,2017-10-04,21,63,409,472
58806,2017-10-04,22,47,235,282
58807,2017-10-04,23,27,117,144
58808,2017-10-05,0,11,46,57
58809,2017-10-05,1,9,22,31
58810,2017-10-05,2,8,22,30
58811,2017-10-05,3,3,10,13
58812,2017-10-05,4,4,10,14
58813,2017-10-05,5,5,104,109
58814,2017-10-05,6,16,393,409
58815,2017-10-05,7,44,989,1033
58816,2017-10-05,8,101,1349,1450
58817,2017-10-05,9,100,544,644
58818,2017-10-05,10,97,266,363
58819,2017-10-05,11,134,373,507
58820,2017-10-05,12,113,492,605
58821,2017-10-05,13,143,465,608
58822,2017-10-05,14,181,392,573
58823,2017-10-05,15,188,494,682
58824,2017-10-05,16,230,829,1059
58825,2017-10-05,17,268,1499,1767
58826,2017-10-05,18,238,1257,1495
58827,2017-10-05,19,157,769,926
58828,2017-10-05,20,83,441,524
58829,2017-10-05,21,83,363,446
58830,2017-10-05,22,68,276,344
58831,2017-10-05,23,46,156,202
58832,2017-10-06,0,31,75,106
58833,2017-10-06,1,21,42,63
58834,2017-10-06,2,13,26,39
58835,2017-10-06,3,3,8,11
58836,2017-10-06,4,3,15,18
58837,2017-10-06,5,6,95,101
58838,2017-10-06,6,22,331,353
58839,2017-10-06,7,47,820,867
58840,2017-10-06,8,92,1195,1287
58841,2017-10-06,9,131,542,673
58842,2017-10-06,10,188,355,543
58843,2017-10-06,11,212,367,579
58844,2017-10-06,12,218,543,761
58845,2017-10-06,13,298,535,833
58846,2017-10-06,14,304,479,783
58847,2017-10-06,15,345,593,938
58848,2017-10-06,16,345,953,1298
58849,2017-10-06,17,414,1332,1746
58850,2017-10-06,18,337,1007,1344
58851,2017-10-06,19,192,608,800
58852,2017-10-06,20,156,365,521
58853,2017-10-06,21,139,300,439
58854,2017-10-06,22,152,348,500
58855,2017-10-06,23,125,252,377
58856,2017-10-07,0,91,150,241
58857,2017-10-07,1,71,87,158
58858,2017-10-07,2,27,64,91
58859,2017-10-07,3,20,34,54
58860,2017-10-07,4,9,12,21
58861,2017-10-07,5,6,23,29
58862,2017-10-07,6,12,54,66
58863,2017-10-07,7,28,142,170
58864,2017-10-07,8,91,293,384
58865,2017-10-07,9,231,442,673
58866,2017-10-07,10,406,521,927
58867,2017-10-07,11,568,617,1185
58868,2017-10-07,12,637,627,1264
58869,2017-10-07,13,653,671,1324
58870,2017-10-07,14,728,639,1367
58871,2017-10-07,15,775,658,1433
58872,2017-10-07,16,715,644,1359
58873,2017-10-07,17,586,647,1233
58874,2017-10-07,18,490,525,1015
58875,2017-10-07,19,315,356,671
58876,2017-10-07,20,227,314,541
58877,2017-10-07,21,231,315,546
58878,2017-10-07,22,207,206,413
58879,2017-10-07,23,134,173,307
58880,2017-10-08,0,82,108,190
58881,2017-10-08,1,73,95,168
58882,2017-10-08,2,38,62,100
58883,2017-10-08,3,39,40,79
58884,2017-10-08,4,7,15,22
58885,2017-10-08,5,7,10,17
58886,2017-10-08,6,25,61,86
58887,2017-10-08,7,50,86,136
58888,2017-10-08,8,61,158,219
58889,2017-10-08,9,138,221,359
58890,2017-10-08,10,167,317,484
58891,2017-10-08,11,289,389,678
58892,2017-10-08,12,381,488,869
58893,2017-10-08,13,422,476,898
58894,2017-10-08,14,478,492,970
58895,2017-10-08,15,447,509,956
58896,2017-10-08,16,421,427,848
58897,2017-10-08,17,413,447,860
58898,2017-10-08,18,336,424,760
58899,2017-10-08,19,187,339,526
58900,2017-10-08,20,159,251,410
58901,2017-10-08,21,137,231,368
58902,2017-10-08,22,90,154,244
58903,2017-10-08,23,51,102,153
58904,2017-10-09,0,27,64,91
58905,2017-10-09,1,31,45,76
58906,2017-10-09,2,11,23,34
58907,2017-10-09,3,4,13,17
58908,2017-10-09,4,7,12,19
58909,2017-10-09,5,3,30,33
58910,2017-10-09,6,3,33,36
58911,2017-10-09,7,1,44,45
58912,2017-10-09,8,10,144,154
58913,2017-10-09,9,27,132,159
58914,2017-10-09,10,47,173,220
58915,2017-10-09,11,141,308,449
58916,2017-10-09,12,191,374,565
58917,2017-10-09,13,241,407,648
58918,2017-10-09,14,222,419,641
58919,2017-10-09,15,336,473,809
58920,2017-10-09,16,251,636,887
58921,2017-10-09,17,326,860,1186
58922,2017-10-09,18,235,839,1074
58923,2017-10-09,19,158,533,691
58924,2017-10-09,20,102,373,475
58925,2017-10-09,21,90,256,346
58926,2017-10-09,22,69,147,216
58927,2017-10-09,23,37,121,158
58928,2017-10-10,0,22,36,58
58929,2017-10-10,1,11,15,26
58930,2017-10-10,2,6,8,14
58931,2017-10-10,3,1,4,5
58932,2017-10-10,4,6,18,24
58933,2017-10-10,5,2,110,112
58934,2017-10-10,6,17,397,414
58935,2017-10-10,7,65,917,982
58936,2017-10-10,8,87,1262,1349
58937,2017-10-10,9,92,512,604
58938,2017-10-10,10,117,247,364
58939,2017-10-10,11,150,275,425
58940,2017-10-10,12,186,334,520
58941,2017-10-10,13,213,375,588
58942,2017-10-10,14,222,336,558
58943,2017-10-10,15,175,445,620
58944,2017-10-10,16,291,734,1025
58945,2017-10-10,17,327,1515,1842
58946,2017-10-10,18,250,1165,1415
58947,2017-10-10,19,149,701,850
58948,2017-10-10,20,110,407,517
58949,2017-10-10,21,88,328,416
58950,2017-10-10,22,50,237,287
58951,2017-10-10,23,39,97,136
58952,2017-10-11,0,12,53,65
58953,2017-10-11,1,3,13,16
58954,2017-10-11,2,7,15,22
58955,2017-10-11,3,2,9,11
58956,2017-10-11,4,3,8,11
58957,2017-10-11,5,4,131,135
58958,2017-10-11,6,11,378,389
58959,2017-10-11,7,33,887,920
58960,2017-10-11,8,67,1217,1284
58961,2017-10-11,9,67,523,590
58962,2017-10-11,10,69,269,338
58963,2017-10-11,11,142,315,457
58964,2017-10-11,12,96,419,515
58965,2017-10-11,13,143,384,527
58966,2017-10-11,14,122,306,428
58967,2017-10-11,15,150,469,619
58968,2017-10-11,16,122,764,886
58969,2017-10-11,17,133,961,1094
58970,2017-10-11,18,72,688,760
58971,2017-10-11,19,39,398,437
58972,2017-10-11,20,27,304,331
58973,2017-10-11,21,23,233,256
58974,2017-10-11,22,27,143,170
58975,2017-10-11,23,16,97,113
58976,2017-10-12,0,4,22,26
58977,2017-10-12,1,1,14,15
58978,2017-10-12,2,0,13,13
58979,2017-10-12,3,1,7,8
58980,2017-10-12,4,3,14,17
58981,2017-10-12,5,3,90,93
58982,2017-10-12,6,12,347,359
58983,2017-10-12,7,38,879,917
58984,2017-10-12,8,59,1211,1270
58985,2017-10-12,9,65,560,625
58986,2017-10-12,10,111,276,387
58987,2017-10-12,11,100,259,359
58988,2017-10-12,12,128,323,451
58989,2017-10-12,13,104,345,449
58990,2017-10-12,14,172,320,492
58991,2017-10-12,15,162,467,629
58992,2017-10-12,16,160,736,896
58993,2017-10-12,17,211,1270,1481
58994,2017-10-12,18,126,1028,1154
58995,2017-10-12,19,125,709,834
58996,2017-10-12,20,69,427,496
58997,2017-10-12,21,50,291,341
58998,2017-10-12,22,52,203,255
58999,2017-10-12,23,31,131,162
59000,2017-10-13,0,24,163,187
59001,2017-10-13,1,92,231,323
59002,2017-10-13,2,22,47,69
59003,2017-10-13,3,12,7,19
59004,2017-10-13,4,0,14,14
59005,2017-10-13,5,4,83,87
59006,2017-10-13,6,23,281,304
59007,2017-10-13,7,47,755,802
59008,2017-10-13,8,80,1268,1348
59009,2017-10-13,9,92,547,639
59010,2017-10-13,10,138,329,467
59011,2017-10-13,11,151,365,516
59012,2017-10-13,12,185,429,614
59013,2017-10-13,13,186,474,660
59014,2017-10-13,14,229,418,647
59015,2017-10-13,15,279,512,791
59016,2017-10-13,16,272,849,1121
59017,2017-10-13,17,234,1111,1345
59018,2017-10-13,18,124,651,775
59019,2017-10-13,19,112,366,478
59020,2017-10-13,20,59,283,342
59021,2017-10-13,21,74,232,306
59022,2017-10-13,22,92,200,292
59023,2017-10-13,23,65,157,222
59024,2017-10-14,0,50,130,180
59025,2017-10-14,1,44,89,133
59026,2017-10-14,2,51,76,127
59027,2017-10-14,3,27,26,53
59028,2017-10-14,4,15,16,31
59029,2017-10-14,5,1,16,17
59030,2017-10-14,6,8,63,71
59031,2017-10-14,7,28,149,177
59032,2017-10-14,8,75,319,394
59033,2017-10-14,9,165,429,594
59034,2017-10-14,10,273,517,790
59035,2017-10-14,11,372,586,958
59036,2017-10-14,12,416,639,1055
59037,2017-10-14,13,518,634,1152
59038,2017-10-14,14,581,664,1245
59039,2017-10-14,15,596,614,1210
59040,2017-10-14,16,595,613,1208
59041,2017-10-14,17,557,642,1199
59042,2017-10-14,18,438,561,999
59043,2017-10-14,19,236,389,625
59044,2017-10-14,20,200,338,538
59045,2017-10-14,21,130,277,407
59046,2017-10-14,22,109,234,343
59047,2017-10-14,23,85,220,305
59048,2017-10-15,0,65,166,231
59049,2017-10-15,1,54,109,163
59050,2017-10-15,2,28,67,95
59051,2017-10-15,3,13,40,53
59052,2017-10-15,4,12,15,27
59053,2017-10-15,5,4,13,17
59054,2017-10-15,6,5,33,38
59055,2017-10-15,7,19,92,111
59056,2017-10-15,8,80,187,267
59057,2017-10-15,9,131,288,419
59058,2017-10-15,10,261,434,695
59059,2017-10-15,11,344,520,864
59060,2017-10-15,12,385,618,1003
59061,2017-10-15,13,453,609,1062
59062,2017-10-15,14,451,619,1070
59063,2017-10-15,15,514,568,1082
59064,2017-10-15,16,512,665,1177
59065,2017-10-15,17,476,691,1167
59066,2017-10-15,18,380,614,994
59067,2017-10-15,19,263,419,682
59068,2017-10-15,20,154,291,445
59069,2017-10-15,21,96,220,316
59070,2017-10-15,22,77,141,218
59071,2017-10-15,23,35,92,127
59072,2017-10-16,0,21,30,51
59073,2017-10-16,1,3,11,14
59074,2017-10-16,2,11,14,25
59075,2017-10-16,3,5,4,9
59076,2017-10-16,4,2,7,9
59077,2017-10-16,5,0,66,66
59078,2017-10-16,6,8,229,237
59079,2017-10-16,7,21,684,705
59080,2017-10-16,8,61,1135,1196
59081,2017-10-16,9,85,514,599
59082,2017-10-16,10,112,260,372
59083,2017-10-16,11,129,277,406
59084,2017-10-16,12,163,413,576
59085,2017-10-16,13,186,422,608
59086,2017-10-16,14,180,327,507
59087,2017-10-16,15,172,454,626
59088,2017-10-16,16,174,830,1004
59089,2017-10-16,17,205,1467,1672
59090,2017-10-16,18,152,1083,1235
59091,2017-10-16,19,94,650,744
59092,2017-10-16,20,75,386,461
59093,2017-10-16,21,57,269,326
59094,2017-10-16,22,47,187,234
59095,2017-10-16,23,22,99,121
59096,2017-10-17,0,5,40,45
59097,2017-10-17,1,7,15,22
59098,2017-10-17,2,1,8,9
59099,2017-10-17,3,2,2,4
59100,2017-10-17,4,3,10,13
59101,2017-10-17,5,1,106,107
59102,2017-10-17,6,10,369,379
59103,2017-10-17,7,30,897,927
59104,2017-10-17,8,68,1329,1397
59105,2017-10-17,9,54,514,568
59106,2017-10-17,10,86,269,355
59107,2017-10-17,11,87,265,352
59108,2017-10-17,12,114,435,549
59109,2017-10-17,13,131,378,509
59110,2017-10-17,14,173,364,537
59111,2017-10-17,15,149,475,624
59112,2017-10-17,16,173,827,1000
59113,2017-10-17,17,169,1523,1692
59114,2017-10-17,18,132,1161,1293
59115,2017-10-17,19,67,652,719
59116,2017-10-17,20,72,384,456
59117,2017-10-17,21,32,296,328
59118,2017-10-17,22,35,198,233
59119,2017-10-17,23,44,124,168
59120,2017-10-18,0,14,46,60
59121,2017-10-18,1,3,12,15
59122,2017-10-18,2,4,13,17
59123,2017-10-18,3,1,4,5
59124,2017-10-18,4,1,14,15
59125,2017-10-18,5,4,118,122
59126,2017-10-18,6,10,362,372
59127,2017-10-18,7,33,885,918
59128,2017-10-18,8,54,1322,1376
59129,2017-10-18,9,69,597,666
59130,2017-10-18,10,87,277,364
59131,2017-10-18,11,116,303,419
59132,2017-10-18,12,122,410,532
59133,2017-10-18,13,190,408,598
59134,2017-10-18,14,166,373,539
59135,2017-10-18,15,185,499,684
59136,2017-10-18,16,180,849,1029
59137,2017-10-18,17,219,1482,1701
59138,2017-10-18,18,182,1151,1333
59139,2017-10-18,19,142,656,798
59140,2017-10-18,20,77,428,505
59141,2017-10-18,21,74,364,438
59142,2017-10-18,22,60,252,312
59143,2017-10-18,23,29,156,185
59144,2017-10-19,0,15,45,60
59145,2017-10-19,1,8,29,37
59146,2017-10-19,2,9,14,23
59147,2017-10-19,3,0,6,6
59148,2017-10-19,4,3,14,17
59149,2017-10-19,5,1,93,94
59150,2017-10-19,6,16,360,376
59151,2017-10-19,7,21,862,883
59152,2017-10-19,8,54,1268,1322
59153,2017-10-19,9,77,571,648
59154,2017-10-19,10,125,287,412
59155,2017-10-19,11,153,304,457
59156,2017-10-19,12,166,429,595
59157,2017-10-19,13,206,401,607
59158,2017-10-19,14,181,391,572
59159,2017-10-19,15,253,503,756
59160,2017-10-19,16,245,804,1049
59161,2017-10-19,17,298,1498,1796
59162,2017-10-19,18,193,1188,1381
59163,2017-10-19,19,105,671,776
59164,2017-10-19,20,63,481,544
59165,2017-10-19,21,65,324,389
59166,2017-10-19,22,63,261,324
59167,2017-10-19,23,44,143,187
59168,2017-10-20,0,28,75,103
59169,2017-10-20,1,15,29,44
59170,2017-10-20,2,18,18,36
59171,2017-10-20,3,5,10,15
59172,2017-10-20,4,4,16,20
59173,2017-10-20,5,3,79,82
59174,2017-10-20,6,13,330,343
59175,2017-10-20,7,36,785,821
59176,2017-10-20,8,77,1263,1340
59177,2017-10-20,9,145,602,747
59178,2017-10-20,10,164,340,504
59179,2017-10-20,11,238,416,654
59180,2017-10-20,12,227,585,812
59181,2017-10-20,13,250,530,780
59182,2017-10-20,14,296,445,741
59183,2017-10-20,15,331,588,919
59184,2017-10-20,16,323,912,1235
59185,2017-10-20,17,374,1315,1689
59186,2017-10-20,18,231,969,1200
59187,2017-10-20,19,144,572,716
59188,2017-10-20,20,147,364,511
59189,2017-10-20,21,98,257,355
59190,2017-10-20,22,88,223,311
59191,2017-10-20,23,86,181,267
59192,2017-10-21,0,44,104,148
59193,2017-10-21,1,18,68,86
59194,2017-10-21,2,15,45,60
59195,2017-10-21,3,13,36,49
59196,2017-10-21,4,8,14,22
59197,2017-10-21,5,1,17,18
59198,2017-10-21,6,7,51,58
59199,2017-10-21,7,38,135,173
59200,2017-10-21,8,58,280,338
59201,2017-10-21,9,193,441,634
59202,2017-10-21,10,314,571,885
59203,2017-10-21,11,521,643,1164
59204,2017-10-21,12,607,680,1287
59205,2017-10-21,13,657,713,1370
59206,2017-10-21,14,682,645,1327
59207,2017-10-21,15,667,669,1336
59208,2017-10-21,16,719,670,1389
59209,2017-10-21,17,562,665,1227
59210,2017-10-21,18,388,556,944
59211,2017-10-21,19,213,440,653
59212,2017-10-21,20,140,269,409
59213,2017-10-21,21,109,227,336
59214,2017-10-21,22,113,193,306
59215,2017-10-21,23,68,173,241
59216,2017-10-22,0,70,140,210
59217,2017-10-22,1,41,87,128
59218,2017-10-22,2,27,71,98
59219,2017-10-22,3,13,45,58
59220,2017-10-22,4,6,18,24
59221,2017-10-22,5,10,18,28
59222,2017-10-22,6,32,68,100
59223,2017-10-22,7,43,113,156
59224,2017-10-22,8,174,270,444
59225,2017-10-22,9,307,417,724
59226,2017-10-22,10,409,607,1016
59227,2017-10-22,11,471,632,1103
59228,2017-10-22,12,532,705,1237
59229,2017-10-22,13,570,650,1220
59230,2017-10-22,14,585,626,1211
59231,2017-10-22,15,571,618,1189
59232,2017-10-22,16,522,634,1156
59233,2017-10-22,17,482,566,1048
59234,2017-10-22,18,300,526,826
59235,2017-10-22,19,147,372,519
59236,2017-10-22,20,96,258,354
59237,2017-10-22,21,91,179,270
59238,2017-10-22,22,42,121,163
59239,2017-10-22,23,27,70,97
59240,2017-10-23,0,16,32,48
59241,2017-10-23,1,11,12,23
59242,2017-10-23,2,2,10,12
59243,2017-10-23,3,5,10,15
59244,2017-10-23,4,4,13,17
59245,2017-10-23,5,2,97,99
59246,2017-10-23,6,10,312,322
59247,2017-10-23,7,35,779,814
59248,2017-10-23,8,75,1062,1137
59249,2017-10-23,9,115,520,635
59250,2017-10-23,10,176,232,408
59251,2017-10-23,11,215,282,497
59252,2017-10-23,12,231,382,613
59253,2017-10-23,13,227,367,594
59254,2017-10-23,14,256,330,586
59255,2017-10-23,15,252,479,731
59256,2017-10-23,16,223,850,1073
59257,2017-10-23,17,250,1427,1677
59258,2017-10-23,18,206,1179,1385
59259,2017-10-23,19,113,665,778
59260,2017-10-23,20,67,418,485
59261,2017-10-23,21,78,264,342
59262,2017-10-23,22,35,165,200
59263,2017-10-23,23,13,96,109
59264,2017-10-24,0,5,33,38
59265,2017-10-24,1,7,13,20
59266,2017-10-24,2,3,8,11
59267,2017-10-24,3,0,2,2
59268,2017-10-24,4,2,14,16
59269,2017-10-24,5,3,97,100
59270,2017-10-24,6,18,354,372
59271,2017-10-24,7,30,915,945
59272,2017-10-24,8,80,1346,1426
59273,2017-10-24,9,104,578,682
59274,2017-10-24,10,98,264,362
59275,2017-10-24,11,133,339,472
59276,2017-10-24,12,169,444,613
59277,2017-10-24,13,163,400,563
59278,2017-10-24,14,193,388,581
59279,2017-10-24,15,192,474,666
59280,2017-10-24,16,193,855,1048
59281,2017-10-24,17,258,1473,1731
59282,2017-10-24,18,169,1228,1397
59283,2017-10-24,19,114,656,770
59284,2017-10-24,20,71,392,463
59285,2017-10-24,21,74,372,446
59286,2017-10-24,22,51,250,301
59287,2017-10-24,23,16,106,122
59288,2017-10-25,0,11,45,56
59289,2017-10-25,1,6,16,22
59290,2017-10-25,2,3,8,11
59291,2017-10-25,3,2,7,9
59292,2017-10-25,4,1,15,16
59293,2017-10-25,5,3,118,121
59294,2017-10-25,6,11,386,397
59295,2017-10-25,7,33,946,979
59296,2017-10-25,8,64,1335,1399
59297,2017-10-25,9,76,589,665
59298,2017-10-25,10,105,289,394
59299,2017-10-25,11,121,346,467
59300,2017-10-25,12,163,453,616
59301,2017-10-25,13,123,419,542
59302,2017-10-25,14,157,362,519
59303,2017-10-25,15,156,470,626
59304,2017-10-25,16,156,778,934
59305,2017-10-25,17,183,1508,1691
59306,2017-10-25,18,149,1168,1317
59307,2017-10-25,19,83,722,805
59308,2017-10-25,20,67,434,501
59309,2017-10-25,21,45,307,352
59310,2017-10-25,22,41,222,263
59311,2017-10-25,23,27,92,119
59312,2017-10-26,0,8,32,40
59313,2017-10-26,1,3,28,31
59314,2017-10-26,2,4,12,16
59315,2017-10-26,3,1,5,6
59316,2017-10-26,4,3,15,18
59317,2017-10-26,5,4,95,99
59318,2017-10-26,6,12,326,338
59319,2017-10-26,7,37,874,911
59320,2017-10-26,8,61,1249,1310
59321,2017-10-26,9,56,526,582
59322,2017-10-26,10,72,255,327
59323,2017-10-26,11,101,314,415
59324,2017-10-26,12,96,416,512
59325,2017-10-26,13,80,360,440
59326,2017-10-26,14,137,366,503
59327,2017-10-26,15,133,471,604
59328,2017-10-26,16,185,772,957
59329,2017-10-26,17,197,1360,1557
59330,2017-10-26,18,124,1100,1224
59331,2017-10-26,19,87,607,694
59332,2017-10-26,20,65,392,457
59333,2017-10-26,21,56,290,346
59334,2017-10-26,22,33,218,251
59335,2017-10-26,23,21,106,127
59336,2017-10-27,0,11,53,64
59337,2017-10-27,1,6,27,33
59338,2017-10-27,2,6,8,14
59339,2017-10-27,3,2,5,7
59340,2017-10-27,4,4,15,19
59341,2017-10-27,5,4,83,87
59342,2017-10-27,6,7,294,301
59343,2017-10-27,7,23,644,667
59344,2017-10-27,8,75,1145,1220
59345,2017-10-27,9,114,612,726
59346,2017-10-27,10,126,300,426
59347,2017-10-27,11,157,358,515
59348,2017-10-27,12,241,523,764
59349,2017-10-27,13,273,500,773
59350,2017-10-27,14,285,475,760
59351,2017-10-27,15,287,594,881
59352,2017-10-27,16,339,874,1213
59353,2017-10-27,17,318,1330,1648
59354,2017-10-27,18,204,926,1130
59355,2017-10-27,19,122,580,702
59356,2017-10-27,20,66,322,388
59357,2017-10-27,21,61,252,313
59358,2017-10-27,22,73,219,292
59359,2017-10-27,23,57,148,205
59360,2017-10-28,0,35,103,138
59361,2017-10-28,1,24,76,100
59362,2017-10-28,2,25,64,89
59363,2017-10-28,3,10,36,46
59364,2017-10-28,4,10,14,24
59365,2017-10-28,5,1,12,13
59366,2017-10-28,6,7,38,45
59367,2017-10-28,7,6,99,105
59368,2017-10-28,8,45,273,318
59369,2017-10-28,9,163,405,568
59370,2017-10-28,10,313,564,877
59371,2017-10-28,11,447,579,1026
59372,2017-10-28,12,495,625,1120
59373,2017-10-28,13,583,647,1230
59374,2017-10-28,14,617,621,1238
59375,2017-10-28,15,657,617,1274
59376,2017-10-28,16,580,558,1138
59377,2017-10-28,17,522,525,1047
59378,2017-10-28,18,365,479,844
59379,2017-10-28,19,181,350,531
59380,2017-10-28,20,120,264,384
59381,2017-10-28,21,115,269,384
59382,2017-10-28,22,105,163,268
59383,2017-10-28,23,55,157,212
59384,2017-10-29,0,46,149,195
59385,2017-10-29,1,56,117,173
59386,2017-10-29,2,32,103,135
59387,2017-10-29,3,26,47,73
59388,2017-10-29,4,4,12,16
59389,2017-10-29,5,2,9,11
59390,2017-10-29,6,2,21,23
59391,2017-10-29,7,4,46,50
59392,2017-10-29,8,32,127,159
59393,2017-10-29,9,66,176,242
59394,2017-10-29,10,113,262,375
59395,2017-10-29,11,148,384,532
59396,2017-10-29,12,172,393,565
59397,2017-10-29,13,188,369,557
59398,2017-10-29,14,182,401,583
59399,2017-10-29,15,66,244,310
59400,2017-10-29,16,28,144,172
59401,2017-10-29,17,48,132,180
59402,2017-10-29,18,12,87,99
59403,2017-10-29,19,5,37,42
59404,2017-10-29,20,1,17,18
59405,2017-10-29,21,2,25,27
59406,2017-10-29,22,3,33,36
59407,2017-10-29,23,2,15,17
59408,2017-10-30,0,2,8,10
59409,2017-10-30,1,1,3,4
59410,2017-10-30,2,0,3,3
59411,2017-10-30,3,0,1,1
59412,2017-10-30,4,0,8,8
59413,2017-10-30,5,2,68,70
59414,2017-10-30,6,4,224,228
59415,2017-10-30,7,19,607,626
59416,2017-10-30,8,41,963,1004
59417,2017-10-30,9,50,432,482
59418,2017-10-30,10,76,196,272
59419,2017-10-30,11,83,229,312
59420,2017-10-30,12,120,349,469
59421,2017-10-30,13,125,301,426
59422,2017-10-30,14,149,291,440
59423,2017-10-30,15,156,399,555
59424,2017-10-30,16,141,737,878
59425,2017-10-30,17,184,1359,1543
59426,2017-10-30,18,138,1022,1160
59427,2017-10-30,19,73,631,704
59428,2017-10-30,20,42,379,421
59429,2017-10-30,21,36,249,285
59430,2017-10-30,22,10,161,171
59431,2017-10-30,23,8,74,82
59432,2017-10-31,0,8,27,35
59433,2017-10-31,1,4,10,14
59434,2017-10-31,2,3,9,12
59435,2017-10-31,3,1,1,2
59436,2017-10-31,4,1,13,14
59437,2017-10-31,5,2,93,95
59438,2017-10-31,6,13,354,367
59439,2017-10-31,7,21,844,865
59440,2017-10-31,8,52,1256,1308
59441,2017-10-31,9,61,472,533
59442,2017-10-31,10,81,264,345
59443,2017-10-31,11,93,329,422
59444,2017-10-31,12,99,399,498
59445,2017-10-31,13,121,367,488
59446,2017-10-31,14,135,367,502
59447,2017-10-31,15,124,529,653
59448,2017-10-31,16,160,929,1089
59449,2017-10-31,17,197,1432,1629
59450,2017-10-31,18,94,1035,1129
59451,2017-10-31,19,77,516,593
59452,2017-10-31,20,67,332,399
59453,2017-10-31,21,39,241,280
59454,2017-10-31,22,18,173,191
59455,2017-10-31,23,22,98,120
59456,2017-11-01,0,7,52,59
59457,2017-11-01,1,4,19,23
59458,2017-11-01,2,3,18,21
59459,2017-11-01,3,1,3,4
59460,2017-11-01,4,1,15,16
59461,2017-11-01,5,3,87,90
59462,2017-11-01,6,6,316,322
59463,2017-11-01,7,17,851,868
59464,2017-11-01,8,47,1203,1250
59465,2017-11-01,9,34,580,614
59466,2017-11-01,10,51,217,268
59467,2017-11-01,11,65,266,331
59468,2017-11-01,12,72,400,472
59469,2017-11-01,13,89,360,449
59470,2017-11-01,14,83,309,392
59471,2017-11-01,15,102,401,503
59472,2017-11-01,16,117,759,876
59473,2017-11-01,17,139,1305,1444
59474,2017-11-01,18,85,1034,1119
59475,2017-11-01,19,46,601,647
59476,2017-11-01,20,30,384,414
59477,2017-11-01,21,39,288,327
59478,2017-11-01,22,29,192,221
59479,2017-11-01,23,24,105,129
59480,2017-11-02,0,10,55,65
59481,2017-11-02,1,8,12,20
59482,2017-11-02,2,0,6,6
59483,2017-11-02,3,0,5,5
59484,2017-11-02,4,4,15,19
59485,2017-11-02,5,1,86,87
59486,2017-11-02,6,7,332,339
59487,2017-11-02,7,19,856,875
59488,2017-11-02,8,51,1285,1336
59489,2017-11-02,9,61,601,662
59490,2017-11-02,10,92,253,345
59491,2017-11-02,11,95,350,445
59492,2017-11-02,12,117,439,556
59493,2017-11-02,13,150,400,550
59494,2017-11-02,14,197,380,577
59495,2017-11-02,15,182,524,706
59496,2017-11-02,16,174,832,1006
59497,2017-11-02,17,227,1500,1727
59498,2017-11-02,18,184,1193,1377
59499,2017-11-02,19,100,662,762
59500,2017-11-02,20,69,454,523
59501,2017-11-02,21,59,357,416
59502,2017-11-02,22,53,296,349
59503,2017-11-02,23,23,147,170
59504,2017-11-03,0,20,66,86
59505,2017-11-03,1,16,33,49
59506,2017-11-03,2,10,18,28
59507,2017-11-03,3,0,11,11
59508,2017-11-03,4,2,13,15
59509,2017-11-03,5,5,79,84
59510,2017-11-03,6,4,255,259
59511,2017-11-03,7,35,728,763
59512,2017-11-03,8,79,1251,1330
59513,2017-11-03,9,121,631,752
59514,2017-11-03,10,168,347,515
59515,2017-11-03,11,194,411,605
59516,2017-11-03,12,267,503,770
59517,2017-11-03,13,292,504,796
59518,2017-11-03,14,251,441,692
59519,2017-11-03,15,254,564,818
59520,2017-11-03,16,323,886,1209
59521,2017-11-03,17,310,1328,1638
59522,2017-11-03,18,191,943,1134
59523,2017-11-03,19,136,574,710
59524,2017-11-03,20,95,371,466
59525,2017-11-03,21,108,303,411
59526,2017-11-03,22,136,266,402
59527,2017-11-03,23,73,159,232
59528,2017-11-04,0,68,125,193
59529,2017-11-04,1,36,74,110
59530,2017-11-04,2,19,49,68
59531,2017-11-04,3,22,24,46
59532,2017-11-04,4,1,12,13
59533,2017-11-04,5,2,15,17
59534,2017-11-04,6,6,43,49
59535,2017-11-04,7,14,117,131
59536,2017-11-04,8,25,257,282
59537,2017-11-04,9,126,342,468
59538,2017-11-04,10,195,476,671
59539,2017-11-04,11,300,514,814
59540,2017-11-04,12,453,574,1027
59541,2017-11-04,13,446,578,1024
59542,2017-11-04,14,471,561,1032
59543,2017-11-04,15,540,578,1118
59544,2017-11-04,16,442,567,1009
59545,2017-11-04,17,252,376,628
59546,2017-11-04,18,67,228,295
59547,2017-11-04,19,24,81,105
59548,2017-11-04,20,4,40,44
59549,2017-11-04,21,3,41,44
59550,2017-11-04,22,15,28,43
59551,2017-11-04,23,5,40,45
59552,2017-11-05,0,20,63,83
59553,2017-11-05,1,25,79,104
59554,2017-11-05,2,7,9,16
59555,2017-11-05,3,2,9,11
59556,2017-11-05,4,0,3,3
59557,2017-11-05,5,6,6,12
59558,2017-11-05,6,12,38,50
59559,2017-11-05,7,15,73,88
59560,2017-11-05,8,34,139,173
59561,2017-11-05,9,64,203,267
59562,2017-11-05,10,65,263,328
59563,2017-11-05,11,102,317,419
59564,2017-11-05,12,171,365,536
59565,2017-11-05,13,155,304,459
59566,2017-11-05,14,160,338,498
59567,2017-11-05,15,193,375,568
59568,2017-11-05,16,158,385,543
59569,2017-11-05,17,120,309,429
59570,2017-11-05,18,75,287,362
59571,2017-11-05,19,57,228,285
59572,2017-11-05,20,43,149,192
59573,2017-11-05,21,41,154,195
59574,2017-11-05,22,34,113,147
59575,2017-11-05,23,31,87,118
59576,2017-11-06,0,10,19,29
59577,2017-11-06,1,3,8,11
59578,2017-11-06,2,2,10,12
59579,2017-11-06,3,0,5,5
59580,2017-11-06,4,1,11,12
59581,2017-11-06,5,7,100,107
59582,2017-11-06,6,8,358,366
59583,2017-11-06,7,28,868,896
59584,2017-11-06,8,51,1080,1131
59585,2017-11-06,9,50,452,502
59586,2017-11-06,10,92,260,352
59587,2017-11-06,11,145,285,430
59588,2017-11-06,12,128,374,502
59589,2017-11-06,13,121,382,503
59590,2017-11-06,14,156,322,478
59591,2017-11-06,15,161,499,660
59592,2017-11-06,16,165,861,1026
59593,2017-11-06,17,131,1223,1354
59594,2017-11-06,18,64,953,1017
59595,2017-11-06,19,55,549,604
59596,2017-11-06,20,47,368,415
59597,2017-11-06,21,41,242,283
59598,2017-11-06,22,36,200,236
59599,2017-11-06,23,15,69,84
59600,2017-11-07,0,13,27,40
59601,2017-11-07,1,1,8,9
59602,2017-11-07,2,3,9,12
59603,2017-11-07,3,0,4,4
59604,2017-11-07,4,2,16,18
59605,2017-11-07,5,4,118,122
59606,2017-11-07,6,10,402,412
59607,2017-11-07,7,29,950,979
59608,2017-11-07,8,41,1299,1340
59609,2017-11-07,9,38,505,543
59610,2017-11-07,10,43,218,261
59611,2017-11-07,11,11,70,81
59612,2017-11-07,12,6,53,59
59613,2017-11-07,13,0,41,41
59614,2017-11-07,14,1,43,44
59615,2017-11-07,15,1,63,64
59616,2017-11-07,16,10,154,164
59617,2017-11-07,17,3,260,263
59618,2017-11-07,18,4,132,136
59619,2017-11-07,19,3,127,130
59620,2017-11-07,20,2,110,112
59621,2017-11-07,21,7,126,133
59622,2017-11-07,22,14,71,85
59623,2017-11-07,23,1,59,60
59624,2017-11-08,0,3,15,18
59625,2017-11-08,1,5,12,17
59626,2017-11-08,2,5,5,10
59627,2017-11-08,3,1,4,5
59628,2017-11-08,4,1,10,11
59629,2017-11-08,5,5,87,92
59630,2017-11-08,6,8,380,388
59631,2017-11-08,7,21,772,793
59632,2017-11-08,8,36,1029,1065
59633,2017-11-08,9,36,440,476
59634,2017-11-08,10,34,202,236
59635,2017-11-08,11,36,242,278
59636,2017-11-08,12,65,306,371
59637,2017-11-08,13,48,326,374
59638,2017-11-08,14,54,283,337
59639,2017-11-08,15,56,363,419
59640,2017-11-08,16,51,677,728
59641,2017-11-08,17,64,1114,1178
59642,2017-11-08,18,40,930,970
59643,2017-11-08,19,24,542,566
59644,2017-11-08,20,29,319,348
59645,2017-11-08,21,29,253,282
59646,2017-11-08,22,29,170,199
59647,2017-11-08,23,20,72,92
59648,2017-11-09,0,12,33,45
59649,2017-11-09,1,3,9,12
59650,2017-11-09,2,10,5,15
59651,2017-11-09,3,6,2,8
59652,2017-11-09,4,1,14,15
59653,2017-11-09,5,2,75,77
59654,2017-11-09,6,6,269,275
59655,2017-11-09,7,25,727,752
59656,2017-11-09,8,43,1144,1187
59657,2017-11-09,9,46,491,537
59658,2017-11-09,10,32,214,246
59659,2017-11-09,11,56,254,310
59660,2017-11-09,12,73,342,415
59661,2017-11-09,13,87,368,455
59662,2017-11-09,14,101,335,436
59663,2017-11-09,15,98,456,554
59664,2017-11-09,16,106,743,849
59665,2017-11-09,17,103,1046,1149
59666,2017-11-09,18,59,867,926
59667,2017-11-09,19,44,483,527
59668,2017-11-09,20,26,194,220
59669,2017-11-09,21,38,229,267
59670,2017-11-09,22,21,176,197
59671,2017-11-09,23,16,111,127
59672,2017-11-10,0,16,60,76
59673,2017-11-10,1,8,24,32
59674,2017-11-10,2,7,11,18
59675,2017-11-10,3,6,9,15
59676,2017-11-10,4,4,15,19
59677,2017-11-10,5,2,33,35
59678,2017-11-10,6,13,138,151
59679,2017-11-10,7,16,323,339
59680,2017-11-10,8,38,615,653
59681,2017-11-10,9,40,366,406
59682,2017-11-10,10,54,274,328
59683,2017-11-10,11,116,347,463
59684,2017-11-10,12,80,343,423
59685,2017-11-10,13,104,359,463
59686,2017-11-10,14,141,331,472
59687,2017-11-10,15,114,336,450
59688,2017-11-10,16,88,451,539
59689,2017-11-10,17,77,568,645
59690,2017-11-10,18,30,411,441
59691,2017-11-10,19,27,244,271
59692,2017-11-10,20,12,165,177
59693,2017-11-10,21,15,124,139
59694,2017-11-10,22,12,99,111
59695,2017-11-10,23,8,80,88
59696,2017-11-11,0,12,38,50
59697,2017-11-11,1,9,37,46
59698,2017-11-11,2,3,27,30
59699,2017-11-11,3,2,8,10
59700,2017-11-11,4,1,12,13
59701,2017-11-11,5,2,7,9
59702,2017-11-11,6,2,29,31
59703,2017-11-11,7,14,78,92
59704,2017-11-11,8,21,120,141
59705,2017-11-11,9,51,233,284
59706,2017-11-11,10,90,267,357
59707,2017-11-11,11,131,335,466
59708,2017-11-11,12,160,363,523
59709,2017-11-11,13,201,388,589
59710,2017-11-11,14,205,398,603
59711,2017-11-11,15,185,326,511
59712,2017-11-11,16,136,312,448
59713,2017-11-11,17,97,257,354
59714,2017-11-11,18,31,208,239
59715,2017-11-11,19,34,191,225
59716,2017-11-11,20,11,130,141
59717,2017-11-11,21,26,106,132
59718,2017-11-11,22,9,97,106
59719,2017-11-11,23,14,77,91
59720,2017-11-12,0,15,67,82
59721,2017-11-12,1,15,44,59
59722,2017-11-12,2,8,29,37
59723,2017-11-12,3,1,16,17
59724,2017-11-12,4,0,13,13
59725,2017-11-12,5,0,4,4
59726,2017-11-12,6,5,30,35
59727,2017-11-12,7,5,69,74
59728,2017-11-12,8,29,111,140
59729,2017-11-12,9,53,222,275
59730,2017-11-12,10,98,261,359
59731,2017-11-12,11,106,333,439
59732,2017-11-12,12,195,370,565
59733,2017-11-12,13,187,336,523
59734,2017-11-12,14,176,390,566
59735,2017-11-12,15,186,356,542
59736,2017-11-12,16,174,394,568
59737,2017-11-12,17,94,331,425
59738,2017-11-12,18,40,269,309
59739,2017-11-12,19,32,177,209
59740,2017-11-12,20,14,139,153
59741,2017-11-12,21,18,128,146
59742,2017-11-12,22,21,95,116
59743,2017-11-12,23,5,36,41
59744,2017-11-13,0,2,8,10
59745,2017-11-13,1,1,10,11
59746,2017-11-13,2,4,2,6
59747,2017-11-13,4,2,7,9
59748,2017-11-13,5,4,61,65
59749,2017-11-13,6,4,256,260
59750,2017-11-13,7,15,676,691
59751,2017-11-13,8,42,945,987
59752,2017-11-13,9,42,453,495
59753,2017-11-13,10,66,214,280
59754,2017-11-13,11,89,234,323
59755,2017-11-13,12,110,290,400
59756,2017-11-13,13,102,308,410
59757,2017-11-13,14,91,295,386
59758,2017-11-13,15,95,381,476
59759,2017-11-13,16,71,646,717
59760,2017-11-13,17,84,1102,1186
59761,2017-11-13,18,58,863,921
59762,2017-11-13,19,47,527,574
59763,2017-11-13,20,29,329,358
59764,2017-11-13,21,35,239,274
59765,2017-11-13,22,29,137,166
59766,2017-11-13,23,10,45,55
59767,2017-11-14,0,3,23,26
59768,2017-11-14,1,4,8,12
59769,2017-11-14,2,3,5,8
59770,2017-11-14,3,1,8,9
59771,2017-11-14,4,1,18,19
59772,2017-11-14,5,1,81,82
59773,2017-11-14,6,8,327,335
59774,2017-11-14,7,8,763,771
59775,2017-11-14,8,51,1239,1290
59776,2017-11-14,9,57,532,589
59777,2017-11-14,10,57,214,271
59778,2017-11-14,11,58,266,324
59779,2017-11-14,12,59,312,371
59780,2017-11-14,13,55,289,344
59781,2017-11-14,14,64,282,346
59782,2017-11-14,15,65,366,431
59783,2017-11-14,16,67,661,728
59784,2017-11-14,17,65,1087,1152
59785,2017-11-14,18,49,878,927
59786,2017-11-14,19,36,488,524
59787,2017-11-14,20,32,344,376
59788,2017-11-14,21,24,231,255
59789,2017-11-14,22,22,181,203
59790,2017-11-14,23,17,84,101
59791,2017-11-15,0,5,30,35
59792,2017-11-15,1,4,10,14
59793,2017-11-15,2,0,10,10
59794,2017-11-15,3,0,4,4
59795,2017-11-15,4,1,15,16
59796,2017-11-15,5,4,95,99
59797,2017-11-15,6,6,318,324
59798,2017-11-15,7,21,814,835
59799,2017-11-15,8,41,1162,1203
59800,2017-11-15,9,31,516,547
59801,2017-11-15,10,46,259,305
59802,2017-11-15,11,56,258,314
59803,2017-11-15,12,60,317,377
59804,2017-11-15,13,72,327,399
59805,2017-11-15,14,94,282,376
59806,2017-11-15,15,57,406,463
59807,2017-11-15,16,67,647,714
59808,2017-11-15,17,75,1116,1191
59809,2017-11-15,18,63,920,983
59810,2017-11-15,19,31,526,557
59811,2017-11-15,20,29,360,389
59812,2017-11-15,21,11,285,296
59813,2017-11-15,22,19,208,227
59814,2017-11-15,23,15,92,107
59815,2017-11-16,0,12,43,55
59816,2017-11-16,1,3,11,14
59817,2017-11-16,2,1,8,9
59818,2017-11-16,3,0,5,5
59819,2017-11-16,4,0,19,19
59820,2017-11-16,5,2,87,89
59821,2017-11-16,6,14,323,337
59822,2017-11-16,7,28,816,844
59823,2017-11-16,8,50,1184,1234
59824,2017-11-16,9,63,498,561
59825,2017-11-16,10,66,241,307
59826,2017-11-16,11,79,290,369
59827,2017-11-16,12,92,390,482
59828,2017-11-16,13,111,311,422
59829,2017-11-16,14,122,323,445
59830,2017-11-16,15,105,455,560
59831,2017-11-16,16,91,672,763
59832,2017-11-16,17,103,1084,1187
59833,2017-11-16,18,71,902,973
59834,2017-11-16,19,38,552,590
59835,2017-11-16,20,25,360,385
59836,2017-11-16,21,33,221,254
59837,2017-11-16,22,19,159,178
59838,2017-11-16,23,14,103,117
59839,2017-11-17,0,11,43,54
59840,2017-11-17,1,4,25,29
59841,2017-11-17,2,2,7,9
59842,2017-11-17,3,2,5,7
59843,2017-11-17,4,1,15,16
59844,2017-11-17,5,2,85,87
59845,2017-11-17,6,7,271,278
59846,2017-11-17,7,27,657,684
59847,2017-11-17,8,45,1075,1120
59848,2017-11-17,9,64,490,554
59849,2017-11-17,10,68,256,324
59850,2017-11-17,11,93,309,402
59851,2017-11-17,12,112,410,522
59852,2017-11-17,13,101,399,500
59853,2017-11-17,14,130,369,499
59854,2017-11-17,15,160,477,637
59855,2017-11-17,16,140,646,786
59856,2017-11-17,17,117,958,1075
59857,2017-11-17,18,50,696,746
59858,2017-11-17,19,48,405,453
59859,2017-11-17,20,39,216,255
59860,2017-11-17,21,33,180,213
59861,2017-11-17,22,32,137,169
59862,2017-11-17,23,24,98,122
59863,2017-11-18,0,26,89,115
59864,2017-11-18,1,17,49,66
59865,2017-11-18,2,8,37,45
59866,2017-11-18,3,1,14,15
59867,2017-11-18,4,2,6,8
59868,2017-11-18,5,1,10,11
59869,2017-11-18,6,6,30,36
59870,2017-11-18,7,16,111,127
59871,2017-11-18,8,44,206,250
59872,2017-11-18,9,62,320,382
59873,2017-11-18,10,142,396,538
59874,2017-11-18,11,159,463,622
59875,2017-11-18,12,232,499,731
59876,2017-11-18,13,331,452,783
59877,2017-11-18,14,306,416,722
59878,2017-11-18,15,225,381,606
59879,2017-11-18,16,210,360,570
59880,2017-11-18,17,187,368,555
59881,2017-11-18,18,118,258,376
59882,2017-11-18,19,77,271,348
59883,2017-11-18,20,79,189,268
59884,2017-11-18,21,49,144,193
59885,2017-11-18,22,51,125,176
59886,2017-11-18,23,87,125,212
59887,2017-11-19,0,37,98,135
59888,2017-11-19,1,10,40,50
59889,2017-11-19,2,8,32,40
59890,2017-11-19,3,14,16,30
59891,2017-11-19,4,4,9,13
59892,2017-11-19,5,1,7,8
59893,2017-11-19,6,6,22,28
59894,2017-11-19,7,15,56,71
59895,2017-11-19,8,36,136,172
59896,2017-11-19,9,79,224,303
59897,2017-11-19,10,99,352,451
59898,2017-11-19,11,177,393,570
59899,2017-11-19,12,225,440,665
59900,2017-11-19,13,157,401,558
59901,2017-11-19,14,161,409,570
59902,2017-11-19,15,121,392,513
59903,2017-11-19,16,88,363,451
59904,2017-11-19,17,72,304,376
59905,2017-11-19,18,34,230,264
59906,2017-11-19,19,19,167,186
59907,2017-11-19,20,21,137,158
59908,2017-11-19,21,10,110,120
59909,2017-11-19,22,14,73,87
59910,2017-11-19,23,17,74,91
59911,2017-11-20,0,6,21,27
59912,2017-11-20,1,5,11,16
59913,2017-11-20,2,0,3,3
59914,2017-11-20,3,1,1,2
59915,2017-11-20,4,0,9,9
59916,2017-11-20,5,2,75,77
59917,2017-11-20,6,4,264,268
59918,2017-11-20,7,14,681,695
59919,2017-11-20,8,33,962,995
59920,2017-11-20,9,42,384,426
59921,2017-11-20,10,63,212,275
59922,2017-11-20,11,61,224,285
59923,2017-11-20,12,84,282,366
59924,2017-11-20,13,89,283,372
59925,2017-11-20,14,108,269,377
59926,2017-11-20,15,130,377,507
59927,2017-11-20,16,121,626,747
59928,2017-11-20,17,82,1027,1109
59929,2017-11-20,18,52,815,867
59930,2017-11-20,19,22,447,469
59931,2017-11-20,20,29,278,307
59932,2017-11-20,21,20,209,229
59933,2017-11-20,22,25,113,138
59934,2017-11-20,23,16,53,69
59935,2017-11-21,0,11,37,48
59936,2017-11-21,1,1,9,10
59937,2017-11-21,2,2,3,5
59938,2017-11-21,3,0,2,2
59939,2017-11-21,4,3,11,14
59940,2017-11-21,5,1,75,76
59941,2017-11-21,6,10,274,284
59942,2017-11-21,7,15,707,722
59943,2017-11-21,8,25,1063,1088
59944,2017-11-21,9,29,500,529
59945,2017-11-21,10,64,237,301
59946,2017-11-21,11,115,270,385
59947,2017-11-21,12,103,346,449
59948,2017-11-21,13,108,360,468
59949,2017-11-21,14,105,294,399
59950,2017-11-21,15,161,425,586
59951,2017-11-21,16,122,646,768
59952,2017-11-21,17,118,971,1089
59953,2017-11-21,18,68,782,850
59954,2017-11-21,19,43,478,521
59955,2017-11-21,20,46,258,304
59956,2017-11-21,21,31,203,234
59957,2017-11-21,22,16,127,143
59958,2017-11-21,23,23,80,103
59959,2017-11-22,0,10,29,39
59960,2017-11-22,1,6,14,20
59961,2017-11-22,2,3,4,7
59962,2017-11-22,3,0,5,5
59963,2017-11-22,4,0,8,8
59964,2017-11-22,5,6,85,91
59965,2017-11-22,6,4,206,210
59966,2017-11-22,7,17,502,519
59967,2017-11-22,8,28,780,808
59968,2017-11-22,9,41,439,480
59969,2017-11-22,10,64,263,327
59970,2017-11-22,11,87,267,354
59971,2017-11-22,12,106,354,460
59972,2017-11-22,13,127,442,569
59973,2017-11-22,14,105,486,591
59974,2017-11-22,15,116,583,699
59975,2017-11-22,16,77,548,625
59976,2017-11-22,17,73,450,523
59977,2017-11-22,18,33,277,310
59978,2017-11-22,19,25,190,215
59979,2017-11-22,20,15,120,135
59980,2017-11-22,21,9,69,78
59981,2017-11-22,22,7,66,73
59982,2017-11-22,23,6,56,62
59983,2017-11-23,0,3,36,39
59984,2017-11-23,1,1,22,23
59985,2017-11-23,2,6,14,20
59986,2017-11-23,3,2,9,11
59987,2017-11-23,4,3,6,9
59988,2017-11-23,5,1,10,11
59989,2017-11-23,6,1,24,25
59990,2017-11-23,7,15,66,81
59991,2017-11-23,8,26,117,143
59992,2017-11-23,9,49,133,182
59993,2017-11-23,10,104,147,251
59994,2017-11-23,11,144,203,347
59995,2017-11-23,12,122,189,311
59996,2017-11-23,13,153,168,321
59997,2017-11-23,14,160,154,314
59998,2017-11-23,15,199,139,338
59999,2017-11-23,16,107,106,213
60000,2017-11-23,17,60,71,131
60001,2017-11-23,18,62,38,100
60002,2017-11-23,19,26,49,75
60003,2017-11-23,20,2,44,46
60004,2017-11-23,21,5,25,30
60005,2017-11-23,22,6,34,40
60006,2017-11-23,23,8,37,45
60007,2017-11-24,0,8,20,28
60008,2017-11-24,1,3,9,12
60009,2017-11-24,2,0,6,6
60010,2017-11-24,3,0,2,2
60011,2017-11-24,4,1,3,4
60012,2017-11-24,5,1,8,9
60013,2017-11-24,6,7,49,56
60014,2017-11-24,7,9,102,111
60015,2017-11-24,8,22,122,144
60016,2017-11-24,9,58,156,214
60017,2017-11-24,10,122,146,268
60018,2017-11-24,11,182,197,379
60019,2017-11-24,12,227,215,442
60020,2017-11-24,13,290,256,546
60021,2017-11-24,14,354,298,652
60022,2017-11-24,15,297,314,611
60023,2017-11-24,16,265,317,582
60024,2017-11-24,17,168,273,441
60025,2017-11-24,18,64,174,238
60026,2017-11-24,19,78,142,220
60027,2017-11-24,20,39,90,129
60028,2017-11-24,21,29,86,115
60029,2017-11-24,22,20,72,92
60030,2017-11-24,23,20,60,80
60031,2017-11-25,0,7,29,36
60032,2017-11-25,1,13,32,45
60033,2017-11-25,2,6,19,25
60034,2017-11-25,3,0,5,5
60035,2017-11-25,4,2,2,4
60036,2017-11-25,5,3,7,10
60037,2017-11-25,6,2,19,21
60038,2017-11-25,7,9,66,75
60039,2017-11-25,8,29,89,118
60040,2017-11-25,9,117,194,311
60041,2017-11-25,10,189,234,423
60042,2017-11-25,11,289,312,601
60043,2017-11-25,12,355,371,726
60044,2017-11-25,13,449,352,801
60045,2017-11-25,14,424,417,841
60046,2017-11-25,15,386,402,788
60047,2017-11-25,16,352,338,690
60048,2017-11-25,17,192,297,489
60049,2017-11-25,18,114,224,338
60050,2017-11-25,19,85,188,273
60051,2017-11-25,20,64,105,169
60052,2017-11-25,21,36,120,156
60053,2017-11-25,22,43,85,128
60054,2017-11-25,23,29,75,104
60055,2017-11-26,0,16,52,68
60056,2017-11-26,1,17,28,45
60057,2017-11-26,2,14,29,43
60058,2017-11-26,3,3,15,18
60059,2017-11-26,4,0,7,7
60060,2017-11-26,5,0,8,8
60061,2017-11-26,6,3,24,27
60062,2017-11-26,7,8,45,53
60063,2017-11-26,8,13,107,120
60064,2017-11-26,9,54,201,255
60065,2017-11-26,10,102,271,373
60066,2017-11-26,11,156,295,451
60067,2017-11-26,12,173,346,519
60068,2017-11-26,13,151,381,532
60069,2017-11-26,14,173,336,509
60070,2017-11-26,15,155,363,518
60071,2017-11-26,16,118,331,449
60072,2017-11-26,17,63,296,359
60073,2017-11-26,18,35,237,272
60074,2017-11-26,19,27,201,228
60075,2017-11-26,20,27,144,171
60076,2017-11-26,21,17,91,108
60077,2017-11-26,22,8,58,66
60078,2017-11-26,23,6,35,41
60079,2017-11-27,0,4,20,24
60080,2017-11-27,1,0,9,9
60081,2017-11-27,2,1,4,5
60082,2017-11-27,3,0,2,2
60083,2017-11-27,4,1,15,16
60084,2017-11-27,5,1,83,84
60085,2017-11-27,6,6,248,254
60086,2017-11-27,7,18,675,693
60087,2017-11-27,8,32,1066,1098
60088,2017-11-27,9,50,399,449
60089,2017-11-27,10,42,182,224
60090,2017-11-27,11,62,235,297
60091,2017-11-27,12,67,302,369
60092,2017-11-27,13,72,331,403
60093,2017-11-27,14,74,296,370
60094,2017-11-27,15,103,403,506
60095,2017-11-27,16,70,674,744
60096,2017-11-27,17,82,1108,1190
60097,2017-11-27,18,59,888,947
60098,2017-11-27,19,35,530,565
60099,2017-11-27,20,27,302,329
60100,2017-11-27,21,11,206,217
60101,2017-11-27,22,16,125,141
60102,2017-11-27,23,13,50,63
60103,2017-11-28,0,4,23,27
60104,2017-11-28,1,2,11,13
60105,2017-11-28,2,4,6,10
60106,2017-11-28,4,3,16,19
60107,2017-11-28,5,0,77,77
60108,2017-11-28,6,6,310,316
60109,2017-11-28,7,22,835,857
60110,2017-11-28,8,33,1219,1252
60111,2017-11-28,9,44,514,558
60112,2017-11-28,10,35,244,279
60113,2017-11-28,11,47,242,289
60114,2017-11-28,12,66,320,386
60115,2017-11-28,13,68,311,379
60116,2017-11-28,14,68,279,347
60117,2017-11-28,15,93,387,480
60118,2017-11-28,16,74,695,769
60119,2017-11-28,17,72,1111,1183
60120,2017-11-28,18,46,954,1000
60121,2017-11-28,19,37,544,581
60122,2017-11-28,20,30,339,369
60123,2017-11-28,21,19,215,234
60124,2017-11-28,22,19,161,180
60125,2017-11-28,23,3,68,71
60126,2017-11-29,0,3,25,28
60127,2017-11-29,1,3,6,9
60128,2017-11-29,2,1,3,4
60129,2017-11-29,3,0,5,5
60130,2017-11-29,4,1,13,14
60131,2017-11-29,5,3,98,101
60132,2017-11-29,6,7,299,306
60133,2017-11-29,7,25,808,833
60134,2017-11-29,8,38,1258,1296
60135,2017-11-29,9,43,518,561
60136,2017-11-29,10,45,253,298
60137,2017-11-29,11,46,266,312
60138,2017-11-29,12,63,378,441
60139,2017-11-29,13,64,358,422
60140,2017-11-29,14,81,312,393
60141,2017-11-29,15,78,437,515
60142,2017-11-29,16,74,679,753
60143,2017-11-29,17,84,1198,1282
60144,2017-11-29,18,66,892,958
60145,2017-11-29,19,40,573,613
60146,2017-11-29,20,26,397,423
60147,2017-11-29,21,32,236,268
60148,2017-11-29,22,13,165,178
60149,2017-11-29,23,38,106,144
60150,2017-11-30,0,10,54,64
60151,2017-11-30,1,4,13,17
60152,2017-11-30,2,2,10,12
60153,2017-11-30,3,2,0,2
60154,2017-11-30,4,1,17,18
60155,2017-11-30,5,2,89,91
60156,2017-11-30,6,1,315,316
60157,2017-11-30,7,22,786,808
60158,2017-11-30,8,40,1229,1269
60159,2017-11-30,9,37,517,554
60160,2017-11-30,10,51,286,337
60161,2017-11-30,11,58,263,321
60162,2017-11-30,12,64,400,464
60163,2017-11-30,13,86,323,409
60164,2017-11-30,14,98,309,407
60165,2017-11-30,15,107,477,584
60166,2017-11-30,16,89,716,805
60167,2017-11-30,17,72,1146,1218
60168,2017-11-30,18,69,857,926
60169,2017-11-30,19,55,584,639
60170,2017-11-30,20,27,389,416
60171,2017-11-30,21,26,180,206
60172,2017-11-30,22,12,170,182
60173,2017-11-30,23,7,95,102
60174,2017-12-01,0,8,41,49
60175,2017-12-01,1,4,23,27
60176,2017-12-01,2,2,9,11
60177,2017-12-01,3,5,2,7
60178,2017-12-01,4,2,13,15
60179,2017-12-01,5,1,78,79
60180,2017-12-01,6,5,275,280
60181,2017-12-01,7,23,646,669
60182,2017-12-01,8,49,1137,1186
60183,2017-12-01,9,50,476,526
60184,2017-12-01,10,47,256,303
60185,2017-12-01,11,73,286,359
60186,2017-12-01,12,81,357,438
60187,2017-12-01,13,119,399,518
60188,2017-12-01,14,121,366,487
60189,2017-12-01,15,102,460,562
60190,2017-12-01,16,114,709,823
60191,2017-12-01,17,88,1084,1172
60192,2017-12-01,18,58,750,808
60193,2017-12-01,19,45,448,493
60194,2017-12-01,20,29,268,297
60195,2017-12-01,21,28,191,219
60196,2017-12-01,22,25,170,195
60197,2017-12-01,23,15,120,135
60198,2017-12-02,0,14,92,106
60199,2017-12-02,1,19,57,76
60200,2017-12-02,2,12,51,63
60201,2017-12-02,3,4,22,26
60202,2017-12-02,4,2,4,6
60203,2017-12-02,5,2,7,9
60204,2017-12-02,6,4,29,33
60205,2017-12-02,7,4,90,94
60206,2017-12-02,8,37,193,230
60207,2017-12-02,9,32,311,343
60208,2017-12-02,10,105,429,534
60209,2017-12-02,11,172,443,615
60210,2017-12-02,12,178,500,678
60211,2017-12-02,13,251,459,710
60212,2017-12-02,14,223,433,656
60213,2017-12-02,15,243,484,727
60214,2017-12-02,16,234,444,678
60215,2017-12-02,17,179,415,594
60216,2017-12-02,18,78,328,406
60217,2017-12-02,19,37,231,268
60218,2017-12-02,20,35,188,223
60219,2017-12-02,21,21,149,170
60220,2017-12-02,22,26,137,163
60221,2017-12-02,23,17,133,150
60222,2017-12-03,0,17,101,118
60223,2017-12-03,1,13,74,87
60224,2017-12-03,2,15,45,60
60225,2017-12-03,3,11,22,33
60226,2017-12-03,4,3,9,12
60227,2017-12-03,5,0,8,8
60228,2017-12-03,6,2,20,22
60229,2017-12-03,7,7,43,50
60230,2017-12-03,8,23,120,143
60231,2017-12-03,9,69,208,277
60232,2017-12-03,10,124,348,472
60233,2017-12-03,11,135,386,521
60234,2017-12-03,12,170,486,656
60235,2017-12-03,13,198,507,705
60236,2017-12-03,14,246,475,721
60237,2017-12-03,15,216,486,702
60238,2017-12-03,16,141,444,585
60239,2017-12-03,17,89,377,466
60240,2017-12-03,18,45,298,343
60241,2017-12-03,19,38,221,259
60242,2017-12-03,20,24,155,179
60243,2017-12-03,21,18,118,136
60244,2017-12-03,22,17,77,94
60245,2017-12-03,23,7,50,57
60246,2017-12-04,0,7,25,32
60247,2017-12-04,1,1,3,4
60248,2017-12-04,2,0,5,5
60249,2017-12-04,3,1,3,4
60250,2017-12-04,4,0,12,12
60251,2017-12-04,5,1,76,77
60252,2017-12-04,6,7,303,310
60253,2017-12-04,7,16,659,675
60254,2017-12-04,8,27,1037,1064
60255,2017-12-04,9,39,410,449
60256,2017-12-04,10,35,210,245
60257,2017-12-04,11,44,228,272
60258,2017-12-04,12,48,311,359
60259,2017-12-04,13,54,269,323
60260,2017-12-04,14,81,267,348
60261,2017-12-04,15,77,373,450
60262,2017-12-04,16,69,640,709
60263,2017-12-04,17,58,1109,1167
60264,2017-12-04,18,45,931,976
60265,2017-12-04,19,38,553,591
60266,2017-12-04,20,16,314,330
60267,2017-12-04,21,28,231,259
60268,2017-12-04,22,16,134,150
60269,2017-12-04,23,13,61,74
60270,2017-12-05,0,11,32,43
60271,2017-12-05,1,7,5,12
60272,2017-12-05,2,4,7,11
60273,2017-12-05,3,4,4,8
60274,2017-12-05,4,0,18,18
60275,2017-12-05,5,2,74,76
60276,2017-12-05,6,8,309,317
60277,2017-12-05,7,19,782,801
60278,2017-12-05,8,40,1222,1262
60279,2017-12-05,9,29,462,491
60280,2017-12-05,10,32,196,228
60281,2017-12-05,11,33,250,283
60282,2017-12-05,12,63,315,378
60283,2017-12-05,13,46,315,361
60284,2017-12-05,14,58,268,326
60285,2017-12-05,15,58,398,456
60286,2017-12-05,16,54,677,731
60287,2017-12-05,17,58,1004,1062
60288,2017-12-05,18,25,602,627
60289,2017-12-05,19,12,205,217
60290,2017-12-05,20,11,151,162
60291,2017-12-05,21,9,197,206
60292,2017-12-05,22,13,102,115
60293,2017-12-05,23,4,97,101
60294,2017-12-06,0,6,34,40
60295,2017-12-06,1,1,16,17
60296,2017-12-06,2,1,4,5
60297,2017-12-06,3,1,2,3
60298,2017-12-06,4,1,16,17
60299,2017-12-06,5,1,89,90
60300,2017-12-06,6,8,287,295
60301,2017-12-06,7,19,745,764
60302,2017-12-06,8,28,1060,1088
60303,2017-12-06,9,27,466,493
60304,2017-12-06,10,27,199,226
60305,2017-12-06,11,33,195,228
60306,2017-12-06,12,31,308,339
60307,2017-12-06,13,40,290,330
60308,2017-12-06,14,34,249,283
60309,2017-12-06,15,28,356,384
60310,2017-12-06,16,42,597,639
60311,2017-12-06,17,45,941,986
60312,2017-12-06,18,47,874,921
60313,2017-12-06,19,27,487,514
60314,2017-12-06,20,16,367,383
60315,2017-12-06,21,16,223,239
60316,2017-12-06,22,17,149,166
60317,2017-12-06,23,17,74,91
60318,2017-12-07,0,10,41,51
60319,2017-12-07,1,4,13,17
60320,2017-12-07,2,2,5,7
60321,2017-12-07,3,3,2,5
60322,2017-12-07,4,2,14,16
60323,2017-12-07,5,1,82,83
60324,2017-12-07,6,5,277,282
60325,2017-12-07,7,18,752,770
60326,2017-12-07,8,37,1083,1120
60327,2017-12-07,9,41,482,523
60328,2017-12-07,10,28,211,239
60329,2017-12-07,11,53,239,292
60330,2017-12-07,12,44,282,326
60331,2017-12-07,13,38,250,288
60332,2017-12-07,14,57,291,348
60333,2017-12-07,15,70,336,406
60334,2017-12-07,16,52,593,645
60335,2017-12-07,17,66,964,1030
60336,2017-12-07,18,54,837,891
60337,2017-12-07,19,35,517,552
60338,2017-12-07,20,22,292,314
60339,2017-12-07,21,15,238,253
60340,2017-12-07,22,14,148,162
60341,2017-12-07,23,14,86,100
60342,2017-12-08,0,3,26,29
60343,2017-12-08,1,2,17,19
60344,2017-12-08,2,1,15,16
60345,2017-12-08,3,0,10,10
60346,2017-12-08,4,1,17,18
60347,2017-12-08,5,1,73,74
60348,2017-12-08,6,8,247,255
60349,2017-12-08,7,20,556,576
60350,2017-12-08,8,29,963,992
60351,2017-12-08,9,36,515,551
60352,2017-12-08,10,44,244,288
60353,2017-12-08,11,52,245,297
60354,2017-12-08,12,58,305,363
60355,2017-12-08,13,45,310,355
60356,2017-12-08,14,56,297,353
60357,2017-12-08,15,43,377,420
60358,2017-12-08,16,80,576,656
60359,2017-12-08,17,46,807,853
60360,2017-12-08,18,34,581,615
60361,2017-12-08,19,27,374,401
60362,2017-12-08,20,34,226,260
60363,2017-12-08,21,27,170,197
60364,2017-12-08,22,28,136,164
60365,2017-12-08,23,18,101,119
60366,2017-12-09,0,10,73,83
60367,2017-12-09,1,9,45,54
60368,2017-12-09,2,3,41,44
60369,2017-12-09,3,2,17,19
60370,2017-12-09,4,4,4,8
60371,2017-12-09,5,1,6,7
60372,2017-12-09,6,1,15,16
60373,2017-12-09,7,6,73,79
60374,2017-12-09,8,6,131,137
60375,2017-12-09,9,8,158,166
60376,2017-12-09,10,11,165,176
60377,2017-12-09,11,6,165,171
60378,2017-12-09,12,22,162,184
60379,2017-12-09,13,18,157,175
60380,2017-12-09,14,9,126,135
60381,2017-12-09,15,9,126,135
60382,2017-12-09,16,14,130,144
60383,2017-12-09,17,11,122,133
60384,2017-12-09,18,5,95,100
60385,2017-12-09,19,8,87,95
60386,2017-12-09,20,10,86,96
60387,2017-12-09,21,2,56,58
60388,2017-12-09,22,9,63,72
60389,2017-12-09,23,0,59,59
60390,2017-12-10,0,4,44,48
60391,2017-12-10,1,6,44,50
60392,2017-12-10,2,2,19,21
60393,2017-12-10,3,2,19,21
60394,2017-12-10,4,1,12,13
60395,2017-12-10,5,1,9,10
60396,2017-12-10,6,1,20,21
60397,2017-12-10,7,7,71,78
60398,2017-12-10,8,9,97,106
60399,2017-12-10,9,18,145,163
60400,2017-12-10,10,38,236,274
60401,2017-12-10,11,42,278,320
60402,2017-12-10,12,54,299,353
60403,2017-12-10,13,65,293,358
60404,2017-12-10,14,65,301,366
60405,2017-12-10,15,67,335,402
60406,2017-12-10,16,54,343,397
60407,2017-12-10,17,42,260,302
60408,2017-12-10,18,27,238,265
60409,2017-12-10,19,26,175,201
60410,2017-12-10,20,17,103,120
60411,2017-12-10,21,15,116,131
60412,2017-12-10,22,14,73,87
60413,2017-12-10,23,2,42,44
60414,2017-12-11,0,2,26,28
60415,2017-12-11,1,1,4,5
60416,2017-12-11,2,0,4,4
60417,2017-12-11,3,0,1,1
60418,2017-12-11,4,1,9,10
60419,2017-12-11,5,1,73,74
60420,2017-12-11,6,3,226,229
60421,2017-12-11,7,12,627,639
60422,2017-12-11,8,23,1015,1038
60423,2017-12-11,9,31,424,455
60424,2017-12-11,10,29,197,226
60425,2017-12-11,11,46,206,252
60426,2017-12-11,12,39,292,331
60427,2017-12-11,13,39,295,334
60428,2017-12-11,14,53,257,310
60429,2017-12-11,15,56,320,376
60430,2017-12-11,16,39,543,582
60431,2017-12-11,17,25,1001,1026
60432,2017-12-11,18,30,783,813
60433,2017-12-11,19,26,445,471
60434,2017-12-11,20,16,270,286
60435,2017-12-11,21,15,205,220
60436,2017-12-11,22,4,100,104
60437,2017-12-11,23,6,51,57
60438,2017-12-12,0,5,24,29
60439,2017-12-12,1,3,10,13
60440,2017-12-12,2,1,6,7
60441,2017-12-12,3,0,3,3
60442,2017-12-12,4,0,8,8
60443,2017-12-12,5,1,86,87
60444,2017-12-12,6,5,277,282
60445,2017-12-12,7,8,710,718
60446,2017-12-12,8,39,1175,1214
60447,2017-12-12,9,41,496,537
60448,2017-12-12,10,41,194,235
60449,2017-12-12,11,44,224,268
60450,2017-12-12,12,42,266,308
60451,2017-12-12,13,36,256,292
60452,2017-12-12,14,41,214,255
60453,2017-12-12,15,37,328,365
60454,2017-12-12,16,40,521,561
60455,2017-12-12,17,31,909,940
60456,2017-12-12,18,22,739,761
60457,2017-12-12,19,12,346,358
60458,2017-12-12,20,7,209,216
60459,2017-12-12,21,4,141,145
60460,2017-12-12,22,3,81,84
60461,2017-12-12,23,0,38,38
60462,2017-12-13,0,0,21,21
60463,2017-12-13,1,2,4,6
60464,2017-12-13,2,0,7,7
60465,2017-12-13,3,0,5,5
60466,2017-12-13,4,0,6,6
60467,2017-12-13,5,0,52,52
60468,2017-12-13,6,1,196,197
60469,2017-12-13,7,13,448,461
60470,2017-12-13,8,20,828,848
60471,2017-12-13,9,17,368,385
60472,2017-12-13,10,12,165,177
60473,2017-12-13,11,11,152,163
60474,2017-12-13,12,9,190,199
60475,2017-12-13,13,13,185,198
60476,2017-12-13,14,17,184,201
60477,2017-12-13,15,14,245,259
60478,2017-12-13,16,17,410,427
60479,2017-12-13,17,25,717,742
60480,2017-12-13,18,17,559,576
60481,2017-12-13,19,12,331,343
60482,2017-12-13,20,8,197,205
60483,2017-12-13,21,3,177,180
60484,2017-12-13,22,8,114,122
60485,2017-12-13,23,3,71,74
60486,2017-12-14,0,1,27,28
60487,2017-12-14,1,4,13,17
60488,2017-12-14,2,1,3,4
60489,2017-12-14,3,2,3,5
60490,2017-12-14,4,0,7,7
60491,2017-12-14,5,4,65,69
60492,2017-12-14,6,1,254,255
60493,2017-12-14,7,13,598,611
60494,2017-12-14,8,23,1004,1027
60495,2017-12-14,9,22,409,431
60496,2017-12-14,10,14,182,196
60497,2017-12-14,11,22,184,206
60498,2017-12-14,12,16,244,260
60499,2017-12-14,13,21,242,263
60500,2017-12-14,14,27,227,254
60501,2017-12-14,15,33,336,369
60502,2017-12-14,16,33,471,504
60503,2017-12-14,17,34,789,823
60504,2017-12-14,18,16,664,680
60505,2017-12-14,19,19,387,406
60506,2017-12-14,20,10,227,237
60507,2017-12-14,21,12,197,209
60508,2017-12-14,22,7,139,146
60509,2017-12-14,23,7,76,83
60510,2017-12-15,0,2,47,49
60511,2017-12-15,1,2,31,33
60512,2017-12-15,2,2,11,13
60513,2017-12-15,3,2,1,3
60514,2017-12-15,4,1,8,9
60515,2017-12-15,5,1,58,59
60516,2017-12-15,6,2,199,201
60517,2017-12-15,7,12,466,478
60518,2017-12-15,8,23,842,865
60519,2017-12-15,9,16,456,472
60520,2017-12-15,10,15,198,213
60521,2017-12-15,11,8,230,238
60522,2017-12-15,12,29,228,257
60523,2017-12-15,13,17,175,192
60524,2017-12-15,14,10,141,151
60525,2017-12-15,15,10,198,208
60526,2017-12-15,16,5,256,261
60527,2017-12-15,17,7,399,406
60528,2017-12-15,18,11,299,310
60529,2017-12-15,19,2,177,179
60530,2017-12-15,20,8,102,110
60531,2017-12-15,21,2,114,116
60532,2017-12-15,22,7,75,82
60533,2017-12-15,23,4,56,60
60534,2017-12-16,0,6,39,45
60535,2017-12-16,1,3,36,39
60536,2017-12-16,2,4,27,31
60537,2017-12-16,3,2,16,18
60538,2017-12-16,4,0,5,5
60539,2017-12-16,5,1,6,7
60540,2017-12-16,6,1,20,21
60541,2017-12-16,7,2,75,77
60542,2017-12-16,8,8,144,152
60543,2017-12-16,9,25,190,215
60544,2017-12-16,10,47,278,325
60545,2017-12-16,11,69,355,424
60546,2017-12-16,12,87,386,473
60547,2017-12-16,13,93,333,426
60548,2017-12-16,14,115,375,490
60549,2017-12-16,15,126,387,513
60550,2017-12-16,16,92,368,460
60551,2017-12-16,17,77,310,387
60552,2017-12-16,18,29,257,286
60553,2017-12-16,19,28,206,234
60554,2017-12-16,20,23,129,152
60555,2017-12-16,21,38,99,137
60556,2017-12-16,22,28,118,146
60557,2017-12-16,23,27,94,121
60558,2017-12-17,0,7,69,76
60559,2017-12-17,1,5,55,60
60560,2017-12-17,2,3,33,36
60561,2017-12-17,3,2,23,25
60562,2017-12-17,4,0,9,9
60563,2017-12-17,5,0,9,9
60564,2017-12-17,6,2,14,16
60565,2017-12-17,7,4,47,51
60566,2017-12-17,8,7,126,133
60567,2017-12-17,9,47,176,223
60568,2017-12-17,10,54,275,329
60569,2017-12-17,11,87,319,406
60570,2017-12-17,12,118,406,524
60571,2017-12-17,13,101,386,487
60572,2017-12-17,14,123,394,517
60573,2017-12-17,15,110,360,470
60574,2017-12-17,16,80,361,441
60575,2017-12-17,17,92,282,374
60576,2017-12-17,18,33,227,260
60577,2017-12-17,19,25,213,238
60578,2017-12-17,20,32,147,179
60579,2017-12-17,21,29,112,141
60580,2017-12-17,22,5,85,90
60581,2017-12-17,23,2,44,46
60582,2017-12-18,0,6,21,27
60583,2017-12-18,1,8,11,19
60584,2017-12-18,2,2,15,17
60585,2017-12-18,3,1,8,9
60586,2017-12-18,4,1,12,13
60587,2017-12-18,5,1,64,65
60588,2017-12-18,6,7,248,255
60589,2017-12-18,7,10,614,624
60590,2017-12-18,8,52,1054,1106
60591,2017-12-18,9,48,543,591
60592,2017-12-18,10,37,223,260
60593,2017-12-18,11,76,254,330
60594,2017-12-18,12,91,338,429
60595,2017-12-18,13,89,309,398
60596,2017-12-18,14,131,276,407
60597,2017-12-18,15,87,358,445
60598,2017-12-18,16,87,600,687
60599,2017-12-18,17,75,1006,1081
60600,2017-12-18,18,60,814,874
60601,2017-12-18,19,51,480,531
60602,2017-12-18,20,38,265,303
60603,2017-12-18,21,39,209,248
60604,2017-12-18,22,31,131,162
60605,2017-12-18,23,20,76,96
60606,2017-12-19,0,10,50,60
60607,2017-12-19,1,5,7,12
60608,2017-12-19,2,0,7,7
60609,2017-12-19,3,2,5,7
60610,2017-12-19,4,1,14,15
60611,2017-12-19,5,8,78,86
60612,2017-12-19,6,8,290,298
60613,2017-12-19,7,16,681,697
60614,2017-12-19,8,44,1177,1221
60615,2017-12-19,9,37,498,535
60616,2017-12-19,10,74,238,312
60617,2017-12-19,11,94,325,419
60618,2017-12-19,12,114,369,483
60619,2017-12-19,13,127,344,471
60620,2017-12-19,14,120,329,449
60621,2017-12-19,15,141,444,585
60622,2017-12-19,16,103,624,727
60623,2017-12-19,17,113,1052,1165
60624,2017-12-19,18,77,859,936
60625,2017-12-19,19,43,512,555
60626,2017-12-19,20,37,312,349
60627,2017-12-19,21,47,227,274
60628,2017-12-19,22,20,157,177
60629,2017-12-19,23,9,71,80
60630,2017-12-20,0,13,39,52
60631,2017-12-20,1,4,11,15
60632,2017-12-20,2,0,10,10
60633,2017-12-20,3,1,7,8
60634,2017-12-20,4,4,11,15
60635,2017-12-20,5,3,90,93
60636,2017-12-20,6,3,275,278
60637,2017-12-20,7,26,680,706
60638,2017-12-20,8,31,1012,1043
60639,2017-12-20,9,34,503,537
60640,2017-12-20,10,51,229,280
60641,2017-12-20,11,67,259,326
60642,2017-12-20,12,73,324,397
60643,2017-12-20,13,50,306,356
60644,2017-12-20,14,69,287,356
60645,2017-12-20,15,74,371,445
60646,2017-12-20,16,74,554,628
60647,2017-12-20,17,73,881,954
60648,2017-12-20,18,32,679,711
60649,2017-12-20,19,49,379,428
60650,2017-12-20,20,19,233,252
60651,2017-12-20,21,21,163,184
60652,2017-12-20,22,24,147,171
60653,2017-12-20,23,23,68,91
60654,2017-12-21,0,12,30,42
60655,2017-12-21,1,3,17,20
60656,2017-12-21,2,2,6,8
60657,2017-12-21,3,0,5,5
60658,2017-12-21,4,2,9,11
60659,2017-12-21,5,1,65,66
60660,2017-12-21,6,2,206,208
60661,2017-12-21,7,11,491,502
60662,2017-12-21,8,28,835,863
60663,2017-12-21,9,45,402,447
60664,2017-12-21,10,34,216,250
60665,2017-12-21,11,67,238,305
60666,2017-12-21,12,79,327,406
60667,2017-12-21,13,68,260,328
60668,2017-12-21,14,58,291,349
60669,2017-12-21,15,66,370,436
60670,2017-12-21,16,57,508,565
60671,2017-12-21,17,58,744,802
60672,2017-12-21,18,22,527,549
60673,2017-12-21,19,25,300,325
60674,2017-12-21,20,12,167,179
60675,2017-12-21,21,18,142,160
60676,2017-12-21,22,8,106,114
60677,2017-12-21,23,5,59,64
60678,2017-12-22,0,4,41,45
60679,2017-12-22,1,5,11,16
60680,2017-12-22,2,2,7,9
60681,2017-12-22,3,0,9,9
60682,2017-12-22,4,2,7,9
60683,2017-12-22,5,1,48,49
60684,2017-12-22,6,5,159,164
60685,2017-12-22,7,12,302,314
60686,2017-12-22,8,20,524,544
60687,2017-12-22,9,31,344,375
60688,2017-12-22,10,45,217,262
60689,2017-12-22,11,93,262,355
60690,2017-12-22,12,66,334,400
60691,2017-12-22,13,90,395,485
60692,2017-12-22,14,107,414,521
60693,2017-12-22,15,106,507,613
60694,2017-12-22,16,93,415,508
60695,2017-12-22,17,80,374,454
60696,2017-12-22,18,52,294,346
60697,2017-12-22,19,28,141,169
60698,2017-12-22,20,33,125,158
60699,2017-12-22,21,29,102,131
60700,2017-12-22,22,30,100,130
60701,2017-12-22,23,29,64,93
60702,2017-12-23,0,3,37,40
60703,2017-12-23,1,10,24,34
60704,2017-12-23,2,3,18,21
60705,2017-12-23,3,6,7,13
60706,2017-12-23,4,1,5,6
60707,2017-12-23,5,0,7,7
60708,2017-12-23,6,1,24,25
60709,2017-12-23,7,8,52,60
60710,2017-12-23,8,12,79,91
60711,2017-12-23,9,47,153,200
60712,2017-12-23,10,57,171,228
60713,2017-12-23,11,69,197,266
60714,2017-12-23,12,59,206,265
60715,2017-12-23,13,48,206,254
60716,2017-12-23,14,72,148,220
60717,2017-12-23,15,29,106,135
60718,2017-12-23,16,47,131,178
60719,2017-12-23,17,17,77,94
60720,2017-12-23,18,3,34,37
60721,2017-12-23,19,11,51,62
60722,2017-12-23,20,4,49,53
60723,2017-12-23,21,11,44,55
60724,2017-12-23,22,17,43,60
60725,2017-12-23,23,24,36,60
60726,2017-12-24,0,3,26,29
60727,2017-12-24,1,7,17,24
60728,2017-12-24,2,6,15,21
60729,2017-12-24,3,2,10,12
60730,2017-12-24,4,3,10,13
60731,2017-12-24,5,0,4,4
60732,2017-12-24,6,0,16,16
60733,2017-12-24,7,0,24,24
60734,2017-12-24,8,23,60,83
60735,2017-12-24,9,23,99,122
60736,2017-12-24,10,47,135,182
60737,2017-12-24,11,46,158,204
60738,2017-12-24,12,47,159,206
60739,2017-12-24,13,43,147,190
60740,2017-12-24,14,52,125,177
60741,2017-12-24,15,46,131,177
60742,2017-12-24,16,36,122,158
60743,2017-12-24,17,15,84,99
60744,2017-12-24,18,19,58,77
60745,2017-12-24,19,16,49,65
60746,2017-12-24,20,8,42,50
60747,2017-12-24,21,8,30,38
60748,2017-12-24,22,10,20,30
60749,2017-12-24,23,9,30,39
60750,2017-12-25,0,1,17,18
60751,2017-12-25,1,0,8,8
60752,2017-12-25,2,0,4,4
60753,2017-12-25,3,4,4,8
60754,2017-12-25,4,1,3,4
60755,2017-12-25,5,1,5,6
60756,2017-12-25,6,0,8,8
60757,2017-12-25,7,3,14,17
60758,2017-12-25,8,3,22,25
60759,2017-12-25,9,12,43,55
60760,2017-12-25,10,9,30,39
60761,2017-12-25,11,40,50,90
60762,2017-12-25,12,36,53,89
60763,2017-12-25,13,54,63,117
60764,2017-12-25,14,55,75,130
60765,2017-12-25,15,46,79,125
60766,2017-12-25,16,30,59,89
60767,2017-12-25,17,18,50,68
60768,2017-12-25,18,5,21,26
60769,2017-12-25,19,2,38,40
60770,2017-12-25,20,3,16,19
60771,2017-12-25,21,4,25,29
60772,2017-12-25,22,1,11,12
60773,2017-12-25,23,0,15,15
60774,2017-12-26,0,2,10,12
60775,2017-12-26,1,0,3,3
60776,2017-12-26,2,1,4,5
60777,2017-12-26,3,1,3,4
60778,2017-12-26,4,0,6,6
60779,2017-12-26,5,0,15,15
60780,2017-12-26,6,0,60,60
60781,2017-12-26,7,2,126,128
60782,2017-12-26,8,17,181,198
60783,2017-12-26,9,13,154,167
60784,2017-12-26,10,26,118,144
60785,2017-12-26,11,26,117,143
60786,2017-12-26,12,37,143,180
60787,2017-12-26,13,56,138,194
60788,2017-12-26,14,40,167,207
60789,2017-12-26,15,37,178,215
60790,2017-12-26,16,77,230,307
60791,2017-12-26,17,22,240,262
60792,2017-12-26,18,17,176,193
60793,2017-12-26,19,14,102,116
60794,2017-12-26,20,2,78,80
60795,2017-12-26,21,4,69,73
60796,2017-12-26,22,5,35,40
60797,2017-12-26,23,4,31,35
60798,2017-12-27,0,3,12,15
60799,2017-12-27,1,0,3,3
60800,2017-12-27,3,2,6,8
60801,2017-12-27,4,0,7,7
60802,2017-12-27,5,2,23,25
60803,2017-12-27,6,6,99,105
60804,2017-12-27,7,8,198,206
60805,2017-12-27,8,10,327,337
60806,2017-12-27,9,38,203,241
60807,2017-12-27,10,32,136,168
60808,2017-12-27,11,43,141,184
60809,2017-12-27,12,41,166,207
60810,2017-12-27,13,36,145,181
60811,2017-12-27,14,39,157,196
60812,2017-12-27,15,39,210,249
60813,2017-12-27,16,33,252,285
60814,2017-12-27,17,27,297,324
60815,2017-12-27,18,13,209,222
60816,2017-12-27,19,6,135,141
60817,2017-12-27,20,0,76,76
60818,2017-12-27,21,2,64,66
60819,2017-12-27,22,5,40,45
60820,2017-12-27,23,1,28,29
60821,2017-12-28,0,0,13,13
60822,2017-12-28,1,0,6,6
60823,2017-12-28,2,0,5,5
60824,2017-12-28,3,1,5,6
60825,2017-12-28,4,1,9,10
60826,2017-12-28,5,0,25,25
60827,2017-12-28,6,0,81,81
60828,2017-12-28,7,8,160,168
60829,2017-12-28,8,9,298,307
60830,2017-12-28,9,12,193,205
60831,2017-12-28,10,13,112,125
60832,2017-12-28,11,13,127,140
60833,2017-12-28,12,22,151,173
60834,2017-12-28,13,24,131,155
60835,2017-12-28,14,17,118,135
60836,2017-12-28,15,36,175,211
60837,2017-12-28,16,27,241,268
60838,2017-12-28,17,17,274,291
60839,2017-12-28,18,14,204,218
60840,2017-12-28,19,2,116,118
60841,2017-12-28,20,6,74,80
60842,2017-12-28,21,7,38,45
60843,2017-12-28,22,11,38,49
60844,2017-12-28,23,8,24,32
60845,2017-12-29,0,3,18,21
60846,2017-12-29,1,1,5,6
60847,2017-12-29,2,0,7,7
60848,2017-12-29,3,0,3,3
60849,2017-12-29,4,0,6,6
60850,2017-12-29,5,0,28,28
60851,2017-12-29,6,4,72,76
60852,2017-12-29,7,5,129,134
60853,2017-12-29,8,8,223,231
60854,2017-12-29,9,14,190,204
60855,2017-12-29,10,16,118,134
60856,2017-12-29,11,29,139,168
60857,2017-12-29,12,35,203,238
60858,2017-12-29,13,45,195,240
60859,2017-12-29,14,36,184,220
60860,2017-12-29,15,32,220,252
60861,2017-12-29,16,50,271,321
60862,2017-12-29,17,21,228,249
60863,2017-12-29,18,14,152,166
60864,2017-12-29,19,6,127,133
60865,2017-12-29,20,7,56,63
60866,2017-12-29,21,5,66,71
60867,2017-12-29,22,10,53,63
60868,2017-12-29,23,3,51,54
60869,2017-12-30,0,8,30,38
60870,2017-12-30,1,2,18,20
60871,2017-12-30,2,1,9,10
60872,2017-12-30,3,0,8,8
60873,2017-12-30,4,0,4,4
60874,2017-12-30,5,1,2,3
60875,2017-12-30,6,1,13,14
60876,2017-12-30,7,1,17,18
60877,2017-12-30,8,3,55,58
60878,2017-12-30,9,9,70,79
60879,2017-12-30,10,8,99,107
60880,2017-12-30,11,17,137,154
60881,2017-12-30,12,33,135,168
60882,2017-12-30,13,26,142,168
60883,2017-12-30,14,17,162,179
60884,2017-12-30,15,35,156,191
60885,2017-12-30,16,33,151,184
60886,2017-12-30,17,19,102,121
60887,2017-12-30,18,9,91,100
60888,2017-12-30,19,11,79,90
60889,2017-12-30,20,1,53,54
60890,2017-12-30,21,7,47,54
60891,2017-12-30,22,1,30,31
60892,2017-12-30,23,0,23,23
60893,2017-12-31,0,1,14,15
60894,2017-12-31,1,4,7,11
60895,2017-12-31,2,1,11,12
60896,2017-12-31,3,0,6,6
60897,2017-12-31,4,0,7,7
60898,2017-12-31,5,0,2,2
60899,2017-12-31,6,0,5,5
60900,2017-12-31,7,0,22,22
60901,2017-12-31,8,1,41,42
60902,2017-12-31,9,5,86,91
60903,2017-12-31,10,6,92,98
60904,2017-12-31,11,11,85,96
60905,2017-12-31,12,20,126,146
60906,2017-12-31,13,14,135,149
60907,2017-12-31,14,14,128,142
60908,2017-12-31,15,9,120,129
60909,2017-12-31,16,11,113,124
60910,2017-12-31,17,8,91,99
60911,2017-12-31,18,0,67,67
60912,2017-12-31,19,4,55,59
60913,2017-12-31,20,0,30,30
60914,2017-12-31,21,2,44,46
60915,2017-12-31,22,4,21,25
60916,2017-12-31,23,1,13,14
60917,2018-01-01,0,6,28,34
60918,2018-01-01,1,11,38,49
60919,2018-01-01,2,7,30,37
60920,2018-01-01,3,1,8,9
60921,2018-01-01,4,2,10,12
60922,2018-01-01,5,3,5,8
60923,2018-01-01,6,0,9,9
60924,2018-01-01,7,1,10,11
60925,2018-01-01,8,0,19,19
60926,2018-01-01,9,1,30,31
60927,2018-01-01,10,6,55,61
60928,2018-01-01,11,11,86,97
60929,2018-01-01,12,21,83,104
60930,2018-01-01,13,19,97,116
60931,2018-01-01,14,17,96,113
60932,2018-01-01,15,12,112,124
60933,2018-01-01,16,6,82,88
60934,2018-01-01,17,6,81,87
60935,2018-01-01,18,6,45,51
60936,2018-01-01,19,2,54,56
60937,2018-01-01,20,2,39,41
60938,2018-01-01,21,3,24,27
60939,2018-01-01,22,2,18,20
60940,2018-01-01,23,0,9,9
60941,2018-01-02,0,0,3,3
60942,2018-01-02,1,3,3,6
60943,2018-01-02,2,1,3,4
60944,2018-01-02,3,0,4,4
60945,2018-01-02,4,0,10,10
60946,2018-01-02,5,0,43,43
60947,2018-01-02,6,1,134,135
60948,2018-01-02,7,5,279,284
60949,2018-01-02,8,7,494,501
60950,2018-01-02,9,4,253,257
60951,2018-01-02,10,6,102,108
60952,2018-01-02,11,9,115,124
60953,2018-01-02,12,19,139,158
60954,2018-01-02,13,17,140,157
60955,2018-01-02,14,20,120,140
60956,2018-01-02,15,21,188,209
60957,2018-01-02,16,25,319,344
60958,2018-01-02,17,13,480,493
60959,2018-01-02,18,5,366,371
60960,2018-01-02,19,8,204,212
60961,2018-01-02,20,8,92,100
60962,2018-01-02,21,5,65,70
60963,2018-01-02,22,2,41,43
60964,2018-01-02,23,0,16,16
60965,2018-01-03,0,1,8,9
60966,2018-01-03,1,0,2,2
60967,2018-01-03,2,0,3,3
60968,2018-01-03,3,0,5,5
60969,2018-01-03,4,0,12,12
60970,2018-01-03,5,0,47,47
60971,2018-01-03,6,0,145,145
60972,2018-01-03,7,6,336,342
60973,2018-01-03,8,8,618,626
60974,2018-01-03,9,13,309,322
60975,2018-01-03,10,19,133,152
60976,2018-01-03,11,19,125,144
60977,2018-01-03,12,23,166,189
60978,2018-01-03,13,19,158,177
60979,2018-01-03,14,30,132,162
60980,2018-01-03,15,29,232,261
60981,2018-01-03,16,31,337,368
60982,2018-01-03,17,30,639,669
60983,2018-01-03,18,17,504,521
60984,2018-01-03,19,16,240,256
60985,2018-01-03,20,6,136,142
60986,2018-01-03,21,6,94,100
60987,2018-01-03,22,4,63,67
60988,2018-01-03,23,2,25,27
60989,2018-01-04,0,0,9,9
60990,2018-01-04,1,1,5,6
60991,2018-01-04,3,0,3,3
60992,2018-01-04,4,0,7,7
60993,2018-01-04,5,0,22,22
60994,2018-01-04,6,0,46,46
60995,2018-01-04,7,2,85,87
60996,2018-01-04,8,3,203,206
60997,2018-01-04,9,4,181,185
60998,2018-01-04,10,5,153,158
60999,2018-01-04,11,3,104,107
61000,2018-01-04,12,10,81,91
61001,2018-01-04,13,4,84,88
61002,2018-01-04,14,3,92,95
61003,2018-01-04,15,1,108,109
61004,2018-01-04,16,1,186,187
61005,2018-01-04,17,15,330,345
61006,2018-01-04,18,6,274,280
61007,2018-01-04,19,5,156,161
61008,2018-01-04,20,1,67,68
61009,2018-01-04,21,1,54,55
61010,2018-01-04,22,0,31,31
61011,2018-01-04,23,1,21,22
61012,2018-01-05,0,1,8,9
61013,2018-01-05,1,0,3,3
61014,2018-01-05,4,0,4,4
61015,2018-01-05,5,0,33,33
61016,2018-01-05,6,0,68,68
61017,2018-01-05,7,1,171,172
61018,2018-01-05,8,5,382,387
61019,2018-01-05,9,1,184,185
61020,2018-01-05,10,5,97,102
61021,2018-01-05,11,5,89,94
61022,2018-01-05,12,6,128,134
61023,2018-01-05,13,3,108,111
61024,2018-01-05,14,7,100,107
61025,2018-01-05,15,3,146,149
61026,2018-01-05,16,10,225,235
61027,2018-01-05,17,4,361,365
61028,2018-01-05,18,4,244,248
61029,2018-01-05,19,1,127,128
61030,2018-01-05,20,1,64,65
61031,2018-01-05,21,4,45,49
61032,2018-01-05,22,1,37,38
61033,2018-01-05,23,0,23,23
61034,2018-01-06,0,1,15,16
61035,2018-01-06,1,0,12,12
61036,2018-01-06,2,0,5,5
61037,2018-01-06,3,1,5,6
61038,2018-01-06,4,0,3,3
61039,2018-01-06,5,0,5,5
61040,2018-01-06,6,0,5,5
61041,2018-01-06,7,0,21,21
61042,2018-01-06,8,1,54,55
61043,2018-01-06,9,1,87,88
61044,2018-01-06,10,2,123,125
61045,2018-01-06,11,5,127,132
61046,2018-01-06,12,9,134,143
61047,2018-01-06,13,5,122,127
61048,2018-01-06,14,5,116,121
61049,2018-01-06,15,11,132,143
61050,2018-01-06,16,3,111,114
61051,2018-01-06,17,4,69,73
61052,2018-01-06,18,1,95,96
61053,2018-01-06,19,0,54,54
61054,2018-01-06,20,0,53,53
61055,2018-01-06,21,0,37,37
61056,2018-01-06,22,2,34,36
61057,2018-01-06,23,1,18,19
61058,2018-01-07,0,1,23,24
61059,2018-01-07,1,1,11,12
61060,2018-01-07,2,0,13,13
61061,2018-01-07,3,0,8,8
61062,2018-01-07,4,0,6,6
61063,2018-01-07,5,0,6,6
61064,2018-01-07,6,0,5,5
61065,2018-01-07,7,0,27,27
61066,2018-01-07,8,3,47,50
61067,2018-01-07,9,0,77,77
61068,2018-01-07,10,14,111,125
61069,2018-01-07,11,5,115,120
61070,2018-01-07,12,13,162,175
61071,2018-01-07,13,19,150,169
61072,2018-01-07,14,21,140,161
61073,2018-01-07,15,13,154,167
61074,2018-01-07,16,7,147,154
61075,2018-01-07,17,8,132,140
61076,2018-01-07,18,5,93,98
61077,2018-01-07,19,3,68,71
61078,2018-01-07,20,7,55,62
61079,2018-01-07,21,2,35,37
61080,2018-01-07,22,3,26,29
61081,2018-01-07,23,1,16,17
61082,2018-01-08,0,0,7,7
61083,2018-01-08,1,0,3,3
61084,2018-01-08,2,0,5,5
61085,2018-01-08,3,0,5,5
61086,2018-01-08,4,0,9,9
61087,2018-01-08,5,0,54,54
61088,2018-01-08,6,2,167,169
61089,2018-01-08,7,6,407,413
61090,2018-01-08,8,16,701,717
61091,2018-01-08,9,6,300,306
61092,2018-01-08,10,13,141,154
61093,2018-01-08,11,9,143,152
61094,2018-01-08,12,20,216,236
61095,2018-01-08,13,15,173,188
61096,2018-01-08,14,16,185,201
61097,2018-01-08,15,19,187,206
61098,2018-01-08,16,24,280,304
61099,2018-01-08,17,10,391,401
61100,2018-01-08,18,7,214,221
61101,2018-01-08,19,1,130,131
61102,2018-01-08,20,4,64,68
61103,2018-01-08,21,1,61,62
61104,2018-01-08,22,3,41,44
61105,2018-01-08,23,2,22,24
61106,2018-01-09,0,3,21,24
61107,2018-01-09,1,2,3,5
61108,2018-01-09,2,0,9,9
61109,2018-01-09,3,0,4,4
61110,2018-01-09,4,0,6,6
61111,2018-01-09,5,1,49,50
61112,2018-01-09,6,1,154,155
61113,2018-01-09,7,6,346,352
61114,2018-01-09,8,17,699,716
61115,2018-01-09,9,11,340,351
61116,2018-01-09,10,27,136,163
61117,2018-01-09,11,28,137,165
61118,2018-01-09,12,25,192,217
61119,2018-01-09,13,35,212,247
61120,2018-01-09,14,40,159,199
61121,2018-01-09,15,43,285,328
61122,2018-01-09,16,37,494,531
61123,2018-01-09,17,42,865,907
61124,2018-01-09,18,26,703,729
61125,2018-01-09,19,17,383,400
61126,2018-01-09,20,14,254,268
61127,2018-01-09,21,7,146,153
61128,2018-01-09,22,9,94,103
61129,2018-01-09,23,1,41,42
61130,2018-01-10,0,4,9,13
61131,2018-01-10,1,0,8,8
61132,2018-01-10,2,2,6,8
61133,2018-01-10,3,0,4,4
61134,2018-01-10,4,0,10,10
61135,2018-01-10,5,1,70,71
61136,2018-01-10,6,5,224,229
61137,2018-01-10,7,15,594,609
61138,2018-01-10,8,19,959,978
61139,2018-01-10,9,22,379,401
61140,2018-01-10,10,11,175,186
61141,2018-01-10,11,28,173,201
61142,2018-01-10,12,32,229,261
61143,2018-01-10,13,39,194,233
61144,2018-01-10,14,35,195,230
61145,2018-01-10,15,50,288,338
61146,2018-01-10,16,40,510,550
61147,2018-01-10,17,66,860,926
61148,2018-01-10,18,27,726,753
61149,2018-01-10,19,23,367,390
61150,2018-01-10,20,17,256,273
61151,2018-01-10,21,38,189,227
61152,2018-01-10,22,29,111,140
61153,2018-01-10,23,7,55,62
61154,2018-01-11,0,1,20,21
61155,2018-01-11,1,1,4,5
61156,2018-01-11,2,2,4,6
61157,2018-01-11,3,1,2,3
61158,2018-01-11,4,2,14,16
61159,2018-01-11,5,0,75,75
61160,2018-01-11,6,6,259,265
61161,2018-01-11,7,15,641,656
61162,2018-01-11,8,29,1093,1122
61163,2018-01-11,9,29,404,433
61164,2018-01-11,10,29,196,225
61165,2018-01-11,11,42,197,239
61166,2018-01-11,12,51,273,324
61167,2018-01-11,13,62,268,330
61168,2018-01-11,14,58,246,304
61169,2018-01-11,15,62,351,413
61170,2018-01-11,16,81,544,625
61171,2018-01-11,17,84,999,1083
61172,2018-01-11,18,45,823,868
61173,2018-01-11,19,23,428,451
61174,2018-01-11,20,31,275,306
61175,2018-01-11,21,6,196,202
61176,2018-01-11,22,13,146,159
61177,2018-01-11,23,6,73,79
61178,2018-01-12,0,4,30,34
61179,2018-01-12,1,10,16,26
61180,2018-01-12,2,4,11,15
61181,2018-01-12,3,2,3,5
61182,2018-01-12,4,1,8,9
61183,2018-01-12,5,1,42,43
61184,2018-01-12,6,3,105,108
61185,2018-01-12,7,12,339,351
61186,2018-01-12,8,22,739,761
61187,2018-01-12,9,14,264,278
61188,2018-01-12,10,12,113,125
61189,2018-01-12,11,14,172,186
61190,2018-01-12,12,31,237,268
61191,2018-01-12,13,44,279,323
61192,2018-01-12,14,78,269,347
61193,2018-01-12,15,78,381,459
61194,2018-01-12,16,86,505,591
61195,2018-01-12,17,46,564,610
61196,2018-01-12,18,29,496,525
61197,2018-01-12,19,27,321,348
61198,2018-01-12,20,12,116,128
61199,2018-01-12,21,22,104,126
61200,2018-01-12,22,9,122,131
61201,2018-01-12,23,5,48,53
61202,2018-01-13,0,2,37,39
61203,2018-01-13,1,3,22,25
61204,2018-01-13,2,3,27,30
61205,2018-01-13,3,1,11,12
61206,2018-01-13,4,1,5,6
61207,2018-01-13,5,0,7,7
61208,2018-01-13,6,0,22,22
61209,2018-01-13,7,7,52,59
61210,2018-01-13,8,15,124,139
61211,2018-01-13,9,18,197,215
61212,2018-01-13,10,30,203,233
61213,2018-01-13,11,58,266,324
61214,2018-01-13,12,54,250,304
61215,2018-01-13,13,56,277,333
61216,2018-01-13,14,104,264,368
61217,2018-01-13,15,81,218,299
61218,2018-01-13,16,53,215,268
61219,2018-01-13,17,45,159,204
61220,2018-01-13,18,9,129,138
61221,2018-01-13,19,9,97,106
61222,2018-01-13,20,3,94,97
61223,2018-01-13,21,3,64,67
61224,2018-01-13,22,1,41,42
61225,2018-01-13,23,3,38,41
61226,2018-01-14,0,4,29,33
61227,2018-01-14,1,0,27,27
61228,2018-01-14,2,3,5,8
61229,2018-01-14,3,0,8,8
61230,2018-01-14,4,0,5,5
61231,2018-01-14,5,0,3,3
61232,2018-01-14,6,4,8,12
61233,2018-01-14,7,0,32,32
61234,2018-01-14,8,3,48,51
61235,2018-01-14,9,8,88,96
61236,2018-01-14,10,31,135,166
61237,2018-01-14,11,25,204,229
61238,2018-01-14,12,29,208,237
61239,2018-01-14,13,29,195,224
61240,2018-01-14,14,34,175,209
61241,2018-01-14,15,44,207,251
61242,2018-01-14,16,12,186,198
61243,2018-01-14,17,19,138,157
61244,2018-01-14,18,11,123,134
61245,2018-01-14,19,6,69,75
61246,2018-01-14,20,0,60,60
61247,2018-01-14,21,7,50,57
61248,2018-01-14,22,2,41,43
61249,2018-01-14,23,1,24,25
61250,2018-01-15,0,2,18,20
61251,2018-01-15,1,3,14,17
61252,2018-01-15,2,2,6,8
61253,2018-01-15,3,0,4,4
61254,2018-01-15,4,0,13,13
61255,2018-01-15,5,0,17,17
61256,2018-01-15,6,2,25,27
61257,2018-01-15,7,1,74,75
61258,2018-01-15,8,12,147,159
61259,2018-01-15,9,7,162,169
61260,2018-01-15,10,20,175,195
61261,2018-01-15,11,33,208,241
61262,2018-01-15,12,37,207,244
61263,2018-01-15,13,33,228,261
61264,2018-01-15,14,28,225,253
61265,2018-01-15,15,46,232,278
61266,2018-01-15,16,32,260,292
61267,2018-01-15,17,29,310,339
61268,2018-01-15,18,18,238,256
61269,2018-01-15,19,4,166,170
61270,2018-01-15,20,9,96,105
61271,2018-01-15,21,8,85,93
61272,2018-01-15,22,4,51,55
61273,2018-01-15,23,2,30,32
61274,2018-01-16,0,1,7,8
61275,2018-01-16,1,2,5,7
61276,2018-01-16,2,0,6,6
61277,2018-01-16,3,0,2,2
61278,2018-01-16,4,0,13,13
61279,2018-01-16,5,2,70,72
61280,2018-01-16,6,5,211,216
61281,2018-01-16,7,8,519,527
61282,2018-01-16,8,21,978,999
61283,2018-01-16,9,17,459,476
61284,2018-01-16,10,10,171,181
61285,2018-01-16,11,17,208,225
61286,2018-01-16,12,22,223,245
61287,2018-01-16,13,18,187,205
61288,2018-01-16,14,36,173,209
61289,2018-01-16,15,31,300,331
61290,2018-01-16,16,31,455,486
61291,2018-01-16,17,38,872,910
61292,2018-01-16,18,19,718,737
61293,2018-01-16,19,28,372,400
61294,2018-01-16,20,8,245,253
61295,2018-01-16,21,12,153,165
61296,2018-01-16,22,33,68,101
61297,2018-01-16,23,25,37,62
61298,2018-01-17,0,2,7,9
61299,2018-01-17,1,2,9,11
61300,2018-01-17,2,0,4,4
61301,2018-01-17,3,0,5,5
61302,2018-01-17,4,0,6,6
61303,2018-01-17,5,0,51,51
61304,2018-01-17,6,4,92,96
61305,2018-01-17,7,2,264,266
61306,2018-01-17,8,13,478,491
61307,2018-01-17,9,6,257,263
61308,2018-01-17,10,3,122,125
61309,2018-01-17,11,9,117,126
61310,2018-01-17,12,4,154,158
61311,2018-01-17,13,7,131,138
61312,2018-01-17,14,4,118,122
61313,2018-01-17,15,9,167,176
61314,2018-01-17,16,8,338,346
61315,2018-01-17,17,13,599,612
61316,2018-01-17,18,17,485,502
61317,2018-01-17,19,8,249,257
61318,2018-01-17,20,3,163,166
61319,2018-01-17,21,5,96,101
61320,2018-01-17,22,4,46,50
61321,2018-01-17,23,1,26,27
61322,2018-01-18,0,0,12,12
61323,2018-01-18,1,0,2,2
61324,2018-01-18,2,0,3,3
61325,2018-01-18,3,0,1,1
61326,2018-01-18,4,2,5,7
61327,2018-01-18,5,1,55,56
61328,2018-01-18,6,3,168,171
61329,2018-01-18,7,5,414,419
61330,2018-01-18,8,13,733,746
61331,2018-01-18,9,14,412,426
61332,2018-01-18,10,9,161,170
61333,2018-01-18,11,16,171,187
61334,2018-01-18,12,30,239,269
61335,2018-01-18,13,38,206,244
61336,2018-01-18,14,27,178,205
61337,2018-01-18,15,41,255,296
61338,2018-01-18,16,37,445,482
61339,2018-01-18,17,38,798,836
61340,2018-01-18,18,17,630,647
61341,2018-01-18,19,11,405,416
61342,2018-01-18,20,11,274,285
61343,2018-01-18,21,9,155,164
61344,2018-01-18,22,4,102,106
61345,2018-01-18,23,0,47,47
61346,2018-01-19,0,2,24,26
61347,2018-01-19,1,1,8,9
61348,2018-01-19,2,0,4,4
61349,2018-01-19,3,0,5,5
61350,2018-01-19,4,4,7,11
61351,2018-01-19,5,2,53,55
61352,2018-01-19,6,5,177,182
61353,2018-01-19,7,3,430,433
61354,2018-01-19,8,23,863,886
61355,2018-01-19,9,36,444,480
61356,2018-01-19,10,20,200,220
61357,2018-01-19,11,43,278,321
61358,2018-01-19,12,73,326,399
61359,2018-01-19,13,83,311,394
61360,2018-01-19,14,69,271,340
61361,2018-01-19,15,100,389,489
61362,2018-01-19,16,113,588,701
61363,2018-01-19,17,69,882,951
61364,2018-01-19,18,50,630,680
61365,2018-01-19,19,25,374,399
61366,2018-01-19,20,18,194,212
61367,2018-01-19,21,27,156,183
61368,2018-01-19,22,15,115,130
61369,2018-01-19,23,13,81,94
61370,2018-01-20,0,6,64,70
61371,2018-01-20,1,11,33,44
61372,2018-01-20,2,3,23,26
61373,2018-01-20,3,6,15,21
61374,2018-01-20,4,2,2,4
61375,2018-01-20,5,1,11,12
61376,2018-01-20,6,1,16,17
61377,2018-01-20,7,5,61,66
61378,2018-01-20,8,20,152,172
61379,2018-01-20,9,55,236,291
61380,2018-01-20,10,115,381,496
61381,2018-01-20,11,206,485,691
61382,2018-01-20,12,214,539,753
61383,2018-01-20,13,279,543,822
61384,2018-01-20,14,288,583,871
61385,2018-01-20,15,289,627,916
61386,2018-01-20,16,331,543,874
61387,2018-01-20,17,211,425,636
61388,2018-01-20,18,69,302,371
61389,2018-01-20,19,54,234,288
61390,2018-01-20,20,41,154,195
61391,2018-01-20,21,27,102,129
61392,2018-01-20,22,25,131,156
61393,2018-01-20,23,21,83,104
61394,2018-01-21,0,13,71,84
61395,2018-01-21,1,14,67,81
61396,2018-01-21,2,7,44,51
61397,2018-01-21,3,0,21,21
61398,2018-01-21,4,1,9,10
61399,2018-01-21,5,0,5,5
61400,2018-01-21,6,0,17,17
61401,2018-01-21,7,7,48,55
61402,2018-01-21,8,25,120,145
61403,2018-01-21,9,44,197,241
61404,2018-01-21,10,99,362,461
61405,2018-01-21,11,147,399,546
61406,2018-01-21,12,132,444,576
61407,2018-01-21,13,195,420,615
61408,2018-01-21,14,240,561,801
61409,2018-01-21,15,207,504,711
61410,2018-01-21,16,158,407,565
61411,2018-01-21,17,92,346,438
61412,2018-01-21,18,66,319,385
61413,2018-01-21,19,28,181,209
61414,2018-01-21,20,18,155,173
61415,2018-01-21,21,35,142,177
61416,2018-01-21,22,27,87,114
61417,2018-01-21,23,16,44,60
61418,2018-01-22,0,9,21,30
61419,2018-01-22,1,1,7,8
61420,2018-01-22,2,2,8,10
61421,2018-01-22,3,1,8,9
61422,2018-01-22,4,0,12,12
61423,2018-01-22,5,0,65,65
61424,2018-01-22,6,7,252,259
61425,2018-01-22,7,12,629,641
61426,2018-01-22,8,28,1072,1100
61427,2018-01-22,9,27,486,513
61428,2018-01-22,10,44,243,287
61429,2018-01-22,11,41,342,383
61430,2018-01-22,12,65,367,432
61431,2018-01-22,13,72,396,468
61432,2018-01-22,14,81,307,388
61433,2018-01-22,15,116,413,529
61434,2018-01-22,16,110,621,731
61435,2018-01-22,17,107,1108,1215
61436,2018-01-22,18,55,863,918
61437,2018-01-22,19,44,529,573
61438,2018-01-22,20,47,326,373
61439,2018-01-22,21,24,214,238
61440,2018-01-22,22,11,125,136
61441,2018-01-22,23,8,55,63
61442,2018-01-23,0,0,27,27
61443,2018-01-23,1,1,8,9
61444,2018-01-23,2,12,8,20
61445,2018-01-23,3,0,4,4
61446,2018-01-23,4,0,8,8
61447,2018-01-23,5,0,47,47
61448,2018-01-23,6,3,130,133
61449,2018-01-23,7,13,401,414
61450,2018-01-23,8,20,1022,1042
61451,2018-01-23,9,39,504,543
61452,2018-01-23,10,15,255,270
61453,2018-01-23,11,46,230,276
61454,2018-01-23,12,55,316,371
61455,2018-01-23,13,42,314,356
61456,2018-01-23,14,71,253,324
61457,2018-01-23,15,54,346,400
61458,2018-01-23,16,63,643,706
61459,2018-01-23,17,50,1131,1181
61460,2018-01-23,18,47,854,901
61461,2018-01-23,19,30,471,501
61462,2018-01-23,20,14,276,290
61463,2018-01-23,21,17,196,213
61464,2018-01-23,22,9,89,98
61465,2018-01-23,23,11,55,66
61466,2018-01-24,0,8,18,26
61467,2018-01-24,1,2,10,12
61468,2018-01-24,2,0,7,7
61469,2018-01-24,3,0,2,2
61470,2018-01-24,4,0,11,11
61471,2018-01-24,5,1,84,85
61472,2018-01-24,6,6,300,306
61473,2018-01-24,7,7,690,697
61474,2018-01-24,8,34,1146,1180
61475,2018-01-24,9,18,460,478
61476,2018-01-24,10,20,195,215
61477,2018-01-24,11,16,223,239
61478,2018-01-24,12,24,255,279
61479,2018-01-24,13,27,246,273
61480,2018-01-24,14,30,213,243
61481,2018-01-24,15,29,320,349
61482,2018-01-24,16,45,516,561
61483,2018-01-24,17,38,950,988
61484,2018-01-24,18,29,730,759
61485,2018-01-24,19,27,415,442
61486,2018-01-24,20,2,221,223
61487,2018-01-24,21,6,170,176
61488,2018-01-24,22,7,109,116
61489,2018-01-24,23,2,59,61
61490,2018-01-25,0,6,16,22
61491,2018-01-25,1,1,1,2
61492,2018-01-25,2,0,3,3
61493,2018-01-25,3,0,6,6
61494,2018-01-25,4,0,13,13
61495,2018-01-25,5,1,63,64
61496,2018-01-25,6,1,238,239
61497,2018-01-25,7,8,576,584
61498,2018-01-25,8,20,958,978
61499,2018-01-25,9,8,426,434
61500,2018-01-25,10,19,180,199
61501,2018-01-25,11,18,205,223
61502,2018-01-25,12,23,238,261
61503,2018-01-25,13,40,200,240
61504,2018-01-25,14,22,207,229
61505,2018-01-25,15,37,313,350
61506,2018-01-25,16,47,482,529
61507,2018-01-25,17,44,879,923
61508,2018-01-25,18,18,684,702
61509,2018-01-25,19,18,400,418
61510,2018-01-25,20,9,255,264
61511,2018-01-25,21,9,198,207
61512,2018-01-25,22,9,125,134
61513,2018-01-25,23,8,64,72
61514,2018-01-26,0,6,20,26
61515,2018-01-26,1,1,8,9
61516,2018-01-26,2,2,3,5
61517,2018-01-26,3,3,5,8
61518,2018-01-26,4,1,11,12
61519,2018-01-26,5,2,62,64
61520,2018-01-26,6,6,186,192
61521,2018-01-26,7,9,486,495
61522,2018-01-26,8,19,854,873
61523,2018-01-26,9,30,439,469
61524,2018-01-26,10,37,195,232
61525,2018-01-26,11,42,246,288
61526,2018-01-26,12,61,333,394
61527,2018-01-26,13,59,303,362
61528,2018-01-26,14,50,271,321
61529,2018-01-26,15,67,353,420
61530,2018-01-26,16,64,533,597
61531,2018-01-26,17,71,840,911
61532,2018-01-26,18,27,596,623
61533,2018-01-26,19,25,344,369
61534,2018-01-26,20,14,195,209
61535,2018-01-26,21,18,148,166
61536,2018-01-26,22,13,121,134
61537,2018-01-26,23,9,105,114
61538,2018-01-27,0,9,56,65
61539,2018-01-27,1,11,50,61
61540,2018-01-27,2,7,27,34
61541,2018-01-27,3,1,18,19
61542,2018-01-27,4,2,11,13
61543,2018-01-27,5,0,9,9
61544,2018-01-27,6,3,26,29
61545,2018-01-27,7,6,75,81
61546,2018-01-27,8,29,169,198
61547,2018-01-27,9,68,254,322
61548,2018-01-27,10,139,389,528
61549,2018-01-27,11,159,468,627
61550,2018-01-27,12,284,545,829
61551,2018-01-27,13,362,556,918
61552,2018-01-27,14,445,595,1040
61553,2018-01-27,15,458,571,1029
61554,2018-01-27,16,330,505,835
61555,2018-01-27,17,204,380,584
61556,2018-01-27,18,106,289,395
61557,2018-01-27,19,66,253,319
61558,2018-01-27,20,61,212,273
61559,2018-01-27,21,31,137,168
61560,2018-01-27,22,52,139,191
61561,2018-01-27,23,29,110,139
61562,2018-01-28,0,26,76,102
61563,2018-01-28,1,14,48,62
61564,2018-01-28,2,15,29,44
61565,2018-01-28,3,1,9,10
61566,2018-01-28,4,2,6,8
61567,2018-01-28,5,0,7,7
61568,2018-01-28,6,3,18,21
61569,2018-01-28,7,5,45,50
61570,2018-01-28,8,12,66,78
61571,2018-01-28,9,10,80,90
61572,2018-01-28,10,5,132,137
61573,2018-01-28,11,20,154,174
61574,2018-01-28,12,30,179,209
61575,2018-01-28,13,29,152,181
61576,2018-01-28,14,35,202,237
61577,2018-01-28,15,44,222,266
61578,2018-01-28,16,53,220,273
61579,2018-01-28,17,31,239,270
61580,2018-01-28,18,16,179,195
61581,2018-01-28,19,13,168,181
61582,2018-01-28,20,11,81,92
61583,2018-01-28,21,4,67,71
61584,2018-01-28,22,7,59,66
61585,2018-01-28,23,1,42,43
61586,2018-01-29,0,3,8,11
61587,2018-01-29,1,1,8,9
61588,2018-01-29,2,1,8,9
61589,2018-01-29,3,1,5,6
61590,2018-01-29,4,0,11,11
61591,2018-01-29,5,2,69,71
61592,2018-01-29,6,3,236,239
61593,2018-01-29,7,9,592,601
61594,2018-01-29,8,21,989,1010
61595,2018-01-29,9,14,427,441
61596,2018-01-29,10,25,167,192
61597,2018-01-29,11,38,182,220
61598,2018-01-29,12,30,229,259
61599,2018-01-29,13,21,226,247
61600,2018-01-29,14,33,200,233
61601,2018-01-29,15,36,312,348
61602,2018-01-29,16,35,516,551
61603,2018-01-29,17,43,910,953
61604,2018-01-29,18,30,712,742
61605,2018-01-29,19,17,444,461
61606,2018-01-29,20,12,272,284
61607,2018-01-29,21,12,192,204
61608,2018-01-29,22,12,96,108
61609,2018-01-29,23,8,47,55
61610,2018-01-30,0,6,16,22
61611,2018-01-30,1,5,10,15
61612,2018-01-30,2,2,5,7
61613,2018-01-30,3,2,3,5
61614,2018-01-30,4,1,9,10
61615,2018-01-30,5,0,62,62
61616,2018-01-30,6,4,192,196
61617,2018-01-30,7,13,505,518
61618,2018-01-30,8,17,900,917
61619,2018-01-30,9,25,404,429
61620,2018-01-30,10,10,173,183
61621,2018-01-30,11,10,155,165
61622,2018-01-30,12,7,231,238
61623,2018-01-30,13,15,173,188
61624,2018-01-30,14,22,152,174
61625,2018-01-30,15,12,208,220
61626,2018-01-30,16,19,361,380
61627,2018-01-30,17,15,711,726
61628,2018-01-30,18,20,586,606
61629,2018-01-30,19,11,326,337
61630,2018-01-30,20,5,210,215
61631,2018-01-30,21,1,111,112
61632,2018-01-30,22,9,85,94
61633,2018-01-30,23,3,41,44
61634,2018-01-31,0,0,10,10
61635,2018-01-31,1,0,6,6
61636,2018-01-31,2,0,2,2
61637,2018-01-31,3,0,1,1
61638,2018-01-31,4,0,7,7
61639,2018-01-31,5,2,64,66
61640,2018-01-31,6,6,201,207
61641,2018-01-31,7,12,490,502
61642,2018-01-31,8,19,808,827
61643,2018-01-31,9,17,429,446
61644,2018-01-31,10,20,162,182
61645,2018-01-31,11,25,171,196
61646,2018-01-31,12,25,206,231
61647,2018-01-31,13,19,193,212
61648,2018-01-31,14,24,178,202
61649,2018-01-31,15,36,259,295
61650,2018-01-31,16,37,454,491
61651,2018-01-31,17,23,825,848
61652,2018-01-31,18,29,644,673
61653,2018-01-31,19,11,368,379
61654,2018-01-31,20,10,242,252
61655,2018-01-31,21,5,175,180
61656,2018-01-31,22,3,113,116
61657,2018-01-31,23,3,52,55
61658,2018-02-01,0,0,22,22
61659,2018-02-01,1,0,10,10
61660,2018-02-01,2,0,2,2
61661,2018-02-01,3,1,3,4
61662,2018-02-01,4,0,9,9
61663,2018-02-01,5,0,68,68
61664,2018-02-01,6,3,233,236
61665,2018-02-01,7,11,587,598
61666,2018-02-01,8,32,1033,1065
61667,2018-02-01,9,23,464,487
61668,2018-02-01,10,15,205,220
61669,2018-02-01,11,30,223,253
61670,2018-02-01,12,46,283,329
61671,2018-02-01,13,28,239,267
61672,2018-02-01,14,31,228,259
61673,2018-02-01,15,29,338,367
61674,2018-02-01,16,41,527,568
61675,2018-02-01,17,43,922,965
61676,2018-02-01,18,21,780,801
61677,2018-02-01,19,23,502,525
61678,2018-02-01,20,21,314,335
61679,2018-02-01,21,8,187,195
61680,2018-02-01,22,3,100,103
61681,2018-02-01,23,3,41,44
61682,2018-02-02,0,2,20,22
61683,2018-02-02,1,1,8,9
61684,2018-02-02,2,2,8,10
61685,2018-02-02,3,0,7,7
61686,2018-02-02,4,1,12,13
61687,2018-02-02,5,1,58,59
61688,2018-02-02,6,2,181,183
61689,2018-02-02,7,8,424,432
61690,2018-02-02,8,22,772,794
61691,2018-02-02,9,21,402,423
61692,2018-02-02,10,20,165,185
61693,2018-02-02,11,16,190,206
61694,2018-02-02,12,14,209,223
61695,2018-02-02,13,17,203,220
61696,2018-02-02,14,17,190,207
61697,2018-02-02,15,24,246,270
61698,2018-02-02,16,11,333,344
61699,2018-02-02,17,10,567,577
61700,2018-02-02,18,12,404,416
61701,2018-02-02,19,13,228,241
61702,2018-02-02,20,3,133,136
61703,2018-02-02,21,4,82,86
61704,2018-02-02,22,0,78,78
61705,2018-02-02,23,4,54,58
61706,2018-02-03,0,2,35,37
61707,2018-02-03,1,4,28,32
61708,2018-02-03,2,2,15,17
61709,2018-02-03,3,0,5,5
61710,2018-02-03,4,2,7,9
61711,2018-02-03,5,1,6,7
61712,2018-02-03,6,1,16,17
61713,2018-02-03,7,0,54,54
61714,2018-02-03,8,8,128,136
61715,2018-02-03,9,11,180,191
61716,2018-02-03,10,31,222,253
61717,2018-02-03,11,68,291,359
61718,2018-02-03,12,59,293,352
61719,2018-02-03,13,67,286,353
61720,2018-02-03,14,81,255,336
61721,2018-02-03,15,78,279,357
61722,2018-02-03,16,54,263,317
61723,2018-02-03,17,39,201,240
61724,2018-02-03,18,16,225,241
61725,2018-02-03,19,9,153,162
61726,2018-02-03,20,6,97,103
61727,2018-02-03,21,5,91,96
61728,2018-02-03,22,4,67,71
61729,2018-02-03,23,3,46,49
61730,2018-02-04,0,3,48,51
61731,2018-02-04,1,3,47,50
61732,2018-02-04,2,3,26,29
61733,2018-02-04,3,2,18,20
61734,2018-02-04,4,1,10,11
61735,2018-02-04,5,1,10,11
61736,2018-02-04,6,2,25,27
61737,2018-02-04,7,3,40,43
61738,2018-02-04,8,2,100,102
61739,2018-02-04,9,10,148,158
61740,2018-02-04,10,16,151,167
61741,2018-02-04,11,10,107,117
61742,2018-02-04,12,5,80,85
61743,2018-02-04,13,2,64,66
61744,2018-02-04,14,3,50,53
61745,2018-02-04,15,0,47,47
61746,2018-02-04,16,0,24,24
61747,2018-02-04,17,2,23,25
61748,2018-02-04,18,0,25,25
61749,2018-02-04,19,4,39,43
61750,2018-02-04,20,2,36,38
61751,2018-02-04,21,4,28,32
61752,2018-02-04,22,15,127,142
61753,2018-02-04,23,7,55,62
61754,2018-02-05,0,0,12,12
61755,2018-02-05,1,3,4,7
61756,2018-02-05,2,0,3,3
61757,2018-02-05,3,0,2,2
61758,2018-02-05,4,1,15,16
61759,2018-02-05,5,0,53,53
61760,2018-02-05,6,1,177,178
61761,2018-02-05,7,6,404,410
61762,2018-02-05,8,17,795,812
61763,2018-02-05,9,18,379,397
61764,2018-02-05,10,31,133,164
61765,2018-02-05,11,9,149,158
61766,2018-02-05,12,14,198,212
61767,2018-02-05,13,15,182,197
61768,2018-02-05,14,23,172,195
61769,2018-02-05,15,33,243,276
61770,2018-02-05,16,36,373,409
61771,2018-02-05,17,26,841,867
61772,2018-02-05,18,21,612,633
61773,2018-02-05,19,12,354,366
61774,2018-02-05,20,7,259,266
61775,2018-02-05,21,2,151,153
61776,2018-02-05,22,3,75,78
61777,2018-02-05,23,3,28,31
61778,2018-02-06,0,2,16,18
61779,2018-02-06,1,1,6,7
61780,2018-02-06,2,0,2,2
61781,2018-02-06,4,0,13,13
61782,2018-02-06,5,2,80,82
61783,2018-02-06,6,3,219,222
61784,2018-02-06,7,6,539,545
61785,2018-02-06,8,14,960,974
61786,2018-02-06,9,13,430,443
61787,2018-02-06,10,21,186,207
61788,2018-02-06,11,14,204,218
61789,2018-02-06,12,22,210,232
61790,2018-02-06,13,23,217,240
61791,2018-02-06,14,21,181,202
61792,2018-02-06,15,35,283,318
61793,2018-02-06,16,28,463,491
61794,2018-02-06,17,29,884,913
61795,2018-02-06,18,23,711,734
61796,2018-02-06,19,17,411,428
61797,2018-02-06,20,12,218,230
61798,2018-02-06,21,9,183,192
61799,2018-02-06,22,7,97,104
61800,2018-02-06,23,2,39,41
61801,2018-02-07,0,1,19,20
61802,2018-02-07,1,1,3,4
61803,2018-02-07,2,0,5,5
61804,2018-02-07,3,0,3,3
61805,2018-02-07,4,0,9,9
61806,2018-02-07,5,1,51,52
61807,2018-02-07,6,4,143,147
61808,2018-02-07,7,14,365,379
61809,2018-02-07,8,15,747,762
61810,2018-02-07,9,14,513,527
61811,2018-02-07,10,11,222,233
61812,2018-02-07,11,3,57,60
61813,2018-02-07,12,0,65,65
61814,2018-02-07,13,0,40,40
61815,2018-02-07,14,1,59,60
61816,2018-02-07,15,1,104,105
61817,2018-02-07,16,3,135,138
61818,2018-02-07,17,5,304,309
61819,2018-02-07,18,7,471,478
61820,2018-02-07,19,6,295,301
61821,2018-02-07,20,5,234,239
61822,2018-02-07,21,4,167,171
61823,2018-02-07,22,2,91,93
61824,2018-02-07,23,4,34,38
61825,2018-02-08,0,2,22,24
61826,2018-02-08,1,0,6,6
61827,2018-02-08,2,0,1,1
61828,2018-02-08,3,0,5,5
61829,2018-02-08,4,0,12,12
61830,2018-02-08,5,1,67,68
61831,2018-02-08,6,2,193,195
61832,2018-02-08,7,5,472,477
61833,2018-02-08,8,18,863,881
61834,2018-02-08,9,16,457,473
61835,2018-02-08,10,17,177,194
61836,2018-02-08,11,26,161,187
61837,2018-02-08,12,25,226,251
61838,2018-02-08,13,16,214,230
61839,2018-02-08,14,19,195,214
61840,2018-02-08,15,19,279,298
61841,2018-02-08,16,17,426,443
61842,2018-02-08,17,47,833,880
61843,2018-02-08,18,16,652,668
61844,2018-02-08,19,11,380,391
61845,2018-02-08,20,7,237,244
61846,2018-02-08,21,12,191,203
61847,2018-02-08,22,3,105,108
61848,2018-02-08,23,10,62,72
61849,2018-02-09,0,5,28,33
61850,2018-02-09,1,1,5,6
61851,2018-02-09,2,0,3,3
61852,2018-02-09,3,1,4,5
61853,2018-02-09,4,0,15,15
61854,2018-02-09,5,5,43,48
61855,2018-02-09,6,2,165,167
61856,2018-02-09,7,7,428,435
61857,2018-02-09,8,27,854,881
61858,2018-02-09,9,19,441,460
61859,2018-02-09,10,22,209,231
61860,2018-02-09,11,32,215,247
61861,2018-02-09,12,42,246,288
61862,2018-02-09,13,58,258,316
61863,2018-02-09,14,70,242,312
61864,2018-02-09,15,58,341,399
61865,2018-02-09,16,75,507,582
61866,2018-02-09,17,86,864,950
61867,2018-02-09,18,38,599,637
61868,2018-02-09,19,24,361,385
61869,2018-02-09,20,14,195,209
61870,2018-02-09,21,15,131,146
61871,2018-02-09,22,18,112,130
61872,2018-02-09,23,20,108,128
61873,2018-02-10,0,8,50,58
61874,2018-02-10,1,6,45,51
61875,2018-02-10,2,3,31,34
61876,2018-02-10,3,4,8,12
61877,2018-02-10,4,0,7,7
61878,2018-02-10,5,1,14,15
61879,2018-02-10,6,1,28,29
61880,2018-02-10,7,7,78,85
61881,2018-02-10,8,16,147,163
61882,2018-02-10,9,46,287,333
61883,2018-02-10,10,78,322,400
61884,2018-02-10,11,27,143,170
61885,2018-02-10,12,12,85,97
61886,2018-02-10,13,2,56,58
61887,2018-02-10,14,4,56,60
61888,2018-02-10,15,2,47,49
61889,2018-02-10,16,14,70,84
61890,2018-02-10,17,15,63,78
61891,2018-02-10,18,2,58,60
61892,2018-02-10,19,2,51,53
61893,2018-02-10,20,16,63,79
61894,2018-02-10,21,5,46,51
61895,2018-02-10,22,5,28,33
61896,2018-02-10,23,3,35,38
61897,2018-02-11,0,2,27,29
61898,2018-02-11,1,3,25,28
61899,2018-02-11,2,3,21,24
61900,2018-02-11,3,3,10,13
61901,2018-02-11,4,0,1,1
61902,2018-02-11,5,0,1,1
61903,2018-02-11,6,0,4,4
61904,2018-02-11,7,1,19,20
61905,2018-02-11,8,1,30,31
61906,2018-02-11,9,1,67,68
61907,2018-02-11,10,12,98,110
61908,2018-02-11,11,4,104,108
61909,2018-02-11,12,27,196,223
61910,2018-02-11,13,49,238,287
61911,2018-02-11,14,96,278,374
61912,2018-02-11,15,116,311,427
61913,2018-02-11,16,108,320,428
61914,2018-02-11,17,96,324,420
61915,2018-02-11,18,16,142,158
61916,2018-02-11,19,23,148,171
61917,2018-02-11,20,22,109,131
61918,2018-02-11,21,26,94,120
61919,2018-02-11,22,17,73,90
61920,2018-02-11,23,22,48,70
61921,2018-02-12,0,11,15,26
61922,2018-02-12,1,10,10,20
61923,2018-02-12,2,2,8,10
61924,2018-02-12,3,0,12,12
61925,2018-02-12,4,0,15,15
61926,2018-02-12,5,1,60,61
61927,2018-02-12,6,6,137,143
61928,2018-02-12,7,7,312,319
61929,2018-02-12,8,21,734,755
61930,2018-02-12,9,21,322,343
61931,2018-02-12,10,14,130,144
61932,2018-02-12,11,23,123,146
61933,2018-02-12,12,43,229,272
61934,2018-02-12,13,43,243,286
61935,2018-02-12,14,59,220,279
61936,2018-02-12,15,48,343,391
61937,2018-02-12,16,63,512,575
61938,2018-02-12,17,81,1021,1102
61939,2018-02-12,18,42,798,840
61940,2018-02-12,19,20,451,471
61941,2018-02-12,20,12,249,261
61942,2018-02-12,21,12,189,201
61943,2018-02-12,22,14,119,133
61944,2018-02-12,23,4,48,52
61945,2018-02-13,0,1,15,16
61946,2018-02-13,1,0,4,4
61947,2018-02-13,2,0,4,4
61948,2018-02-13,3,1,3,4
61949,2018-02-13,4,0,17,17
61950,2018-02-13,5,0,83,83
61951,2018-02-13,6,3,227,230
61952,2018-02-13,7,10,581,591
61953,2018-02-13,8,29,980,1009
61954,2018-02-13,9,29,474,503
61955,2018-02-13,10,24,211,235
61956,2018-02-13,11,36,200,236
61957,2018-02-13,12,45,249,294
61958,2018-02-13,13,46,251,297
61959,2018-02-13,14,27,208,235
61960,2018-02-13,15,25,287,312
61961,2018-02-13,16,38,451,489
61962,2018-02-13,17,34,814,848
61963,2018-02-13,18,20,721,741
61964,2018-02-13,19,9,415,424
61965,2018-02-13,20,7,265,272
61966,2018-02-13,21,7,190,197
61967,2018-02-13,22,9,113,122
61968,2018-02-13,23,6,66,72
61969,2018-02-14,0,4,24,28
61970,2018-02-14,1,0,6,6
61971,2018-02-14,3,1,6,7
61972,2018-02-14,4,1,14,15
61973,2018-02-14,5,2,64,66
61974,2018-02-14,6,3,250,253
61975,2018-02-14,7,14,629,643
61976,2018-02-14,8,29,1020,1049
61977,2018-02-14,9,24,466,490
61978,2018-02-14,10,20,216,236
61979,2018-02-14,11,31,210,241
61980,2018-02-14,12,26,294,320
61981,2018-02-14,13,45,275,320
61982,2018-02-14,14,28,263,291
61983,2018-02-14,15,57,362,419
61984,2018-02-14,16,44,594,638
61985,2018-02-14,17,97,1021,1118
61986,2018-02-14,18,40,715,755
61987,2018-02-14,19,32,430,462
61988,2018-02-14,20,24,255,279
61989,2018-02-14,21,26,188,214
61990,2018-02-14,22,25,120,145
61991,2018-02-14,23,11,34,45
61992,2018-02-15,0,2,15,17
61993,2018-02-15,1,3,13,16
61994,2018-02-15,2,1,2,3
61995,2018-02-15,3,0,2,2
61996,2018-02-15,4,1,18,19
61997,2018-02-15,5,1,76,77
61998,2018-02-15,6,1,243,244
61999,2018-02-15,7,11,612,623
62000,2018-02-15,8,37,1077,1114
62001,2018-02-15,9,25,465,490
62002,2018-02-15,10,43,222,265
62003,2018-02-15,11,54,231,285
62004,2018-02-15,12,69,316,385
62005,2018-02-15,13,86,298,384
62006,2018-02-15,14,102,263,365
62007,2018-02-15,15,139,399,538
62008,2018-02-15,16,140,677,817
62009,2018-02-15,17,176,1191,1367
62010,2018-02-15,18,89,874,963
62011,2018-02-15,19,57,571,628
62012,2018-02-15,20,49,400,449
62013,2018-02-15,21,48,317,365
62014,2018-02-15,22,35,178,213
62015,2018-02-15,23,25,104,129
62016,2018-02-16,0,18,37,55
62017,2018-02-16,1,21,23,44
62018,2018-02-16,2,8,21,29
62019,2018-02-16,3,2,11,13
62020,2018-02-16,4,1,12,13
62021,2018-02-16,5,2,39,41
62022,2018-02-16,6,4,143,147
62023,2018-02-16,7,11,341,352
62024,2018-02-16,8,36,800,836
62025,2018-02-16,9,38,467,505
62026,2018-02-16,10,60,195,255
62027,2018-02-16,11,74,254,328
62028,2018-02-16,12,72,298,370
62029,2018-02-16,13,57,277,334
62030,2018-02-16,14,47,200,247
62031,2018-02-16,15,73,344,417
62032,2018-02-16,16,82,497,579
62033,2018-02-16,17,91,846,937
62034,2018-02-16,18,35,533,568
62035,2018-02-16,19,23,298,321
62036,2018-02-16,20,13,199,212
62037,2018-02-16,21,8,109,117
62038,2018-02-16,22,20,94,114
62039,2018-02-16,23,12,76,88
62040,2018-02-17,0,12,47,59
62041,2018-02-17,1,4,32,36
62042,2018-02-17,2,5,36,41
62043,2018-02-17,3,5,13,18
62044,2018-02-17,4,1,4,5
62045,2018-02-17,5,2,10,12
62046,2018-02-17,6,3,23,26
62047,2018-02-17,7,4,58,62
62048,2018-02-17,8,9,125,134
62049,2018-02-17,9,34,226,260
62050,2018-02-17,10,73,298,371
62051,2018-02-17,11,138,321,459
62052,2018-02-17,12,145,346,491
62053,2018-02-17,13,151,304,455
62054,2018-02-17,14,59,157,216
62055,2018-02-17,15,8,85,93
62056,2018-02-17,16,6,54,60
62057,2018-02-17,17,0,38,38
62058,2018-02-17,18,3,22,25
62059,2018-02-17,19,10,47,57
62060,2018-02-17,20,6,51,57
62061,2018-02-17,21,3,42,45
62062,2018-02-17,22,8,38,46
62063,2018-02-17,23,6,47,53
62064,2018-02-18,0,3,36,39
62065,2018-02-18,1,7,20,27
62066,2018-02-18,2,3,27,30
62067,2018-02-18,3,5,11,16
62068,2018-02-18,4,1,9,10
62069,2018-02-18,5,1,7,8
62070,2018-02-18,6,6,13,19
62071,2018-02-18,7,9,34,43
62072,2018-02-18,8,26,86,112
62073,2018-02-18,9,65,162,227
62074,2018-02-18,10,107,243,350
62075,2018-02-18,11,202,315,517
62076,2018-02-18,12,286,364,650
62077,2018-02-18,13,330,385,715
62078,2018-02-18,14,418,417,835
62079,2018-02-18,15,437,463,900
62080,2018-02-18,16,405,356,761
62081,2018-02-18,17,305,375,680
62082,2018-02-18,18,107,254,361
62083,2018-02-18,19,59,156,215
62084,2018-02-18,20,59,109,168
62085,2018-02-18,21,30,74,104
62086,2018-02-18,22,22,84,106
62087,2018-02-18,23,15,48,63
62088,2018-02-19,0,10,34,44
62089,2018-02-19,1,6,16,22
62090,2018-02-19,2,0,13,13
62091,2018-02-19,3,1,6,7
62092,2018-02-19,4,1,8,9
62093,2018-02-19,5,0,31,31
62094,2018-02-19,6,4,51,55
62095,2018-02-19,7,4,83,87
62096,2018-02-19,8,21,195,216
62097,2018-02-19,9,25,189,214
62098,2018-02-19,10,74,185,259
62099,2018-02-19,11,70,251,321
62100,2018-02-19,12,83,308,391
62101,2018-02-19,13,63,250,313
62102,2018-02-19,14,60,235,295
62103,2018-02-19,15,80,279,359
62104,2018-02-19,16,91,291,382
62105,2018-02-19,17,76,369,445
62106,2018-02-19,18,50,340,390
62107,2018-02-19,19,28,229,257
62108,2018-02-19,20,19,140,159
62109,2018-02-19,21,22,139,161
62110,2018-02-19,22,15,81,96
62111,2018-02-19,23,10,44,54
62112,2018-02-20,0,3,20,23
62113,2018-02-20,1,0,11,11
62114,2018-02-20,2,0,7,7
62115,2018-02-20,3,2,5,7
62116,2018-02-20,4,1,12,13
62117,2018-02-20,5,0,87,87
62118,2018-02-20,6,5,276,281
62119,2018-02-20,7,17,660,677
62120,2018-02-20,8,38,1054,1092
62121,2018-02-20,9,41,430,471
62122,2018-02-20,10,68,216,284
62123,2018-02-20,11,125,253,378
62124,2018-02-20,12,173,375,548
62125,2018-02-20,13,166,338,504
62126,2018-02-20,14,192,286,478
62127,2018-02-20,15,188,433,621
62128,2018-02-20,16,205,704,909
62129,2018-02-20,17,220,1334,1554
62130,2018-02-20,18,154,1045,1199
62131,2018-02-20,19,90,628,718
62132,2018-02-20,20,73,368,441
62133,2018-02-20,21,53,319,372
62134,2018-02-20,22,33,188,221
62135,2018-02-20,23,21,71,92
62136,2018-02-21,0,5,28,33
62137,2018-02-21,1,6,9,15
62138,2018-02-21,2,2,2,4
62139,2018-02-21,4,0,9,9
62140,2018-02-21,5,4,103,107
62141,2018-02-21,6,9,330,339
62142,2018-02-21,7,22,853,875
62143,2018-02-21,8,43,1227,1270
62144,2018-02-21,9,71,438,509
62145,2018-02-21,10,84,224,308
62146,2018-02-21,11,109,285,394
62147,2018-02-21,12,104,381,485
62148,2018-02-21,13,151,330,481
62149,2018-02-21,14,159,305,464
62150,2018-02-21,15,215,476,691
62151,2018-02-21,16,200,748,948
62152,2018-02-21,17,301,1464,1765
62153,2018-02-21,18,174,1060,1234
62154,2018-02-21,19,109,601,710
62155,2018-02-21,20,79,416,495
62156,2018-02-21,21,67,259,326
62157,2018-02-21,22,45,176,221
62158,2018-02-21,23,30,92,122
62159,2018-02-22,0,16,52,68
62160,2018-02-22,1,0,17,17
62161,2018-02-22,2,2,6,8
62162,2018-02-22,3,0,4,4
62163,2018-02-22,4,0,10,10
62164,2018-02-22,5,4,83,87
62165,2018-02-22,6,3,268,271
62166,2018-02-22,7,15,745,760
62167,2018-02-22,8,34,1112,1146
62168,2018-02-22,9,41,505,546
62169,2018-02-22,10,39,221,260
62170,2018-02-22,11,36,207,243
62171,2018-02-22,12,70,282,352
62172,2018-02-22,13,49,274,323
62173,2018-02-22,14,61,235,296
62174,2018-02-22,15,99,293,392
62175,2018-02-22,16,44,407,451
62176,2018-02-22,17,29,462,491
62177,2018-02-22,18,34,490,524
62178,2018-02-22,19,33,366,399
62179,2018-02-22,20,11,242,253
62180,2018-02-22,21,10,174,184
62181,2018-02-22,22,16,118,134
62182,2018-02-22,23,11,64,75
62183,2018-02-23,0,12,36,48
62184,2018-02-23,1,1,10,11
62185,2018-02-23,2,4,10,14
62186,2018-02-23,3,1,3,4
62187,2018-02-23,4,2,10,12
62188,2018-02-23,5,0,61,61
62189,2018-02-23,6,5,158,163
62190,2018-02-23,7,7,344,351
62191,2018-02-23,8,20,615,635
62192,2018-02-23,9,45,365,410
62193,2018-02-23,10,46,198,244
62194,2018-02-23,11,49,203,252
62195,2018-02-23,12,49,223,272
62196,2018-02-23,13,76,227,303
62197,2018-02-23,14,53,260,313
62198,2018-02-23,15,83,344,427
62199,2018-02-23,16,101,537,638
62200,2018-02-23,17,72,841,913
62201,2018-02-23,18,59,584,643
62202,2018-02-23,19,51,401,452
62203,2018-02-23,20,28,234,262
62204,2018-02-23,21,21,177,198
62205,2018-02-23,22,16,124,140
62206,2018-02-23,23,17,98,115
62207,2018-02-24,0,22,85,107
62208,2018-02-24,1,18,72,90
62209,2018-02-24,2,13,43,56
62210,2018-02-24,3,8,11,19
62211,2018-02-24,4,3,9,12
62212,2018-02-24,5,0,15,15
62213,2018-02-24,6,8,25,33
62214,2018-02-24,7,21,82,103
62215,2018-02-24,8,26,184,210
62216,2018-02-24,9,57,297,354
62217,2018-02-24,10,80,325,405
62218,2018-02-24,11,144,402,546
62219,2018-02-24,12,142,445,587
62220,2018-02-24,13,168,389,557
62221,2018-02-24,14,105,269,374
62222,2018-02-24,15,96,284,380
62223,2018-02-24,16,99,204,303
62224,2018-02-24,17,78,235,313
62225,2018-02-24,18,45,243,288
62226,2018-02-24,19,45,223,268
62227,2018-02-24,20,25,129,154
62228,2018-02-24,21,4,105,109
62229,2018-02-24,22,5,60,65
62230,2018-02-24,23,6,52,58
62231,2018-02-25,0,9,50,59
62232,2018-02-25,1,8,39,47
62233,2018-02-25,2,7,50,57
62234,2018-02-25,3,4,35,39
62235,2018-02-25,4,2,9,11
62236,2018-02-25,5,0,16,16
62237,2018-02-25,6,1,19,20
62238,2018-02-25,7,8,45,53
62239,2018-02-25,8,1,53,54
62240,2018-02-25,9,18,95,113
62241,2018-02-25,10,27,162,189
62242,2018-02-25,11,36,188,224
62243,2018-02-25,12,42,245,287
62244,2018-02-25,13,85,270,355
62245,2018-02-25,14,89,323,412
62246,2018-02-25,15,104,386,490
62247,2018-02-25,16,135,374,509
62248,2018-02-25,17,95,357,452
62249,2018-02-25,18,67,285,352
62250,2018-02-25,19,39,208,247
62251,2018-02-25,20,28,134,162
62252,2018-02-25,21,24,145,169
62253,2018-02-25,22,25,108,133
62254,2018-02-25,23,44,59,103
62255,2018-02-26,0,14,18,32
62256,2018-02-26,1,1,13,14
62257,2018-02-26,2,1,12,13
62258,2018-02-26,3,4,9,13
62259,2018-02-26,4,2,19,21
62260,2018-02-26,5,7,83,90
62261,2018-02-26,6,9,268,277
62262,2018-02-26,7,13,688,701
62263,2018-02-26,8,24,1054,1078
62264,2018-02-26,9,23,427,450
62265,2018-02-26,10,31,187,218
62266,2018-02-26,11,36,216,252
62267,2018-02-26,12,78,266,344
62268,2018-02-26,13,47,236,283
62269,2018-02-26,14,70,224,294
62270,2018-02-26,15,65,318,383
62271,2018-02-26,16,55,605,660
62272,2018-02-26,17,75,1147,1222
62273,2018-02-26,18,43,838,881
62274,2018-02-26,19,36,463,499
62275,2018-02-26,20,19,292,311
62276,2018-02-26,21,13,199,212
62277,2018-02-26,22,13,118,131
62278,2018-02-26,23,14,72,86
62279,2018-02-27,0,8,26,34
62280,2018-02-27,1,3,11,14
62281,2018-02-27,2,0,11,11
62282,2018-02-27,3,4,3,7
62283,2018-02-27,4,0,10,10
62284,2018-02-27,5,1,82,83
62285,2018-02-27,6,8,256,264
62286,2018-02-27,7,19,753,772
62287,2018-02-27,8,28,1204,1232
62288,2018-02-27,9,31,485,516
62289,2018-02-27,10,32,205,237
62290,2018-02-27,11,68,239,307
62291,2018-02-27,12,63,327,390
62292,2018-02-27,13,78,310,388
62293,2018-02-27,14,78,258,336
62294,2018-02-27,15,96,388,484
62295,2018-02-27,16,89,674,763
62296,2018-02-27,17,119,1239,1358
62297,2018-02-27,18,85,965,1050
62298,2018-02-27,19,43,513,556
62299,2018-02-27,20,43,324,367
62300,2018-02-27,21,23,253,276
62301,2018-02-27,22,21,129,150
62302,2018-02-27,23,18,62,80
62303,2018-02-28,0,1,27,28
62304,2018-02-28,1,1,11,12
62305,2018-02-28,2,1,6,7
62306,2018-02-28,3,0,4,4
62307,2018-02-28,4,1,17,18
62308,2018-02-28,5,3,100,103
62309,2018-02-28,6,4,267,271
62310,2018-02-28,7,27,766,793
62311,2018-02-28,8,56,1199,1255
62312,2018-02-28,9,32,452,484
62313,2018-02-28,10,37,217,254
62314,2018-02-28,11,31,264,295
62315,2018-02-28,12,64,353,417
62316,2018-02-28,13,55,332,387
62317,2018-02-28,14,76,281,357
62318,2018-02-28,15,117,353,470
62319,2018-02-28,16,119,680,799
62320,2018-02-28,17,106,1246,1352
62321,2018-02-28,18,77,900,977
62322,2018-02-28,19,36,523,559
62323,2018-02-28,20,23,305,328
62324,2018-02-28,21,29,224,253
62325,2018-02-28,22,21,170,191
62326,2018-02-28,23,14,81,95
62327,2018-03-01,0,7,37,44
62328,2018-03-01,1,1,14,15
62329,2018-03-01,2,1,6,7
62330,2018-03-01,3,0,8,8
62331,2018-03-01,4,0,15,15
62332,2018-03-01,5,0,85,85
62333,2018-03-01,6,5,287,292
62334,2018-03-01,7,15,752,767
62335,2018-03-01,8,38,1149,1187
62336,2018-03-01,9,21,456,477
62337,2018-03-01,10,16,105,121
62338,2018-03-01,11,26,169,195
62339,2018-03-01,12,49,246,295
62340,2018-03-01,13,47,242,289
62341,2018-03-01,14,41,245,286
62342,2018-03-01,15,57,305,362
62343,2018-03-01,16,66,564,630
62344,2018-03-01,17,70,977,1047
62345,2018-03-01,18,45,751,796
62346,2018-03-01,19,25,417,442
62347,2018-03-01,20,9,109,118
62348,2018-03-01,21,5,120,125
62349,2018-03-01,22,16,124,140
62350,2018-03-01,23,12,59,71
62351,2018-03-02,0,2,29,31
62352,2018-03-02,1,2,9,11
62353,2018-03-02,2,1,5,6
62354,2018-03-02,3,0,4,4
62355,2018-03-02,4,0,7,7
62356,2018-03-02,5,1,37,38
62357,2018-03-02,6,4,87,91
62358,2018-03-02,7,6,144,150
62359,2018-03-02,8,8,326,334
62360,2018-03-02,9,15,213,228
62361,2018-03-02,10,14,123,137
62362,2018-03-02,11,24,173,197
62363,2018-03-02,12,15,161,176
62364,2018-03-02,13,28,172,200
62365,2018-03-02,14,15,122,137
62366,2018-03-02,15,31,157,188
62367,2018-03-02,16,32,185,217
62368,2018-03-02,17,23,295,318
62369,2018-03-02,18,18,230,248
62370,2018-03-02,19,10,149,159
62371,2018-03-02,20,3,84,87
62372,2018-03-02,21,2,72,74
62373,2018-03-02,22,3,69,72
62374,2018-03-02,23,8,48,56
62375,2018-03-03,0,6,46,52
62376,2018-03-03,1,2,34,36
62377,2018-03-03,2,2,22,24
62378,2018-03-03,3,0,9,9
62379,2018-03-03,4,0,5,5
62380,2018-03-03,5,0,7,7
62381,2018-03-03,6,0,28,28
62382,2018-03-03,7,5,60,65
62383,2018-03-03,8,12,128,140
62384,2018-03-03,9,19,226,245
62385,2018-03-03,10,54,234,288
62386,2018-03-03,11,99,303,402
62387,2018-03-03,12,121,366,487
62388,2018-03-03,13,184,412,596
62389,2018-03-03,14,203,415,618
62390,2018-03-03,15,202,426,628
62391,2018-03-03,16,228,349,577
62392,2018-03-03,17,188,303,491
62393,2018-03-03,18,57,283,340
62394,2018-03-03,19,36,174,210
62395,2018-03-03,20,20,130,150
62396,2018-03-03,21,10,101,111
62397,2018-03-03,22,16,87,103
62398,2018-03-03,23,7,95,102
62399,2018-03-04,0,9,67,76
62400,2018-03-04,1,4,40,44
62401,2018-03-04,2,1,36,37
62402,2018-03-04,3,2,14,16
62403,2018-03-04,4,0,7,7
62404,2018-03-04,5,0,6,6
62405,2018-03-04,6,3,27,30
62406,2018-03-04,7,9,87,96
62407,2018-03-04,8,60,138,198
62408,2018-03-04,9,67,191,258
62409,2018-03-04,10,128,316,444
62410,2018-03-04,11,193,356,549
62411,2018-03-04,12,207,476,683
62412,2018-03-04,13,272,434,706
62413,2018-03-04,14,251,436,687
62414,2018-03-04,15,250,398,648
62415,2018-03-04,16,207,395,602
62416,2018-03-04,17,191,351,542
62417,2018-03-04,18,60,266,326
62418,2018-03-04,19,28,196,224
62419,2018-03-04,20,15,100,115
62420,2018-03-04,21,12,79,91
62421,2018-03-04,22,6,67,73
62422,2018-03-04,23,10,44,54
62423,2018-03-05,0,8,33,41
62424,2018-03-05,1,4,5,9
62425,2018-03-05,2,2,3,5
62426,2018-03-05,3,0,3,3
62427,2018-03-05,4,0,11,11
62428,2018-03-05,5,1,56,57
62429,2018-03-05,6,8,232,240
62430,2018-03-05,7,14,552,566
62431,2018-03-05,8,27,792,819
62432,2018-03-05,9,29,340,369
62433,2018-03-05,10,45,166,211
62434,2018-03-05,11,68,197,265
62435,2018-03-05,12,73,252,325
62436,2018-03-05,13,78,235,313
62437,2018-03-05,14,95,195,290
62438,2018-03-05,15,107,310,417
62439,2018-03-05,16,146,538,684
62440,2018-03-05,17,130,991,1121
62441,2018-03-05,18,46,766,812
62442,2018-03-05,19,34,440,474
62443,2018-03-05,20,19,246,265
62444,2018-03-05,21,40,178,218
62445,2018-03-05,22,22,99,121
62446,2018-03-05,23,6,56,62
62447,2018-03-06,0,2,21,23
62448,2018-03-06,1,0,9,9
62449,2018-03-06,2,2,6,8
62450,2018-03-06,3,0,10,10
62451,2018-03-06,4,0,14,14
62452,2018-03-06,5,1,72,73
62453,2018-03-06,6,4,282,286
62454,2018-03-06,7,18,646,664
62455,2018-03-06,8,50,1091,1141
62456,2018-03-06,9,34,445,479
62457,2018-03-06,10,37,184,221
62458,2018-03-06,11,41,227,268
62459,2018-03-06,12,55,272,327
62460,2018-03-06,13,33,258,291
62461,2018-03-06,14,46,182,228
62462,2018-03-06,15,44,223,267
62463,2018-03-06,16,42,409,451
62464,2018-03-06,17,44,876,920
62465,2018-03-06,18,34,746,780
62466,2018-03-06,19,24,384,408
62467,2018-03-06,20,6,119,125
62468,2018-03-06,21,9,61,70
62469,2018-03-06,22,3,50,53
62470,2018-03-06,23,7,20,27
62471,2018-03-07,0,4,14,18
62472,2018-03-07,1,3,3,6
62473,2018-03-07,2,0,2,2
62474,2018-03-07,3,1,6,7
62475,2018-03-07,4,0,10,10
62476,2018-03-07,5,0,64,64
62477,2018-03-07,6,0,213,213
62478,2018-03-07,7,10,432,442
62479,2018-03-07,8,18,687,705
62480,2018-03-07,9,18,286,304
62481,2018-03-07,10,14,116,130
62482,2018-03-07,11,34,166,200
62483,2018-03-07,12,29,221,250
62484,2018-03-07,13,33,243,276
62485,2018-03-07,14,28,178,206
62486,2018-03-07,15,54,288,342
62487,2018-03-07,16,59,477,536
62488,2018-03-07,17,65,952,1017
62489,2018-03-07,18,41,766,807
62490,2018-03-07,19,22,376,398
62491,2018-03-07,20,17,253,270
62492,2018-03-07,21,14,200,214
62493,2018-03-07,22,7,126,133
62494,2018-03-07,23,1,61,62
62495,2018-03-08,0,1,41,42
62496,2018-03-08,1,0,4,4
62497,2018-03-08,2,1,4,5
62498,2018-03-08,3,0,6,6
62499,2018-03-08,4,0,17,17
62500,2018-03-08,5,1,73,74
62501,2018-03-08,6,7,250,257
62502,2018-03-08,7,10,607,617
62503,2018-03-08,8,27,1060,1087
62504,2018-03-08,9,29,446,475
62505,2018-03-08,10,50,177,227
62506,2018-03-08,11,75,213,288
62507,2018-03-08,12,60,275,335
62508,2018-03-08,13,57,251,308
62509,2018-03-08,14,67,214,281
62510,2018-03-08,15,60,331,391
62511,2018-03-08,16,59,501,560
62512,2018-03-08,17,70,907,977
62513,2018-03-08,18,43,718,761
62514,2018-03-08,19,27,395,422
62515,2018-03-08,20,6,257,263
62516,2018-03-08,21,10,188,198
62517,2018-03-08,22,11,106,117
62518,2018-03-08,23,2,63,65
62519,2018-03-09,0,4,28,32
62520,2018-03-09,1,2,14,16
62521,2018-03-09,2,2,8,10
62522,2018-03-09,3,0,6,6
62523,2018-03-09,4,0,17,17
62524,2018-03-09,5,2,45,47
62525,2018-03-09,6,3,208,211
62526,2018-03-09,7,12,508,520
62527,2018-03-09,8,30,896,926
62528,2018-03-09,9,46,388,434
62529,2018-03-09,10,45,183,228
62530,2018-03-09,11,52,223,275
62531,2018-03-09,12,62,289,351
62532,2018-03-09,13,66,263,329
62533,2018-03-09,14,69,260,329
62534,2018-03-09,15,85,368,453
62535,2018-03-09,16,82,530,612
62536,2018-03-09,17,81,845,926
62537,2018-03-09,18,41,549,590
62538,2018-03-09,19,25,295,320
62539,2018-03-09,20,25,228,253
62540,2018-03-09,21,12,128,140
62541,2018-03-09,22,12,94,106
62542,2018-03-09,23,22,82,104
62543,2018-03-10,0,8,50,58
62544,2018-03-10,1,8,36,44
62545,2018-03-10,2,1,27,28
62546,2018-03-10,3,1,8,9
62547,2018-03-10,4,0,9,9
62548,2018-03-10,5,0,20,20
62549,2018-03-10,6,5,57,62
62550,2018-03-10,7,33,173,206
62551,2018-03-10,8,61,262,323
62552,2018-03-10,9,102,355,457
62553,2018-03-10,10,171,410,581
62554,2018-03-10,11,209,441,650
62555,2018-03-10,12,271,449,720
62556,2018-03-10,13,325,437,762
62557,2018-03-10,14,363,461,824
62558,2018-03-10,15,375,452,827
62559,2018-03-10,16,342,435,777
62560,2018-03-10,17,270,395,665
62561,2018-03-10,18,120,257,377
62562,2018-03-10,19,74,181,255
62563,2018-03-10,20,64,160,224
62564,2018-03-10,21,34,155,189
62565,2018-03-10,22,11,97,108
62566,2018-03-10,23,17,99,116
62567,2018-03-11,0,3,53,56
62568,2018-03-11,1,7,49,56
62569,2018-03-11,3,7,33,40
62570,2018-03-11,4,1,9,10
62571,2018-03-11,5,2,4,6
62572,2018-03-11,6,1,18,19
62573,2018-03-11,7,5,35,40
62574,2018-03-11,8,25,99,124
62575,2018-03-11,9,64,156,220
62576,2018-03-11,10,147,291,438
62577,2018-03-11,11,193,320,513
62578,2018-03-11,12,204,401,605
62579,2018-03-11,13,327,414,741
62580,2018-03-11,14,349,477,826
62581,2018-03-11,15,391,504,895
62582,2018-03-11,16,360,464,824
62583,2018-03-11,17,343,425,768
62584,2018-03-11,18,254,337,591
62585,2018-03-11,19,147,261,408
62586,2018-03-11,20,65,169,234
62587,2018-03-11,21,34,116,150
62588,2018-03-11,22,43,79,122
62589,2018-03-11,23,11,44,55
62590,2018-03-12,0,5,23,28
62591,2018-03-12,1,6,10,16
62592,2018-03-12,2,0,15,15
62593,2018-03-12,3,1,3,4
62594,2018-03-12,4,0,19,19
62595,2018-03-12,5,1,61,62
62596,2018-03-12,6,7,186,193
62597,2018-03-12,7,15,499,514
62598,2018-03-12,8,31,955,986
62599,2018-03-12,9,44,427,471
62600,2018-03-12,10,58,178,236
62601,2018-03-12,11,65,188,253
62602,2018-03-12,12,58,214,272
62603,2018-03-12,13,73,220,293
62604,2018-03-12,14,84,204,288
62605,2018-03-12,15,79,297,376
62606,2018-03-12,16,103,491,594
62607,2018-03-12,17,98,925,1023
62608,2018-03-12,18,48,699,747
62609,2018-03-12,19,28,388,416
62610,2018-03-12,20,11,219,230
62611,2018-03-12,21,11,123,134
62612,2018-03-12,22,10,63,73
62613,2018-03-12,23,1,40,41
62614,2018-03-13,0,0,15,15
62615,2018-03-13,1,0,8,8
62616,2018-03-13,2,0,4,4
62617,2018-03-13,3,0,5,5
62618,2018-03-13,4,0,12,12
62619,2018-03-13,5,3,53,56
62620,2018-03-13,6,2,211,213
62621,2018-03-13,7,15,483,498
62622,2018-03-13,8,30,938,968
62623,2018-03-13,9,28,402,430
62624,2018-03-13,10,42,161,203
62625,2018-03-13,11,42,154,196
62626,2018-03-13,12,52,213,265
62627,2018-03-13,13,64,219,283
62628,2018-03-13,14,71,202,273
62629,2018-03-13,15,111,271,382
62630,2018-03-13,16,81,465,546
62631,2018-03-13,17,109,974,1083
62632,2018-03-13,18,82,758,840
62633,2018-03-13,19,30,436,466
62634,2018-03-13,20,25,263,288
62635,2018-03-13,21,31,185,216
62636,2018-03-13,22,20,103,123
62637,2018-03-13,23,8,63,71
62638,2018-03-14,0,1,22,23
62639,2018-03-14,1,1,5,6
62640,2018-03-14,2,0,5,5
62641,2018-03-14,3,1,3,4
62642,2018-03-14,4,0,17,17
62643,2018-03-14,5,3,64,67
62644,2018-03-14,6,0,214,214
62645,2018-03-14,7,15,518,533
62646,2018-03-14,8,32,932,964
62647,2018-03-14,9,26,416,442
62648,2018-03-14,10,30,170,200
62649,2018-03-14,11,28,199,227
62650,2018-03-14,12,45,218,263
62651,2018-03-14,13,36,186,222
62652,2018-03-14,14,44,168,212
62653,2018-03-14,15,46,262,308
62654,2018-03-14,16,52,444,496
62655,2018-03-14,17,64,880,944
62656,2018-03-14,18,44,684,728
62657,2018-03-14,19,28,408,436
62658,2018-03-14,20,16,240,256
62659,2018-03-14,21,12,143,155
62660,2018-03-14,22,4,98,102
62661,2018-03-14,23,3,39,42
62662,2018-03-15,0,2,19,21
62663,2018-03-15,1,0,6,6
62664,2018-03-15,2,1,4,5
62665,2018-03-15,3,1,3,4
62666,2018-03-15,4,0,12,12
62667,2018-03-15,5,1,67,68
62668,2018-03-15,6,5,201,206
62669,2018-03-15,7,8,505,513
62670,2018-03-15,8,46,943,989
62671,2018-03-15,9,43,469,512
62672,2018-03-15,10,37,218,255
62673,2018-03-15,11,69,243,312
62674,2018-03-15,12,101,288,389
62675,2018-03-15,13,87,255,342
62676,2018-03-15,14,83,235,318
62677,2018-03-15,15,113,347,460
62678,2018-03-15,16,112,511,623
62679,2018-03-15,17,206,907,1113
62680,2018-03-15,18,104,817,921
62681,2018-03-15,19,68,478,546
62682,2018-03-15,20,46,270,316
62683,2018-03-15,21,25,229,254
62684,2018-03-15,22,37,159,196
62685,2018-03-15,23,29,80,109
62686,2018-03-16,0,12,53,65
62687,2018-03-16,1,0,16,16
62688,2018-03-16,2,1,5,6
62689,2018-03-16,3,0,4,4
62690,2018-03-16,4,0,10,10
62691,2018-03-16,5,2,66,68
62692,2018-03-16,6,2,176,178
62693,2018-03-16,7,16,411,427
62694,2018-03-16,8,23,756,779
62695,2018-03-16,9,26,439,465
62696,2018-03-16,10,33,202,235
62697,2018-03-16,11,56,233,289
62698,2018-03-16,12,73,301,374
62699,2018-03-16,13,98,263,361
62700,2018-03-16,14,86,225,311
62701,2018-03-16,15,104,334,438
62702,2018-03-16,16,125,479,604
62703,2018-03-16,17,168,831,999
62704,2018-03-16,18,86,642,728
62705,2018-03-16,19,49,319,368
62706,2018-03-16,20,25,167,192
62707,2018-03-16,21,25,152,177
62708,2018-03-16,22,25,97,122
62709,2018-03-16,23,14,103,117
62710,2018-03-17,0,8,78,86
62711,2018-03-17,1,8,46,54
62712,2018-03-17,2,7,18,25
62713,2018-03-17,3,3,17,20
62714,2018-03-17,4,0,10,10
62715,2018-03-17,5,1,10,11
62716,2018-03-17,6,0,24,24
62717,2018-03-17,7,8,57,65
62718,2018-03-17,8,26,149,175
62719,2018-03-17,9,75,253,328
62720,2018-03-17,10,97,342,439
62721,2018-03-17,11,137,346,483
62722,2018-03-17,12,139,372,511
62723,2018-03-17,13,163,343,506
62724,2018-03-17,14,138,286,424
62725,2018-03-17,15,152,281,433
62726,2018-03-17,16,146,280,426
62727,2018-03-17,17,158,233,391
62728,2018-03-17,18,134,246,380
62729,2018-03-17,19,65,209,274
62730,2018-03-17,20,38,140,178
62731,2018-03-17,21,34,116,150
62732,2018-03-17,22,25,122,147
62733,2018-03-17,23,15,89,104
62734,2018-03-18,0,15,71,86
62735,2018-03-18,1,14,49,63
62736,2018-03-18,2,8,47,55
62737,2018-03-18,3,0,24,24
62738,2018-03-18,4,1,8,9
62739,2018-03-18,5,0,7,7
62740,2018-03-18,6,4,16,20
62741,2018-03-18,7,8,48,56
62742,2018-03-18,8,16,112,128
62743,2018-03-18,9,71,218,289
62744,2018-03-18,10,146,345,491
62745,2018-03-18,11,257,374,631
62746,2018-03-18,12,339,474,813
62747,2018-03-18,13,394,497,891
62748,2018-03-18,14,476,516,992
62749,2018-03-18,15,565,558,1123
62750,2018-03-18,16,480,504,984
62751,2018-03-18,17,446,517,963
62752,2018-03-18,18,271,421,692
62753,2018-03-18,19,162,301,463
62754,2018-03-18,20,84,189,273
62755,2018-03-18,21,71,154,225
62756,2018-03-18,22,27,119,146
62757,2018-03-18,23,36,80,116
62758,2018-03-19,0,8,21,29
62759,2018-03-19,1,5,11,16
62760,2018-03-19,2,5,5,10
62761,2018-03-19,3,4,1,5
62762,2018-03-19,4,0,22,22
62763,2018-03-19,5,2,58,60
62764,2018-03-19,6,3,204,207
62765,2018-03-19,7,21,556,577
62766,2018-03-19,8,55,950,1005
62767,2018-03-19,9,40,440,480
62768,2018-03-19,10,96,192,288
62769,2018-03-19,11,123,225,348
62770,2018-03-19,12,125,303,428
62771,2018-03-19,13,176,307,483
62772,2018-03-19,14,200,247,447
62773,2018-03-19,15,154,341,495
62774,2018-03-19,16,179,609,788
62775,2018-03-19,17,201,1144,1345
62776,2018-03-19,18,143,940,1083
62777,2018-03-19,19,97,545,642
62778,2018-03-19,20,49,318,367
62779,2018-03-19,21,33,215,248
62780,2018-03-19,22,15,102,117
62781,2018-03-19,23,15,52,67
62782,2018-03-20,0,5,18,23
62783,2018-03-20,1,1,7,8
62784,2018-03-20,2,0,5,5
62785,2018-03-20,3,2,1,3
62786,2018-03-20,4,0,12,12
62787,2018-03-20,5,1,44,45
62788,2018-03-20,6,0,70,70
62789,2018-03-20,7,0,128,128
62790,2018-03-20,8,7,260,267
62791,2018-03-20,9,10,186,196
62792,2018-03-20,10,3,46,49
62793,2018-03-20,11,5,43,48
62794,2018-03-20,12,1,33,34
62795,2018-03-20,13,1,45,46
62796,2018-03-20,14,2,51,53
62797,2018-03-20,15,2,62,64
62798,2018-03-20,16,3,129,132
62799,2018-03-20,17,8,277,285
62800,2018-03-20,18,5,285,290
62801,2018-03-20,19,3,133,136
62802,2018-03-20,20,3,110,113
62803,2018-03-20,21,4,64,68
62804,2018-03-20,22,2,37,39
62805,2018-03-20,23,2,24,26
62806,2018-03-21,0,2,6,8
62807,2018-03-21,1,1,3,4
62808,2018-03-21,2,1,6,7
62809,2018-03-21,3,0,4,4
62810,2018-03-21,4,0,8,8
62811,2018-03-21,5,0,23,23
62812,2018-03-21,6,0,41,41
62813,2018-03-21,7,2,50,52
62814,2018-03-21,8,4,82,86
62815,2018-03-21,9,0,43,43
62816,2018-03-21,10,3,19,22
62817,2018-03-21,11,3,30,33
62818,2018-03-21,12,3,31,34
62819,2018-03-21,13,3,33,36
62820,2018-03-21,14,3,41,44
62821,2018-03-21,15,2,62,64
62822,2018-03-21,16,6,85,91
62823,2018-03-21,17,6,146,152
62824,2018-03-21,18,6,154,160
62825,2018-03-21,19,5,123,128
62826,2018-03-21,20,1,89,90
62827,2018-03-21,21,4,72,76
62828,2018-03-21,22,4,58,62
62829,2018-03-21,23,0,30,30
62830,2018-03-22,0,2,20,22
62831,2018-03-22,1,0,9,9
62832,2018-03-22,2,0,2,2
62833,2018-03-22,3,0,7,7
62834,2018-03-22,4,0,14,14
62835,2018-03-22,5,1,35,36
62836,2018-03-22,6,2,110,112
62837,2018-03-22,7,8,296,304
62838,2018-03-22,8,26,548,574
62839,2018-03-22,9,16,466,482
62840,2018-03-22,10,19,256,275
62841,2018-03-22,11,22,163,185
62842,2018-03-22,12,22,245,267
62843,2018-03-22,13,31,194,225
62844,2018-03-22,14,36,236,272
62845,2018-03-22,15,72,284,356
62846,2018-03-22,16,80,439,519
62847,2018-03-22,17,86,891,977
62848,2018-03-22,18,60,752,812
62849,2018-03-22,19,30,432,462
62850,2018-03-22,20,15,258,273
62851,2018-03-22,21,6,230,236
62852,2018-03-22,22,6,116,122
62853,2018-03-22,23,15,70,85
62854,2018-03-23,0,5,44,49
62855,2018-03-23,1,5,17,22
62856,2018-03-23,2,1,7,8
62857,2018-03-23,3,0,6,6
62858,2018-03-23,4,1,12,13
62859,2018-03-23,5,2,56,58
62860,2018-03-23,6,4,185,189
62861,2018-03-23,7,12,466,478
62862,2018-03-23,8,28,854,882
62863,2018-03-23,9,24,466,490
62864,2018-03-23,10,64,223,287
62865,2018-03-23,11,75,261,336
62866,2018-03-23,12,94,285,379
62867,2018-03-23,13,149,305,454
62868,2018-03-23,14,122,313,435
62869,2018-03-23,15,166,401,567
62870,2018-03-23,16,187,545,732
62871,2018-03-23,17,151,937,1088
62872,2018-03-23,18,123,700,823
62873,2018-03-23,19,78,422,500
62874,2018-03-23,20,48,219,267
62875,2018-03-23,21,48,180,228
62876,2018-03-23,22,19,107,126
62877,2018-03-23,23,19,84,103
62878,2018-03-24,0,16,71,87
62879,2018-03-24,1,9,46,55
62880,2018-03-24,2,5,29,34
62881,2018-03-24,3,1,14,15
62882,2018-03-24,4,0,11,11
62883,2018-03-24,5,4,16,20
62884,2018-03-24,6,10,38,48
62885,2018-03-24,7,13,82,95
62886,2018-03-24,8,25,228,253
62887,2018-03-24,9,103,360,463
62888,2018-03-24,10,188,529,717
62889,2018-03-24,11,266,623,889
62890,2018-03-24,12,325,493,818
62891,2018-03-24,13,384,553,937
62892,2018-03-24,14,533,655,1188
62893,2018-03-24,15,476,682,1158
62894,2018-03-24,16,371,538,909
62895,2018-03-24,17,325,418,743
62896,2018-03-24,18,211,378,589
62897,2018-03-24,19,123,289,412
62898,2018-03-24,20,65,169,234
62899,2018-03-24,21,40,130,170
62900,2018-03-24,22,41,117,158
62901,2018-03-24,23,18,123,141
62902,2018-03-25,0,7,91,98
62903,2018-03-25,1,13,55,68
62904,2018-03-25,2,16,49,65
62905,2018-03-25,3,12,23,35
62906,2018-03-25,4,0,6,6
62907,2018-03-25,5,0,9,9
62908,2018-03-25,6,2,16,18
62909,2018-03-25,7,6,50,56
62910,2018-03-25,8,26,111,137
62911,2018-03-25,9,53,213,266
62912,2018-03-25,10,150,296,446
62913,2018-03-25,11,177,359,536
62914,2018-03-25,12,209,392,601
62915,2018-03-25,13,280,380,660
62916,2018-03-25,14,285,396,681
62917,2018-03-25,15,300,430,730
62918,2018-03-25,16,249,406,655
62919,2018-03-25,17,200,360,560
62920,2018-03-25,18,115,306,421
62921,2018-03-25,19,104,209,313
62922,2018-03-25,20,39,163,202
62923,2018-03-25,21,31,105,136
62924,2018-03-25,22,8,89,97
62925,2018-03-25,23,7,41,48
62926,2018-03-26,0,3,19,22
62927,2018-03-26,1,5,12,17
62928,2018-03-26,2,0,4,4
62929,2018-03-26,3,2,2,4
62930,2018-03-26,4,1,19,20
62931,2018-03-26,5,1,69,70
62932,2018-03-26,6,4,203,207
62933,2018-03-26,7,15,516,531
62934,2018-03-26,8,33,905,938
62935,2018-03-26,9,56,473,529
62936,2018-03-26,10,128,210,338
62937,2018-03-26,11,191,222,413
62938,2018-03-26,12,199,274,473
62939,2018-03-26,13,218,258,476
62940,2018-03-26,14,191,282,473
62941,2018-03-26,15,227,361,588
62942,2018-03-26,16,234,571,805
62943,2018-03-26,17,253,1053,1306
62944,2018-03-26,18,196,807,1003
62945,2018-03-26,19,75,488,563
62946,2018-03-26,20,24,299,323
62947,2018-03-26,21,33,163,196
62948,2018-03-26,22,16,103,119
62949,2018-03-26,23,10,47,57
62950,2018-03-27,0,6,17,23
62951,2018-03-27,1,2,7,9
62952,2018-03-27,2,0,1,1
62953,2018-03-27,3,0,2,2
62954,2018-03-27,4,0,17,17
62955,2018-03-27,5,2,63,65
62956,2018-03-27,6,6,219,225
62957,2018-03-27,7,17,589,606
62958,2018-03-27,8,36,1016,1052
62959,2018-03-27,9,65,508,573
62960,2018-03-27,10,114,206,320
62961,2018-03-27,11,108,228,336
62962,2018-03-27,12,113,238,351
62963,2018-03-27,13,68,255,323
62964,2018-03-27,14,105,182,287
62965,2018-03-27,15,112,297,409
62966,2018-03-27,16,129,474,603
62967,2018-03-27,17,95,912,1007
62968,2018-03-27,18,76,629,705
62969,2018-03-27,19,17,361,378
62970,2018-03-27,20,26,233,259
62971,2018-03-27,21,22,207,229
62972,2018-03-27,22,14,104,118
62973,2018-03-27,23,17,60,77
62974,2018-03-28,0,7,21,28
62975,2018-03-28,1,1,6,7
62976,2018-03-28,2,2,4,6
62977,2018-03-28,3,2,3,5
62978,2018-03-28,4,0,9,9
62979,2018-03-28,5,4,71,75
62980,2018-03-28,6,3,199,202
62981,2018-03-28,7,18,491,509
62982,2018-03-28,8,31,1024,1055
62983,2018-03-28,9,70,523,593
62984,2018-03-28,10,148,212,360
62985,2018-03-28,11,178,244,422
62986,2018-03-28,12,176,328,504
62987,2018-03-28,13,166,283,449
62988,2018-03-28,14,196,238,434
62989,2018-03-28,15,196,299,495
62990,2018-03-28,16,78,312,390
62991,2018-03-28,17,53,440,493
62992,2018-03-28,18,42,370,412
62993,2018-03-28,19,20,302,322
62994,2018-03-28,20,23,230,253
62995,2018-03-28,21,15,138,153
62996,2018-03-28,22,23,123,146
62997,2018-03-28,23,12,79,91
62998,2018-03-29,0,5,27,32
62999,2018-03-29,1,2,17,19
63000,2018-03-29,2,2,1,3
63001,2018-03-29,3,0,8,8
63002,2018-03-29,4,1,18,19
63003,2018-03-29,5,1,74,75
63004,2018-03-29,6,7,240,247
63005,2018-03-29,7,19,595,614
63006,2018-03-29,8,69,975,1044
63007,2018-03-29,9,85,528,613
63008,2018-03-29,10,169,229,398
63009,2018-03-29,11,210,293,503
63010,2018-03-29,12,248,372,620
63011,2018-03-29,13,299,364,663
63012,2018-03-29,14,338,357,695
63013,2018-03-29,15,423,467,890
63014,2018-03-29,16,363,713,1076
63015,2018-03-29,17,459,1276,1735
63016,2018-03-29,18,504,1131,1635
63017,2018-03-29,19,314,739,1053
63018,2018-03-29,20,221,443,664
63019,2018-03-29,21,189,316,505
63020,2018-03-29,22,122,236,358
63021,2018-03-29,23,76,133,209
63022,2018-03-30,0,54,84,138
63023,2018-03-30,1,26,31,57
63024,2018-03-30,2,17,26,43
63025,2018-03-30,3,6,7,13
63026,2018-03-30,4,5,16,21
63027,2018-03-30,5,0,58,58
63028,2018-03-30,6,10,196,206
63029,2018-03-30,7,29,524,553
63030,2018-03-30,8,76,912,988
63031,2018-03-30,9,158,530,688
63032,2018-03-30,10,285,316,601
63033,2018-03-30,11,320,369,689
63034,2018-03-30,12,421,401,822
63035,2018-03-30,13,312,390,702
63036,2018-03-30,14,285,390,675
63037,2018-03-30,15,306,416,722
63038,2018-03-30,16,193,548,741
63039,2018-03-30,17,279,763,1042
63040,2018-03-30,18,181,607,788
63041,2018-03-30,19,218,377,595
63042,2018-03-30,20,134,237,371
63043,2018-03-30,21,125,166,291
63044,2018-03-30,22,63,129,192
63045,2018-03-30,23,36,79,115
63046,2018-03-31,0,9,63,72
63047,2018-03-31,1,18,42,60
63048,2018-03-31,2,10,29,39
63049,2018-03-31,3,3,27,30
63050,2018-03-31,4,2,5,7
63051,2018-03-31,5,0,13,13
63052,2018-03-31,6,12,30,42
63053,2018-03-31,7,36,98,134
63054,2018-03-31,8,106,203,309
63055,2018-03-31,9,242,355,597
63056,2018-03-31,10,516,462,978
63057,2018-03-31,11,721,578,1299
63058,2018-03-31,12,853,618,1471
63059,2018-03-31,13,900,705,1605
63060,2018-03-31,14,930,626,1556
63061,2018-03-31,15,963,690,1653
63062,2018-03-31,16,959,627,1586
63063,2018-03-31,17,786,659,1445
63064,2018-03-31,18,577,481,1058
63065,2018-03-31,19,365,358,723
63066,2018-03-31,20,253,242,495
63067,2018-03-31,21,139,160,299
63068,2018-03-31,22,98,132,230
63069,2018-03-31,23,48,120,168
63070,2018-04-01,0,28,96,124
63071,2018-04-01,1,31,45,76
63072,2018-04-01,2,8,42,50
63073,2018-04-01,3,9,18,27
63074,2018-04-01,4,1,5,6
63075,2018-04-01,5,6,23,29
63076,2018-04-01,6,19,35,54
63077,2018-04-01,7,52,82,134
63078,2018-04-01,8,108,172,280
63079,2018-04-01,9,176,266,442
63080,2018-04-01,10,375,377,752
63081,2018-04-01,11,391,385,776
63082,2018-04-01,12,438,449,887
63083,2018-04-01,13,490,477,967
63084,2018-04-01,14,499,476,975
63085,2018-04-01,15,538,454,992
63086,2018-04-01,16,466,434,900
63087,2018-04-01,17,512,441,953
63088,2018-04-01,18,406,386,792
63089,2018-04-01,19,228,281,509
63090,2018-04-01,20,133,173,306
63091,2018-04-01,21,79,117,196
63092,2018-04-01,22,42,96,138
63093,2018-04-01,23,40,61,101
63094,2018-04-02,0,16,27,43
63095,2018-04-02,1,18,13,31
63096,2018-04-02,2,2,11,13
63097,2018-04-02,3,2,2,4
63098,2018-04-02,4,0,14,14
63099,2018-04-02,5,2,56,58
63100,2018-04-02,6,3,160,163
63101,2018-04-02,7,21,461,482
63102,2018-04-02,8,42,835,877
63103,2018-04-02,9,90,439,529
63104,2018-04-02,10,150,217,367
63105,2018-04-02,11,144,254,398
63106,2018-04-02,12,151,280,431
63107,2018-04-02,13,153,264,417
63108,2018-04-02,14,194,260,454
63109,2018-04-02,15,159,348,507
63110,2018-04-02,16,191,603,794
63111,2018-04-02,17,196,1086,1282
63112,2018-04-02,18,131,879,1010
63113,2018-04-02,19,83,521,604
63114,2018-04-02,20,58,366,424
63115,2018-04-02,21,31,201,232
63116,2018-04-02,22,37,112,149
63117,2018-04-02,23,16,103,119
63118,2018-04-03,0,7,24,31
63119,2018-04-03,1,0,12,12
63120,2018-04-03,2,0,2,2
63121,2018-04-03,3,0,1,1
63122,2018-04-03,4,0,22,22
63123,2018-04-03,5,1,71,72
63124,2018-04-03,6,9,247,256
63125,2018-04-03,7,23,651,674
63126,2018-04-03,8,63,1144,1207
63127,2018-04-03,9,79,488,567
63128,2018-04-03,10,89,211,300
63129,2018-04-03,11,119,252,371
63130,2018-04-03,12,132,313,445
63131,2018-04-03,13,139,282,421
63132,2018-04-03,14,121,233,354
63133,2018-04-03,15,76,298,374
63134,2018-04-03,16,137,484,621
63135,2018-04-03,17,173,1031,1204
63136,2018-04-03,18,123,790,913
63137,2018-04-03,19,109,444,553
63138,2018-04-03,20,46,265,311
63139,2018-04-03,21,38,216,254
63140,2018-04-03,22,30,140,170
63141,2018-04-03,23,16,73,89
63142,2018-04-04,0,3,29,32
63143,2018-04-04,1,2,14,16
63144,2018-04-04,2,3,8,11
63145,2018-04-04,3,1,4,5
63146,2018-04-04,4,0,18,18
63147,2018-04-04,5,3,96,99
63148,2018-04-04,6,9,308,317
63149,2018-04-04,7,23,739,762
63150,2018-04-04,8,54,1182,1236
63151,2018-04-04,9,71,558,629
63152,2018-04-04,10,108,234,342
63153,2018-04-04,11,136,229,365
63154,2018-04-04,12,100,229,329
63155,2018-04-04,13,119,279,398
63156,2018-04-04,14,180,270,450
63157,2018-04-04,15,158,337,495
63158,2018-04-04,16,152,553,705
63159,2018-04-04,17,180,1109,1289
63160,2018-04-04,18,140,873,1013
63161,2018-04-04,19,89,531,620
63162,2018-04-04,20,37,295,332
63163,2018-04-04,21,29,228,257
63164,2018-04-04,22,10,116,126
63165,2018-04-04,23,11,52,63
63166,2018-04-05,0,4,25,29
63167,2018-04-05,1,5,8,13
63168,2018-04-05,2,3,3,6
63169,2018-04-05,3,1,2,3
63170,2018-04-05,4,1,18,19
63171,2018-04-05,5,4,68,72
63172,2018-04-05,6,9,256,265
63173,2018-04-05,7,30,683,713
63174,2018-04-05,8,60,1046,1106
63175,2018-04-05,9,73,474,547
63176,2018-04-05,10,114,229,343
63177,2018-04-05,11,144,266,410
63178,2018-04-05,12,157,343,500
63179,2018-04-05,13,185,336,521
63180,2018-04-05,14,262,286,548
63181,2018-04-05,15,327,432,759
63182,2018-04-05,16,313,650,963
63183,2018-04-05,17,356,1219,1575
63184,2018-04-05,18,289,1050,1339
63185,2018-04-05,19,172,636,808
63186,2018-04-05,20,85,421,506
63187,2018-04-05,21,33,282,315
63188,2018-04-05,22,52,211,263
63189,2018-04-05,23,15,96,111
63190,2018-04-06,0,13,54,67
63191,2018-04-06,1,3,23,26
63192,2018-04-06,2,5,7,12
63193,2018-04-06,3,4,7,11
63194,2018-04-06,4,2,15,17
63195,2018-04-06,5,4,61,65
63196,2018-04-06,6,14,243,257
63197,2018-04-06,7,34,615,649
63198,2018-04-06,8,88,1083,1171
63199,2018-04-06,9,129,549,678
63200,2018-04-06,10,139,243,382
63201,2018-04-06,11,263,311,574
63202,2018-04-06,12,274,391,665
63203,2018-04-06,13,347,413,760
63204,2018-04-06,14,417,386,803
63205,2018-04-06,15,512,578,1090
63206,2018-04-06,16,568,935,1503
63207,2018-04-06,17,628,1410,2038
63208,2018-04-06,18,500,1092,1592
63209,2018-04-06,19,351,639,990
63210,2018-04-06,20,190,375,565
63211,2018-04-06,21,151,251,402
63212,2018-04-06,22,147,198,345
63213,2018-04-06,23,102,166,268
63214,2018-04-07,0,80,96,176
63215,2018-04-07,1,41,63,104
63216,2018-04-07,2,23,55,78
63217,2018-04-07,3,13,16,29
63218,2018-04-07,4,3,15,18
63219,2018-04-07,5,2,16,18
63220,2018-04-07,6,10,38,48
63221,2018-04-07,7,13,71,84
63222,2018-04-07,8,41,188,229
63223,2018-04-07,9,78,322,400
63224,2018-04-07,10,152,341,493
63225,2018-04-07,11,207,473,680
63226,2018-04-07,12,187,477,664
63227,2018-04-07,13,199,408,607
63228,2018-04-07,14,196,439,635
63229,2018-04-07,15,233,408,641
63230,2018-04-07,16,232,400,632
63231,2018-04-07,17,212,350,562
63232,2018-04-07,18,142,313,455
63233,2018-04-07,19,61,286,347
63234,2018-04-07,20,45,198,243
63235,2018-04-07,21,28,159,187
63236,2018-04-07,22,32,107,139
63237,2018-04-07,23,22,86,108
63238,2018-04-08,0,36,60,96
63239,2018-04-08,1,12,59,71
63240,2018-04-08,2,5,55,60
63241,2018-04-08,3,3,24,27
63242,2018-04-08,4,0,6,6
63243,2018-04-08,5,2,14,16
63244,2018-04-08,6,53,192,245
63245,2018-04-08,7,43,110,153
63246,2018-04-08,8,52,160,212
63247,2018-04-08,9,132,296,428
63248,2018-04-08,10,186,456,642
63249,2018-04-08,11,287,434,721
63250,2018-04-08,12,394,484,878
63251,2018-04-08,13,420,553,973
63252,2018-04-08,14,411,544,955
63253,2018-04-08,15,388,515,903
63254,2018-04-08,16,484,563,1047
63255,2018-04-08,17,443,475,918
63256,2018-04-08,18,275,435,710
63257,2018-04-08,19,170,316,486
63258,2018-04-08,20,45,184,229
63259,2018-04-08,21,25,125,150
63260,2018-04-08,22,30,93,123
63261,2018-04-08,23,25,84,109
63262,2018-04-09,0,15,33,48
63263,2018-04-09,1,5,16,21
63264,2018-04-09,2,1,11,12
63265,2018-04-09,3,4,5,9
63266,2018-04-09,4,5,10,15
63267,2018-04-09,5,0,57,57
63268,2018-04-09,6,7,239,246
63269,2018-04-09,7,21,537,558
63270,2018-04-09,8,32,851,883
63271,2018-04-09,9,30,378,408
63272,2018-04-09,10,59,194,253
63273,2018-04-09,11,105,211,316
63274,2018-04-09,12,100,246,346
63275,2018-04-09,13,111,219,330
63276,2018-04-09,14,95,225,320
63277,2018-04-09,15,91,284,375
63278,2018-04-09,16,98,499,597
63279,2018-04-09,17,140,1009,1149
63280,2018-04-09,18,85,871,956
63281,2018-04-09,19,40,454,494
63282,2018-04-09,20,30,279,309
63283,2018-04-09,21,19,200,219
63284,2018-04-09,22,5,80,85
63285,2018-04-09,23,2,38,40
63286,2018-04-10,0,4,19,23
63287,2018-04-10,1,2,5,7
63288,2018-04-10,2,1,5,6
63289,2018-04-10,3,2,2,4
63290,2018-04-10,4,1,15,16
63291,2018-04-10,5,2,81,83
63292,2018-04-10,6,12,253,265
63293,2018-04-10,7,17,721,738
63294,2018-04-10,8,47,1069,1116
63295,2018-04-10,9,50,495,545
63296,2018-04-10,10,104,211,315
63297,2018-04-10,11,125,231,356
63298,2018-04-10,12,83,314,397
63299,2018-04-10,13,107,322,429
63300,2018-04-10,14,150,248,398
63301,2018-04-10,15,157,389,546
63302,2018-04-10,16,162,647,809
63303,2018-04-10,17,246,1244,1490
63304,2018-04-10,18,177,1035,1212
63305,2018-04-10,19,130,601,731
63306,2018-04-10,20,76,347,423
63307,2018-04-10,21,55,265,320
63308,2018-04-10,22,38,162,200
63309,2018-04-10,23,8,68,76
63310,2018-04-11,0,10,35,45
63311,2018-04-11,1,0,9,9
63312,2018-04-11,2,3,8,11
63313,2018-04-11,3,0,2,2
63314,2018-04-11,4,0,14,14
63315,2018-04-11,5,5,91,96
63316,2018-04-11,6,15,262,277
63317,2018-04-11,7,19,744,763
63318,2018-04-11,8,44,1174,1218
63319,2018-04-11,9,44,510,554
63320,2018-04-11,10,68,241,309
63321,2018-04-11,11,147,247,394
63322,2018-04-11,12,97,351,448
63323,2018-04-11,13,112,373,485
63324,2018-04-11,14,142,296,438
63325,2018-04-11,15,154,430,584
63326,2018-04-11,16,188,642,830
63327,2018-04-11,17,209,1226,1435
63328,2018-04-11,18,196,1077,1273
63329,2018-04-11,19,139,695,834
63330,2018-04-11,20,90,400,490
63331,2018-04-11,21,38,304,342
63332,2018-04-11,22,37,169,206
63333,2018-04-11,23,24,82,106
63334,2018-04-12,0,7,29,36
63335,2018-04-12,1,0,14,14
63336,2018-04-12,2,2,7,9
63337,2018-04-12,3,0,6,6
63338,2018-04-12,4,0,10,10
63339,2018-04-12,5,2,79,81
63340,2018-04-12,6,12,278,290
63341,2018-04-12,7,29,748,777
63342,2018-04-12,8,52,1193,1245
63343,2018-04-12,9,80,542,622
63344,2018-04-12,10,93,247,340
63345,2018-04-12,11,149,271,420
63346,2018-04-12,12,142,359,501
63347,2018-04-12,13,178,380,558
63348,2018-04-12,14,209,355,564
63349,2018-04-12,15,214,467,681
63350,2018-04-12,16,269,732,1001
63351,2018-04-12,17,328,1441,1769
63352,2018-04-12,18,315,1213,1528
63353,2018-04-12,19,256,756,1012
63354,2018-04-12,20,139,433,572
63355,2018-04-12,21,112,351,463
63356,2018-04-12,22,107,254,361
63357,2018-04-12,23,64,160,224
63358,2018-04-13,0,34,49,83
63359,2018-04-13,1,15,33,48
63360,2018-04-13,2,3,15,18
63361,2018-04-13,3,7,13,20
63362,2018-04-13,4,4,15,19
63363,2018-04-13,5,7,92,99
63364,2018-04-13,6,30,271,301
63365,2018-04-13,7,47,704,751
63366,2018-04-13,8,76,1151,1227
63367,2018-04-13,9,108,570,678
63368,2018-04-13,10,212,348,560
63369,2018-04-13,11,270,404,674
63370,2018-04-13,12,283,494,777
63371,2018-04-13,13,343,529,872
63372,2018-04-13,14,466,525,991
63373,2018-04-13,15,486,660,1146
63374,2018-04-13,16,490,911,1401
63375,2018-04-13,17,583,1398,1981
63376,2018-04-13,18,502,1003,1505
63377,2018-04-13,19,370,595,965
63378,2018-04-13,20,291,411,702
63379,2018-04-13,21,181,308,489
63380,2018-04-13,22,210,267,477
63381,2018-04-13,23,106,205,311
63382,2018-04-14,0,103,127,230
63383,2018-04-14,1,60,83,143
63384,2018-04-14,2,40,52,92
63385,2018-04-14,3,20,30,50
63386,2018-04-14,4,13,19,32
63387,2018-04-14,5,4,23,27
63388,2018-04-14,6,23,60,83
63389,2018-04-14,7,45,145,190
63390,2018-04-14,8,132,283,415
63391,2018-04-14,9,282,514,796
63392,2018-04-14,10,493,581,1074
63393,2018-04-14,11,709,686,1395
63394,2018-04-14,12,883,753,1636
63395,2018-04-14,13,984,770,1754
63396,2018-04-14,14,935,685,1620
63397,2018-04-14,15,1050,746,1796
63398,2018-04-14,16,945,696,1641
63399,2018-04-14,17,882,678,1560
63400,2018-04-14,18,726,570,1296
63401,2018-04-14,19,621,514,1135
63402,2018-04-14,20,416,357,773
63403,2018-04-14,21,329,314,643
63404,2018-04-14,22,201,198,399
63405,2018-04-14,23,142,188,330
63406,2018-04-15,0,105,134,239
63407,2018-04-15,1,93,96,189
63408,2018-04-15,2,52,60,112
63409,2018-04-15,3,26,38,64
63410,2018-04-15,4,6,20,26
63411,2018-04-15,5,3,19,22
63412,2018-04-15,6,12,36,48
63413,2018-04-15,7,28,78,106
63414,2018-04-15,8,77,168,245
63415,2018-04-15,9,190,287,477
63416,2018-04-15,10,263,405,668
63417,2018-04-15,11,81,225,306
63418,2018-04-15,12,141,344,485
63419,2018-04-15,13,92,276,368
63420,2018-04-15,14,36,141,177
63421,2018-04-15,15,78,201,279
63422,2018-04-15,16,93,261,354
63423,2018-04-15,17,28,145,173
63424,2018-04-15,18,35,131,166
63425,2018-04-15,19,15,83,98
63426,2018-04-15,20,6,68,74
63427,2018-04-15,21,14,59,73
63428,2018-04-15,22,3,45,48
63429,2018-04-15,23,17,41,58
63430,2018-04-16,0,1,10,11
63431,2018-04-16,1,1,6,7
63432,2018-04-16,2,0,1,1
63433,2018-04-16,3,0,1,1
63434,2018-04-16,4,0,7,7
63435,2018-04-16,5,0,30,30
63436,2018-04-16,6,8,142,150
63437,2018-04-16,7,8,406,414
63438,2018-04-16,8,12,595,607
63439,2018-04-16,9,14,186,200
63440,2018-04-16,10,29,98,127
63441,2018-04-16,11,36,169,205
63442,2018-04-16,12,58,203,261
63443,2018-04-16,13,51,168,219
63444,2018-04-16,14,46,152,198
63445,2018-04-16,15,78,261,339
63446,2018-04-16,16,98,488,586
63447,2018-04-16,17,91,988,1079
63448,2018-04-16,18,66,788,854
63449,2018-04-16,19,35,451,486
63450,2018-04-16,20,20,318,338
63451,2018-04-16,21,25,180,205
63452,2018-04-16,22,22,109,131
63453,2018-04-16,23,7,58,65
63454,2018-04-17,0,1,27,28
63455,2018-04-17,1,0,8,8
63456,2018-04-17,2,1,5,6
63457,2018-04-17,3,0,2,2
63458,2018-04-17,4,1,9,10
63459,2018-04-17,5,0,77,77
63460,2018-04-17,6,8,295,303
63461,2018-04-17,7,23,702,725
63462,2018-04-17,8,73,1277,1350
63463,2018-04-17,9,66,562,628
63464,2018-04-17,10,64,228,292
63465,2018-04-17,11,76,216,292
63466,2018-04-17,12,68,292,360
63467,2018-04-17,13,66,233,299
63468,2018-04-17,14,63,228,291
63469,2018-04-17,15,73,311,384
63470,2018-04-17,16,59,515,574
63471,2018-04-17,17,102,1016,1118
63472,2018-04-17,18,65,876,941
63473,2018-04-17,19,45,514,559
63474,2018-04-17,20,23,301,324
63475,2018-04-17,21,26,217,243
63476,2018-04-17,22,13,114,127
63477,2018-04-17,23,4,54,58
63478,2018-04-18,0,6,25,31
63479,2018-04-18,1,0,5,5
63480,2018-04-18,2,0,2,2
63481,2018-04-18,3,1,5,6
63482,2018-04-18,4,2,15,17
63483,2018-04-18,5,3,83,86
63484,2018-04-18,6,14,257,271
63485,2018-04-18,7,23,694,717
63486,2018-04-18,8,36,1096,1132
63487,2018-04-18,9,49,519,568
63488,2018-04-18,10,62,223,285
63489,2018-04-18,11,84,293,377
63490,2018-04-18,12,114,350,464
63491,2018-04-18,13,135,361,496
63492,2018-04-18,14,178,350,528
63493,2018-04-18,15,193,423,616
63494,2018-04-18,16,177,690,867
63495,2018-04-18,17,195,1286,1481
63496,2018-04-18,18,175,1167,1342
63497,2018-04-18,19,147,684,831
63498,2018-04-18,20,97,454,551
63499,2018-04-18,21,56,320,376
63500,2018-04-18,22,53,194,247
63501,2018-04-18,23,28,71,99
63502,2018-04-19,0,14,44,58
63503,2018-04-19,1,1,7,8
63504,2018-04-19,2,1,5,6
63505,2018-04-19,3,1,11,12
63506,2018-04-19,4,1,15,16
63507,2018-04-19,5,3,73,76
63508,2018-04-19,6,16,269,285
63509,2018-04-19,7,32,590,622
63510,2018-04-19,8,15,633,648
63511,2018-04-19,9,37,436,473
63512,2018-04-19,10,82,274,356
63513,2018-04-19,11,88,220,308
63514,2018-04-19,12,49,243,292
63515,2018-04-19,13,64,275,339
63516,2018-04-19,14,102,264,366
63517,2018-04-19,15,93,375,468
63518,2018-04-19,16,102,575,677
63519,2018-04-19,17,139,1047,1186
63520,2018-04-19,18,104,928,1032
63521,2018-04-19,19,53,536,589
63522,2018-04-19,20,34,298,332
63523,2018-04-19,21,26,242,268
63524,2018-04-19,22,18,168,186
63525,2018-04-19,23,7,81,88
63526,2018-04-20,0,2,46,48
63527,2018-04-20,1,4,16,20
63528,2018-04-20,2,4,12,16
63529,2018-04-20,3,0,8,8
63530,2018-04-20,4,1,12,13
63531,2018-04-20,5,0,69,69
63532,2018-04-20,6,11,239,250
63533,2018-04-20,7,23,589,612
63534,2018-04-20,8,47,994,1041
63535,2018-04-20,9,77,530,607
63536,2018-04-20,10,70,249,319
63537,2018-04-20,11,124,313,437
63538,2018-04-20,12,172,440,612
63539,2018-04-20,13,172,435,607
63540,2018-04-20,14,210,418,628
63541,2018-04-20,15,249,555,804
63542,2018-04-20,16,261,778,1039
63543,2018-04-20,17,239,1166,1405
63544,2018-04-20,18,232,909,1141
63545,2018-04-20,19,158,570,728
63546,2018-04-20,20,105,318,423
63547,2018-04-20,21,75,208,283
63548,2018-04-20,22,50,194,244
63549,2018-04-20,23,60,152,212
63550,2018-04-21,0,35,109,144
63551,2018-04-21,1,12,56,68
63552,2018-04-21,2,14,34,48
63553,2018-04-21,3,7,15,22
63554,2018-04-21,4,1,10,11
63555,2018-04-21,5,2,22,24
63556,2018-04-21,6,7,54,61
63557,2018-04-21,7,28,114,142
63558,2018-04-21,8,95,251,346
63559,2018-04-21,9,135,434,569
63560,2018-04-21,10,250,496,746
63561,2018-04-21,11,379,604,983
63562,2018-04-21,12,460,642,1102
63563,2018-04-21,13,660,688,1348
63564,2018-04-21,14,757,703,1460
63565,2018-04-21,15,660,633,1293
63566,2018-04-21,16,687,624,1311
63567,2018-04-21,17,631,588,1219
63568,2018-04-21,18,486,547,1033
63569,2018-04-21,19,310,432,742
63570,2018-04-21,20,214,265,479
63571,2018-04-21,21,132,190,322
63572,2018-04-21,22,112,180,292
63573,2018-04-21,23,105,166,271
63574,2018-04-22,0,46,95,141
63575,2018-04-22,1,25,69,94
63576,2018-04-22,2,27,62,89
63577,2018-04-22,3,30,21,51
63578,2018-04-22,4,8,11,19
63579,2018-04-22,5,2,27,29
63580,2018-04-22,6,14,39,53
63581,2018-04-22,7,26,86,112
63582,2018-04-22,8,58,194,252
63583,2018-04-22,9,179,314,493
63584,2018-04-22,10,366,464,830
63585,2018-04-22,11,562,558,1120
63586,2018-04-22,12,604,641,1245
63587,2018-04-22,13,640,688,1328
63588,2018-04-22,14,693,657,1350
63589,2018-04-22,15,608,626,1234
63590,2018-04-22,16,555,618,1173
63591,2018-04-22,17,461,559,1020
63592,2018-04-22,18,359,430,789
63593,2018-04-22,19,242,368,610
63594,2018-04-22,20,155,268,423
63595,2018-04-22,21,99,210,309
63596,2018-04-22,22,47,112,159
63597,2018-04-22,23,27,48,75
63598,2018-04-23,0,7,30,37
63599,2018-04-23,1,2,8,10
63600,2018-04-23,2,0,7,7
63601,2018-04-23,3,4,5,9
63602,2018-04-23,4,4,19,23
63603,2018-04-23,5,0,82,82
63604,2018-04-23,6,19,254,273
63605,2018-04-23,7,39,707,746
63606,2018-04-23,8,77,994,1071
63607,2018-04-23,9,74,436,510
63608,2018-04-23,10,115,235,350
63609,2018-04-23,11,167,328,495
63610,2018-04-23,12,233,395,628
63611,2018-04-23,13,222,353,575
63612,2018-04-23,14,236,348,584
63613,2018-04-23,15,248,398,646
63614,2018-04-23,16,269,682,951
63615,2018-04-23,17,258,1338,1596
63616,2018-04-23,18,233,1132,1365
63617,2018-04-23,19,164,633,797
63618,2018-04-23,20,103,395,498
63619,2018-04-23,21,58,256,314
63620,2018-04-23,22,29,123,152
63621,2018-04-23,23,19,76,95
63622,2018-04-24,0,17,25,42
63623,2018-04-24,1,8,12,20
63624,2018-04-24,2,1,5,6
63625,2018-04-24,3,0,2,2
63626,2018-04-24,4,3,20,23
63627,2018-04-24,5,7,103,110
63628,2018-04-24,6,14,306,320
63629,2018-04-24,7,38,823,861
63630,2018-04-24,8,65,1295,1360
63631,2018-04-24,9,58,558,616
63632,2018-04-24,10,87,219,306
63633,2018-04-24,11,84,268,352
63634,2018-04-24,12,120,282,402
63635,2018-04-24,13,101,296,397
63636,2018-04-24,14,65,259,324
63637,2018-04-24,15,45,186,231
63638,2018-04-24,16,30,226,256
63639,2018-04-24,17,27,466,493
63640,2018-04-24,18,22,389,411
63641,2018-04-24,19,12,210,222
63642,2018-04-24,20,4,141,145
63643,2018-04-24,21,7,96,103
63644,2018-04-24,22,5,39,44
63645,2018-04-24,23,7,24,31
63646,2018-04-25,0,1,12,13
63647,2018-04-25,1,5,5,10
63648,2018-04-25,2,0,1,1
63649,2018-04-25,3,0,1,1
63650,2018-04-25,4,0,6,6
63651,2018-04-25,5,2,72,74
63652,2018-04-25,6,7,222,229
63653,2018-04-25,7,14,600,614
63654,2018-04-25,8,40,809,849
63655,2018-04-25,9,28,296,324
63656,2018-04-25,10,36,178,214
63657,2018-04-25,11,38,182,220
63658,2018-04-25,12,53,285,338
63659,2018-04-25,13,71,249,320
63660,2018-04-25,14,89,245,334
63661,2018-04-25,15,127,376,503
63662,2018-04-25,16,135,633,768
63663,2018-04-25,17,138,1115,1253
63664,2018-04-25,18,134,1015,1149
63665,2018-04-25,19,111,590,701
63666,2018-04-25,20,81,424,505
63667,2018-04-25,21,76,294,370
63668,2018-04-25,22,26,220,246
63669,2018-04-25,23,30,102,132
63670,2018-04-26,0,10,44,54
63671,2018-04-26,1,5,18,23
63672,2018-04-26,2,6,10,16
63673,2018-04-26,3,1,7,8
63674,2018-04-26,4,0,14,14
63675,2018-04-26,5,2,93,95
63676,2018-04-26,6,20,328,348
63677,2018-04-26,7,46,826,872
63678,2018-04-26,8,93,1242,1335
63679,2018-04-26,9,69,569,638
63680,2018-04-26,10,129,274,403
63681,2018-04-26,11,152,328,480
63682,2018-04-26,12,196,398,594
63683,2018-04-26,13,225,415,640
63684,2018-04-26,14,258,332,590
63685,2018-04-26,15,275,486,761
63686,2018-04-26,16,301,770,1071
63687,2018-04-26,17,354,1422,1776
63688,2018-04-26,18,327,1195,1522
63689,2018-04-26,19,242,772,1014
63690,2018-04-26,20,146,468,614
63691,2018-04-26,21,124,390,514
63692,2018-04-26,22,97,244,341
63693,2018-04-26,23,65,152,217
63694,2018-04-27,0,15,60,75
63695,2018-04-27,1,26,38,64
63696,2018-04-27,2,21,22,43
63697,2018-04-27,3,4,2,6
63698,2018-04-27,4,0,3,3
63699,2018-04-27,5,1,27,28
63700,2018-04-27,6,6,87,93
63701,2018-04-27,7,16,233,249
63702,2018-04-27,8,21,464,485
63703,2018-04-27,9,61,390,451
63704,2018-04-27,10,79,233,312
63705,2018-04-27,11,133,313,446
63706,2018-04-27,12,146,365,511
63707,2018-04-27,13,162,372,534
63708,2018-04-27,14,237,355,592
63709,2018-04-27,15,264,481,745
63710,2018-04-27,16,253,762,1015
63711,2018-04-27,17,319,1116,1435
63712,2018-04-27,18,231,900,1131
63713,2018-04-27,19,192,517,709
63714,2018-04-27,20,98,373,471
63715,2018-04-27,21,100,275,375
63716,2018-04-27,22,89,220,309
63717,2018-04-27,23,56,183,239
63718,2018-04-28,0,53,111,164
63719,2018-04-28,1,52,53,105
63720,2018-04-28,2,18,42,60
63721,2018-04-28,3,13,21,34
63722,2018-04-28,4,3,6,9
63723,2018-04-28,5,10,25,35
63724,2018-04-28,6,11,56,67
63725,2018-04-28,7,44,130,174
63726,2018-04-28,8,82,252,334
63727,2018-04-28,9,178,398,576
63728,2018-04-28,10,321,527,848
63729,2018-04-28,11,592,572,1164
63730,2018-04-28,12,638,721,1359
63731,2018-04-28,13,750,774,1524
63732,2018-04-28,14,819,738,1557
63733,2018-04-28,15,745,734,1479
63734,2018-04-28,16,707,624,1331
63735,2018-04-28,17,593,620,1213
63736,2018-04-28,18,433,473,906
63737,2018-04-28,19,287,409,696
63738,2018-04-28,20,219,298,517
63739,2018-04-28,21,184,208,392
63740,2018-04-28,22,79,140,219
63741,2018-04-28,23,33,102,135
63742,2018-04-29,0,22,60,82
63743,2018-04-29,1,10,66,76
63744,2018-04-29,2,14,42,56
63745,2018-04-29,3,8,36,44
63746,2018-04-29,4,2,14,16
63747,2018-04-29,5,11,24,35
63748,2018-04-29,6,31,56,87
63749,2018-04-29,7,54,71,125
63750,2018-04-29,8,89,209,298
63751,2018-04-29,9,201,319,520
63752,2018-04-29,10,236,408,644
63753,2018-04-29,11,217,417,634
63754,2018-04-29,12,241,516,757
63755,2018-04-29,13,280,457,737
63756,2018-04-29,14,323,426,749
63757,2018-04-29,15,295,460,755
63758,2018-04-29,16,298,490,788
63759,2018-04-29,17,277,464,741
63760,2018-04-29,18,176,453,629
63761,2018-04-29,19,135,297,432
63762,2018-04-29,20,64,186,250
63763,2018-04-29,21,35,151,186
63764,2018-04-29,22,27,86,113
63765,2018-04-29,23,20,63,83
63766,2018-04-30,0,11,32,43
63767,2018-04-30,1,8,12,20
63768,2018-04-30,2,2,9,11
63769,2018-04-30,3,1,7,8
63770,2018-04-30,4,0,18,18
63771,2018-04-30,5,4,77,81
63772,2018-04-30,6,17,242,259
63773,2018-04-30,7,35,694,729
63774,2018-04-30,8,77,1102,1179
63775,2018-04-30,9,94,512,606
63776,2018-04-30,10,113,257,370
63777,2018-04-30,11,151,293,444
63778,2018-04-30,12,156,367,523
63779,2018-04-30,13,194,385,579
63780,2018-04-30,14,247,323,570
63781,2018-04-30,15,225,467,692
63782,2018-04-30,16,199,768,967
63783,2018-04-30,17,291,1366,1657
63784,2018-04-30,18,203,1229,1432
63785,2018-04-30,19,185,729,914
63786,2018-04-30,20,127,412,539
63787,2018-04-30,21,78,281,359
63788,2018-04-30,22,51,173,224
63789,2018-04-30,23,35,74,109
63790,2018-05-01,0,15,37,52
63791,2018-05-01,1,12,15,27
63792,2018-05-01,2,3,5,8
63793,2018-05-01,3,0,4,4
63794,2018-05-01,4,0,20,20
63795,2018-05-01,5,3,85,88
63796,2018-05-01,6,7,353,360
63797,2018-05-01,7,40,923,963
63798,2018-05-01,8,84,1262,1346
63799,2018-05-01,9,103,534,637
63800,2018-05-01,10,138,254,392
63801,2018-05-01,11,163,326,489
63802,2018-05-01,12,175,437,612
63803,2018-05-01,13,181,419,600
63804,2018-05-01,14,250,369,619
63805,2018-05-01,15,248,519,767
63806,2018-05-01,16,255,813,1068
63807,2018-05-01,17,330,1550,1880
63808,2018-05-01,18,300,1239,1539
63809,2018-05-01,19,224,812,1036
63810,2018-05-01,20,147,463,610
63811,2018-05-01,21,90,360,450
63812,2018-05-01,22,89,251,340
63813,2018-05-01,23,54,163,217
63814,2018-05-02,0,12,50,62
63815,2018-05-02,1,9,20,29
63816,2018-05-02,2,5,5,10
63817,2018-05-02,3,2,8,10
63818,2018-05-02,4,0,21,21
63819,2018-05-02,5,6,106,112
63820,2018-05-02,6,25,369,394
63821,2018-05-02,7,44,878,922
63822,2018-05-02,8,96,1372,1468
63823,2018-05-02,9,91,604,695
63824,2018-05-02,10,129,298,427
63825,2018-05-02,11,156,322,478
63826,2018-05-02,12,194,409,603
63827,2018-05-02,13,197,410,607
63828,2018-05-02,14,170,369,539
63829,2018-05-02,15,186,495,681
63830,2018-05-02,16,191,770,961
63831,2018-05-02,17,303,1444,1747
63832,2018-05-02,18,282,1202,1484
63833,2018-05-02,19,208,749,957
63834,2018-05-02,20,140,498,638
63835,2018-05-02,21,110,399,509
63836,2018-05-02,22,113,256,369
63837,2018-05-02,23,67,142,209
63838,2018-05-03,0,37,40,77
63839,2018-05-03,1,16,24,40
63840,2018-05-03,2,12,7,19
63841,2018-05-03,3,4,7,11
63842,2018-05-03,4,0,20,20
63843,2018-05-03,5,4,90,94
63844,2018-05-03,6,22,351,373
63845,2018-05-03,7,41,907,948
63846,2018-05-03,8,102,1421,1523
63847,2018-05-03,9,115,606,721
63848,2018-05-03,10,141,280,421
63849,2018-05-03,11,160,386,546
63850,2018-05-03,12,200,451,651
63851,2018-05-03,13,189,393,582
63852,2018-05-03,14,184,303,487
63853,2018-05-03,15,200,500,700
63854,2018-05-03,16,259,754,1013
63855,2018-05-03,17,285,1368,1653
63856,2018-05-03,18,255,1171,1426
63857,2018-05-03,19,273,761,1034
63858,2018-05-03,20,161,531,692
63859,2018-05-03,21,134,378,512
63860,2018-05-03,22,100,290,390
63861,2018-05-03,23,63,167,230
63862,2018-05-04,0,42,64,106
63863,2018-05-04,1,31,26,57
63864,2018-05-04,2,19,12,31
63865,2018-05-04,3,8,11,19
63866,2018-05-04,4,2,17,19
63867,2018-05-04,5,3,81,84
63868,2018-05-04,6,26,308,334
63869,2018-05-04,7,50,742,792
63870,2018-05-04,8,91,1137,1228
63871,2018-05-04,9,115,609,724
63872,2018-05-04,10,216,318,534
63873,2018-05-04,11,258,365,623
63874,2018-05-04,12,334,445,779
63875,2018-05-04,13,354,473,827
63876,2018-05-04,14,357,441,798
63877,2018-05-04,15,352,545,897
63878,2018-05-04,16,378,817,1195
63879,2018-05-04,17,436,1263,1699
63880,2018-05-04,18,332,887,1219
63881,2018-05-04,19,254,639,893
63882,2018-05-04,20,101,233,334
63883,2018-05-04,21,96,223,319
63884,2018-05-04,22,108,221,329
63885,2018-05-04,23,80,198,278
63886,2018-05-05,0,48,113,161
63887,2018-05-05,1,44,80,124
63888,2018-05-05,2,29,54,83
63889,2018-05-05,3,16,34,50
63890,2018-05-05,4,10,10,20
63891,2018-05-05,5,6,20,26
63892,2018-05-05,6,15,51,66
63893,2018-05-05,7,33,145,178
63894,2018-05-05,8,94,320,414
63895,2018-05-05,9,218,481,699
63896,2018-05-05,10,294,553,847
63897,2018-05-05,11,379,635,1014
63898,2018-05-05,12,441,661,1102
63899,2018-05-05,13,457,618,1075
63900,2018-05-05,14,426,545,971
63901,2018-05-05,15,474,572,1046
63902,2018-05-05,16,459,537,996
63903,2018-05-05,17,344,448,792
63904,2018-05-05,18,278,371,649
63905,2018-05-05,19,243,345,588
63906,2018-05-05,20,169,258,427
63907,2018-05-05,21,113,228,341
63908,2018-05-05,22,111,182,293
63909,2018-05-05,23,81,207,288
63910,2018-05-06,0,66,136,202
63911,2018-05-06,1,53,81,134
63912,2018-05-06,2,38,55,93
63913,2018-05-06,3,15,37,52
63914,2018-05-06,4,7,17,24
63915,2018-05-06,5,2,12,14
63916,2018-05-06,6,3,38,41
63917,2018-05-06,7,25,88,113
63918,2018-05-06,8,79,210,289
63919,2018-05-06,9,150,345,495
63920,2018-05-06,10,347,481,828
63921,2018-05-06,11,420,541,961
63922,2018-05-06,12,435,622,1057
63923,2018-05-06,13,445,613,1058
63924,2018-05-06,14,462,579,1041
63925,2018-05-06,15,381,549,930
63926,2018-05-06,16,426,530,956
63927,2018-05-06,17,374,505,879
63928,2018-05-06,18,256,453,709
63929,2018-05-06,19,197,359,556
63930,2018-05-06,20,148,240,388
63931,2018-05-06,21,77,199,276
63932,2018-05-06,22,65,131,196
63933,2018-05-06,23,44,73,117
63934,2018-05-07,0,19,34,53
63935,2018-05-07,1,13,7,20
63936,2018-05-07,2,6,10,16
63937,2018-05-07,3,0,6,6
63938,2018-05-07,4,2,21,23
63939,2018-05-07,5,5,87,92
63940,2018-05-07,6,27,314,341
63941,2018-05-07,7,56,797,853
63942,2018-05-07,8,109,1109,1218
63943,2018-05-07,9,126,546,672
63944,2018-05-07,10,151,274,425
63945,2018-05-07,11,191,335,526
63946,2018-05-07,12,202,435,637
63947,2018-05-07,13,270,435,705
63948,2018-05-07,14,274,389,663
63949,2018-05-07,15,294,498,792
63950,2018-05-07,16,275,777,1052
63951,2018-05-07,17,351,1474,1825
63952,2018-05-07,18,281,1233,1514
63953,2018-05-07,19,254,717,971
63954,2018-05-07,20,152,448,600
63955,2018-05-07,21,111,273,384
63956,2018-05-07,22,80,178,258
63957,2018-05-07,23,68,106,174
63958,2018-05-08,0,15,41,56
63959,2018-05-08,1,15,16,31
63960,2018-05-08,2,7,6,13
63961,2018-05-08,3,2,5,7
63962,2018-05-08,4,0,22,22
63963,2018-05-08,5,6,91,97
63964,2018-05-08,6,18,379,397
63965,2018-05-08,7,46,992,1038
63966,2018-05-08,8,86,1318,1404
63967,2018-05-08,9,106,581,687
63968,2018-05-08,10,133,273,406
63969,2018-05-08,11,111,324,435
63970,2018-05-08,12,161,403,564
63971,2018-05-08,13,213,367,580
63972,2018-05-08,14,193,316,509
63973,2018-05-08,15,227,466,693
63974,2018-05-08,16,236,805,1041
63975,2018-05-08,17,237,1565,1802
63976,2018-05-08,18,257,1235,1492
63977,2018-05-08,19,209,817,1026
63978,2018-05-08,20,118,516,634
63979,2018-05-08,21,101,354,455
63980,2018-05-08,22,66,210,276
63981,2018-05-08,23,57,133,190
63982,2018-05-09,0,22,42,64
63983,2018-05-09,1,14,8,22
63984,2018-05-09,2,2,8,10
63985,2018-05-09,3,4,5,9
63986,2018-05-09,4,6,22,28
63987,2018-05-09,5,8,103,111
63988,2018-05-09,6,23,382,405
63989,2018-05-09,7,56,916,972
63990,2018-05-09,8,83,1430,1513
63991,2018-05-09,9,101,609,710
63992,2018-05-09,10,114,291,405
63993,2018-05-09,11,145,332,477
63994,2018-05-09,12,140,368,508
63995,2018-05-09,13,185,433,618
63996,2018-05-09,14,200,400,600
63997,2018-05-09,15,202,470,672
63998,2018-05-09,16,225,787,1012
63999,2018-05-09,17,310,1455,1765
64000,2018-05-09,18,272,1201,1473
64001,2018-05-09,19,223,855,1078
64002,2018-05-09,20,152,541,693
64003,2018-05-09,21,105,358,463
64004,2018-05-09,22,82,235,317
64005,2018-05-09,23,34,97,131
64006,2018-05-10,0,36,61,97
64007,2018-05-10,1,15,28,43
64008,2018-05-10,2,16,9,25
64009,2018-05-10,3,2,10,12
64010,2018-05-10,4,3,17,20
64011,2018-05-10,5,6,98,104
64012,2018-05-10,6,21,359,380
64013,2018-05-10,7,37,866,903
64014,2018-05-10,8,60,1335,1395
64015,2018-05-10,9,111,557,668
64016,2018-05-10,10,145,282,427
64017,2018-05-10,11,152,310,462
64018,2018-05-10,12,155,420,575
64019,2018-05-10,13,152,408,560
64020,2018-05-10,14,203,355,558
64021,2018-05-10,15,217,486,703
64022,2018-05-10,16,176,617,793
64023,2018-05-10,17,257,1238,1495
64024,2018-05-10,18,257,1092,1349
64025,2018-05-10,19,189,656,845
64026,2018-05-10,20,164,453,617
64027,2018-05-10,21,132,344,476
64028,2018-05-10,22,81,264,345
64029,2018-05-10,23,62,134,196
64030,2018-05-11,0,57,69,126
64031,2018-05-11,1,19,26,45
64032,2018-05-11,2,8,22,30
64033,2018-05-11,3,8,7,15
64034,2018-05-11,4,4,21,25
64035,2018-05-11,5,6,102,108
64036,2018-05-11,6,26,306,332
64037,2018-05-11,7,51,755,806
64038,2018-05-11,8,96,1177,1273
64039,2018-05-11,9,123,574,697
64040,2018-05-11,10,222,320,542
64041,2018-05-11,11,265,384,649
64042,2018-05-11,12,323,517,840
64043,2018-05-11,13,315,505,820
64044,2018-05-11,14,324,427,751
64045,2018-05-11,15,318,621,939
64046,2018-05-11,16,313,864,1177
64047,2018-05-11,17,388,1252,1640
64048,2018-05-11,18,308,966,1274
64049,2018-05-11,19,329,666,995
64050,2018-05-11,20,231,430,661
64051,2018-05-11,21,184,324,508
64052,2018-05-11,22,135,272,407
64053,2018-05-11,23,127,237,364
64054,2018-05-12,0,83,133,216
64055,2018-05-12,1,50,96,146
64056,2018-05-12,2,23,61,84
64057,2018-05-12,3,16,26,42
64058,2018-05-12,4,7,19,26
64059,2018-05-12,5,11,24,35
64060,2018-05-12,6,19,53,72
64061,2018-05-12,7,44,141,185
64062,2018-05-12,8,88,322,410
64063,2018-05-12,9,271,530,801
64064,2018-05-12,10,428,579,1007
64065,2018-05-12,11,484,632,1116
64066,2018-05-12,12,542,667,1209
64067,2018-05-12,13,599,680,1279
64068,2018-05-12,14,564,633,1197
64069,2018-05-12,15,522,644,1166
64070,2018-05-12,16,553,609,1162
64071,2018-05-12,17,466,557,1023
64072,2018-05-12,18,516,477,993
64073,2018-05-12,19,375,454,829
64074,2018-05-12,20,147,247,394
64075,2018-05-12,21,116,180,296
64076,2018-05-12,22,94,195,289
64077,2018-05-12,23,93,154,247
64078,2018-05-13,0,70,110,180
64079,2018-05-13,1,30,63,93
64080,2018-05-13,2,26,56,82
64081,2018-05-13,3,20,28,48
64082,2018-05-13,4,11,21,32
64083,2018-05-13,5,0,5,5
64084,2018-05-13,6,1,16,17
64085,2018-05-13,7,26,55,81
64086,2018-05-13,8,56,172,228
64087,2018-05-13,9,110,227,337
64088,2018-05-13,10,92,186,278
64089,2018-05-13,11,207,368,575
64090,2018-05-13,12,337,484,821
64091,2018-05-13,13,364,490,854
64092,2018-05-13,14,321,502,823
64093,2018-05-13,15,357,474,831
64094,2018-05-13,16,286,448,734
64095,2018-05-13,17,208,384,592
64096,2018-05-13,18,149,333,482
64097,2018-05-13,19,172,278,450
64098,2018-05-13,20,106,208,314
64099,2018-05-13,21,99,131,230
64100,2018-05-13,22,17,71,88
64101,2018-05-13,23,16,64,80
64102,2018-05-14,0,15,33,48
64103,2018-05-14,1,6,13,19
64104,2018-05-14,2,7,9,16
64105,2018-05-14,3,1,8,9
64106,2018-05-14,4,0,18,18
64107,2018-05-14,5,8,71,79
64108,2018-05-14,6,11,284,295
64109,2018-05-14,7,24,698,722
64110,2018-05-14,8,50,1052,1102
64111,2018-05-14,9,78,552,630
64112,2018-05-14,10,128,229,357
64113,2018-05-14,11,181,264,445
64114,2018-05-14,12,191,355,546
64115,2018-05-14,13,232,340,572
64116,2018-05-14,14,313,345,658
64117,2018-05-14,15,303,460,763
64118,2018-05-14,16,279,812,1091
64119,2018-05-14,17,326,1497,1823
64120,2018-05-14,18,221,977,1198
64121,2018-05-14,19,9,62,71
64122,2018-05-14,20,7,60,67
64123,2018-05-14,21,14,58,72
64124,2018-05-14,22,24,102,126
64125,2018-05-14,23,52,79,131
64126,2018-05-15,0,15,31,46
64127,2018-05-15,1,14,16,30
64128,2018-05-15,2,7,4,11
64129,2018-05-15,4,0,3,3
64130,2018-05-15,5,6,68,74
64131,2018-05-15,6,15,350,365
64132,2018-05-15,7,44,842,886
64133,2018-05-15,8,84,1325,1409
64134,2018-05-15,9,105,535,640
64135,2018-05-15,10,130,249,379
64136,2018-05-15,11,169,315,484
64137,2018-05-15,12,190,381,571
64138,2018-05-15,13,193,337,530
64139,2018-05-15,14,239,339,578
64140,2018-05-15,15,236,422,658
64141,2018-05-15,16,246,720,966
64142,2018-05-15,17,292,1455,1747
64143,2018-05-15,18,290,1153,1443
64144,2018-05-15,19,226,667,893
64145,2018-05-15,20,99,343,442
64146,2018-05-15,21,20,53,73
64147,2018-05-15,22,29,94,123
64148,2018-05-15,23,22,80,102
64149,2018-05-16,0,17,26,43
64150,2018-05-16,1,8,15,23
64151,2018-05-16,2,2,11,13
64152,2018-05-16,3,1,7,8
64153,2018-05-16,4,0,9,9
64154,2018-05-16,5,3,73,76
64155,2018-05-16,6,11,299,310
64156,2018-05-16,7,45,734,779
64157,2018-05-16,8,69,1197,1266
64158,2018-05-16,9,61,502,563
64159,2018-05-16,10,102,219,321
64160,2018-05-16,11,70,162,232
64161,2018-05-16,12,80,199,279
64162,2018-05-16,13,55,151,206
64163,2018-05-16,14,57,157,214
64164,2018-05-16,15,43,159,202
64165,2018-05-16,16,38,234,272
64166,2018-05-16,17,52,390,442
64167,2018-05-16,18,43,492,535
64168,2018-05-16,19,50,356,406
64169,2018-05-16,20,53,294,347
64170,2018-05-16,21,32,223,255
64171,2018-05-16,22,20,96,116
64172,2018-05-16,23,6,51,57
64173,2018-05-17,0,0,20,20
64174,2018-05-17,1,7,14,21
64175,2018-05-17,2,4,7,11
64176,2018-05-17,3,0,6,6
64177,2018-05-17,4,0,17,17
64178,2018-05-17,5,3,65,68
64179,2018-05-17,6,10,185,195
64180,2018-05-17,7,5,315,320
64181,2018-05-17,8,14,352,366
64182,2018-05-17,9,18,240,258
64183,2018-05-17,10,14,124,138
64184,2018-05-17,11,26,106,132
64185,2018-05-17,12,9,79,88
64186,2018-05-17,13,22,95,117
64187,2018-05-17,14,15,87,102
64188,2018-05-17,15,32,112,144
64189,2018-05-17,16,36,288,324
64190,2018-05-17,17,40,427,467
64191,2018-05-17,18,67,674,741
64192,2018-05-17,19,83,482,565
64193,2018-05-17,20,40,282,322
64194,2018-05-17,21,28,113,141
64195,2018-05-17,22,21,109,130
64196,2018-05-17,23,16,86,102
64197,2018-05-18,0,5,25,30
64198,2018-05-18,1,6,9,15
64199,2018-05-18,2,2,6,8
64200,2018-05-18,3,1,2,3
64201,2018-05-18,4,3,11,14
64202,2018-05-18,5,6,60,66
64203,2018-05-18,6,12,169,181
64204,2018-05-18,7,22,418,440
64205,2018-05-18,8,41,732,773
64206,2018-05-18,9,32,461,493
64207,2018-05-18,10,25,143,168
64208,2018-05-18,11,8,53,61
64209,2018-05-18,12,6,38,44
64210,2018-05-18,13,29,90,119
64211,2018-05-18,14,29,145,174
64212,2018-05-18,15,33,178,211
64213,2018-05-18,16,55,424,479
64214,2018-05-18,17,58,637,695
64215,2018-05-18,18,21,214,235
64216,2018-05-18,19,22,210,232
64217,2018-05-18,20,19,107,126
64218,2018-05-18,21,14,71,85
64219,2018-05-18,22,12,56,68
64220,2018-05-18,23,10,46,56
64221,2018-05-19,0,3,25,28
64222,2018-05-19,1,3,9,12
64223,2018-05-19,2,0,22,22
64224,2018-05-19,3,0,13,13
64225,2018-05-19,4,1,4,5
64226,2018-05-19,5,0,8,8
64227,2018-05-19,6,12,30,42
64228,2018-05-19,7,18,71,89
64229,2018-05-19,8,9,82,91
64230,2018-05-19,9,22,153,175
64231,2018-05-19,10,48,194,242
64232,2018-05-19,11,85,268,353
64233,2018-05-19,12,62,354,416
64234,2018-05-19,13,126,347,473
64235,2018-05-19,14,138,374,512
64236,2018-05-19,15,196,382,578
64237,2018-05-19,16,235,426,661
64238,2018-05-19,17,238,421,659
64239,2018-05-19,18,239,397,636
64240,2018-05-19,19,228,380,608
64241,2018-05-19,20,162,264,426
64242,2018-05-19,21,84,166,250
64243,2018-05-19,22,75,187,262
64244,2018-05-19,23,60,177,237
64245,2018-05-20,0,77,143,220
64246,2018-05-20,1,39,92,131
64247,2018-05-20,2,26,54,80
64248,2018-05-20,3,31,30,61
64249,2018-05-20,4,6,15,21
64250,2018-05-20,5,6,17,23
64251,2018-05-20,6,6,43,49
64252,2018-05-20,7,36,112,148
64253,2018-05-20,8,96,232,328
64254,2018-05-20,9,163,300,463
64255,2018-05-20,10,327,497,824
64256,2018-05-20,11,461,637,1098
64257,2018-05-20,12,565,743,1308
64258,2018-05-20,13,558,706,1264
64259,2018-05-20,14,504,672,1176
64260,2018-05-20,15,550,654,1204
64261,2018-05-20,16,548,642,1190
64262,2018-05-20,17,523,600,1123
64263,2018-05-20,18,426,574,1000
64264,2018-05-20,19,323,492,815
64265,2018-05-20,20,265,371,636
64266,2018-05-20,21,191,252,443
64267,2018-05-20,22,133,180,313
64268,2018-05-20,23,68,92,160
64269,2018-05-21,0,35,40,75
64270,2018-05-21,1,17,22,39
64271,2018-05-21,2,23,11,34
64272,2018-05-21,3,0,10,10
64273,2018-05-21,4,1,24,25
64274,2018-05-21,5,10,102,112
64275,2018-05-21,6,20,320,340
64276,2018-05-21,7,46,842,888
64277,2018-05-21,8,87,1218,1305
64278,2018-05-21,9,120,498,618
64279,2018-05-21,10,214,247,461
64280,2018-05-21,11,298,275,573
64281,2018-05-21,12,267,398,665
64282,2018-05-21,13,251,405,656
64283,2018-05-21,14,297,374,671
64284,2018-05-21,15,282,499,781
64285,2018-05-21,16,283,797,1080
64286,2018-05-21,17,335,1467,1802
64287,2018-05-21,18,320,1311,1631
64288,2018-05-21,19,198,881,1079
64289,2018-05-21,20,168,573,741
64290,2018-05-21,21,127,358,485
64291,2018-05-21,22,87,243,330
64292,2018-05-21,23,72,153,225
64293,2018-05-22,0,20,44,64
64294,2018-05-22,1,12,25,37
64295,2018-05-22,2,9,10,19
64296,2018-05-22,3,2,4,6
64297,2018-05-22,4,0,20,20
64298,2018-05-22,5,6,99,105
64299,2018-05-22,6,19,346,365
64300,2018-05-22,7,47,698,745
64301,2018-05-22,8,51,926,977
64302,2018-05-22,9,65,604,669
64303,2018-05-22,10,73,256,329
64304,2018-05-22,11,55,187,242
64305,2018-05-22,12,104,326,430
64306,2018-05-22,13,125,321,446
64307,2018-05-22,14,161,309,470
64308,2018-05-22,15,184,440,624
64309,2018-05-22,16,89,440,529
64310,2018-05-22,17,10,194,204
64311,2018-05-22,18,42,469,511
64312,2018-05-22,19,109,496,605
64313,2018-05-22,20,92,418,510
64314,2018-05-22,21,74,292,366
64315,2018-05-22,22,44,189,233
64316,2018-05-22,23,29,92,121
64317,2018-05-23,0,27,43,70
64318,2018-05-23,1,21,10,31
64319,2018-05-23,2,4,15,19
64320,2018-05-23,3,1,3,4
64321,2018-05-23,4,2,15,17
64322,2018-05-23,5,10,108,118
64323,2018-05-23,6,20,368,388
64324,2018-05-23,7,42,881,923
64325,2018-05-23,8,78,1305,1383
64326,2018-05-23,9,102,605,707
64327,2018-05-23,10,108,287,395
64328,2018-05-23,11,159,301,460
64329,2018-05-23,12,188,450,638
64330,2018-05-23,13,191,420,611
64331,2018-05-23,14,229,396,625
64332,2018-05-23,15,239,511,750
64333,2018-05-23,16,214,813,1027
64334,2018-05-23,17,311,1414,1725
64335,2018-05-23,18,303,1223,1526
64336,2018-05-23,19,262,915,1177
64337,2018-05-23,20,185,568,753
64338,2018-05-23,21,141,380,521
64339,2018-05-23,22,95,272,367
64340,2018-05-23,23,109,221,330
64341,2018-05-24,0,37,69,106
64342,2018-05-24,1,17,30,47
64343,2018-05-24,2,0,14,14
64344,2018-05-24,3,4,4,8
64345,2018-05-24,4,2,22,24
64346,2018-05-24,5,8,83,91
64347,2018-05-24,6,25,340,365
64348,2018-05-24,7,52,828,880
64349,2018-05-24,8,90,1262,1352
64350,2018-05-24,9,125,568,693
64351,2018-05-24,10,148,304,452
64352,2018-05-24,11,191,306,497
64353,2018-05-24,12,257,448,705
64354,2018-05-24,13,248,427,675
64355,2018-05-24,14,225,418,643
64356,2018-05-24,15,267,522,789
64357,2018-05-24,16,255,769,1024
64358,2018-05-24,17,317,1408,1725
64359,2018-05-24,18,294,1106,1400
64360,2018-05-24,19,286,796,1082
64361,2018-05-24,20,215,576,791
64362,2018-05-24,21,132,424,556
64363,2018-05-24,22,94,263,357
64364,2018-05-24,23,64,128,192
64365,2018-05-25,0,29,66,95
64366,2018-05-25,1,31,26,57
64367,2018-05-25,2,12,22,34
64368,2018-05-25,3,3,12,15
64369,2018-05-25,4,1,18,19
64370,2018-05-25,5,1,96,97
64371,2018-05-25,6,13,309,322
64372,2018-05-25,7,40,643,683
64373,2018-05-25,8,102,1087,1189
64374,2018-05-25,9,155,600,755
64375,2018-05-25,10,270,341,611
64376,2018-05-25,11,263,370,633
64377,2018-05-25,12,257,561,818
64378,2018-05-25,13,267,565,832
64379,2018-05-25,14,320,630,950
64380,2018-05-25,15,341,785,1126
64381,2018-05-25,16,418,896,1314
64382,2018-05-25,17,361,951,1312
64383,2018-05-25,18,383,761,1144
64384,2018-05-25,19,334,551,885
64385,2018-05-25,20,301,384,685
64386,2018-05-25,21,213,297,510
64387,2018-05-25,22,165,246,411
64388,2018-05-25,23,136,190,326
64389,2018-05-26,0,75,114,189
64390,2018-05-26,1,48,70,118
64391,2018-05-26,2,32,72,104
64392,2018-05-26,3,7,23,30
64393,2018-05-26,4,9,21,30
64394,2018-05-26,5,11,17,28
64395,2018-05-26,6,17,60,77
64396,2018-05-26,7,51,140,191
64397,2018-05-26,8,153,239,392
64398,2018-05-26,9,257,385,642
64399,2018-05-26,10,429,512,941
64400,2018-05-26,11,489,542,1031
64401,2018-05-26,12,575,602,1177
64402,2018-05-26,13,602,584,1186
64403,2018-05-26,14,596,555,1151
64404,2018-05-26,15,466,486,952
64405,2018-05-26,16,467,445,912
64406,2018-05-26,17,451,431,882
64407,2018-05-26,18,331,356,687
64408,2018-05-26,19,271,262,533
64409,2018-05-26,20,198,199,397
64410,2018-05-26,21,169,179,348
64411,2018-05-26,22,163,180,343
64412,2018-05-26,23,122,150,272
64413,2018-05-27,0,71,87,158
64414,2018-05-27,1,60,60,120
64415,2018-05-27,2,41,52,93
64416,2018-05-27,3,24,23,47
64417,2018-05-27,4,4,14,18
64418,2018-05-27,5,15,17,32
64419,2018-05-27,6,11,45,56
64420,2018-05-27,7,61,96,157
64421,2018-05-27,8,119,224,343
64422,2018-05-27,9,330,370,700
64423,2018-05-27,10,461,498,959
64424,2018-05-27,11,662,564,1226
64425,2018-05-27,12,618,593,1211
64426,2018-05-27,13,691,556,1247
64427,2018-05-27,14,691,544,1235
64428,2018-05-27,15,673,501,1174
64429,2018-05-27,16,539,441,980
64430,2018-05-27,17,422,382,804
64431,2018-05-27,18,345,392,737
64432,2018-05-27,19,261,256,517
64433,2018-05-27,20,108,178,286
64434,2018-05-27,21,160,169,329
64435,2018-05-27,22,151,148,299
64436,2018-05-27,23,107,135,242
64437,2018-05-28,0,55,75,130
64438,2018-05-28,1,34,58,92
64439,2018-05-28,2,5,20,25
64440,2018-05-28,3,10,18,28
64441,2018-05-28,4,3,16,19
64442,2018-05-28,5,5,19,24
64443,2018-05-28,6,13,44,57
64444,2018-05-28,7,30,53,83
64445,2018-05-28,8,78,138,216
64446,2018-05-28,9,147,268,415
64447,2018-05-28,10,281,368,649
64448,2018-05-28,11,341,467,808
64449,2018-05-28,12,434,539,973
64450,2018-05-28,13,508,594,1102
64451,2018-05-28,14,546,597,1143
64452,2018-05-28,15,532,595,1127
64453,2018-05-28,16,472,619,1091
64454,2018-05-28,17,503,564,1067
64455,2018-05-28,18,363,538,901
64456,2018-05-28,19,307,438,745
64457,2018-05-28,20,201,290,491
64458,2018-05-28,21,181,232,413
64459,2018-05-28,22,91,164,255
64460,2018-05-28,23,134,145,279
64461,2018-05-29,0,38,56,94
64462,2018-05-29,1,10,13,23
64463,2018-05-29,2,5,9,14
64464,2018-05-29,3,1,10,11
64465,2018-05-29,4,1,18,19
64466,2018-05-29,5,4,89,93
64467,2018-05-29,6,15,336,351
64468,2018-05-29,7,31,822,853
64469,2018-05-29,8,76,1106,1182
64470,2018-05-29,9,110,470,580
64471,2018-05-29,10,173,265,438
64472,2018-05-29,11,191,290,481
64473,2018-05-29,12,198,402,600
64474,2018-05-29,13,217,383,600
64475,2018-05-29,14,228,317,545
64476,2018-05-29,15,247,458,705
64477,2018-05-29,16,240,752,992
64478,2018-05-29,17,296,1416,1712
64479,2018-05-29,18,249,1182,1431
64480,2018-05-29,19,238,776,1014
64481,2018-05-29,20,184,572,756
64482,2018-05-29,21,103,329,432
64483,2018-05-29,22,66,197,263
64484,2018-05-29,23,41,110,151
64485,2018-05-30,0,19,51,70
64486,2018-05-30,1,10,10,20
64487,2018-05-30,2,7,8,15
64488,2018-05-30,3,4,11,15
64489,2018-05-30,4,6,22,28
64490,2018-05-30,5,6,122,128
64491,2018-05-30,6,23,396,419
64492,2018-05-30,7,41,878,919
64493,2018-05-30,8,98,1307,1405
64494,2018-05-30,9,66,528,594
64495,2018-05-30,10,99,289,388
64496,2018-05-30,11,110,283,393
64497,2018-05-30,12,153,334,487
64498,2018-05-30,13,153,333,486
64499,2018-05-30,14,150,302,452
64500,2018-05-30,15,202,453,655
64501,2018-05-30,16,208,732,940
64502,2018-05-30,17,242,1348,1590
64503,2018-05-30,18,223,1136,1359
64504,2018-05-30,19,187,749,936
64505,2018-05-30,20,148,486,634
64506,2018-05-30,21,78,268,346
64507,2018-05-30,22,63,196,259
64508,2018-05-30,23,47,177,224
64509,2018-05-31,0,9,36,45
64510,2018-05-31,1,3,9,12
64511,2018-05-31,2,0,8,8
64512,2018-05-31,3,1,8,9
64513,2018-05-31,4,2,16,18
64514,2018-05-31,5,6,91,97
64515,2018-05-31,6,9,311,320
64516,2018-05-31,7,24,693,717
64517,2018-05-31,8,86,1229,1315
64518,2018-05-31,9,113,578,691
64519,2018-05-31,10,123,294,417
64520,2018-05-31,11,129,272,401
64521,2018-05-31,12,127,341,468
64522,2018-05-31,13,152,375,527
64523,2018-05-31,14,155,354,509
64524,2018-05-31,15,146,419,565
64525,2018-05-31,16,163,655,818
64526,2018-05-31,17,204,1361,1565
64527,2018-05-31,18,111,753,864
64528,2018-05-31,19,10,116,126
64529,2018-05-31,20,20,176,196
64530,2018-05-31,21,32,191,223
64531,2018-05-31,22,19,103,122
64532,2018-05-31,23,14,83,97
64533,2018-06-01,0,23,51,74
64534,2018-06-01,1,12,38,50
64535,2018-06-01,2,8,21,29
64536,2018-06-01,3,6,8,14
64537,2018-06-01,4,1,17,18
64538,2018-06-01,5,10,100,110
64539,2018-06-01,6,20,288,308
64540,2018-06-01,7,49,711,760
64541,2018-06-01,8,109,1180,1289
64542,2018-06-01,9,89,603,692
64543,2018-06-01,10,154,316,470
64544,2018-06-01,11,179,349,528
64545,2018-06-01,12,266,435,701
64546,2018-06-01,13,265,419,684
64547,2018-06-01,14,253,438,691
64548,2018-06-01,15,225,539,764
64549,2018-06-01,16,295,808,1103
64550,2018-06-01,17,290,1243,1533
64551,2018-06-01,18,277,1018,1295
64552,2018-06-01,19,249,732,981
64553,2018-06-01,20,265,447,712
64554,2018-06-01,21,157,351,508
64555,2018-06-01,22,130,291,421
64556,2018-06-01,23,85,195,280
64557,2018-06-02,0,43,123,166
64558,2018-06-02,1,34,56,90
64559,2018-06-02,2,33,63,96
64560,2018-06-02,3,13,34,47
64561,2018-06-02,4,6,15,21
64562,2018-06-02,5,5,24,29
64563,2018-06-02,6,16,47,63
64564,2018-06-02,7,34,145,179
64565,2018-06-02,8,101,299,400
64566,2018-06-02,9,181,405,586
64567,2018-06-02,10,275,582,857
64568,2018-06-02,11,360,668,1028
64569,2018-06-02,12,456,659,1115
64570,2018-06-02,13,488,646,1134
64571,2018-06-02,14,440,600,1040
64572,2018-06-02,15,356,598,954
64573,2018-06-02,16,158,257,415
64574,2018-06-02,17,178,262,440
64575,2018-06-02,18,212,353,565
64576,2018-06-02,19,222,378,600
64577,2018-06-02,20,187,286,473
64578,2018-06-02,21,104,189,293
64579,2018-06-02,22,61,136,197
64580,2018-06-02,23,110,267,377
64581,2018-06-03,0,66,137,203
64582,2018-06-03,1,58,94,152
64583,2018-06-03,2,36,81,117
64584,2018-06-03,3,17,24,41
64585,2018-06-03,4,8,15,23
64586,2018-06-03,5,1,14,15
64587,2018-06-03,6,13,56,69
64588,2018-06-03,7,26,102,128
64589,2018-06-03,8,7,53,60
64590,2018-06-03,9,17,95,112
64591,2018-06-03,10,14,77,91
64592,2018-06-03,11,6,54,60
64593,2018-06-03,12,10,58,68
64594,2018-06-03,13,6,39,45
64595,2018-06-03,14,13,53,66
64596,2018-06-03,15,14,87,101
64597,2018-06-03,16,6,75,81
64598,2018-06-03,17,11,72,83
64599,2018-06-03,18,16,81,97
64600,2018-06-03,19,20,76,96
64601,2018-06-03,20,12,100,112
64602,2018-06-03,21,15,76,91
64603,2018-06-03,22,25,89,114
64604,2018-06-03,23,34,44,78
64605,2018-06-04,0,11,37,48
64606,2018-06-04,1,12,20,32
64607,2018-06-04,2,4,5,9
64608,2018-06-04,3,4,4,8
64609,2018-06-04,4,1,25,26
64610,2018-06-04,5,5,96,101
64611,2018-06-04,6,12,340,352
64612,2018-06-04,7,43,807,850
64613,2018-06-04,8,70,1174,1244
64614,2018-06-04,9,83,482,565
64615,2018-06-04,10,129,251,380
64616,2018-06-04,11,151,291,442
64617,2018-06-04,12,198,347,545
64618,2018-06-04,13,258,376,634
64619,2018-06-04,14,312,345,657
64620,2018-06-04,15,334,474,808
64621,2018-06-04,16,365,826,1191
64622,2018-06-04,17,398,1523,1921
64623,2018-06-04,18,295,1285,1580
64624,2018-06-04,19,289,888,1177
64625,2018-06-04,20,242,560,802
64626,2018-06-04,21,171,414,585
64627,2018-06-04,22,146,267,413
64628,2018-06-04,23,130,259,389
64629,2018-06-05,0,34,76,110
64630,2018-06-05,1,26,20,46
64631,2018-06-05,2,4,8,12
64632,2018-06-05,3,4,6,10
64633,2018-06-05,4,3,19,22
64634,2018-06-05,5,6,110,116
64635,2018-06-05,6,22,408,430
64636,2018-06-05,7,56,975,1031
64637,2018-06-05,8,97,1393,1490
64638,2018-06-05,9,99,590,689
64639,2018-06-05,10,145,288,433
64640,2018-06-05,11,162,328,490
64641,2018-06-05,12,202,409,611
64642,2018-06-05,13,174,365,539
64643,2018-06-05,14,198,410,608
64644,2018-06-05,15,201,500,701
64645,2018-06-05,16,237,868,1105
64646,2018-06-05,17,239,1471,1710
64647,2018-06-05,18,221,1252,1473
64648,2018-06-05,19,180,711,891
64649,2018-06-05,20,131,533,664
64650,2018-06-05,21,106,392,498
64651,2018-06-05,22,84,219,303
64652,2018-06-05,23,42,121,163
64653,2018-06-06,0,19,54,73
64654,2018-06-06,1,18,23,41
64655,2018-06-06,2,22,10,32
64656,2018-06-06,3,15,5,20
64657,2018-06-06,4,10,22,32
64658,2018-06-06,5,10,129,139
64659,2018-06-06,6,23,428,451
64660,2018-06-06,7,54,1030,1084
64661,2018-06-06,8,96,1404,1500
64662,2018-06-06,9,100,575,675
64663,2018-06-06,10,137,292,429
64664,2018-06-06,11,169,351,520
64665,2018-06-06,12,172,452,624
64666,2018-06-06,13,198,428,626
64667,2018-06-06,14,182,389,571
64668,2018-06-06,15,243,490,733
64669,2018-06-06,16,238,830,1068
64670,2018-06-06,17,300,1569,1869
64671,2018-06-06,18,295,1302,1597
64672,2018-06-06,19,228,764,992
64673,2018-06-06,20,210,617,827
64674,2018-06-06,21,115,383,498
64675,2018-06-06,22,79,248,327
64676,2018-06-06,23,39,133,172
64677,2018-06-07,0,17,52,69
64678,2018-06-07,1,6,18,24
64679,2018-06-07,2,6,12,18
64680,2018-06-07,3,1,7,8
64681,2018-06-07,4,3,23,26
64682,2018-06-07,5,4,83,87
64683,2018-06-07,6,22,373,395
64684,2018-06-07,7,38,946,984
64685,2018-06-07,8,90,1392,1482
64686,2018-06-07,9,123,563,686
64687,2018-06-07,10,142,265,407
64688,2018-06-07,11,179,333,512
64689,2018-06-07,12,215,446,661
64690,2018-06-07,13,182,403,585
64691,2018-06-07,14,252,394,646
64692,2018-06-07,15,225,526,751
64693,2018-06-07,16,319,773,1092
64694,2018-06-07,17,343,1480,1823
64695,2018-06-07,18,333,1252,1585
64696,2018-06-07,19,339,952,1291
64697,2018-06-07,20,183,604,787
64698,2018-06-07,21,145,445,590
64699,2018-06-07,22,146,297,443
64700,2018-06-07,23,277,477,754
64701,2018-06-08,0,242,299,541
64702,2018-06-08,1,65,105,170
64703,2018-06-08,2,32,39,71
64704,2018-06-08,3,9,17,26
64705,2018-06-08,4,7,28,35
64706,2018-06-08,5,5,74,79
64707,2018-06-08,6,23,312,335
64708,2018-06-08,7,55,723,778
64709,2018-06-08,8,114,1213,1327
64710,2018-06-08,9,118,635,753
64711,2018-06-08,10,201,295,496
64712,2018-06-08,11,228,354,582
64713,2018-06-08,12,279,466,745
64714,2018-06-08,13,321,499,820
64715,2018-06-08,14,330,431,761
64716,2018-06-08,15,337,611,948
64717,2018-06-08,16,349,897,1246
64718,2018-06-08,17,400,1264,1664
64719,2018-06-08,18,321,961,1282
64720,2018-06-08,19,263,652,915
64721,2018-06-08,20,228,509,737
64722,2018-06-08,21,204,358,562
64723,2018-06-08,22,150,277,427
64724,2018-06-08,23,78,178,256
64725,2018-06-09,0,68,154,222
64726,2018-06-09,1,40,88,128
64727,2018-06-09,2,23,42,65
64728,2018-06-09,3,25,30,55
64729,2018-06-09,4,9,30,39
64730,2018-06-09,5,14,27,41
64731,2018-06-09,6,25,108,133
64732,2018-06-09,7,50,146,196
64733,2018-06-09,8,93,319,412
64734,2018-06-09,9,241,477,718
64735,2018-06-09,10,352,646,998
64736,2018-06-09,11,445,691,1136
64737,2018-06-09,12,474,690,1164
64738,2018-06-09,13,483,646,1129
64739,2018-06-09,14,466,622,1088
64740,2018-06-09,15,468,599,1067
64741,2018-06-09,16,483,567,1050
64742,2018-06-09,17,464,453,917
64743,2018-06-09,18,415,431,846
64744,2018-06-09,19,415,503,918
64745,2018-06-09,20,277,400,677
64746,2018-06-09,21,125,160,285
64747,2018-06-09,22,66,133,199
64748,2018-06-09,23,47,176,223
64749,2018-06-10,0,68,136,204
64750,2018-06-10,1,39,80,119
64751,2018-06-10,2,37,63,100
64752,2018-06-10,3,28,43,71
64753,2018-06-10,4,8,13,21
64754,2018-06-10,5,10,18,28
64755,2018-06-10,6,14,62,76
64756,2018-06-10,7,40,116,156
64757,2018-06-10,8,75,213,288
64758,2018-06-10,9,197,331,528
64759,2018-06-10,10,324,531,855
64760,2018-06-10,11,406,517,923
64761,2018-06-10,12,415,631,1046
64762,2018-06-10,13,499,641,1140
64763,2018-06-10,14,391,606,997
64764,2018-06-10,15,416,600,1016
64765,2018-06-10,16,417,495,912
64766,2018-06-10,17,316,500,816
64767,2018-06-10,18,285,429,714
64768,2018-06-10,19,212,464,676
64769,2018-06-10,20,186,357,543
64770,2018-06-10,21,95,230,325
64771,2018-06-10,22,88,173,261
64772,2018-06-10,23,43,82,125
64773,2018-06-11,0,27,38,65
64774,2018-06-11,1,10,13,23
64775,2018-06-11,2,2,8,10
64776,2018-06-11,4,2,14,16
64777,2018-06-11,5,2,58,60
64778,2018-06-11,6,10,189,199
64779,2018-06-11,7,39,564,603
64780,2018-06-11,8,64,1011,1075
64781,2018-06-11,9,52,371,423
64782,2018-06-11,10,50,143,193
64783,2018-06-11,11,71,193,264
64784,2018-06-11,12,118,288,406
64785,2018-06-11,13,162,290,452
64786,2018-06-11,14,138,285,423
64787,2018-06-11,15,193,415,608
64788,2018-06-11,16,193,686,879
64789,2018-06-11,17,262,1372,1634
64790,2018-06-11,18,232,1099,1331
64791,2018-06-11,19,177,634,811
64792,2018-06-11,20,132,441,573
64793,2018-06-11,21,81,290,371
64794,2018-06-11,22,56,185,241
64795,2018-06-11,23,50,101,151
64796,2018-06-12,0,16,49,65
64797,2018-06-12,1,17,20,37
64798,2018-06-12,2,0,6,6
64799,2018-06-12,3,0,11,11
64800,2018-06-12,4,3,16,19
64801,2018-06-12,5,3,100,103
64802,2018-06-12,6,27,387,414
64803,2018-06-12,7,58,897,955
64804,2018-06-12,8,121,1365,1486
64805,2018-06-12,9,155,680,835
64806,2018-06-12,10,215,476,691
64807,2018-06-12,11,259,496,755
64808,2018-06-12,12,272,596,868
64809,2018-06-12,13,278,525,803
64810,2018-06-12,14,294,483,777
64811,2018-06-12,15,332,552,884
64812,2018-06-12,16,278,803,1081
64813,2018-06-12,17,322,1405,1727
64814,2018-06-12,18,261,1186,1447
64815,2018-06-12,19,257,794,1051
64816,2018-06-12,20,192,598,790
64817,2018-06-12,21,128,399,527
64818,2018-06-12,22,85,237,322
64819,2018-06-12,23,56,107,163
64820,2018-06-13,0,7,45,52
64821,2018-06-13,1,6,16,22
64822,2018-06-13,2,2,6,8
64823,2018-06-13,3,1,7,8
64824,2018-06-13,4,1,21,22
64825,2018-06-13,5,6,106,112
64826,2018-06-13,6,25,417,442
64827,2018-06-13,7,53,950,1003
64828,2018-06-13,8,85,1426,1511
64829,2018-06-13,9,111,581,692
64830,2018-06-13,10,154,271,425
64831,2018-06-13,11,166,348,514
64832,2018-06-13,12,184,412,596
64833,2018-06-13,13,181,375,556
64834,2018-06-13,14,201,363,564
64835,2018-06-13,15,226,487,713
64836,2018-06-13,16,266,794,1060
64837,2018-06-13,17,315,1471,1786
64838,2018-06-13,18,328,1235,1563
64839,2018-06-13,19,249,857,1106
64840,2018-06-13,20,206,626,832
64841,2018-06-13,21,145,432,577
64842,2018-06-13,22,85,281,366
64843,2018-06-13,23,73,121,194
64844,2018-06-14,0,32,65,97
64845,2018-06-14,1,22,33,55
64846,2018-06-14,2,5,12,17
64847,2018-06-14,3,3,6,9
64848,2018-06-14,4,1,26,27
64849,2018-06-14,5,10,92,102
64850,2018-06-14,6,38,408,446
64851,2018-06-14,7,56,934,990
64852,2018-06-14,8,110,1321,1431
64853,2018-06-14,9,124,572,696
64854,2018-06-14,10,156,301,457
64855,2018-06-14,11,207,334,541
64856,2018-06-14,12,249,471,720
64857,2018-06-14,13,235,447,682
64858,2018-06-14,14,232,396,628
64859,2018-06-14,15,198,525,723
64860,2018-06-14,16,257,800,1057
64861,2018-06-14,17,370,1512,1882
64862,2018-06-14,18,331,1244,1575
64863,2018-06-14,19,309,763,1072
64864,2018-06-14,20,220,608,828
64865,2018-06-14,21,164,463,627
64866,2018-06-14,22,135,322,457
64867,2018-06-14,23,73,178,251
64868,2018-06-15,0,57,81,138
64869,2018-06-15,1,29,30,59
64870,2018-06-15,2,12,25,37
64871,2018-06-15,3,7,6,13
64872,2018-06-15,4,0,20,20
64873,2018-06-15,5,16,130,146
64874,2018-06-15,6,28,334,362
64875,2018-06-15,7,64,819,883
64876,2018-06-15,8,116,1215,1331
64877,2018-06-15,9,142,593,735
64878,2018-06-15,10,209,338,547
64879,2018-06-15,11,221,419,640
64880,2018-06-15,12,287,496,783
64881,2018-06-15,13,295,550,845
64882,2018-06-15,14,324,536,860
64883,2018-06-15,15,318,586,904
64884,2018-06-15,16,363,898,1261
64885,2018-06-15,17,343,1359,1702
64886,2018-06-15,18,377,958,1335
64887,2018-06-15,19,316,685,1001
64888,2018-06-15,20,308,484,792
64889,2018-06-15,21,229,377,606
64890,2018-06-15,22,149,337,486
64891,2018-06-15,23,107,223,330
64892,2018-06-16,0,62,138,200
64893,2018-06-16,1,37,88,125
64894,2018-06-16,2,28,62,90
64895,2018-06-16,3,13,27,40
64896,2018-06-16,4,3,16,19
64897,2018-06-16,5,4,44,48
64898,2018-06-16,6,14,80,94
64899,2018-06-16,7,44,165,209
64900,2018-06-16,8,104,373,477
64901,2018-06-16,9,241,491,732
64902,2018-06-16,10,317,576,893
64903,2018-06-16,11,504,732,1236
64904,2018-06-16,12,557,599,1156
64905,2018-06-16,13,530,669,1199
64906,2018-06-16,14,565,649,1214
64907,2018-06-16,15,507,640,1147
64908,2018-06-16,16,566,629,1195
64909,2018-06-16,17,519,581,1100
64910,2018-06-16,18,404,592,996
64911,2018-06-16,19,418,482,900
64912,2018-06-16,20,336,379,715
64913,2018-06-16,21,291,312,603
64914,2018-06-16,22,184,264,448
64915,2018-06-16,23,140,205,345
64916,2018-06-17,0,69,145,214
64917,2018-06-17,1,37,101,138
64918,2018-06-17,2,21,67,88
64919,2018-06-17,3,12,28,40
64920,2018-06-17,4,8,22,30
64921,2018-06-17,5,9,25,34
64922,2018-06-17,6,17,45,62
64923,2018-06-17,7,37,117,154
64924,2018-06-17,8,133,275,408
64925,2018-06-17,9,225,368,593
64926,2018-06-17,10,322,558,880
64927,2018-06-17,11,358,552,910
64928,2018-06-17,12,385,527,912
64929,2018-06-17,13,395,590,985
64930,2018-06-17,14,433,556,989
64931,2018-06-17,15,437,517,954
64932,2018-06-17,16,392,563,955
64933,2018-06-17,17,328,486,814
64934,2018-06-17,18,268,527,795
64935,2018-06-17,19,272,410,682
64936,2018-06-17,20,194,345,539
64937,2018-06-17,21,159,242,401
64938,2018-06-17,22,113,150,263
64939,2018-06-17,23,84,135,219
64940,2018-06-18,0,37,38,75
64941,2018-06-18,1,13,15,28
64942,2018-06-18,2,7,12,19
64943,2018-06-18,3,1,5,6
64944,2018-06-18,4,1,19,20
64945,2018-06-18,5,9,97,106
64946,2018-06-18,6,19,364,383
64947,2018-06-18,7,45,821,866
64948,2018-06-18,8,96,1048,1144
64949,2018-06-18,9,141,475,616
64950,2018-06-18,10,145,263,408
64951,2018-06-18,11,176,262,438
64952,2018-06-18,12,196,313,509
64953,2018-06-18,13,195,331,526
64954,2018-06-18,14,164,309,473
64955,2018-06-18,15,195,370,565
64956,2018-06-18,16,227,686,913
64957,2018-06-18,17,260,1361,1621
64958,2018-06-18,18,210,1060,1270
64959,2018-06-18,19,184,675,859
64960,2018-06-18,20,172,484,656
64961,2018-06-18,21,127,352,479
64962,2018-06-18,22,105,262,367
64963,2018-06-18,23,57,150,207
64964,2018-06-19,0,25,38,63
64965,2018-06-19,1,20,23,43
64966,2018-06-19,2,7,6,13
64967,2018-06-19,3,1,10,11
64968,2018-06-19,4,4,22,26
64969,2018-06-19,5,6,117,123
64970,2018-06-19,6,24,381,405
64971,2018-06-19,7,64,939,1003
64972,2018-06-19,8,82,1214,1296
64973,2018-06-19,9,77,513,590
64974,2018-06-19,10,125,265,390
64975,2018-06-19,11,138,298,436
64976,2018-06-19,12,153,354,507
64977,2018-06-19,13,138,351,489
64978,2018-06-19,14,31,123,154
64979,2018-06-19,15,37,178,215
64980,2018-06-19,16,96,539,635
64981,2018-06-19,17,184,1249,1433
64982,2018-06-19,18,210,1208,1418
64983,2018-06-19,19,193,741,934
64984,2018-06-19,20,183,604,787
64985,2018-06-19,21,112,383,495
64986,2018-06-19,22,84,296,380
64987,2018-06-19,23,63,124,187
64988,2018-06-20,0,31,52,83
64989,2018-06-20,1,11,19,30
64990,2018-06-20,2,5,7,12
64991,2018-06-20,3,3,6,9
64992,2018-06-20,4,2,19,21
64993,2018-06-20,5,11,119,130
64994,2018-06-20,6,29,387,416
64995,2018-06-20,7,39,962,1001
64996,2018-06-20,8,71,1370,1441
64997,2018-06-20,9,66,587,653
64998,2018-06-20,10,101,263,364
64999,2018-06-20,11,115,302,417
65000,2018-06-20,12,126,381,507
65001,2018-06-20,13,193,377,570
65002,2018-06-20,14,207,373,580
65003,2018-06-20,15,212,485,697
65004,2018-06-20,16,240,822,1062
65005,2018-06-20,17,187,1017,1204
65006,2018-06-20,18,192,991,1183
65007,2018-06-20,19,162,779,941
65008,2018-06-20,20,43,215,258
65009,2018-06-20,21,24,114,138
65010,2018-06-20,22,12,135,147
65011,2018-06-20,23,19,76,95
65012,2018-06-21,0,13,36,49
65013,2018-06-21,1,7,23,30
65014,2018-06-21,2,2,9,11
65015,2018-06-21,3,0,5,5
65016,2018-06-21,4,2,21,23
65017,2018-06-21,5,8,106,114
65018,2018-06-21,6,17,395,412
65019,2018-06-21,7,40,881,921
65020,2018-06-21,8,95,1241,1336
65021,2018-06-21,9,88,571,659
65022,2018-06-21,10,113,261,374
65023,2018-06-21,11,121,297,418
65024,2018-06-21,12,131,328,459
65025,2018-06-21,13,171,403,574
65026,2018-06-21,14,196,364,560
65027,2018-06-21,15,225,441,666
65028,2018-06-21,16,259,773,1032
65029,2018-06-21,17,354,1341,1695
65030,2018-06-21,18,289,1187,1476
65031,2018-06-21,19,218,782,1000
65032,2018-06-21,20,222,500,722
65033,2018-06-21,21,155,439,594
65034,2018-06-21,22,182,333,515
65035,2018-06-21,23,93,157,250
65036,2018-06-22,0,51,76,127
65037,2018-06-22,1,9,25,34
65038,2018-06-22,2,7,20,27
65039,2018-06-22,3,0,6,6
65040,2018-06-22,4,3,18,21
65041,2018-06-22,5,8,85,93
65042,2018-06-22,6,8,217,225
65043,2018-06-22,7,13,290,303
65044,2018-06-22,8,25,617,642
65045,2018-06-22,9,23,249,272
65046,2018-06-22,10,16,92,108
65047,2018-06-22,11,25,123,148
65048,2018-06-22,12,24,147,171
65049,2018-06-22,13,21,112,133
65050,2018-06-22,14,26,174,200
65051,2018-06-22,15,65,278,343
65052,2018-06-22,16,82,459,541
65053,2018-06-22,17,114,738,852
65054,2018-06-22,18,123,616,739
65055,2018-06-22,19,74,321,395
65056,2018-06-22,20,86,266,352
65057,2018-06-22,21,74,274,348
65058,2018-06-22,22,70,191,261
65059,2018-06-22,23,47,149,196
65060,2018-06-23,0,36,92,128
65061,2018-06-23,1,33,99,132
65062,2018-06-23,2,23,49,72
65063,2018-06-23,3,19,26,45
65064,2018-06-23,4,2,16,18
65065,2018-06-23,5,2,24,26
65066,2018-06-23,6,11,64,75
65067,2018-06-23,7,20,131,151
65068,2018-06-23,8,38,250,288
65069,2018-06-23,9,113,377,490
65070,2018-06-23,10,204,480,684
65071,2018-06-23,11,257,539,796
65072,2018-06-23,12,299,583,882
65073,2018-06-23,13,355,612,967
65074,2018-06-23,14,379,638,1017
65075,2018-06-23,15,389,516,905
65076,2018-06-23,16,388,665,1053
65077,2018-06-23,17,381,596,977
65078,2018-06-23,18,350,486,836
65079,2018-06-23,19,199,284,483
65080,2018-06-23,20,107,166,273
65081,2018-06-23,21,124,172,296
65082,2018-06-23,22,110,225,335
65083,2018-06-23,23,75,184,259
65084,2018-06-24,0,52,140,192
65085,2018-06-24,1,37,91,128
65086,2018-06-24,2,27,64,91
65087,2018-06-24,3,13,29,42
65088,2018-06-24,4,12,17,29
65089,2018-06-24,5,13,34,47
65090,2018-06-24,6,15,55,70
65091,2018-06-24,7,31,111,142
65092,2018-06-24,8,64,210,274
65093,2018-06-24,9,168,342,510
65094,2018-06-24,10,336,558,894
65095,2018-06-24,11,434,608,1042
65096,2018-06-24,12,418,602,1020
65097,2018-06-24,13,520,687,1207
65098,2018-06-24,14,467,600,1067
65099,2018-06-24,15,412,620,1032
65100,2018-06-24,16,371,549,920
65101,2018-06-24,17,326,576,902
65102,2018-06-24,18,304,582,886
65103,2018-06-24,19,324,455,779
65104,2018-06-24,20,273,409,682
65105,2018-06-24,21,76,186,262
65106,2018-06-24,22,73,151,224
65107,2018-06-24,23,53,68,121
65108,2018-06-25,0,28,46,74
65109,2018-06-25,1,11,24,35
65110,2018-06-25,2,4,11,15
65111,2018-06-25,3,0,4,4
65112,2018-06-25,4,1,15,16
65113,2018-06-25,5,9,94,103
65114,2018-06-25,6,14,356,370
65115,2018-06-25,7,44,853,897
65116,2018-06-25,8,82,1252,1334
65117,2018-06-25,9,83,545,628
65118,2018-06-25,10,144,283,427
65119,2018-06-25,11,250,330,580
65120,2018-06-25,12,211,408,619
65121,2018-06-25,13,230,446,676
65122,2018-06-25,14,176,336,512
65123,2018-06-25,15,236,412,648
65124,2018-06-25,16,258,737,995
65125,2018-06-25,17,335,1508,1843
65126,2018-06-25,18,249,1232,1481
65127,2018-06-25,19,252,859,1111
65128,2018-06-25,20,198,573,771
65129,2018-06-25,21,140,383,523
65130,2018-06-25,22,106,191,297
65131,2018-06-25,23,76,111,187
65132,2018-06-26,0,39,44,83
65133,2018-06-26,1,14,16,30
65134,2018-06-26,2,8,11,19
65135,2018-06-26,3,1,8,9
65136,2018-06-26,4,6,16,22
65137,2018-06-26,5,5,109,114
65138,2018-06-26,6,28,453,481
65139,2018-06-26,7,58,983,1041
65140,2018-06-26,8,96,1330,1426
65141,2018-06-26,9,84,589,673
65142,2018-06-26,10,130,303,433
65143,2018-06-26,11,144,331,475
65144,2018-06-26,12,229,429,658
65145,2018-06-26,13,177,403,580
65146,2018-06-26,14,185,352,537
65147,2018-06-26,15,210,433,643
65148,2018-06-26,16,195,789,984
65149,2018-06-26,17,299,1507,1806
65150,2018-06-26,18,308,1273,1581
65151,2018-06-26,19,232,896,1128
65152,2018-06-26,20,244,652,896
65153,2018-06-26,21,169,448,617
65154,2018-06-26,22,83,262,345
65155,2018-06-26,23,79,112,191
65156,2018-06-27,0,30,57,87
65157,2018-06-27,1,5,15,20
65158,2018-06-27,2,8,8,16
65159,2018-06-27,3,0,9,9
65160,2018-06-27,4,4,24,28
65161,2018-06-27,5,8,118,126
65162,2018-06-27,6,13,405,418
65163,2018-06-27,7,80,948,1028
65164,2018-06-27,8,84,1338,1422
65165,2018-06-27,9,94,555,649
65166,2018-06-27,10,88,274,362
65167,2018-06-27,11,79,187,266
65168,2018-06-27,12,60,213,273
65169,2018-06-27,13,121,239,360
65170,2018-06-27,14,147,297,444
65171,2018-06-27,15,146,377,523
65172,2018-06-27,16,230,766,996
65173,2018-06-27,17,242,1329,1571
65174,2018-06-27,18,239,1226,1465
65175,2018-06-27,19,226,777,1003
65176,2018-06-27,20,186,621,807
65177,2018-06-27,21,127,389,516
65178,2018-06-27,22,96,250,346
65179,2018-06-27,23,66,114,180
65180,2018-06-28,0,29,63,92
65181,2018-06-28,1,17,24,41
65182,2018-06-28,2,1,12,13
65183,2018-06-28,3,6,9,15
65184,2018-06-28,4,1,24,25
65185,2018-06-28,5,6,96,102
65186,2018-06-28,6,29,377,406
65187,2018-06-28,7,61,869,930
65188,2018-06-28,8,115,1403,1518
65189,2018-06-28,9,94,594,688
65190,2018-06-28,10,114,294,408
65191,2018-06-28,11,157,326,483
65192,2018-06-28,12,181,437,618
65193,2018-06-28,13,174,442,616
65194,2018-06-28,14,206,388,594
65195,2018-06-28,15,232,526,758
65196,2018-06-28,16,179,794,973
65197,2018-06-28,17,299,1440,1739
65198,2018-06-28,18,293,1194,1487
65199,2018-06-28,19,239,881,1120
65200,2018-06-28,20,240,628,868
65201,2018-06-28,21,174,431,605
65202,2018-06-28,22,118,343,461
65203,2018-06-28,23,100,174,274
65204,2018-06-29,0,39,80,119
65205,2018-06-29,1,16,54,70
65206,2018-06-29,2,7,18,25
65207,2018-06-29,3,2,10,12
65208,2018-06-29,4,8,24,32
65209,2018-06-29,5,8,107,115
65210,2018-06-29,6,27,313,340
65211,2018-06-29,7,62,772,834
65212,2018-06-29,8,100,1207,1307
65213,2018-06-29,9,109,583,692
65214,2018-06-29,10,137,326,463
65215,2018-06-29,11,188,357,545
65216,2018-06-29,12,234,426,660
65217,2018-06-29,13,248,437,685
65218,2018-06-29,14,289,448,737
65219,2018-06-29,15,245,580,825
65220,2018-06-29,16,253,798,1051
65221,2018-06-29,17,292,1142,1434
65222,2018-06-29,18,262,880,1142
65223,2018-06-29,19,258,652,910
65224,2018-06-29,20,275,459,734
65225,2018-06-29,21,192,340,532
65226,2018-06-29,22,179,244,423
65227,2018-06-29,23,151,197,348
65228,2018-06-30,0,101,145,246
65229,2018-06-30,1,68,102,170
65230,2018-06-30,2,29,66,95
65231,2018-06-30,3,26,34,60
65232,2018-06-30,4,10,21,31
65233,2018-06-30,5,12,30,42
65234,2018-06-30,6,28,65,93
65235,2018-06-30,7,58,149,207
65236,2018-06-30,8,127,286,413
65237,2018-06-30,9,235,523,758
65238,2018-06-30,10,302,617,919
65239,2018-06-30,11,318,583,901
65240,2018-06-30,12,316,688,1004
65241,2018-06-30,13,384,688,1072
65242,2018-06-30,14,389,624,1013
65243,2018-06-30,15,302,471,773
65244,2018-06-30,16,366,575,941
65245,2018-06-30,17,330,466,796
65246,2018-06-30,18,301,462,763
65247,2018-06-30,19,333,380,713
65248,2018-06-30,20,377,397,774
65249,2018-06-30,21,248,332,580
65250,2018-06-30,22,207,229,436
65251,2018-06-30,23,107,170,277
65252,2018-07-01,0,80,141,221
65253,2018-07-01,1,51,70,121
65254,2018-07-01,2,31,74,105
65255,2018-07-01,3,22,29,51
65256,2018-07-01,4,8,14,22
65257,2018-07-01,5,10,23,33
65258,2018-07-01,6,14,54,68
65259,2018-07-01,7,40,112,152
65260,2018-07-01,8,92,219,311
65261,2018-07-01,9,202,398,600
65262,2018-07-01,10,266,457,723
65263,2018-07-01,11,265,465,730
65264,2018-07-01,12,309,495,804
65265,2018-07-01,13,311,487,798
65266,2018-07-01,14,259,442,701
65267,2018-07-01,15,261,423,684
65268,2018-07-01,16,251,423,674
65269,2018-07-01,17,255,494,749
65270,2018-07-01,18,264,497,761
65271,2018-07-01,19,245,388,633
65272,2018-07-01,20,216,358,574
65273,2018-07-01,21,159,303,462
65274,2018-07-01,22,113,191,304
65275,2018-07-01,23,60,116,176
65276,2018-07-02,0,19,39,58
65277,2018-07-02,1,12,18,30
65278,2018-07-02,2,1,2,3
65279,2018-07-02,3,0,4,4
65280,2018-07-02,4,2,17,19
65281,2018-07-02,5,10,101,111
65282,2018-07-02,6,24,327,351
65283,2018-07-02,7,53,703,756
65284,2018-07-02,8,76,994,1070
65285,2018-07-02,9,149,449,598
65286,2018-07-02,10,159,265,424
65287,2018-07-02,11,144,276,420
65288,2018-07-02,12,160,338,498
65289,2018-07-02,13,195,332,527
65290,2018-07-02,14,153,313,466
65291,2018-07-02,15,198,357,555
65292,2018-07-02,16,189,573,762
65293,2018-07-02,17,194,1159,1353
65294,2018-07-02,18,180,966,1146
65295,2018-07-02,19,216,676,892
65296,2018-07-02,20,205,478,683
65297,2018-07-02,21,158,374,532
65298,2018-07-02,22,114,260,374
65299,2018-07-02,23,83,123,206
65300,2018-07-03,0,29,54,83
65301,2018-07-03,1,20,11,31
65302,2018-07-03,2,5,1,6
65303,2018-07-03,3,0,11,11
65304,2018-07-03,4,2,23,25
65305,2018-07-03,5,7,84,91
65306,2018-07-03,6,23,357,380
65307,2018-07-03,7,57,733,790
65308,2018-07-03,8,85,1008,1093
65309,2018-07-03,9,131,535,666
65310,2018-07-03,10,175,290,465
65311,2018-07-03,11,151,310,461
65312,2018-07-03,12,175,384,559
65313,2018-07-03,13,180,458,638
65314,2018-07-03,14,207,468,675
65315,2018-07-03,15,173,582,755
65316,2018-07-03,16,175,645,820
65317,2018-07-03,17,274,960,1234
65318,2018-07-03,18,226,814,1040
65319,2018-07-03,19,245,616,861
65320,2018-07-03,20,231,483,714
65321,2018-07-03,21,200,427,627
65322,2018-07-03,22,157,298,455
65323,2018-07-03,23,132,181,313
65324,2018-07-04,0,49,109,158
65325,2018-07-04,1,58,64,122
65326,2018-07-04,2,25,46,71
65327,2018-07-04,3,5,26,31
65328,2018-07-04,4,5,21,26
65329,2018-07-04,5,8,41,49
65330,2018-07-04,6,27,83,110
65331,2018-07-04,7,53,145,198
65332,2018-07-04,8,83,251,334
65333,2018-07-04,9,219,448,667
65334,2018-07-04,10,291,536,827
65335,2018-07-04,11,358,522,880
65336,2018-07-04,12,369,558,927
65337,2018-07-04,13,374,614,988
65338,2018-07-04,14,490,577,1067
65339,2018-07-04,15,425,475,900
65340,2018-07-04,16,408,453,861
65341,2018-07-04,17,495,521,1016
65342,2018-07-04,18,563,526,1089
65343,2018-07-04,19,523,500,1023
65344,2018-07-04,20,502,465,967
65345,2018-07-04,21,483,671,1154
65346,2018-07-04,22,424,529,953
65347,2018-07-04,23,86,176,262
65348,2018-07-05,0,45,63,108
65349,2018-07-05,1,9,36,45
65350,2018-07-05,2,10,11,21
65351,2018-07-05,3,0,10,10
65352,2018-07-05,4,4,13,17
65353,2018-07-05,5,5,64,69
65354,2018-07-05,6,20,268,288
65355,2018-07-05,7,65,598,663
65356,2018-07-05,8,108,976,1084
65357,2018-07-05,9,160,584,744
65358,2018-07-05,10,230,358,588
65359,2018-07-05,11,230,328,558
65360,2018-07-05,12,256,467,723
65361,2018-07-05,13,222,399,621
65362,2018-07-05,14,316,385,701
65363,2018-07-05,15,311,536,847
65364,2018-07-05,16,328,764,1092
65365,2018-07-05,17,342,1257,1599
65366,2018-07-05,18,329,1048,1377
65367,2018-07-05,19,308,733,1041
65368,2018-07-05,20,276,510,786
65369,2018-07-05,21,188,363,551
65370,2018-07-05,22,167,280,447
65371,2018-07-05,23,95,146,241
65372,2018-07-06,0,43,71,114
65373,2018-07-06,1,33,53,86
65374,2018-07-06,2,8,13,21
65375,2018-07-06,3,10,4,14
65376,2018-07-06,4,2,15,17
65377,2018-07-06,5,14,106,120
65378,2018-07-06,6,37,287,324
65379,2018-07-06,7,40,537,577
65380,2018-07-06,8,102,967,1069
65381,2018-07-06,9,148,563,711
65382,2018-07-06,10,181,333,514
65383,2018-07-06,11,225,378,603
65384,2018-07-06,12,290,474,764
65385,2018-07-06,13,293,501,794
65386,2018-07-06,14,275,406,681
65387,2018-07-06,15,266,522,788
65388,2018-07-06,16,324,836,1160
65389,2018-07-06,17,426,1126,1552
65390,2018-07-06,18,336,907,1243
65391,2018-07-06,19,347,623,970
65392,2018-07-06,20,286,452,738
65393,2018-07-06,21,258,335,593
65394,2018-07-06,22,165,313,478
65395,2018-07-06,23,135,235,370
65396,2018-07-07,0,64,158,222
65397,2018-07-07,1,58,80,138
65398,2018-07-07,2,43,55,98
65399,2018-07-07,3,20,25,45
65400,2018-07-07,4,6,16,22
65401,2018-07-07,5,4,25,29
65402,2018-07-07,6,20,70,90
65403,2018-07-07,7,62,156,218
65404,2018-07-07,8,95,288,383
65405,2018-07-07,9,245,508,753
65406,2018-07-07,10,411,618,1029
65407,2018-07-07,11,423,704,1127
65408,2018-07-07,12,640,874,1514
65409,2018-07-07,13,627,861,1488
65410,2018-07-07,14,676,807,1483
65411,2018-07-07,15,627,654,1281
65412,2018-07-07,16,590,696,1286
65413,2018-07-07,17,565,806,1371
65414,2018-07-07,18,539,648,1187
65415,2018-07-07,19,404,544,948
65416,2018-07-07,20,408,474,882
65417,2018-07-07,21,226,348,574
65418,2018-07-07,22,208,341,549
65419,2018-07-07,23,124,218,342
65420,2018-07-08,0,83,121,204
65421,2018-07-08,1,62,87,149
65422,2018-07-08,2,38,73,111
65423,2018-07-08,3,18,41,59
65424,2018-07-08,4,13,16,29
65425,2018-07-08,5,10,23,33
65426,2018-07-08,6,27,56,83
65427,2018-07-08,7,38,103,141
65428,2018-07-08,8,101,236,337
65429,2018-07-08,9,194,405,599
65430,2018-07-08,10,291,567,858
65431,2018-07-08,11,445,628,1073
65432,2018-07-08,12,489,748,1237
65433,2018-07-08,13,569,740,1309
65434,2018-07-08,14,559,729,1288
65435,2018-07-08,15,493,767,1260
65436,2018-07-08,16,454,743,1197
65437,2018-07-08,17,425,649,1074
65438,2018-07-08,18,418,615,1033
65439,2018-07-08,19,359,515,874
65440,2018-07-08,20,358,461,819
65441,2018-07-08,21,241,397,638
65442,2018-07-08,22,142,187,329
65443,2018-07-08,23,69,140,209
65444,2018-07-09,0,29,39,68
65445,2018-07-09,1,10,23,33
65446,2018-07-09,2,5,10,15
65447,2018-07-09,3,0,5,5
65448,2018-07-09,4,5,16,21
65449,2018-07-09,5,13,133,146
65450,2018-07-09,6,30,367,397
65451,2018-07-09,7,40,885,925
65452,2018-07-09,8,87,1236,1323
65453,2018-07-09,9,116,543,659
65454,2018-07-09,10,172,301,473
65455,2018-07-09,11,213,292,505
65456,2018-07-09,12,262,425,687
65457,2018-07-09,13,221,412,633
65458,2018-07-09,14,228,371,599
65459,2018-07-09,15,260,462,722
65460,2018-07-09,16,281,758,1039
65461,2018-07-09,17,304,1414,1718
65462,2018-07-09,18,261,1278,1539
65463,2018-07-09,19,214,797,1011
65464,2018-07-09,20,201,575,776
65465,2018-07-09,21,155,353,508
65466,2018-07-09,22,79,232,311
65467,2018-07-09,23,62,126,188
65468,2018-07-10,0,25,49,74
65469,2018-07-10,1,7,22,29
65470,2018-07-10,2,6,10,16
65471,2018-07-10,3,1,4,5
65472,2018-07-10,4,0,18,18
65473,2018-07-10,5,10,116,126
65474,2018-07-10,6,20,428,448
65475,2018-07-10,7,61,933,994
65476,2018-07-10,8,90,1349,1439
65477,2018-07-10,9,86,502,588
65478,2018-07-10,10,154,290,444
65479,2018-07-10,11,120,281,401
65480,2018-07-10,12,129,403,532
65481,2018-07-10,13,168,398,566
65482,2018-07-10,14,127,306,433
65483,2018-07-10,15,125,408,533
65484,2018-07-10,16,165,724,889
65485,2018-07-10,17,214,1382,1596
65486,2018-07-10,18,239,1216,1455
65487,2018-07-10,19,202,754,956
65488,2018-07-10,20,194,668,862
65489,2018-07-10,21,150,403,553
65490,2018-07-10,22,99,289,388
65491,2018-07-10,23,50,142,192
65492,2018-07-11,0,26,47,73
65493,2018-07-11,1,15,27,42
65494,2018-07-11,2,8,4,12
65495,2018-07-11,3,1,7,8
65496,2018-07-11,4,2,20,22
65497,2018-07-11,5,18,116,134
65498,2018-07-11,6,30,441,471
65499,2018-07-11,7,53,979,1032
65500,2018-07-11,8,107,1275,1382
65501,2018-07-11,9,126,510,636
65502,2018-07-11,10,136,255,391
65503,2018-07-11,11,197,287,484
65504,2018-07-11,12,141,391,532
65505,2018-07-11,13,189,419,608
65506,2018-07-11,14,160,403,563
65507,2018-07-11,15,215,406,621
65508,2018-07-11,16,230,799,1029
65509,2018-07-11,17,291,1429,1720
65510,2018-07-11,18,259,1260,1519
65511,2018-07-11,19,286,803,1089
65512,2018-07-11,20,213,657,870
65513,2018-07-11,21,155,424,579
65514,2018-07-11,22,117,224,341
65515,2018-07-11,23,65,110,175
65516,2018-07-12,0,41,56,97
65517,2018-07-12,1,6,19,25
65518,2018-07-12,2,8,10,18
65519,2018-07-12,3,2,9,11
65520,2018-07-12,4,3,18,21
65521,2018-07-12,5,10,87,97
65522,2018-07-12,6,24,388,412
65523,2018-07-12,7,61,958,1019
65524,2018-07-12,8,71,1348,1419
65525,2018-07-12,9,94,597,691
65526,2018-07-12,10,158,287,445
65527,2018-07-12,11,144,336,480
65528,2018-07-12,12,212,436,648
65529,2018-07-12,13,201,425,626
65530,2018-07-12,14,222,374,596
65531,2018-07-12,15,251,485,736
65532,2018-07-12,16,252,810,1062
65533,2018-07-12,17,302,1429,1731
65534,2018-07-12,18,334,1261,1595
65535,2018-07-12,19,226,809,1035
65536,2018-07-12,20,227,673,900
65537,2018-07-12,21,135,456,591
65538,2018-07-12,22,138,296,434
65539,2018-07-12,23,61,143,204
65540,2018-07-13,0,37,76,113
65541,2018-07-13,1,9,36,45
65542,2018-07-13,2,19,23,42
65543,2018-07-13,3,8,5,13
65544,2018-07-13,4,2,19,21
65545,2018-07-13,5,9,102,111
65546,2018-07-13,6,21,365,386
65547,2018-07-13,7,42,758,800
65548,2018-07-13,8,90,1267,1357
65549,2018-07-13,9,130,606,736
65550,2018-07-13,10,146,345,491
65551,2018-07-13,11,183,389,572
65552,2018-07-13,12,234,496,730
65553,2018-07-13,13,227,551,778
65554,2018-07-13,14,252,434,686
65555,2018-07-13,15,238,606,844
65556,2018-07-13,16,243,906,1149
65557,2018-07-13,17,336,1254,1590
65558,2018-07-13,18,290,1095,1385
65559,2018-07-13,19,282,789,1071
65560,2018-07-13,20,286,556,842
65561,2018-07-13,21,190,428,618
65562,2018-07-13,22,150,340,490
65563,2018-07-13,23,119,256,375
65564,2018-07-14,0,93,133,226
65565,2018-07-14,1,60,106,166
65566,2018-07-14,2,32,57,89
65567,2018-07-14,3,30,28,58
65568,2018-07-14,4,13,17,30
65569,2018-07-14,5,9,33,42
65570,2018-07-14,6,21,56,77
65571,2018-07-14,7,33,178,211
65572,2018-07-14,8,99,343,442
65573,2018-07-14,9,212,517,729
65574,2018-07-14,10,354,649,1003
65575,2018-07-14,11,423,626,1049
65576,2018-07-14,12,522,677,1199
65577,2018-07-14,13,502,686,1188
65578,2018-07-14,14,628,710,1338
65579,2018-07-14,15,558,721,1279
65580,2018-07-14,16,507,603,1110
65581,2018-07-14,17,455,612,1067
65582,2018-07-14,18,396,578,974
65583,2018-07-14,19,451,580,1031
65584,2018-07-14,20,367,426,793
65585,2018-07-14,21,235,337,572
65586,2018-07-14,22,272,339,611
65587,2018-07-14,23,186,282,468
65588,2018-07-15,0,109,155,264
65589,2018-07-15,1,77,126,203
65590,2018-07-15,2,51,97,148
65591,2018-07-15,3,30,33,63
65592,2018-07-15,4,9,13,22
65593,2018-07-15,5,20,26,46
65594,2018-07-15,6,13,60,73
65595,2018-07-15,7,41,116,157
65596,2018-07-15,8,102,274,376
65597,2018-07-15,9,182,443,625
65598,2018-07-15,10,340,725,1065
65599,2018-07-15,11,330,504,834
65600,2018-07-15,12,339,498,837
65601,2018-07-15,13,462,700,1162
65602,2018-07-15,14,475,677,1152
65603,2018-07-15,15,434,613,1047
65604,2018-07-15,16,367,629,996
65605,2018-07-15,17,346,602,948
65606,2018-07-15,18,294,567,861
65607,2018-07-15,19,223,468,691
65608,2018-07-15,20,226,373,599
65609,2018-07-15,21,201,262,463
65610,2018-07-15,22,110,162,272
65611,2018-07-15,23,88,113,201
65612,2018-07-16,0,50,40,90
65613,2018-07-16,1,14,27,41
65614,2018-07-16,2,13,12,25
65615,2018-07-16,3,9,5,14
65616,2018-07-16,4,1,23,24
65617,2018-07-16,5,6,116,122
65618,2018-07-16,6,15,346,361
65619,2018-07-16,7,38,847,885
65620,2018-07-16,8,98,1073,1171
65621,2018-07-16,9,102,481,583
65622,2018-07-16,10,178,283,461
65623,2018-07-16,11,165,343,508
65624,2018-07-16,12,217,364,581
65625,2018-07-16,13,157,392,549
65626,2018-07-16,14,176,348,524
65627,2018-07-16,15,213,409,622
65628,2018-07-16,16,208,714,922
65629,2018-07-16,17,227,1188,1415
65630,2018-07-16,18,239,1170,1409
65631,2018-07-16,19,229,772,1001
65632,2018-07-16,20,204,563,767
65633,2018-07-16,21,137,366,503
65634,2018-07-16,22,101,252,353
65635,2018-07-16,23,72,135,207
65636,2018-07-17,0,24,66,90
65637,2018-07-17,1,11,14,25
65638,2018-07-17,2,6,7,13
65639,2018-07-17,3,5,6,11
65640,2018-07-17,4,0,18,18
65641,2018-07-17,5,11,132,143
65642,2018-07-17,6,21,364,385
65643,2018-07-17,7,67,960,1027
65644,2018-07-17,8,100,1311,1411
65645,2018-07-17,9,101,548,649
65646,2018-07-17,10,138,288,426
65647,2018-07-17,11,146,300,446
65648,2018-07-17,12,139,356,495
65649,2018-07-17,13,130,312,442
65650,2018-07-17,14,147,341,488
65651,2018-07-17,15,33,93,126
65652,2018-07-17,16,63,379,442
65653,2018-07-17,17,201,1297,1498
65654,2018-07-17,18,223,1201,1424
65655,2018-07-17,19,181,758,939
65656,2018-07-17,20,43,531,574
65657,2018-07-17,21,49,363,412
65658,2018-07-17,22,82,227,309
65659,2018-07-17,23,33,119,152
65660,2018-07-18,0,32,81,113
65661,2018-07-18,1,13,23,36
65662,2018-07-18,2,11,12,23
65663,2018-07-18,3,1,9,10
65664,2018-07-18,4,3,21,24
65665,2018-07-18,5,8,130,138
65666,2018-07-18,6,21,416,437
65667,2018-07-18,7,54,981,1035
65668,2018-07-18,8,93,1408,1501
65669,2018-07-18,9,103,579,682
65670,2018-07-18,10,121,291,412
65671,2018-07-18,11,185,365,550
65672,2018-07-18,12,179,423,602
65673,2018-07-18,13,209,411,620
65674,2018-07-18,14,174,412,586
65675,2018-07-18,15,199,479,678
65676,2018-07-18,16,195,850,1045
65677,2018-07-18,17,338,1525,1863
65678,2018-07-18,18,303,1400,1703
65679,2018-07-18,19,262,896,1158
65680,2018-07-18,20,238,700,938
65681,2018-07-18,21,145,422,567
65682,2018-07-18,22,111,285,396
65683,2018-07-18,23,60,142,202
65684,2018-07-19,0,25,46,71
65685,2018-07-19,1,12,29,41
65686,2018-07-19,2,10,7,17
65687,2018-07-19,3,3,5,8
65688,2018-07-19,4,1,16,17
65689,2018-07-19,5,7,96,103
65690,2018-07-19,6,20,372,392
65691,2018-07-19,7,44,973,1017
65692,2018-07-19,8,75,1298,1373
65693,2018-07-19,9,92,559,651
65694,2018-07-19,10,139,313,452
65695,2018-07-19,11,171,374,545
65696,2018-07-19,12,205,421,626
65697,2018-07-19,13,242,414,656
65698,2018-07-19,14,266,400,666
65699,2018-07-19,15,236,493,729
65700,2018-07-19,16,236,853,1089
65701,2018-07-19,17,310,1488,1798
65702,2018-07-19,18,329,1292,1621
65703,2018-07-19,19,298,814,1112
65704,2018-07-19,20,214,638,852
65705,2018-07-19,21,170,450,620
65706,2018-07-19,22,151,333,484
65707,2018-07-19,23,87,182,269
65708,2018-07-20,0,40,78,118
65709,2018-07-20,1,26,36,62
65710,2018-07-20,2,17,15,32
65711,2018-07-20,3,4,12,16
65712,2018-07-20,4,11,19,30
65713,2018-07-20,5,8,119,127
65714,2018-07-20,6,36,304,340
65715,2018-07-20,7,40,804,844
65716,2018-07-20,8,96,1208,1304
65717,2018-07-20,9,170,567,737
65718,2018-07-20,10,220,364,584
65719,2018-07-20,11,222,422,644
65720,2018-07-20,12,256,527,783
65721,2018-07-20,13,296,537,833
65722,2018-07-20,14,318,500,818
65723,2018-07-20,15,375,620,995
65724,2018-07-20,16,373,880,1253
65725,2018-07-20,17,394,1352,1746
65726,2018-07-20,18,340,1073,1413
65727,2018-07-20,19,286,720,1006
65728,2018-07-20,20,275,521,796
65729,2018-07-20,21,191,370,561
65730,2018-07-20,22,189,345,534
65731,2018-07-20,23,147,288,435
65732,2018-07-21,0,129,163,292
65733,2018-07-21,1,64,99,163
65734,2018-07-21,2,41,54,95
65735,2018-07-21,3,24,30,54
65736,2018-07-21,4,23,17,40
65737,2018-07-21,5,14,28,42
65738,2018-07-21,6,18,61,79
65739,2018-07-21,7,23,159,182
65740,2018-07-21,8,56,239,295
65741,2018-07-21,9,137,358,495
65742,2018-07-21,10,90,269,359
65743,2018-07-21,11,21,110,131
65744,2018-07-21,12,27,64,91
65745,2018-07-21,13,13,62,75
65746,2018-07-21,14,15,54,69
65747,2018-07-21,15,21,49,70
65748,2018-07-21,16,7,46,53
65749,2018-07-21,17,6,30,36
65750,2018-07-21,18,2,19,21
65751,2018-07-21,19,2,24,26
65752,2018-07-21,20,5,23,28
65753,2018-07-21,21,1,22,23
65754,2018-07-21,22,5,17,22
65755,2018-07-21,23,15,38,53
65756,2018-07-22,0,16,64,80
65757,2018-07-22,1,17,55,72
65758,2018-07-22,2,13,44,57
65759,2018-07-22,3,8,22,30
65760,2018-07-22,4,9,22,31
65761,2018-07-22,5,11,24,35
65762,2018-07-22,6,19,46,65
65763,2018-07-22,7,58,91,149
65764,2018-07-22,8,109,243,352
65765,2018-07-22,9,200,403,603
65766,2018-07-22,10,293,584,877
65767,2018-07-22,11,233,521,754
65768,2018-07-22,12,287,557,844
65769,2018-07-22,13,165,336,501
65770,2018-07-22,14,57,146,203
65771,2018-07-22,15,197,451,648
65772,2018-07-22,16,273,532,805
65773,2018-07-22,17,292,508,800
65774,2018-07-22,18,116,266,382
65775,2018-07-22,19,83,177,260
65776,2018-07-22,20,77,203,280
65777,2018-07-22,21,73,163,236
65778,2018-07-22,22,30,59,89
65779,2018-07-22,23,17,53,70
65780,2018-07-23,0,13,20,33
65781,2018-07-23,1,3,8,11
65782,2018-07-23,2,5,6,11
65783,2018-07-23,3,3,5,8
65784,2018-07-23,4,1,16,17
65785,2018-07-23,5,5,104,109
65786,2018-07-23,6,13,274,287
65787,2018-07-23,7,4,256,260
65788,2018-07-23,8,38,848,886
65789,2018-07-23,9,64,440,504
65790,2018-07-23,10,93,178,271
65791,2018-07-23,11,113,262,375
65792,2018-07-23,12,142,313,455
65793,2018-07-23,13,177,325,502
65794,2018-07-23,14,180,325,505
65795,2018-07-23,15,213,360,573
65796,2018-07-23,16,231,670,901
65797,2018-07-23,17,266,1321,1587
65798,2018-07-23,18,197,1032,1229
65799,2018-07-23,19,136,626,762
65800,2018-07-23,20,121,387,508
65801,2018-07-23,21,54,218,272
65802,2018-07-23,22,61,117,178
65803,2018-07-23,23,42,75,117
65804,2018-07-24,0,21,31,52
65805,2018-07-24,1,20,16,36
65806,2018-07-24,2,6,7,13
65807,2018-07-24,3,5,2,7
65808,2018-07-24,4,2,22,24
65809,2018-07-24,5,13,99,112
65810,2018-07-24,6,15,296,311
65811,2018-07-24,7,6,305,311
65812,2018-07-24,8,14,365,379
65813,2018-07-24,9,17,219,236
65814,2018-07-24,10,36,131,167
65815,2018-07-24,11,67,244,311
65816,2018-07-24,12,81,285,366
65817,2018-07-24,13,120,291,411
65818,2018-07-24,14,144,287,431
65819,2018-07-24,15,106,369,475
65820,2018-07-24,16,154,605,759
65821,2018-07-24,17,94,841,935
65822,2018-07-24,18,66,626,692
65823,2018-07-24,19,59,397,456
65824,2018-07-24,20,54,375,429
65825,2018-07-24,21,52,244,296
65826,2018-07-24,22,44,191,235
65827,2018-07-24,23,19,116,135
65828,2018-07-25,0,16,52,68
65829,2018-07-25,1,14,27,41
65830,2018-07-25,2,5,12,17
65831,2018-07-25,3,6,10,16
65832,2018-07-25,4,3,25,28
65833,2018-07-25,5,11,109,120
65834,2018-07-25,6,22,370,392
65835,2018-07-25,7,35,870,905
65836,2018-07-25,8,73,1276,1349
65837,2018-07-25,9,70,602,672
65838,2018-07-25,10,125,283,408
65839,2018-07-25,11,142,268,410
65840,2018-07-25,12,126,338,464
65841,2018-07-25,13,129,324,453
65842,2018-07-25,14,145,307,452
65843,2018-07-25,15,175,416,591
65844,2018-07-25,16,165,712,877
65845,2018-07-25,17,89,830,919
65846,2018-07-25,18,88,645,733
65847,2018-07-25,19,24,162,186
65848,2018-07-25,20,8,118,126
65849,2018-07-25,21,25,102,127
65850,2018-07-25,22,26,102,128
65851,2018-07-25,23,39,136,175
65852,2018-07-26,0,19,59,78
65853,2018-07-26,1,11,18,29
65854,2018-07-26,2,9,13,22
65855,2018-07-26,3,4,7,11
65856,2018-07-26,4,2,23,25
65857,2018-07-26,5,10,108,118
65858,2018-07-26,6,22,365,387
65859,2018-07-26,7,44,878,922
65860,2018-07-26,8,91,1286,1377
65861,2018-07-26,9,97,561,658
65862,2018-07-26,10,115,262,377
65863,2018-07-26,11,229,342,571
65864,2018-07-26,12,199,525,724
65865,2018-07-26,13,195,418,613
65866,2018-07-26,14,214,405,619
65867,2018-07-26,15,238,487,725
65868,2018-07-26,16,248,778,1026
65869,2018-07-26,17,292,1465,1757
65870,2018-07-26,18,254,1279,1533
65871,2018-07-26,19,240,850,1090
65872,2018-07-26,20,223,605,828
65873,2018-07-26,21,175,435,610
65874,2018-07-26,22,113,307,420
65875,2018-07-26,23,105,214,319
65876,2018-07-27,0,58,99,157
65877,2018-07-27,1,13,35,48
65878,2018-07-27,2,10,28,38
65879,2018-07-27,3,5,8,13
65880,2018-07-27,4,7,24,31
65881,2018-07-27,5,11,101,112
65882,2018-07-27,6,24,317,341
65883,2018-07-27,7,52,785,837
65884,2018-07-27,8,91,1194,1285
65885,2018-07-27,9,95,593,688
65886,2018-07-27,10,189,373,562
65887,2018-07-27,11,227,418,645
65888,2018-07-27,12,262,459,721
65889,2018-07-27,13,236,461,697
65890,2018-07-27,14,286,503,789
65891,2018-07-27,15,265,590,855
65892,2018-07-27,16,296,838,1134
65893,2018-07-27,17,252,1219,1471
65894,2018-07-27,18,117,641,758
65895,2018-07-27,19,175,559,734
65896,2018-07-27,20,160,353,513
65897,2018-07-27,21,126,318,444
65898,2018-07-27,22,112,247,359
65899,2018-07-27,23,84,214,298
65900,2018-07-28,0,63,145,208
65901,2018-07-28,1,53,110,163
65902,2018-07-28,2,22,69,91
65903,2018-07-28,3,24,42,66
65904,2018-07-28,4,5,18,23
65905,2018-07-28,5,10,35,45
65906,2018-07-28,6,14,52,66
65907,2018-07-28,7,29,175,204
65908,2018-07-28,8,73,301,374
65909,2018-07-28,9,188,452,640
65910,2018-07-28,10,312,661,973
65911,2018-07-28,11,422,697,1119
65912,2018-07-28,12,563,798,1361
65913,2018-07-28,13,510,704,1214
65914,2018-07-28,14,538,739,1277
65915,2018-07-28,15,494,764,1258
65916,2018-07-28,16,582,705,1287
65917,2018-07-28,17,532,664,1196
65918,2018-07-28,18,460,574,1034
65919,2018-07-28,19,480,589,1069
65920,2018-07-28,20,358,430,788
65921,2018-07-28,21,215,384,599
65922,2018-07-28,22,204,319,523
65923,2018-07-28,23,191,239,430
65924,2018-07-29,0,102,158,260
65925,2018-07-29,1,69,100,169
65926,2018-07-29,2,38,93,131
65927,2018-07-29,3,22,35,57
65928,2018-07-29,4,11,11,22
65929,2018-07-29,5,3,21,24
65930,2018-07-29,6,16,42,58
65931,2018-07-29,7,63,98,161
65932,2018-07-29,8,78,251,329
65933,2018-07-29,9,190,391,581
65934,2018-07-29,10,371,562,933
65935,2018-07-29,11,409,673,1082
65936,2018-07-29,12,527,699,1226
65937,2018-07-29,13,543,665,1208
65938,2018-07-29,14,547,663,1210
65939,2018-07-29,15,513,655,1168
65940,2018-07-29,16,562,696,1258
65941,2018-07-29,17,465,736,1201
65942,2018-07-29,18,388,707,1095
65943,2018-07-29,19,348,550,898
65944,2018-07-29,20,303,440,743
65945,2018-07-29,21,197,286,483
65946,2018-07-29,22,158,201,359
65947,2018-07-29,23,74,156,230
65948,2018-07-30,0,43,43,86
65949,2018-07-30,1,15,22,37
65950,2018-07-30,2,6,8,14
65951,2018-07-30,3,5,6,11
65952,2018-07-30,4,4,19,23
65953,2018-07-30,5,9,115,124
65954,2018-07-30,6,21,367,388
65955,2018-07-30,7,41,795,836
65956,2018-07-30,8,70,1161,1231
65957,2018-07-30,9,109,529,638
65958,2018-07-30,10,173,296,469
65959,2018-07-30,11,187,302,489
65960,2018-07-30,12,252,345,597
65961,2018-07-30,13,294,400,694
65962,2018-07-30,14,257,387,644
65963,2018-07-30,15,239,460,699
65964,2018-07-30,16,243,655,898
65965,2018-07-30,17,76,386,462
65966,2018-07-30,18,27,250,277
65967,2018-07-30,19,54,418,472
65968,2018-07-30,20,71,328,399
65969,2018-07-30,21,96,284,380
65970,2018-07-30,22,79,160,239
65971,2018-07-30,23,38,88,126
65972,2018-07-31,0,18,33,51
65973,2018-07-31,1,6,14,20
65974,2018-07-31,2,5,8,13
65975,2018-07-31,3,3,6,9
65976,2018-07-31,4,1,18,19
65977,2018-07-31,5,9,102,111
65978,2018-07-31,6,23,401,424
65979,2018-07-31,7,29,901,930
65980,2018-07-31,8,94,1133,1227
65981,2018-07-31,9,95,518,613
65982,2018-07-31,10,138,328,466
65983,2018-07-31,11,175,348,523
65984,2018-07-31,12,167,363,530
65985,2018-07-31,13,190,365,555
65986,2018-07-31,14,158,314,472
65987,2018-07-31,15,204,445,649
65988,2018-07-31,16,171,766,937
65989,2018-07-31,17,296,1445,1741
65990,2018-07-31,18,219,1255,1474
65991,2018-07-31,19,198,850,1048
65992,2018-07-31,20,161,571,732
65993,2018-07-31,21,105,341,446
65994,2018-07-31,22,54,260,314
65995,2018-07-31,23,50,130,180
65996,2018-08-01,0,30,53,83
65997,2018-08-01,1,9,17,26
65998,2018-08-01,2,4,3,7
65999,2018-08-01,3,0,1,1
66000,2018-08-01,4,1,11,12
66001,2018-08-01,5,6,114,120
66002,2018-08-01,6,18,378,396
66003,2018-08-01,7,50,886,936
66004,2018-08-01,8,88,1280,1368
66005,2018-08-01,9,102,545,647
66006,2018-08-01,10,155,319,474
66007,2018-08-01,11,207,360,567
66008,2018-08-01,12,163,434,597
66009,2018-08-01,13,194,408,602
66010,2018-08-01,14,158,430,588
66011,2018-08-01,15,199,516,715
66012,2018-08-01,16,218,771,989
66013,2018-08-01,17,288,1436,1724
66014,2018-08-01,18,269,1187,1456
66015,2018-08-01,19,261,786,1047
66016,2018-08-01,20,201,628,829
66017,2018-08-01,21,148,447,595
66018,2018-08-01,22,62,258,320
66019,2018-08-01,23,25,74,99
66020,2018-08-02,0,15,53,68
66021,2018-08-02,1,18,19,37
66022,2018-08-02,2,4,8,12
66023,2018-08-02,3,8,8,16
66024,2018-08-02,4,1,15,16
66025,2018-08-02,5,5,99,104
66026,2018-08-02,6,21,363,384
66027,2018-08-02,7,46,817,863
66028,2018-08-02,8,75,1203,1278
66029,2018-08-02,9,112,584,696
66030,2018-08-02,10,157,293,450
66031,2018-08-02,11,152,331,483
66032,2018-08-02,12,167,397,564
66033,2018-08-02,13,180,389,569
66034,2018-08-02,14,116,247,363
66035,2018-08-02,15,40,136,176
66036,2018-08-02,16,105,379,484
66037,2018-08-02,17,194,1154,1348
66038,2018-08-02,18,192,1046,1238
66039,2018-08-02,19,181,721,902
66040,2018-08-02,20,174,539,713
66041,2018-08-02,21,126,367,493
66042,2018-08-02,22,83,309,392
66043,2018-08-02,23,48,158,206
66044,2018-08-03,0,16,64,80
66045,2018-08-03,1,12,41,53
66046,2018-08-03,2,12,19,31
66047,2018-08-03,3,0,9,9
66048,2018-08-03,4,3,25,28
66049,2018-08-03,5,19,88,107
66050,2018-08-03,6,10,329,339
66051,2018-08-03,7,49,651,700
66052,2018-08-03,8,91,1067,1158
66053,2018-08-03,9,119,602,721
66054,2018-08-03,10,150,288,438
66055,2018-08-03,11,175,357,532
66056,2018-08-03,12,208,454,662
66057,2018-08-03,13,237,434,671
66058,2018-08-03,14,193,381,574
66059,2018-08-03,15,263,543,806
66060,2018-08-03,16,277,807,1084
66061,2018-08-03,17,266,974,1240
66062,2018-08-03,18,79,357,436
66063,2018-08-03,19,162,487,649
66064,2018-08-03,20,121,314,435
66065,2018-08-03,21,61,191,252
66066,2018-08-03,22,40,131,171
66067,2018-08-03,23,25,129,154
66068,2018-08-04,0,25,109,134
66069,2018-08-04,1,23,84,107
66070,2018-08-04,2,26,63,89
66071,2018-08-04,3,3,19,22
66072,2018-08-04,4,1,10,11
66073,2018-08-04,5,6,19,25
66074,2018-08-04,6,9,55,64
66075,2018-08-04,7,23,117,140
66076,2018-08-04,8,82,299,381
66077,2018-08-04,9,244,430,674
66078,2018-08-04,10,344,596,940
66079,2018-08-04,11,422,728,1150
66080,2018-08-04,12,485,745,1230
66081,2018-08-04,13,581,732,1313
66082,2018-08-04,14,576,720,1296
66083,2018-08-04,15,592,642,1234
66084,2018-08-04,16,467,710,1177
66085,2018-08-04,17,465,639,1104
66086,2018-08-04,18,378,573,951
66087,2018-08-04,19,357,479,836
66088,2018-08-04,20,311,385,696
66089,2018-08-04,21,223,370,593
66090,2018-08-04,22,216,285,501
66091,2018-08-04,23,134,206,340
66092,2018-08-05,0,104,144,248
66093,2018-08-05,1,76,117,193
66094,2018-08-05,2,45,55,100
66095,2018-08-05,3,28,35,63
66096,2018-08-05,4,5,12,17
66097,2018-08-05,5,15,24,39
66098,2018-08-05,6,15,48,63
66099,2018-08-05,7,33,89,122
66100,2018-08-05,8,73,219,292
66101,2018-08-05,9,201,405,606
66102,2018-08-05,10,314,564,878
66103,2018-08-05,11,346,579,925
66104,2018-08-05,12,423,608,1031
66105,2018-08-05,13,427,641,1068
66106,2018-08-05,14,432,651,1083
66107,2018-08-05,15,467,552,1019
66108,2018-08-05,16,395,609,1004
66109,2018-08-05,17,373,622,995
66110,2018-08-05,18,369,513,882
66111,2018-08-05,19,337,450,787
66112,2018-08-05,20,297,347,644
66113,2018-08-05,21,179,256,435
66114,2018-08-05,22,109,150,259
66115,2018-08-05,23,79,95,174
66116,2018-08-06,0,48,59,107
66117,2018-08-06,1,19,27,46
66118,2018-08-06,2,1,5,6
66119,2018-08-06,3,0,7,7
66120,2018-08-06,4,3,21,24
66121,2018-08-06,5,11,104,115
66122,2018-08-06,6,19,340,359
66123,2018-08-06,7,30,747,777
66124,2018-08-06,8,97,1032,1129
66125,2018-08-06,9,156,502,658
66126,2018-08-06,10,172,269,441
66127,2018-08-06,11,192,321,513
66128,2018-08-06,12,207,361,568
66129,2018-08-06,13,246,339,585
66130,2018-08-06,14,227,330,557
66131,2018-08-06,15,219,373,592
66132,2018-08-06,16,193,669,862
66133,2018-08-06,17,286,1307,1593
66134,2018-08-06,18,293,1204,1497
66135,2018-08-06,19,255,789,1044
66136,2018-08-06,20,213,484,697
66137,2018-08-06,21,135,299,434
66138,2018-08-06,22,105,196,301
66139,2018-08-06,23,56,89,145
66140,2018-08-07,0,23,33,56
66141,2018-08-07,1,8,15,23
66142,2018-08-07,2,7,9,16
66143,2018-08-07,3,5,7,12
66144,2018-08-07,4,4,23,27
66145,2018-08-07,5,4,108,112
66146,2018-08-07,6,15,400,415
66147,2018-08-07,7,54,827,881
66148,2018-08-07,8,76,1251,1327
66149,2018-08-07,9,124,478,602
66150,2018-08-07,10,149,258,407
66151,2018-08-07,11,184,348,532
66152,2018-08-07,12,161,372,533
66153,2018-08-07,13,161,380,541
66154,2018-08-07,14,184,341,525
66155,2018-08-07,15,154,309,463
66156,2018-08-07,16,146,525,671
66157,2018-08-07,17,267,1339,1606
66158,2018-08-07,18,257,1146,1403
66159,2018-08-07,19,179,731,910
66160,2018-08-07,20,127,479,606
66161,2018-08-07,21,109,362,471
66162,2018-08-07,22,102,263,365
66163,2018-08-07,23,36,122,158
66164,2018-08-08,0,28,50,78
66165,2018-08-08,1,12,13,25
66166,2018-08-08,2,8,8,16
66167,2018-08-08,3,0,12,12
66168,2018-08-08,4,1,18,19
66169,2018-08-08,5,9,118,127
66170,2018-08-08,6,25,401,426
66171,2018-08-08,7,47,916,963
66172,2018-08-08,8,76,1231,1307
66173,2018-08-08,9,93,567,660
66174,2018-08-08,10,138,273,411
66175,2018-08-08,11,164,304,468
66176,2018-08-08,12,153,374,527
66177,2018-08-08,13,169,362,531
66178,2018-08-08,14,132,330,462
66179,2018-08-08,15,177,411,588
66180,2018-08-08,16,181,752,933
66181,2018-08-08,17,253,1375,1628
66182,2018-08-08,18,299,1222,1521
66183,2018-08-08,19,222,801,1023
66184,2018-08-08,20,168,588,756
66185,2018-08-08,21,128,408,536
66186,2018-08-08,22,63,291,354
66187,2018-08-08,23,34,136,170
66188,2018-08-09,0,12,57,69
66189,2018-08-09,1,10,19,29
66190,2018-08-09,2,5,11,16
66191,2018-08-09,3,1,12,13
66192,2018-08-09,4,0,21,21
66193,2018-08-09,5,8,111,119
66194,2018-08-09,6,26,343,369
66195,2018-08-09,7,44,807,851
66196,2018-08-09,8,85,1301,1386
66197,2018-08-09,9,85,598,683
66198,2018-08-09,10,167,349,516
66199,2018-08-09,11,178,354,532
66200,2018-08-09,12,201,419,620
66201,2018-08-09,13,159,423,582
66202,2018-08-09,14,200,326,526
66203,2018-08-09,15,255,473,728
66204,2018-08-09,16,268,731,999
66205,2018-08-09,17,280,1408,1688
66206,2018-08-09,18,256,1193,1449
66207,2018-08-09,19,267,817,1084
66208,2018-08-09,20,213,635,848
66209,2018-08-09,21,154,394,548
66210,2018-08-09,22,101,275,376
66211,2018-08-09,23,57,154,211
66212,2018-08-10,0,39,58,97
66213,2018-08-10,1,20,28,48
66214,2018-08-10,2,6,14,20
66215,2018-08-10,3,2,5,7
66216,2018-08-10,4,3,17,20
66217,2018-08-10,5,11,99,110
66218,2018-08-10,6,31,308,339
66219,2018-08-10,7,39,654,693
66220,2018-08-10,8,87,1159,1246
66221,2018-08-10,9,115,579,694
66222,2018-08-10,10,168,346,514
66223,2018-08-10,11,181,386,567
66224,2018-08-10,12,242,477,719
66225,2018-08-10,13,230,463,693
66226,2018-08-10,14,186,473,659
66227,2018-08-10,15,271,580,851
66228,2018-08-10,16,280,824,1104
66229,2018-08-10,17,261,1145,1406
66230,2018-08-10,18,282,975,1257
66231,2018-08-10,19,258,612,870
66232,2018-08-10,20,219,500,719
66233,2018-08-10,21,213,351,564
66234,2018-08-10,22,147,272,419
66235,2018-08-10,23,113,202,315
66236,2018-08-11,0,78,111,189
66237,2018-08-11,1,35,75,110
66238,2018-08-11,2,34,68,102
66239,2018-08-11,3,19,26,45
66240,2018-08-11,4,5,12,17
66241,2018-08-11,5,4,26,30
66242,2018-08-11,6,13,57,70
66243,2018-08-11,7,47,158,205
66244,2018-08-11,8,68,257,325
66245,2018-08-11,9,172,452,624
66246,2018-08-11,10,276,537,813
66247,2018-08-11,11,363,627,990
66248,2018-08-11,12,365,682,1047
66249,2018-08-11,13,428,689,1117
66250,2018-08-11,14,435,648,1083
66251,2018-08-11,15,410,601,1011
66252,2018-08-11,16,364,510,874
66253,2018-08-11,17,303,399,702
66254,2018-08-11,18,280,435,715
66255,2018-08-11,19,324,414,738
66256,2018-08-11,20,233,313,546
66257,2018-08-11,21,189,274,463
66258,2018-08-11,22,142,182,324
66259,2018-08-11,23,135,197,332
66260,2018-08-12,0,103,161,264
66261,2018-08-12,1,51,109,160
66262,2018-08-12,2,29,60,89
66263,2018-08-12,3,30,38,68
66264,2018-08-12,4,3,20,23
66265,2018-08-12,5,11,24,35
66266,2018-08-12,6,14,47,61
66267,2018-08-12,7,32,96,128
66268,2018-08-12,8,65,208,273
66269,2018-08-12,9,167,352,519
66270,2018-08-12,10,271,508,779
66271,2018-08-12,11,320,636,956
66272,2018-08-12,12,443,700,1143
66273,2018-08-12,13,413,731,1144
66274,2018-08-12,14,405,634,1039
66275,2018-08-12,15,398,734,1132
66276,2018-08-12,16,270,479,749
66277,2018-08-12,17,85,151,236
66278,2018-08-12,18,50,126,176
66279,2018-08-12,19,83,167,250
66280,2018-08-12,20,92,162,254
66281,2018-08-12,21,56,146,202
66282,2018-08-12,22,62,141,203
66283,2018-08-12,23,44,73,117
66284,2018-08-13,0,17,33,50
66285,2018-08-13,1,13,13,26
66286,2018-08-13,2,1,7,8
66287,2018-08-13,3,1,6,7
66288,2018-08-13,4,1,22,23
66289,2018-08-13,5,9,107,116
66290,2018-08-13,6,15,347,362
66291,2018-08-13,7,47,778,825
66292,2018-08-13,8,75,1078,1153
66293,2018-08-13,9,157,525,682
66294,2018-08-13,10,222,284,506
66295,2018-08-13,11,192,350,542
66296,2018-08-13,12,180,386,566
66297,2018-08-13,13,215,422,637
66298,2018-08-13,14,195,333,528
66299,2018-08-13,15,247,446,693
66300,2018-08-13,16,174,658,832
66301,2018-08-13,17,250,1103,1353
66302,2018-08-13,18,241,1120,1361
66303,2018-08-13,19,205,798,1003
66304,2018-08-13,20,148,504,652
66305,2018-08-13,21,89,332,421
66306,2018-08-13,22,84,223,307
66307,2018-08-13,23,49,101,150
66308,2018-08-14,0,17,39,56
66309,2018-08-14,1,19,13,32
66310,2018-08-14,2,15,8,23
66311,2018-08-14,3,16,8,24
66312,2018-08-14,4,0,29,29
66313,2018-08-14,5,12,105,117
66314,2018-08-14,6,17,401,418
66315,2018-08-14,7,62,985,1047
66316,2018-08-14,8,124,1347,1471
66317,2018-08-14,9,97,652,749
66318,2018-08-14,10,150,286,436
66319,2018-08-14,11,146,315,461
66320,2018-08-14,12,163,414,577
66321,2018-08-14,13,217,404,621
66322,2018-08-14,14,184,408,592
66323,2018-08-14,15,190,472,662
66324,2018-08-14,16,246,859,1105
66325,2018-08-14,17,320,1577,1897
66326,2018-08-14,18,217,1201,1418
66327,2018-08-14,19,212,876,1088
66328,2018-08-14,20,164,541,705
66329,2018-08-14,21,92,359,451
66330,2018-08-14,22,61,234,295
66331,2018-08-14,23,40,95,135
66332,2018-08-15,0,11,42,53
66333,2018-08-15,1,4,14,18
66334,2018-08-15,2,2,8,10
66335,2018-08-15,3,3,4,7
66336,2018-08-15,4,2,21,23
66337,2018-08-15,5,8,121,129
66338,2018-08-15,6,34,417,451
66339,2018-08-15,7,64,986,1050
66340,2018-08-15,8,85,1373,1458
66341,2018-08-15,9,82,603,685
66342,2018-08-15,10,141,301,442
66343,2018-08-15,11,193,335,528
66344,2018-08-15,12,173,405,578
66345,2018-08-15,13,148,394,542
66346,2018-08-15,14,179,368,547
66347,2018-08-15,15,198,461,659
66348,2018-08-15,16,232,817,1049
66349,2018-08-15,17,295,1474,1769
66350,2018-08-15,18,285,1217,1502
66351,2018-08-15,19,251,831,1082
66352,2018-08-15,20,163,558,721
66353,2018-08-15,21,116,360,476
66354,2018-08-15,22,120,391,511
66355,2018-08-15,23,59,143,202
66356,2018-08-16,0,32,48,80
66357,2018-08-16,1,10,22,32
66358,2018-08-16,2,3,8,11
66359,2018-08-16,3,3,12,15
66360,2018-08-16,4,4,20,24
66361,2018-08-16,5,7,104,111
66362,2018-08-16,6,14,358,372
66363,2018-08-16,7,49,875,924
66364,2018-08-16,8,70,1278,1348
66365,2018-08-16,9,79,615,694
66366,2018-08-16,10,127,326,453
66367,2018-08-16,11,158,353,511
66368,2018-08-16,12,170,392,562
66369,2018-08-16,13,164,422,586
66370,2018-08-16,14,170,363,533
66371,2018-08-16,15,187,462,649
66372,2018-08-16,16,206,760,966
66373,2018-08-16,17,268,1431,1699
66374,2018-08-16,18,242,1171,1413
66375,2018-08-16,19,271,767,1038
66376,2018-08-16,20,180,558,738
66377,2018-08-16,21,123,382,505
66378,2018-08-16,22,66,267,333
66379,2018-08-16,23,67,154,221
66380,2018-08-17,0,28,62,90
66381,2018-08-17,1,10,31,41
66382,2018-08-17,2,10,22,32
66383,2018-08-17,3,5,10,15
66384,2018-08-17,4,2,19,21
66385,2018-08-17,5,6,106,112
66386,2018-08-17,6,19,317,336
66387,2018-08-17,7,50,743,793
66388,2018-08-17,8,79,1096,1175
66389,2018-08-17,9,68,560,628
66390,2018-08-17,10,140,354,494
66391,2018-08-17,11,158,378,536
66392,2018-08-17,12,180,443,623
66393,2018-08-17,13,168,471,639
66394,2018-08-17,14,224,467,691
66395,2018-08-17,15,195,521,716
66396,2018-08-17,16,258,809,1067
66397,2018-08-17,17,249,1274,1523
66398,2018-08-17,18,204,824,1028
66399,2018-08-17,19,113,402,515
66400,2018-08-17,20,172,331,503
66401,2018-08-17,21,155,303,458
66402,2018-08-17,22,111,312,423
66403,2018-08-17,23,81,194,275
66404,2018-08-18,0,66,136,202
66405,2018-08-18,1,57,106,163
66406,2018-08-18,2,35,74,109
66407,2018-08-18,3,16,25,41
66408,2018-08-18,4,4,17,21
66409,2018-08-18,5,9,18,27
66410,2018-08-18,6,19,64,83
66411,2018-08-18,7,30,121,151
66412,2018-08-18,8,100,283,383
66413,2018-08-18,9,181,440,621
66414,2018-08-18,10,274,611,885
66415,2018-08-18,11,340,639,979
66416,2018-08-18,12,430,745,1175
66417,2018-08-18,13,468,676,1144
66418,2018-08-18,14,426,635,1061
66419,2018-08-18,15,458,650,1108
66420,2018-08-18,16,471,599,1070
66421,2018-08-18,17,392,611,1003
66422,2018-08-18,18,393,590,983
66423,2018-08-18,19,357,503,860
66424,2018-08-18,20,247,358,605
66425,2018-08-18,21,212,305,517
66426,2018-08-18,22,163,282,445
66427,2018-08-18,23,129,205,334
66428,2018-08-19,0,96,149,245
66429,2018-08-19,1,56,120,176
66430,2018-08-19,2,44,82,126
66431,2018-08-19,3,32,34,66
66432,2018-08-19,4,10,15,25
66433,2018-08-19,5,8,26,34
66434,2018-08-19,6,9,44,53
66435,2018-08-19,7,38,99,137
66436,2018-08-19,8,92,239,331
66437,2018-08-19,9,185,415,600
66438,2018-08-19,10,228,564,792
66439,2018-08-19,11,306,675,981
66440,2018-08-19,12,349,642,991
66441,2018-08-19,13,354,674,1028
66442,2018-08-19,14,380,610,990
66443,2018-08-19,15,415,656,1071
66444,2018-08-19,16,377,644,1021
66445,2018-08-19,17,376,613,989
66446,2018-08-19,18,341,653,994
66447,2018-08-19,19,296,530,826
66448,2018-08-19,20,171,321,492
66449,2018-08-19,21,95,268,363
66450,2018-08-19,22,100,228,328
66451,2018-08-19,23,70,88,158
66452,2018-08-20,0,27,48,75
66453,2018-08-20,1,13,18,31
66454,2018-08-20,2,0,16,16
66455,2018-08-20,3,4,9,13
66456,2018-08-20,4,2,16,18
66457,2018-08-20,5,11,97,108
66458,2018-08-20,6,14,330,344
66459,2018-08-20,7,22,680,702
66460,2018-08-20,8,75,1068,1143
66461,2018-08-20,9,107,472,579
66462,2018-08-20,10,145,321,466
66463,2018-08-20,11,177,291,468
66464,2018-08-20,12,164,395,559
66465,2018-08-20,13,193,398,591
66466,2018-08-20,14,205,360,565
66467,2018-08-20,15,278,517,795
66468,2018-08-20,16,267,784,1051
66469,2018-08-20,17,352,1475,1827
66470,2018-08-20,18,254,1269,1523
66471,2018-08-20,19,200,728,928
66472,2018-08-20,20,114,442,556
66473,2018-08-20,21,99,298,397
66474,2018-08-20,22,63,196,259
66475,2018-08-20,23,44,94,138
66476,2018-08-21,0,17,40,57
66477,2018-08-21,1,2,19,21
66478,2018-08-21,2,12,10,22
66479,2018-08-21,3,4,10,14
66480,2018-08-21,4,1,18,19
66481,2018-08-21,5,3,102,105
66482,2018-08-21,6,18,420,438
66483,2018-08-21,7,48,979,1027
66484,2018-08-21,8,78,1358,1436
66485,2018-08-21,9,68,483,551
66486,2018-08-21,10,57,149,206
66487,2018-08-21,11,60,210,270
66488,2018-08-21,12,47,212,259
66489,2018-08-21,13,14,39,53
66490,2018-08-21,14,3,44,47
66491,2018-08-21,15,52,296,348
66492,2018-08-21,16,93,686,779
66493,2018-08-21,17,190,1367,1557
66494,2018-08-21,18,155,1118,1273
66495,2018-08-21,19,93,596,689
66496,2018-08-21,20,19,131,150
66497,2018-08-21,21,15,141,156
66498,2018-08-21,22,21,146,167
66499,2018-08-21,23,32,83,115
66500,2018-08-22,0,16,46,62
66501,2018-08-22,1,6,20,26
66502,2018-08-22,2,5,9,14
66503,2018-08-22,3,5,8,13
66504,2018-08-22,4,2,18,20
66505,2018-08-22,5,8,96,104
66506,2018-08-22,6,24,427,451
66507,2018-08-22,7,33,943,976
66508,2018-08-22,8,63,1355,1418
66509,2018-08-22,9,89,567,656
66510,2018-08-22,10,112,277,389
66511,2018-08-22,11,209,354,563
66512,2018-08-22,12,129,388,517
66513,2018-08-22,13,100,316,416
66514,2018-08-22,14,152,368,520
66515,2018-08-22,15,170,511,681
66516,2018-08-22,16,193,811,1004
66517,2018-08-22,17,281,1521,1802
66518,2018-08-22,18,277,1319,1596
66519,2018-08-22,19,180,935,1115
66520,2018-08-22,20,141,536,677
66521,2018-08-22,21,95,406,501
66522,2018-08-22,22,80,293,373
66523,2018-08-22,23,56,147,203
66524,2018-08-23,0,17,49,66
66525,2018-08-23,1,14,28,42
66526,2018-08-23,2,5,8,13
66527,2018-08-23,3,1,4,5
66528,2018-08-23,4,0,20,20
66529,2018-08-23,5,6,98,104
66530,2018-08-23,6,13,385,398
66531,2018-08-23,7,37,937,974
66532,2018-08-23,8,86,1412,1498
66533,2018-08-23,9,72,606,678
66534,2018-08-23,10,137,314,451
66535,2018-08-23,11,141,391,532
66536,2018-08-23,12,158,496,654
66537,2018-08-23,13,167,524,691
66538,2018-08-23,14,181,441,622
66539,2018-08-23,15,217,601,818
66540,2018-08-23,16,220,910,1130
66541,2018-08-23,17,329,1588,1917
66542,2018-08-23,18,246,1263,1509
66543,2018-08-23,19,231,910,1141
66544,2018-08-23,20,190,580,770
66545,2018-08-23,21,130,426,556
66546,2018-08-23,22,63,310,373
66547,2018-08-23,23,53,162,215
66548,2018-08-24,0,19,58,77
66549,2018-08-24,1,10,34,44
66550,2018-08-24,2,8,13,21
66551,2018-08-24,3,2,16,18
66552,2018-08-24,4,1,19,20
66553,2018-08-24,5,4,98,102
66554,2018-08-24,6,6,312,318
66555,2018-08-24,7,32,798,830
66556,2018-08-24,8,67,1228,1295
66557,2018-08-24,9,106,607,713
66558,2018-08-24,10,143,375,518
66559,2018-08-24,11,245,421,666
66560,2018-08-24,12,222,555,777
66561,2018-08-24,13,240,544,784
66562,2018-08-24,14,235,525,760
66563,2018-08-24,15,236,682,918
66564,2018-08-24,16,254,1004,1258
66565,2018-08-24,17,256,1429,1685
66566,2018-08-24,18,203,1052,1255
66567,2018-08-24,19,214,691,905
66568,2018-08-24,20,203,502,705
66569,2018-08-24,21,149,386,535
66570,2018-08-24,22,118,277,395
66571,2018-08-24,23,91,210,301
66572,2018-08-25,0,50,128,178
66573,2018-08-25,1,40,99,139
66574,2018-08-25,2,27,68,95
66575,2018-08-25,3,17,32,49
66576,2018-08-25,4,5,21,26
66577,2018-08-25,5,3,16,19
66578,2018-08-25,6,6,63,69
66579,2018-08-25,7,30,140,170
66580,2018-08-25,8,70,286,356
66581,2018-08-25,9,178,521,699
66582,2018-08-25,10,280,606,886
66583,2018-08-25,11,353,678,1031
66584,2018-08-25,12,411,819,1230
66585,2018-08-25,13,392,806,1198
66586,2018-08-25,14,407,712,1119
66587,2018-08-25,15,423,741,1164
66588,2018-08-25,16,494,753,1247
66589,2018-08-25,17,431,702,1133
66590,2018-08-25,18,370,627,997
66591,2018-08-25,19,360,557,917
66592,2018-08-25,20,210,419,629
66593,2018-08-25,21,205,345,550
66594,2018-08-25,22,125,326,451
66595,2018-08-25,23,84,221,305
66596,2018-08-26,0,59,142,201
66597,2018-08-26,1,62,99,161
66598,2018-08-26,2,30,84,114
66599,2018-08-26,3,20,30,50
66600,2018-08-26,4,10,19,29
66601,2018-08-26,5,2,24,26
66602,2018-08-26,6,6,53,59
66603,2018-08-26,7,23,100,123
66604,2018-08-26,8,60,251,311
66605,2018-08-26,9,189,372,561
66606,2018-08-26,10,266,588,854
66607,2018-08-26,11,321,624,945
66608,2018-08-26,12,400,656,1056
66609,2018-08-26,13,385,619,1004
66610,2018-08-26,14,377,655,1032
66611,2018-08-26,15,351,656,1007
66612,2018-08-26,16,391,672,1063
66613,2018-08-26,17,391,656,1047
66614,2018-08-26,18,324,529,853
66615,2018-08-26,19,210,469,679
66616,2018-08-26,20,176,366,542
66617,2018-08-26,21,106,247,353
66618,2018-08-26,22,84,166,250
66619,2018-08-26,23,20,79,99
66620,2018-08-27,0,19,34,53
66621,2018-08-27,1,15,19,34
66622,2018-08-27,2,6,10,16
66623,2018-08-27,3,3,5,8
66624,2018-08-27,4,2,17,19
66625,2018-08-27,5,9,104,113
66626,2018-08-27,6,22,339,361
66627,2018-08-27,7,28,849,877
66628,2018-08-27,8,77,1058,1135
66629,2018-08-27,9,105,494,599
66630,2018-08-27,10,111,274,385
66631,2018-08-27,11,104,315,419
66632,2018-08-27,12,138,371,509
66633,2018-08-27,13,94,350,444
66634,2018-08-27,14,121,330,451
66635,2018-08-27,15,112,408,520
66636,2018-08-27,16,129,768,897
66637,2018-08-27,17,170,1423,1593
66638,2018-08-27,18,147,1157,1304
66639,2018-08-27,19,158,738,896
66640,2018-08-27,20,98,437,535
66641,2018-08-27,21,82,329,411
66642,2018-08-27,22,36,182,218
66643,2018-08-27,23,20,86,106
66644,2018-08-28,0,25,41,66
66645,2018-08-28,1,2,13,15
66646,2018-08-28,2,0,10,10
66647,2018-08-28,3,2,8,10
66648,2018-08-28,4,1,16,17
66649,2018-08-28,5,7,115,122
66650,2018-08-28,6,20,421,441
66651,2018-08-28,7,29,992,1021
66652,2018-08-28,8,90,1253,1343
66653,2018-08-28,9,75,512,587
66654,2018-08-28,10,111,267,378
66655,2018-08-28,11,130,284,414
66656,2018-08-28,12,88,332,420
66657,2018-08-28,13,108,314,422
66658,2018-08-28,14,108,286,394
66659,2018-08-28,15,94,407,501
66660,2018-08-28,16,134,652,786
66661,2018-08-28,17,167,1368,1535
66662,2018-08-28,18,204,1131,1335
66663,2018-08-28,19,190,704,894
66664,2018-08-28,20,131,512,643
66665,2018-08-28,21,64,330,394
66666,2018-08-28,22,51,219,270
66667,2018-08-28,23,25,101,126
66668,2018-08-29,0,6,54,60
66669,2018-08-29,1,8,21,29
66670,2018-08-29,2,4,11,15
66671,2018-08-29,3,2,7,9
66672,2018-08-29,4,0,14,14
66673,2018-08-29,5,10,126,136
66674,2018-08-29,6,18,418,436
66675,2018-08-29,7,50,941,991
66676,2018-08-29,8,58,1233,1291
66677,2018-08-29,9,59,571,630
66678,2018-08-29,10,78,278,356
66679,2018-08-29,11,73,262,335
66680,2018-08-29,12,82,356,438
66681,2018-08-29,13,75,347,422
66682,2018-08-29,14,94,243,337
66683,2018-08-29,15,92,402,494
66684,2018-08-29,16,117,633,750
66685,2018-08-29,17,181,1333,1514
66686,2018-08-29,18,148,1065,1213
66687,2018-08-29,19,128,758,886
66688,2018-08-29,20,70,494,564
66689,2018-08-29,21,82,371,453
66690,2018-08-29,22,73,289,362
66691,2018-08-29,23,37,146,183
66692,2018-08-30,0,14,52,66
66693,2018-08-30,1,10,16,26
66694,2018-08-30,2,0,9,9
66695,2018-08-30,3,2,10,12
66696,2018-08-30,4,2,18,20
66697,2018-08-30,5,4,101,105
66698,2018-08-30,6,16,376,392
66699,2018-08-30,7,38,845,883
66700,2018-08-30,8,54,1162,1216
66701,2018-08-30,9,55,486,541
66702,2018-08-30,10,79,287,366
66703,2018-08-30,11,101,293,394
66704,2018-08-30,12,97,343,440
66705,2018-08-30,13,86,365,451
66706,2018-08-30,14,95,311,406
66707,2018-08-30,15,97,416,513
66708,2018-08-30,16,116,660,776
66709,2018-08-30,17,207,1377,1584
66710,2018-08-30,18,172,1100,1272
66711,2018-08-30,19,138,707,845
66712,2018-08-30,20,73,478,551
66713,2018-08-30,21,70,369,439
66714,2018-08-30,22,63,245,308
66715,2018-08-30,23,39,134,173
66716,2018-08-31,0,21,68,89
66717,2018-08-31,1,7,25,32
66718,2018-08-31,2,7,14,21
66719,2018-08-31,3,4,12,16
66720,2018-08-31,4,1,16,17
66721,2018-08-31,5,4,101,105
66722,2018-08-31,6,10,285,295
66723,2018-08-31,7,36,682,718
66724,2018-08-31,8,61,1077,1138
66725,2018-08-31,9,80,561,641
66726,2018-08-31,10,127,320,447
66727,2018-08-31,11,125,340,465
66728,2018-08-31,12,179,467,646
66729,2018-08-31,13,147,477,624
66730,2018-08-31,14,156,606,762
66731,2018-08-31,15,167,760,927
66732,2018-08-31,16,205,826,1031
66733,2018-08-31,17,194,939,1133
66734,2018-08-31,18,201,743,944
66735,2018-08-31,19,150,526,676
66736,2018-08-31,20,114,341,455
66737,2018-08-31,21,34,153,187
66738,2018-08-31,22,23,120,143
66739,2018-08-31,23,8,82,90
66740,2018-09-01,0,23,85,108
66741,2018-09-01,1,36,68,104
66742,2018-09-01,2,45,59,104
66743,2018-09-01,3,16,25,41
66744,2018-09-01,4,5,10,15
66745,2018-09-01,5,3,23,26
66746,2018-09-01,6,15,76,91
66747,2018-09-01,7,25,96,121
66748,2018-09-01,8,45,231,276
66749,2018-09-01,9,100,372,472
66750,2018-09-01,10,200,521,721
66751,2018-09-01,11,290,520,810
66752,2018-09-01,12,374,618,992
66753,2018-09-01,13,343,537,880
66754,2018-09-01,14,391,595,986
66755,2018-09-01,15,279,519,798
66756,2018-09-01,16,326,500,826
66757,2018-09-01,17,406,534,940
66758,2018-09-01,18,371,432,803
66759,2018-09-01,19,404,330,734
66760,2018-09-01,20,201,266,467
66761,2018-09-01,21,97,155,252
66762,2018-09-01,22,27,74,101
66763,2018-09-01,23,61,102,163
66764,2018-09-02,0,30,93,123
66765,2018-09-02,1,40,77,117
66766,2018-09-02,2,27,57,84
66767,2018-09-02,3,24,39,63
66768,2018-09-02,4,1,15,16
66769,2018-09-02,5,3,37,40
66770,2018-09-02,6,9,43,52
66771,2018-09-02,7,19,99,118
66772,2018-09-02,8,68,218,286
66773,2018-09-02,9,219,374,593
66774,2018-09-02,10,354,523,877
66775,2018-09-02,11,451,655,1106
66776,2018-09-02,12,485,709,1194
66777,2018-09-02,13,514,692,1206
66778,2018-09-02,14,558,604,1162
66779,2018-09-02,15,529,552,1081
66780,2018-09-02,16,435,605,1040
66781,2018-09-02,17,444,571,1015
66782,2018-09-02,18,410,579,989
66783,2018-09-02,19,403,524,927
66784,2018-09-02,20,301,384,685
66785,2018-09-02,21,234,350,584
66786,2018-09-02,22,200,325,525
66787,2018-09-02,23,131,212,343
66788,2018-09-03,0,64,123,187
66789,2018-09-03,1,37,62,99
66790,2018-09-03,2,46,28,74
66791,2018-09-03,3,16,27,43
66792,2018-09-03,4,5,20,25
66793,2018-09-03,5,4,25,29
66794,2018-09-03,6,10,70,80
66795,2018-09-03,7,40,115,155
66796,2018-09-03,8,88,237,325
66797,2018-09-03,9,184,391,575
66798,2018-09-03,10,277,480,757
66799,2018-09-03,11,320,521,841
66800,2018-09-03,12,330,608,938
66801,2018-09-03,13,360,554,914
66802,2018-09-03,14,338,507,845
66803,2018-09-03,15,266,475,741
66804,2018-09-03,16,268,508,776
66805,2018-09-03,17,279,536,815
66806,2018-09-03,18,258,514,772
66807,2018-09-03,19,223,474,697
66808,2018-09-03,20,132,301,433
66809,2018-09-03,21,108,247,355
66810,2018-09-03,22,56,168,224
66811,2018-09-03,23,20,83,103
66812,2018-09-04,0,4,49,53
66813,2018-09-04,1,2,13,15
66814,2018-09-04,2,1,11,12
66815,2018-09-04,3,3,4,7
66816,2018-09-04,4,1,15,16
66817,2018-09-04,5,7,100,107
66818,2018-09-04,6,12,382,394
66819,2018-09-04,7,33,831,864
66820,2018-09-04,8,50,1051,1101
66821,2018-09-04,9,50,442,492
66822,2018-09-04,10,60,261,321
66823,2018-09-04,11,79,264,343
66824,2018-09-04,12,96,368,464
66825,2018-09-04,13,98,316,414
66826,2018-09-04,14,83,242,325
66827,2018-09-04,15,72,321,393
66828,2018-09-04,16,88,608,696
66829,2018-09-04,17,157,1350,1507
66830,2018-09-04,18,158,1199,1357
66831,2018-09-04,19,119,698,817
66832,2018-09-04,20,60,450,510
66833,2018-09-04,21,47,275,322
66834,2018-09-04,22,46,213,259
66835,2018-09-04,23,25,110,135
66836,2018-09-05,0,11,47,58
66837,2018-09-05,1,3,14,17
66838,2018-09-05,2,2,14,16
66839,2018-09-05,3,3,6,9
66840,2018-09-05,4,0,21,21
66841,2018-09-05,5,8,134,142
66842,2018-09-05,6,24,460,484
66843,2018-09-05,7,46,1032,1078
66844,2018-09-05,8,62,1298,1360
66845,2018-09-05,9,64,498,562
66846,2018-09-05,10,50,265,315
66847,2018-09-05,11,57,297,354
66848,2018-09-05,12,73,403,476
66849,2018-09-05,13,76,366,442
66850,2018-09-05,14,89,310,399
66851,2018-09-05,15,102,447,549
66852,2018-09-05,16,115,775,890
66853,2018-09-05,17,148,1394,1542
66854,2018-09-05,18,145,1250,1395
66855,2018-09-05,19,118,818,936
66856,2018-09-05,20,87,540,627
66857,2018-09-05,21,57,401,458
66858,2018-09-05,22,44,225,269
66859,2018-09-05,23,31,128,159
66860,2018-09-06,0,12,46,58
66861,2018-09-06,1,0,16,16
66862,2018-09-06,2,0,9,9
66863,2018-09-06,3,3,4,7
66864,2018-09-06,4,3,13,16
66865,2018-09-06,5,7,97,104
66866,2018-09-06,6,22,414,436
66867,2018-09-06,7,25,994,1019
66868,2018-09-06,8,62,1254,1316
66869,2018-09-06,9,53,532,585
66870,2018-09-06,10,75,269,344
66871,2018-09-06,11,84,273,357
66872,2018-09-06,12,92,383,475
66873,2018-09-06,13,87,401,488
66874,2018-09-06,14,96,318,414
66875,2018-09-06,15,95,441,536
66876,2018-09-06,16,125,738,863
66877,2018-09-06,17,174,1433,1607
66878,2018-09-06,18,142,1264,1406
66879,2018-09-06,19,116,783,899
66880,2018-09-06,20,95,558,653
66881,2018-09-06,21,62,426,488
66882,2018-09-06,22,63,290,353
66883,2018-09-06,23,54,180,234
66884,2018-09-07,0,19,83,102
66885,2018-09-07,1,16,39,55
66886,2018-09-07,2,7,19,26
66887,2018-09-07,3,1,4,5
66888,2018-09-07,4,0,16,16
66889,2018-09-07,5,12,92,104
66890,2018-09-07,6,17,348,365
66891,2018-09-07,7,35,884,919
66892,2018-09-07,8,60,1283,1343
66893,2018-09-07,9,56,612,668
66894,2018-09-07,10,88,302,390
66895,2018-09-07,11,124,360,484
66896,2018-09-07,12,128,446,574
66897,2018-09-07,13,129,424,553
66898,2018-09-07,14,140,434,574
66899,2018-09-07,15,181,507,688
66900,2018-09-07,16,139,860,999
66901,2018-09-07,17,69,544,613
66902,2018-09-07,18,7,140,147
66903,2018-09-07,19,37,330,367
66904,2018-09-07,20,21,188,209
66905,2018-09-07,21,4,27,31
66906,2018-09-07,22,8,49,57
66907,2018-09-07,23,24,103,127
66908,2018-09-08,0,20,107,127
66909,2018-09-08,1,18,64,82
66910,2018-09-08,2,17,40,57
66911,2018-09-08,3,13,24,37
66912,2018-09-08,4,4,14,18
66913,2018-09-08,5,3,16,19
66914,2018-09-08,6,9,68,77
66915,2018-09-08,7,20,138,158
66916,2018-09-08,8,40,308,348
66917,2018-09-08,9,92,365,457
66918,2018-09-08,10,120,574,694
66919,2018-09-08,11,208,608,816
66920,2018-09-08,12,218,712,930
66921,2018-09-08,13,175,554,729
66922,2018-09-08,14,40,206,246
66923,2018-09-08,15,31,231,262
66924,2018-09-08,16,79,330,409
66925,2018-09-08,17,103,365,468
66926,2018-09-08,18,114,346,460
66927,2018-09-08,19,102,308,410
66928,2018-09-08,20,119,245,364
66929,2018-09-08,21,111,217,328
66930,2018-09-08,22,70,186,256
66931,2018-09-08,23,55,138,193
66932,2018-09-09,0,11,47,58
66933,2018-09-09,1,6,75,81
66934,2018-09-09,2,11,39,50
66935,2018-09-09,3,6,22,28
66936,2018-09-09,4,1,8,9
66937,2018-09-09,5,2,8,10
66938,2018-09-09,6,4,8,12
66939,2018-09-09,7,1,12,13
66940,2018-09-09,8,1,29,30
66941,2018-09-09,9,7,87,94
66942,2018-09-09,10,15,93,108
66943,2018-09-09,11,9,92,101
66944,2018-09-09,12,20,110,130
66945,2018-09-09,13,19,127,146
66946,2018-09-09,14,15,91,106
66947,2018-09-09,15,20,92,112
66948,2018-09-09,16,9,139,148
66949,2018-09-09,17,47,260,307
66950,2018-09-09,18,35,271,306
66951,2018-09-09,19,45,250,295
66952,2018-09-09,20,26,169,195
66953,2018-09-09,21,55,143,198
66954,2018-09-09,22,43,130,173
66955,2018-09-09,23,14,74,88
66956,2018-09-10,0,15,27,42
66957,2018-09-10,1,6,14,20
66958,2018-09-10,2,1,6,7
66959,2018-09-10,3,4,2,6
66960,2018-09-10,4,10,10,20
66961,2018-09-10,5,7,88,95
66962,2018-09-10,6,6,275,281
66963,2018-09-10,7,20,649,669
66964,2018-09-10,8,45,1081,1126
66965,2018-09-10,9,38,448,486
66966,2018-09-10,10,41,173,214
66967,2018-09-10,11,49,212,261
66968,2018-09-10,12,94,344,438
66969,2018-09-10,13,86,312,398
66970,2018-09-10,14,86,274,360
66971,2018-09-10,15,94,368,462
66972,2018-09-10,16,101,718,819
66973,2018-09-10,17,122,1330,1452
66974,2018-09-10,18,121,1061,1182
66975,2018-09-10,19,74,633,707
66976,2018-09-10,20,41,339,380
66977,2018-09-10,21,29,224,253
66978,2018-09-10,22,33,154,187
66979,2018-09-10,23,23,80,103
66980,2018-09-11,0,16,41,57
66981,2018-09-11,1,6,12,18
66982,2018-09-11,2,3,6,9
66983,2018-09-11,3,1,4,5
66984,2018-09-11,4,0,18,18
66985,2018-09-11,5,5,93,98
66986,2018-09-11,6,14,357,371
66987,2018-09-11,7,22,892,914
66988,2018-09-11,8,57,1305,1362
66989,2018-09-11,9,58,531,589
66990,2018-09-11,10,72,299,371
66991,2018-09-11,11,88,266,354
66992,2018-09-11,12,106,395,501
66993,2018-09-11,13,124,360,484
66994,2018-09-11,14,120,319,439
66995,2018-09-11,15,118,457,575
66996,2018-09-11,16,137,790,927
66997,2018-09-11,17,177,1513,1690
66998,2018-09-11,18,109,1188,1297
66999,2018-09-11,19,65,698,763
67000,2018-09-11,20,50,414,464
67001,2018-09-11,21,51,327,378
67002,2018-09-11,22,41,227,268
67003,2018-09-11,23,34,116,150
67004,2018-09-12,0,8,49,57
67005,2018-09-12,1,9,19,28
67006,2018-09-12,2,4,8,12
67007,2018-09-12,3,0,5,5
67008,2018-09-12,4,1,15,16
67009,2018-09-12,5,6,119,125
67010,2018-09-12,6,16,404,420
67011,2018-09-12,7,35,995,1030
67012,2018-09-12,8,53,1290,1343
67013,2018-09-12,9,49,551,600
67014,2018-09-12,10,76,268,344
67015,2018-09-12,11,77,308,385
67016,2018-09-12,12,104,405,509
67017,2018-09-12,13,94,414,508
67018,2018-09-12,14,109,367,476
67019,2018-09-12,15,120,520,640
67020,2018-09-12,16,136,786,922
67021,2018-09-12,17,158,1502,1660
67022,2018-09-12,18,137,1101,1238
67023,2018-09-12,19,72,622,694
67024,2018-09-12,20,35,461,496
67025,2018-09-12,21,58,376,434
67026,2018-09-12,22,35,259,294
67027,2018-09-12,23,32,113,145
67028,2018-09-13,0,24,69,93
67029,2018-09-13,1,13,23,36
67030,2018-09-13,2,7,14,21
67031,2018-09-13,3,3,9,12
67032,2018-09-13,4,2,20,22
67033,2018-09-13,5,3,97,100
67034,2018-09-13,6,10,380,390
67035,2018-09-13,7,29,949,978
67036,2018-09-13,8,47,1373,1420
67037,2018-09-13,9,56,590,646
67038,2018-09-13,10,63,221,284
67039,2018-09-13,11,67,229,296
67040,2018-09-13,12,73,359,432
67041,2018-09-13,13,105,353,458
67042,2018-09-13,14,81,330,411
67043,2018-09-13,15,114,472,586
67044,2018-09-13,16,151,754,905
67045,2018-09-13,17,161,1429,1590
67046,2018-09-13,18,150,1221,1371
67047,2018-09-13,19,114,783,897
67048,2018-09-13,20,85,561,646
67049,2018-09-13,21,60,397,457
67050,2018-09-13,22,43,278,321
67051,2018-09-13,23,36,171,207
67052,2018-09-14,0,19,74,93
67053,2018-09-14,1,16,37,53
67054,2018-09-14,2,13,18,31
67055,2018-09-14,3,4,6,10
67056,2018-09-14,4,3,18,21
67057,2018-09-14,5,4,81,85
67058,2018-09-14,6,10,318,328
67059,2018-09-14,7,22,791,813
67060,2018-09-14,8,56,1250,1306
67061,2018-09-14,9,58,598,656
67062,2018-09-14,10,68,328,396
67063,2018-09-14,11,97,389,486
67064,2018-09-14,12,107,466,573
67065,2018-09-14,13,137,457,594
67066,2018-09-14,14,179,456,635
67067,2018-09-14,15,129,561,690
67068,2018-09-14,16,158,844,1002
67069,2018-09-14,17,186,1354,1540
67070,2018-09-14,18,180,1032,1212
67071,2018-09-14,19,130,657,787
67072,2018-09-14,20,87,425,512
67073,2018-09-14,21,91,330,421
67074,2018-09-14,22,86,241,327
67075,2018-09-14,23,44,248,292
67076,2018-09-15,0,38,152,190
67077,2018-09-15,1,36,92,128
67078,2018-09-15,2,26,70,96
67079,2018-09-15,3,8,20,28
67080,2018-09-15,4,5,20,25
67081,2018-09-15,5,7,35,42
67082,2018-09-15,6,12,69,81
67083,2018-09-15,7,21,162,183
67084,2018-09-15,8,45,298,343
67085,2018-09-15,9,105,436,541
67086,2018-09-15,10,184,606,790
67087,2018-09-15,11,236,742,978
67088,2018-09-15,12,250,802,1052
67089,2018-09-15,13,361,776,1137
67090,2018-09-15,14,359,735,1094
67091,2018-09-15,15,369,717,1086
67092,2018-09-15,16,336,714,1050
67093,2018-09-15,17,361,749,1110
67094,2018-09-15,18,281,583,864
67095,2018-09-15,19,200,506,706
67096,2018-09-15,20,179,400,579
67097,2018-09-15,21,161,335,496
67098,2018-09-15,22,121,282,403
67099,2018-09-15,23,132,203,335
67100,2018-09-16,0,67,206,273
67101,2018-09-16,1,55,139,194
67102,2018-09-16,2,51,91,142
67103,2018-09-16,3,23,58,81
67104,2018-09-16,4,6,22,28
67105,2018-09-16,5,6,31,37
67106,2018-09-16,6,25,107,132
67107,2018-09-16,7,41,105,146
67108,2018-09-16,8,44,240,284
67109,2018-09-16,9,111,369,480
67110,2018-09-16,10,196,598,794
67111,2018-09-16,11,225,675,900
67112,2018-09-16,12,242,752,994
67113,2018-09-16,13,250,713,963
67114,2018-09-16,14,290,686,976
67115,2018-09-16,15,330,723,1053
67116,2018-09-16,16,290,745,1035
67117,2018-09-16,17,255,644,899
67118,2018-09-16,18,227,609,836
67119,2018-09-16,19,191,417,608
67120,2018-09-16,20,135,307,442
67121,2018-09-16,21,73,231,304
67122,2018-09-16,22,44,161,205
67123,2018-09-16,23,20,81,101
67124,2018-09-17,0,14,27,41
67125,2018-09-17,1,7,15,22
67126,2018-09-17,2,6,8,14
67127,2018-09-17,3,5,5,10
67128,2018-09-17,4,2,21,23
67129,2018-09-17,5,8,80,88
67130,2018-09-17,6,15,372,387
67131,2018-09-17,7,34,868,902
67132,2018-09-17,8,42,1053,1095
67133,2018-09-17,9,24,307,331
67134,2018-09-17,10,29,161,190
67135,2018-09-17,11,40,237,277
67136,2018-09-17,12,33,181,214
67137,2018-09-17,13,27,139,166
67138,2018-09-17,14,50,220,270
67139,2018-09-17,15,36,240,276
67140,2018-09-17,16,20,263,283
67141,2018-09-17,17,9,266,275
67142,2018-09-17,18,26,535,561
67143,2018-09-17,19,40,548,588
67144,2018-09-17,20,34,384,418
67145,2018-09-17,21,23,271,294
67146,2018-09-17,22,23,116,139
67147,2018-09-17,23,12,68,80
67148,2018-09-18,0,4,18,22
67149,2018-09-18,1,2,7,9
67150,2018-09-18,2,0,6,6
67151,2018-09-18,3,2,1,3
67152,2018-09-18,4,1,13,14
67153,2018-09-18,5,4,89,93
67154,2018-09-18,6,19,334,353
67155,2018-09-18,7,30,775,805
67156,2018-09-18,8,33,604,637
67157,2018-09-18,9,27,418,445
67158,2018-09-18,10,38,229,267
67159,2018-09-18,11,55,264,319
67160,2018-09-18,12,50,337,387
67161,2018-09-18,13,41,210,251
67162,2018-09-18,14,43,295,338
67163,2018-09-18,15,80,432,512
67164,2018-09-18,16,81,789,870
67165,2018-09-18,17,142,1477,1619
67166,2018-09-18,18,99,1237,1336
67167,2018-09-18,19,93,817,910
67168,2018-09-18,20,70,485,555
67169,2018-09-18,21,56,414,470
67170,2018-09-18,22,44,212,256
67171,2018-09-18,23,22,125,147
67172,2018-09-19,0,13,46,59
67173,2018-09-19,1,4,17,21
67174,2018-09-19,2,1,5,6
67175,2018-09-19,3,2,9,11
67176,2018-09-19,4,0,21,21
67177,2018-09-19,5,11,121,132
67178,2018-09-19,6,20,400,420
67179,2018-09-19,7,25,1021,1046
67180,2018-09-19,8,67,1318,1385
67181,2018-09-19,9,70,588,658
67182,2018-09-19,10,67,316,383
67183,2018-09-19,11,102,362,464
67184,2018-09-19,12,104,492,596
67185,2018-09-19,13,107,473,580
67186,2018-09-19,14,168,392,560
67187,2018-09-19,15,139,479,618
67188,2018-09-19,16,170,851,1021
67189,2018-09-19,17,194,1595,1789
67190,2018-09-19,18,184,1276,1460
67191,2018-09-19,19,133,804,937
67192,2018-09-19,20,84,504,588
67193,2018-09-19,21,76,404,480
67194,2018-09-19,22,44,282,326
67195,2018-09-19,23,20,119,139
67196,2018-09-20,0,14,61,75
67197,2018-09-20,1,3,19,22
67198,2018-09-20,2,0,9,9
67199,2018-09-20,3,0,6,6
67200,2018-09-20,4,0,20,20
67201,2018-09-20,5,5,107,112
67202,2018-09-20,6,23,385,408
67203,2018-09-20,7,33,1016,1049
67204,2018-09-20,8,43,1317,1360
67205,2018-09-20,9,41,557,598
67206,2018-09-20,10,85,251,336
67207,2018-09-20,11,94,336,430
67208,2018-09-20,12,129,408,537
67209,2018-09-20,13,116,437,553
67210,2018-09-20,14,152,392,544
67211,2018-09-20,15,202,494,696
67212,2018-09-20,16,161,840,1001
67213,2018-09-20,17,183,1541,1724
67214,2018-09-20,18,204,1338,1542
67215,2018-09-20,19,144,749,893
67216,2018-09-20,20,93,520,613
67217,2018-09-20,21,81,419,500
67218,2018-09-20,22,65,289,354
67219,2018-09-20,23,48,189,237
67220,2018-09-21,0,46,83,129
67221,2018-09-21,1,23,35,58
67222,2018-09-21,2,15,19,34
67223,2018-09-21,3,2,6,8
67224,2018-09-21,4,1,23,24
67225,2018-09-21,5,5,96,101
67226,2018-09-21,6,21,361,382
67227,2018-09-21,7,34,817,851
67228,2018-09-21,8,51,1253,1304
67229,2018-09-21,9,21,278,299
67230,2018-09-21,10,41,184,225
67231,2018-09-21,11,87,318,405
67232,2018-09-21,12,139,436,575
67233,2018-09-21,13,150,456,606
67234,2018-09-21,14,171,456,627
67235,2018-09-21,15,213,613,826
67236,2018-09-21,16,203,911,1114
67237,2018-09-21,17,214,1355,1569
67238,2018-09-21,18,199,977,1176
67239,2018-09-21,19,123,641,764
67240,2018-09-21,20,121,420,541
67241,2018-09-21,21,78,325,403
67242,2018-09-21,22,97,302,399
67243,2018-09-21,23,65,229,294
67244,2018-09-22,0,73,157,230
67245,2018-09-22,1,56,99,155
67246,2018-09-22,2,24,66,90
67247,2018-09-22,3,13,28,41
67248,2018-09-22,4,5,21,26
67249,2018-09-22,5,4,29,33
67250,2018-09-22,6,4,32,36
67251,2018-09-22,7,19,132,151
67252,2018-09-22,8,48,272,320
67253,2018-09-22,9,112,566,678
67254,2018-09-22,10,220,618,838
67255,2018-09-22,11,316,789,1105
67256,2018-09-22,12,313,766,1079
67257,2018-09-22,13,364,856,1220
67258,2018-09-22,14,403,801,1204
67259,2018-09-22,15,433,749,1182
67260,2018-09-22,16,429,797,1226
67261,2018-09-22,17,426,744,1170
67262,2018-09-22,18,297,658,955
67263,2018-09-22,19,187,500,687
67264,2018-09-22,20,116,362,478
67265,2018-09-22,21,118,287,405
67266,2018-09-22,22,93,191,284
67267,2018-09-22,23,63,165,228
67268,2018-09-23,0,46,132,178
67269,2018-09-23,1,22,104,126
67270,2018-09-23,2,26,50,76
67271,2018-09-23,3,6,19,25
67272,2018-09-23,4,2,4,6
67273,2018-09-23,5,2,9,11
67274,2018-09-23,6,4,20,24
67275,2018-09-23,7,7,41,48
67276,2018-09-23,8,8,80,88
67277,2018-09-23,9,7,60,67
67278,2018-09-23,10,5,132,137
67279,2018-09-23,11,30,130,160
67280,2018-09-23,12,10,112,122
67281,2018-09-23,13,10,129,139
67282,2018-09-23,14,20,125,145
67283,2018-09-23,15,33,179,212
67284,2018-09-23,16,32,165,197
67285,2018-09-23,17,59,223,282
67286,2018-09-23,18,29,172,201
67287,2018-09-23,19,17,112,129
67288,2018-09-23,20,9,74,83
67289,2018-09-23,21,21,112,133
67290,2018-09-23,22,20,95,115
67291,2018-09-23,23,21,60,81
67292,2018-09-24,0,7,32,39
67293,2018-09-24,1,4,14,18
67294,2018-09-24,2,3,7,10
67295,2018-09-24,3,0,7,7
67296,2018-09-24,4,1,18,19
67297,2018-09-24,5,4,71,75
67298,2018-09-24,6,7,252,259
67299,2018-09-24,7,5,427,432
67300,2018-09-24,8,27,608,635
67301,2018-09-24,9,22,274,296
67302,2018-09-24,10,6,86,92
67303,2018-09-24,11,15,107,122
67304,2018-09-24,12,16,156,172
67305,2018-09-24,13,24,236,260
67306,2018-09-24,14,35,270,305
67307,2018-09-24,15,75,342,417
67308,2018-09-24,16,70,535,605
67309,2018-09-24,17,68,961,1029
67310,2018-09-24,18,33,523,556
67311,2018-09-24,19,28,366,394
67312,2018-09-24,20,18,229,247
67313,2018-09-24,21,10,169,179
67314,2018-09-24,22,8,102,110
67315,2018-09-24,23,4,49,53
67316,2018-09-25,0,7,25,32
67317,2018-09-25,1,0,7,7
67318,2018-09-25,2,0,7,7
67319,2018-09-25,3,1,10,11
67320,2018-09-25,4,1,21,22
67321,2018-09-25,5,4,98,102
67322,2018-09-25,6,7,300,307
67323,2018-09-25,7,11,804,815
67324,2018-09-25,8,24,868,892
67325,2018-09-25,9,11,323,334
67326,2018-09-25,10,16,165,181
67327,2018-09-25,11,54,270,324
67328,2018-09-25,12,44,336,380
67329,2018-09-25,13,35,357,392
67330,2018-09-25,14,75,322,397
67331,2018-09-25,15,103,446,549
67332,2018-09-25,16,84,719,803
67333,2018-09-25,17,143,1424,1567
67334,2018-09-25,18,99,1120,1219
67335,2018-09-25,19,69,643,712
67336,2018-09-25,20,37,423,460
67337,2018-09-25,21,44,311,355
67338,2018-09-25,22,32,237,269
67339,2018-09-25,23,22,116,138
67340,2018-09-26,0,11,43,54
67341,2018-09-26,1,3,17,20
67342,2018-09-26,2,0,6,6
67343,2018-09-26,3,0,4,4
67344,2018-09-26,4,3,16,19
67345,2018-09-26,5,7,127,134
67346,2018-09-26,6,14,381,395
67347,2018-09-26,7,37,992,1029
67348,2018-09-26,8,46,1270,1316
67349,2018-09-26,9,50,531,581
67350,2018-09-26,10,85,310,395
67351,2018-09-26,11,99,362,461
67352,2018-09-26,12,84,425,509
67353,2018-09-26,13,101,373,474
67354,2018-09-26,14,104,438,542
67355,2018-09-26,15,97,521,618
67356,2018-09-26,16,137,816,953
67357,2018-09-26,17,121,1421,1542
67358,2018-09-26,18,90,948,1038
67359,2018-09-26,19,28,255,283
67360,2018-09-26,20,21,187,208
67361,2018-09-26,21,24,284,308
67362,2018-09-26,22,24,193,217
67363,2018-09-26,23,8,86,94
67364,2018-09-27,0,12,53,65
67365,2018-09-27,1,6,14,20
67366,2018-09-27,2,2,11,13
67367,2018-09-27,3,2,9,11
67368,2018-09-27,4,2,23,25
67369,2018-09-27,5,8,99,107
67370,2018-09-27,6,11,339,350
67371,2018-09-27,7,22,885,907
67372,2018-09-27,8,45,1320,1365
67373,2018-09-27,9,44,516,560
67374,2018-09-27,10,64,292,356
67375,2018-09-27,11,77,289,366
67376,2018-09-27,12,88,386,474
67377,2018-09-27,13,71,323,394
67378,2018-09-27,14,21,151,172
67379,2018-09-27,15,20,160,180
67380,2018-09-27,16,9,160,169
67381,2018-09-27,17,18,295,313
67382,2018-09-27,18,14,235,249
67383,2018-09-27,19,9,153,162
67384,2018-09-27,20,4,149,153
67385,2018-09-27,21,2,147,149
67386,2018-09-27,22,14,101,115
67387,2018-09-27,23,14,66,80
67388,2018-09-28,0,6,26,32
67389,2018-09-28,1,0,12,12
67390,2018-09-28,2,0,5,5
67391,2018-09-28,3,2,5,7
67392,2018-09-28,4,0,22,22
67393,2018-09-28,5,3,87,90
67394,2018-09-28,6,8,286,294
67395,2018-09-28,7,25,773,798
67396,2018-09-28,8,39,999,1038
67397,2018-09-28,9,56,486,542
67398,2018-09-28,10,99,312,411
67399,2018-09-28,11,108,388,496
67400,2018-09-28,12,137,469,606
67401,2018-09-28,13,138,530,668
67402,2018-09-28,14,175,510,685
67403,2018-09-28,15,179,632,811
67404,2018-09-28,16,199,920,1119
67405,2018-09-28,17,286,1389,1675
67406,2018-09-28,18,204,1088,1292
67407,2018-09-28,19,131,712,843
67408,2018-09-28,20,111,471,582
67409,2018-09-28,21,107,333,440
67410,2018-09-28,22,55,237,292
67411,2018-09-28,23,51,196,247
67412,2018-09-29,0,56,152,208
67413,2018-09-29,1,36,103,139
67414,2018-09-29,2,33,78,111
67415,2018-09-29,3,15,31,46
67416,2018-09-29,4,4,18,22
67417,2018-09-29,5,5,22,27
67418,2018-09-29,6,9,78,87
67419,2018-09-29,7,27,153,180
67420,2018-09-29,8,45,326,371
67421,2018-09-29,9,145,515,660
67422,2018-09-29,10,207,603,810
67423,2018-09-29,11,299,721,1020
67424,2018-09-29,12,398,806,1204
67425,2018-09-29,13,427,786,1213
67426,2018-09-29,14,496,810,1306
67427,2018-09-29,15,447,833,1280
67428,2018-09-29,16,443,853,1296
67429,2018-09-29,17,404,788,1192
67430,2018-09-29,18,369,661,1030
67431,2018-09-29,19,202,510,712
67432,2018-09-29,20,166,387,553
67433,2018-09-29,21,137,328,465
67434,2018-09-29,22,111,280,391
67435,2018-09-29,23,70,205,275
67436,2018-09-30,0,88,188,276
67437,2018-09-30,1,52,130,182
67438,2018-09-30,2,24,61,85
67439,2018-09-30,3,19,24,43
67440,2018-09-30,4,4,16,20
67441,2018-09-30,5,2,15,17
67442,2018-09-30,6,8,46,54
67443,2018-09-30,7,26,88,114
67444,2018-09-30,8,62,220,282
67445,2018-09-30,9,122,366,488
67446,2018-09-30,10,188,529,717
67447,2018-09-30,11,271,627,898
67448,2018-09-30,12,302,787,1089
67449,2018-09-30,13,295,752,1047
67450,2018-09-30,14,354,729,1083
67451,2018-09-30,15,380,720,1100
67452,2018-09-30,16,341,724,1065
67453,2018-09-30,17,289,790,1079
67454,2018-09-30,18,238,648,886
67455,2018-09-30,19,125,416,541
67456,2018-09-30,20,101,278,379
67457,2018-09-30,21,68,233,301
67458,2018-09-30,22,55,147,202
67459,2018-09-30,23,30,83,113
67460,2018-10-01,0,7,47,54
67461,2018-10-01,1,7,20,27
67462,2018-10-01,2,0,9,9
67463,2018-10-01,3,0,9,9
67464,2018-10-01,4,1,17,18
67465,2018-10-01,5,8,93,101
67466,2018-10-01,6,17,349,366
67467,2018-10-01,7,35,870,905
67468,2018-10-01,8,44,1086,1130
67469,2018-10-01,9,63,509,572
67470,2018-10-01,10,80,277,357
67471,2018-10-01,11,88,336,424
67472,2018-10-01,12,107,456,563
67473,2018-10-01,13,103,447,550
67474,2018-10-01,14,132,392,524
67475,2018-10-01,15,111,514,625
67476,2018-10-01,16,131,911,1042
67477,2018-10-01,17,192,1591,1783
67478,2018-10-01,18,173,1189,1362
67479,2018-10-01,19,105,735,840
67480,2018-10-01,20,69,428,497
67481,2018-10-01,21,49,338,387
67482,2018-10-01,22,28,207,235
67483,2018-10-01,23,22,106,128
67484,2018-10-02,0,11,33,44
67485,2018-10-02,1,5,14,19
67486,2018-10-02,2,3,5,8
67487,2018-10-02,3,7,7,14
67488,2018-10-02,4,4,17,21
67489,2018-10-02,5,5,126,131
67490,2018-10-02,6,21,425,446
67491,2018-10-02,7,36,1016,1052
67492,2018-10-02,8,40,1383,1423
67493,2018-10-02,9,53,564,617
67494,2018-10-02,10,98,302,400
67495,2018-10-02,11,133,276,409
67496,2018-10-02,12,124,411,535
67497,2018-10-02,13,117,393,510
67498,2018-10-02,14,143,388,531
67499,2018-10-02,15,128,558,686
67500,2018-10-02,16,175,940,1115
67501,2018-10-02,17,189,1562,1751
67502,2018-10-02,18,158,1364,1522
67503,2018-10-02,19,98,810,908
67504,2018-10-02,20,64,515,579
67505,2018-10-02,21,60,408,468
67506,2018-10-02,22,32,257,289
67507,2018-10-02,23,31,132,163
67508,2018-10-03,0,18,54,72
67509,2018-10-03,1,8,28,36
67510,2018-10-03,2,4,14,18
67511,2018-10-03,3,1,6,7
67512,2018-10-03,4,1,17,18
67513,2018-10-03,5,11,135,146
67514,2018-10-03,6,17,405,422
67515,2018-10-03,7,25,1030,1055
67516,2018-10-03,8,47,1462,1509
67517,2018-10-03,9,68,521,589
67518,2018-10-03,10,91,301,392
67519,2018-10-03,11,74,347,421
67520,2018-10-03,12,88,454,542
67521,2018-10-03,13,111,433,544
67522,2018-10-03,14,122,389,511
67523,2018-10-03,15,142,505,647
67524,2018-10-03,16,133,885,1018
67525,2018-10-03,17,177,1702,1879
67526,2018-10-03,18,120,1336,1456
67527,2018-10-03,19,109,815,924
67528,2018-10-03,20,95,505,600
67529,2018-10-03,21,53,374,427
67530,2018-10-03,22,40,273,313
67531,2018-10-03,23,31,150,181
67532,2018-10-04,0,11,60,71
67533,2018-10-04,1,1,25,26
67534,2018-10-04,2,5,11,16
67535,2018-10-04,3,5,7,12
67536,2018-10-04,4,4,18,22
67537,2018-10-04,5,6,117,123
67538,2018-10-04,6,19,374,393
67539,2018-10-04,7,29,937,966
67540,2018-10-04,8,42,1372,1414
67541,2018-10-04,9,66,584,650
67542,2018-10-04,10,65,316,381
67543,2018-10-04,11,78,385,463
67544,2018-10-04,12,89,493,582
67545,2018-10-04,13,117,444,561
67546,2018-10-04,14,137,430,567
67547,2018-10-04,15,145,553,698
67548,2018-10-04,16,153,831,984
67549,2018-10-04,17,160,1497,1657
67550,2018-10-04,18,160,1290,1450
67551,2018-10-04,19,87,722,809
67552,2018-10-04,20,78,431,509
67553,2018-10-04,21,50,383,433
67554,2018-10-04,22,45,286,331
67555,2018-10-04,23,32,148,180
67556,2018-10-05,0,23,90,113
67557,2018-10-05,1,5,38,43
67558,2018-10-05,2,1,18,19
67559,2018-10-05,3,2,4,6
67560,2018-10-05,4,3,17,20
67561,2018-10-05,5,6,102,108
67562,2018-10-05,6,16,317,333
67563,2018-10-05,7,29,784,813
67564,2018-10-05,8,71,1274,1345
67565,2018-10-05,9,92,656,748
67566,2018-10-05,10,111,343,454
67567,2018-10-05,11,140,429,569
67568,2018-10-05,12,155,573,728
67569,2018-10-05,13,142,580,722
67570,2018-10-05,14,202,535,737
67571,2018-10-05,15,175,681,856
67572,2018-10-05,16,216,967,1183
67573,2018-10-05,17,185,1259,1444
67574,2018-10-05,18,166,949,1115
67575,2018-10-05,19,119,655,774
67576,2018-10-05,20,80,378,458
67577,2018-10-05,21,86,315,401
67578,2018-10-05,22,81,265,346
67579,2018-10-05,23,60,176,236
67580,2018-10-06,0,37,131,168
67581,2018-10-06,1,24,68,92
67582,2018-10-06,2,14,57,71
67583,2018-10-06,3,11,23,34
67584,2018-10-06,4,6,16,22
67585,2018-10-06,5,7,37,44
67586,2018-10-06,6,7,65,72
67587,2018-10-06,7,26,139,165
67588,2018-10-06,8,52,306,358
67589,2018-10-06,9,102,525,627
67590,2018-10-06,10,216,655,871
67591,2018-10-06,11,321,698,1019
67592,2018-10-06,12,392,736,1128
67593,2018-10-06,13,432,718,1150
67594,2018-10-06,14,414,732,1146
67595,2018-10-06,15,430,730,1160
67596,2018-10-06,16,383,789,1172
67597,2018-10-06,17,339,723,1062
67598,2018-10-06,18,284,557,841
67599,2018-10-06,19,209,461,670
67600,2018-10-06,20,143,303,446
67601,2018-10-06,21,122,244,366
67602,2018-10-06,22,117,199,316
67603,2018-10-06,23,75,224,299
67604,2018-10-07,0,48,141,189
67605,2018-10-07,1,65,117,182
67606,2018-10-07,2,32,70,102
67607,2018-10-07,3,18,42,60
67608,2018-10-07,4,5,14,19
67609,2018-10-07,5,4,21,25
67610,2018-10-07,6,10,80,90
67611,2018-10-07,7,31,116,147
67612,2018-10-07,8,90,251,341
67613,2018-10-07,9,153,389,542
67614,2018-10-07,10,236,553,789
67615,2018-10-07,11,354,625,979
67616,2018-10-07,12,375,753,1128
67617,2018-10-07,13,419,702,1121
67618,2018-10-07,14,412,748,1160
67619,2018-10-07,15,440,792,1232
67620,2018-10-07,16,460,743,1203
67621,2018-10-07,17,417,728,1145
67622,2018-10-07,18,345,666,1011
67623,2018-10-07,19,223,492,715
67624,2018-10-07,20,155,348,503
67625,2018-10-07,21,120,248,368
67626,2018-10-07,22,54,208,262
67627,2018-10-07,23,48,169,217
67628,2018-10-08,0,26,71,97
67629,2018-10-08,1,20,55,75
67630,2018-10-08,2,7,30,37
67631,2018-10-08,3,2,9,11
67632,2018-10-08,4,3,13,16
67633,2018-10-08,5,4,65,69
67634,2018-10-08,6,13,170,183
67635,2018-10-08,7,13,379,392
67636,2018-10-08,8,81,675,756
67637,2018-10-08,9,126,475,601
67638,2018-10-08,10,161,409,570
67639,2018-10-08,11,188,499,687
67640,2018-10-08,12,314,569,883
67641,2018-10-08,13,256,567,823
67642,2018-10-08,14,281,590,871
67643,2018-10-08,15,254,640,894
67644,2018-10-08,16,224,683,907
67645,2018-10-08,17,269,1037,1306
67646,2018-10-08,18,242,933,1175
67647,2018-10-08,19,150,626,776
67648,2018-10-08,20,94,401,495
67649,2018-10-08,21,56,269,325
67650,2018-10-08,22,54,200,254
67651,2018-10-08,23,44,117,161
67652,2018-10-09,0,24,52,76
67653,2018-10-09,1,11,11,22
67654,2018-10-09,2,3,10,13
67655,2018-10-09,3,0,6,6
67656,2018-10-09,4,4,24,28
67657,2018-10-09,5,5,112,117
67658,2018-10-09,6,11,328,339
67659,2018-10-09,7,37,932,969
67660,2018-10-09,8,44,1236,1280
67661,2018-10-09,9,62,509,571
67662,2018-10-09,10,93,293,386
67663,2018-10-09,11,109,304,413
67664,2018-10-09,12,129,377,506
67665,2018-10-09,13,161,419,580
67666,2018-10-09,14,113,375,488
67667,2018-10-09,15,138,468,606
67668,2018-10-09,16,143,774,917
67669,2018-10-09,17,161,1418,1579
67670,2018-10-09,18,130,1134,1264
67671,2018-10-09,19,102,680,782
67672,2018-10-09,20,69,447,516
67673,2018-10-09,21,44,322,366
67674,2018-10-09,22,34,236,270
67675,2018-10-09,23,31,123,154
67676,2018-10-10,0,16,42,58
67677,2018-10-10,1,2,15,17
67678,2018-10-10,2,0,11,11
67679,2018-10-10,3,3,4,7
67680,2018-10-10,4,0,14,14
67681,2018-10-10,5,11,129,140
67682,2018-10-10,6,18,396,414
67683,2018-10-10,7,35,1003,1038
67684,2018-10-10,8,65,1330,1395
67685,2018-10-10,9,45,604,649
67686,2018-10-10,10,86,286,372
67687,2018-10-10,11,91,361,452
67688,2018-10-10,12,104,421,525
67689,2018-10-10,13,101,416,517
67690,2018-10-10,14,127,333,460
67691,2018-10-10,15,139,458,597
67692,2018-10-10,16,117,806,923
67693,2018-10-10,17,195,1525,1720
67694,2018-10-10,18,145,1311,1456
67695,2018-10-10,19,117,747,864
67696,2018-10-10,20,56,515,571
67697,2018-10-10,21,64,372,436
67698,2018-10-10,22,36,208,244
67699,2018-10-10,23,41,149,190
67700,2018-10-11,0,23,57,80
67701,2018-10-11,1,5,23,28
67702,2018-10-11,2,2,11,13
67703,2018-10-11,3,0,2,2
67704,2018-10-11,4,1,22,23
67705,2018-10-11,5,7,120,127
67706,2018-10-11,6,5,187,192
67707,2018-10-11,7,6,450,456
67708,2018-10-11,8,34,1115,1149
67709,2018-10-11,9,44,544,588
67710,2018-10-11,10,50,308,358
67711,2018-10-11,11,75,357,432
67712,2018-10-11,12,64,436,500
67713,2018-10-11,13,83,425,508
67714,2018-10-11,14,73,288,361
67715,2018-10-11,15,63,416,479
67716,2018-10-11,16,49,576,625
67717,2018-10-11,17,39,456,495
67718,2018-10-11,18,7,223,230
67719,2018-10-11,19,11,101,112
67720,2018-10-11,20,2,82,84
67721,2018-10-11,21,2,42,44
67722,2018-10-11,22,3,46,49
67723,2018-10-11,23,0,37,37
67724,2018-10-12,0,6,32,38
67725,2018-10-12,1,4,19,23
67726,2018-10-12,2,3,17,20
67727,2018-10-12,3,3,4,7
67728,2018-10-12,4,0,18,18
67729,2018-10-12,5,7,82,89
67730,2018-10-12,6,14,288,302
67731,2018-10-12,7,19,807,826
67732,2018-10-12,8,49,1066,1115
67733,2018-10-12,9,72,532,604
67734,2018-10-12,10,121,313,434
67735,2018-10-12,11,125,429,554
67736,2018-10-12,12,156,522,678
67737,2018-10-12,13,208,540,748
67738,2018-10-12,14,208,498,706
67739,2018-10-12,15,218,649,867
67740,2018-10-12,16,262,956,1218
67741,2018-10-12,17,225,1467,1692
67742,2018-10-12,18,163,1039,1202
67743,2018-10-12,19,90,620,710
67744,2018-10-12,20,105,392,497
67745,2018-10-12,21,84,294,378
67746,2018-10-12,22,32,245,277
67747,2018-10-12,23,46,170,216
67748,2018-10-13,0,29,113,142
67749,2018-10-13,1,26,93,119
67750,2018-10-13,2,27,57,84
67751,2018-10-13,3,4,29,33
67752,2018-10-13,4,0,12,12
67753,2018-10-13,5,1,21,22
67754,2018-10-13,6,3,25,28
67755,2018-10-13,7,11,105,116
67756,2018-10-13,8,20,240,260
67757,2018-10-13,9,75,425,500
67758,2018-10-13,10,182,531,713
67759,2018-10-13,11,169,584,753
67760,2018-10-13,12,229,732,961
67761,2018-10-13,13,312,693,1005
67762,2018-10-13,14,339,733,1072
67763,2018-10-13,15,328,716,1044
67764,2018-10-13,16,313,651,964
67765,2018-10-13,17,285,667,952
67766,2018-10-13,18,217,566,783
67767,2018-10-13,19,131,445,576
67768,2018-10-13,20,84,264,348
67769,2018-10-13,21,104,226,330
67770,2018-10-13,22,60,199,259
67771,2018-10-13,23,47,165,212
67772,2018-10-14,0,32,125,157
67773,2018-10-14,1,23,83,106
67774,2018-10-14,2,12,45,57
67775,2018-10-14,3,8,18,26
67776,2018-10-14,4,3,12,15
67777,2018-10-14,5,1,11,12
67778,2018-10-14,6,3,25,28
67779,2018-10-14,7,10,75,85
67780,2018-10-14,8,42,174,216
67781,2018-10-14,9,97,343,440
67782,2018-10-14,10,110,359,469
67783,2018-10-14,11,59,313,372
67784,2018-10-14,12,126,458,584
67785,2018-10-14,13,166,524,690
67786,2018-10-14,14,196,552,748
67787,2018-10-14,15,239,510,749
67788,2018-10-14,16,206,563,769
67789,2018-10-14,17,193,545,738
67790,2018-10-14,18,135,456,591
67791,2018-10-14,19,103,306,409
67792,2018-10-14,20,41,233,274
67793,2018-10-14,21,63,167,230
67794,2018-10-14,22,38,118,156
67795,2018-10-14,23,24,93,117
67796,2018-10-15,0,11,37,48
67797,2018-10-15,1,13,9,22
67798,2018-10-15,2,14,7,21
67799,2018-10-15,3,1,7,8
67800,2018-10-15,4,1,13,14
67801,2018-10-15,5,2,47,49
67802,2018-10-15,6,4,121,125
67803,2018-10-15,7,4,299,303
67804,2018-10-15,8,13,425,438
67805,2018-10-15,9,22,369,391
67806,2018-10-15,10,52,228,280
67807,2018-10-15,11,55,283,338
67808,2018-10-15,12,85,375,460
67809,2018-10-15,13,74,336,410
67810,2018-10-15,14,93,269,362
67811,2018-10-15,15,79,377,456
67812,2018-10-15,16,79,625,704
67813,2018-10-15,17,105,1236,1341
67814,2018-10-15,18,90,1003,1093
67815,2018-10-15,19,48,548,596
67816,2018-10-15,20,41,362,403
67817,2018-10-15,21,28,325,353
67818,2018-10-15,22,19,169,188
67819,2018-10-15,23,24,92,116
67820,2018-10-16,0,7,46,53
67821,2018-10-16,1,5,24,29
67822,2018-10-16,2,2,8,10
67823,2018-10-16,3,2,10,12
67824,2018-10-16,4,1,16,17
67825,2018-10-16,5,6,97,103
67826,2018-10-16,6,17,371,388
67827,2018-10-16,7,18,906,924
67828,2018-10-16,8,43,1326,1369
67829,2018-10-16,9,42,565,607
67830,2018-10-16,10,43,265,308
67831,2018-10-16,11,83,273,356
67832,2018-10-16,12,73,370,443
67833,2018-10-16,13,62,353,415
67834,2018-10-16,14,78,337,415
67835,2018-10-16,15,133,493,626
67836,2018-10-16,16,123,800,923
67837,2018-10-16,17,133,1520,1653
67838,2018-10-16,18,95,1124,1219
67839,2018-10-16,19,54,676,730
67840,2018-10-16,20,39,427,466
67841,2018-10-16,21,33,320,353
67842,2018-10-16,22,27,176,203
67843,2018-10-16,23,9,110,119
67844,2018-10-17,0,6,56,62
67845,2018-10-17,1,2,22,24
67846,2018-10-17,2,1,9,10
67847,2018-10-17,3,0,2,2
67848,2018-10-17,4,2,12,14
67849,2018-10-17,5,7,103,110
67850,2018-10-17,6,15,367,382
67851,2018-10-17,7,30,939,969
67852,2018-10-17,8,41,1336,1377
67853,2018-10-17,9,54,545,599
67854,2018-10-17,10,78,289,367
67855,2018-10-17,11,87,317,404
67856,2018-10-17,12,95,430,525
67857,2018-10-17,13,95,386,481
67858,2018-10-17,14,115,393,508
67859,2018-10-17,15,116,533,649
67860,2018-10-17,16,134,864,998
67861,2018-10-17,17,173,1503,1676
67862,2018-10-17,18,120,1217,1337
67863,2018-10-17,19,56,676,732
67864,2018-10-17,20,48,474,522
67865,2018-10-17,21,26,402,428
67866,2018-10-17,22,47,274,321
67867,2018-10-17,23,19,125,144
67868,2018-10-18,0,8,41,49
67869,2018-10-18,1,0,26,26
67870,2018-10-18,2,3,10,13
67871,2018-10-18,3,1,4,5
67872,2018-10-18,4,0,11,11
67873,2018-10-18,5,4,90,94
67874,2018-10-18,6,10,315,325
67875,2018-10-18,7,17,792,809
67876,2018-10-18,8,37,1250,1287
67877,2018-10-18,9,43,532,575
67878,2018-10-18,10,62,292,354
67879,2018-10-18,11,85,308,393
67880,2018-10-18,12,107,357,464
67881,2018-10-18,13,120,361,481
67882,2018-10-18,14,103,400,503
67883,2018-10-18,15,145,480,625
67884,2018-10-18,16,149,785,934
67885,2018-10-18,17,159,1363,1522
67886,2018-10-18,18,104,1126,1230
67887,2018-10-18,19,52,623,675
67888,2018-10-18,20,48,394,442
67889,2018-10-18,21,22,307,329
67890,2018-10-18,22,23,243,266
67891,2018-10-18,23,23,144,167
67892,2018-10-19,0,10,65,75
67893,2018-10-19,1,8,39,47
67894,2018-10-19,2,2,12,14
67895,2018-10-19,3,1,3,4
67896,2018-10-19,4,1,12,13
67897,2018-10-19,5,5,68,73
67898,2018-10-19,6,7,271,278
67899,2018-10-19,7,33,672,705
67900,2018-10-19,8,32,1111,1143
67901,2018-10-19,9,52,545,597
67902,2018-10-19,10,91,304,395
67903,2018-10-19,11,123,370,493
67904,2018-10-19,12,144,495,639
67905,2018-10-19,13,157,501,658
67906,2018-10-19,14,192,492,684
67907,2018-10-19,15,222,574,796
67908,2018-10-19,16,181,934,1115
67909,2018-10-19,17,204,1244,1448
67910,2018-10-19,18,106,897,1003
67911,2018-10-19,19,53,559,612
67912,2018-10-19,20,60,343,403
67913,2018-10-19,21,48,269,317
67914,2018-10-19,22,50,211,261
67915,2018-10-19,23,30,156,186
67916,2018-10-20,0,10,60,70
67917,2018-10-20,1,19,68,87
67918,2018-10-20,2,5,45,50
67919,2018-10-20,3,0,6,6
67920,2018-10-20,4,0,10,10
67921,2018-10-20,5,1,14,15
67922,2018-10-20,6,5,41,46
67923,2018-10-20,7,18,138,156
67924,2018-10-20,8,38,272,310
67925,2018-10-20,9,89,448,537
67926,2018-10-20,10,160,554,714
67927,2018-10-20,11,195,598,793
67928,2018-10-20,12,281,647,928
67929,2018-10-20,13,324,657,981
67930,2018-10-20,14,331,702,1033
67931,2018-10-20,15,405,671,1076
67932,2018-10-20,16,372,725,1097
67933,2018-10-20,17,298,610,908
67934,2018-10-20,18,209,585,794
67935,2018-10-20,19,129,423,552
67936,2018-10-20,20,107,296,403
67937,2018-10-20,21,102,285,387
67938,2018-10-20,22,40,213,253
67939,2018-10-20,23,27,155,182
67940,2018-10-21,0,19,109,128
67941,2018-10-21,1,23,90,113
67942,2018-10-21,2,18,60,78
67943,2018-10-21,3,14,25,39
67944,2018-10-21,4,2,9,11
67945,2018-10-21,5,2,10,12
67946,2018-10-21,6,2,33,35
67947,2018-10-21,7,15,58,73
67948,2018-10-21,8,34,196,230
67949,2018-10-21,9,68,260,328
67950,2018-10-21,10,121,413,534
67951,2018-10-21,11,144,507,651
67952,2018-10-21,12,171,574,745
67953,2018-10-21,13,137,515,652
67954,2018-10-21,14,168,537,705
67955,2018-10-21,15,193,520,713
67956,2018-10-21,16,168,499,667
67957,2018-10-21,17,148,512,660
67958,2018-10-21,18,86,361,447
67959,2018-10-21,19,56,287,343
67960,2018-10-21,20,41,177,218
67961,2018-10-21,21,22,109,131
67962,2018-10-21,22,18,96,114
67963,2018-10-21,23,20,58,78
67964,2018-10-22,0,12,23,35
67965,2018-10-22,1,13,13,26
67966,2018-10-22,2,12,6,18
67967,2018-10-22,3,0,4,4
67968,2018-10-22,4,2,14,16
67969,2018-10-22,5,2,74,76
67970,2018-10-22,6,7,260,267
67971,2018-10-22,7,12,665,677
67972,2018-10-22,8,28,950,978
67973,2018-10-22,9,56,479,535
67974,2018-10-22,10,68,238,306
67975,2018-10-22,11,95,248,343
67976,2018-10-22,12,80,343,423
67977,2018-10-22,13,91,373,464
67978,2018-10-22,14,117,324,441
67979,2018-10-22,15,114,455,569
67980,2018-10-22,16,119,768,887
67981,2018-10-22,17,150,1347,1497
67982,2018-10-22,18,88,1032,1120
67983,2018-10-22,19,48,535,583
67984,2018-10-22,20,31,353,384
67985,2018-10-22,21,32,278,310
67986,2018-10-22,22,8,136,144
67987,2018-10-22,23,14,83,97
67988,2018-10-23,0,8,40,48
67989,2018-10-23,1,2,12,14
67990,2018-10-23,2,2,8,10
67991,2018-10-23,3,0,2,2
67992,2018-10-23,4,1,17,18
67993,2018-10-23,5,3,109,112
67994,2018-10-23,6,10,324,334
67995,2018-10-23,7,22,788,810
67996,2018-10-23,8,56,1280,1336
67997,2018-10-23,9,50,518,568
67998,2018-10-23,10,79,251,330
67999,2018-10-23,11,74,283,357
68000,2018-10-23,12,82,440,522
68001,2018-10-23,13,74,396,470
68002,2018-10-23,14,77,392,469
68003,2018-10-23,15,111,508,619
68004,2018-10-23,16,122,911,1033
68005,2018-10-23,17,148,1522,1670
68006,2018-10-23,18,97,1161,1258
68007,2018-10-23,19,60,647,707
68008,2018-10-23,20,47,372,419
68009,2018-10-23,21,27,282,309
68010,2018-10-23,22,16,192,208
68011,2018-10-23,23,10,96,106
68012,2018-10-24,0,6,48,54
68013,2018-10-24,1,3,16,19
68014,2018-10-24,2,0,6,6
68015,2018-10-24,3,0,5,5
68016,2018-10-24,4,1,14,15
68017,2018-10-24,5,6,114,120
68018,2018-10-24,6,8,331,339
68019,2018-10-24,7,19,857,876
68020,2018-10-24,8,41,1271,1312
68021,2018-10-24,9,64,574,638
68022,2018-10-24,10,48,299,347
68023,2018-10-24,11,65,292,357
68024,2018-10-24,12,66,387,453
68025,2018-10-24,13,69,350,419
68026,2018-10-24,14,84,323,407
68027,2018-10-24,15,84,476,560
68028,2018-10-24,16,119,713,832
68029,2018-10-24,17,92,1326,1418
68030,2018-10-24,18,64,988,1052
68031,2018-10-24,19,46,629,675
68032,2018-10-24,20,38,406,444
68033,2018-10-24,21,28,317,345
68034,2018-10-24,22,22,185,207
68035,2018-10-24,23,13,87,100
68036,2018-10-25,0,5,32,37
68037,2018-10-25,1,0,18,18
68038,2018-10-25,2,0,7,7
68039,2018-10-25,3,1,7,8
68040,2018-10-25,4,0,12,12
68041,2018-10-25,5,3,75,78
68042,2018-10-25,6,7,300,307
68043,2018-10-25,7,11,718,729
68044,2018-10-25,8,27,1106,1133
68045,2018-10-25,9,45,558,603
68046,2018-10-25,10,57,258,315
68047,2018-10-25,11,62,261,323
68048,2018-10-25,12,91,382,473
68049,2018-10-25,13,81,376,457
68050,2018-10-25,14,94,344,438
68051,2018-10-25,15,111,446,557
68052,2018-10-25,16,116,708,824
68053,2018-10-25,17,115,1206,1321
68054,2018-10-25,18,76,963,1039
68055,2018-10-25,19,57,531,588
68056,2018-10-25,20,37,376,413
68057,2018-10-25,21,21,286,307
68058,2018-10-25,22,11,205,216
68059,2018-10-25,23,15,120,135
68060,2018-10-26,0,9,66,75
68061,2018-10-26,1,7,27,34
68062,2018-10-26,2,2,18,20
68063,2018-10-26,3,2,7,9
68064,2018-10-26,4,2,19,21
68065,2018-10-26,5,1,103,104
68066,2018-10-26,6,7,257,264
68067,2018-10-26,7,9,647,656
68068,2018-10-26,8,33,1128,1161
68069,2018-10-26,9,58,550,608
68070,2018-10-26,10,53,269,322
68071,2018-10-26,11,72,356,428
68072,2018-10-26,12,79,399,478
68073,2018-10-26,13,92,407,499
68074,2018-10-26,14,58,325,383
68075,2018-10-26,15,86,406,492
68076,2018-10-26,16,69,577,646
68077,2018-10-26,17,64,623,687
68078,2018-10-26,18,19,305,324
68079,2018-10-26,19,5,93,98
68080,2018-10-26,20,4,52,56
68081,2018-10-26,21,4,56,60
68082,2018-10-26,22,1,23,24
68083,2018-10-26,23,2,29,31
68084,2018-10-27,0,2,28,30
68085,2018-10-27,1,4,33,37
68086,2018-10-27,2,2,19,21
68087,2018-10-27,3,1,10,11
68088,2018-10-27,4,0,3,3
68089,2018-10-27,5,0,8,8
68090,2018-10-27,6,0,17,17
68091,2018-10-27,7,4,59,63
68092,2018-10-27,8,3,59,62
68093,2018-10-27,9,5,80,85
68094,2018-10-27,10,8,118,126
68095,2018-10-27,11,16,210,226
68096,2018-10-27,12,18,200,218
68097,2018-10-27,13,41,240,281
68098,2018-10-27,14,56,356,412
68099,2018-10-27,15,95,385,480
68100,2018-10-27,16,137,403,540
68101,2018-10-27,17,112,422,534
68102,2018-10-27,18,79,374,453
68103,2018-10-27,19,46,278,324
68104,2018-10-27,20,44,187,231
68105,2018-10-27,21,40,198,238
68106,2018-10-27,22,30,143,173
68107,2018-10-27,23,31,119,150
68108,2018-10-28,0,20,92,112
68109,2018-10-28,1,30,94,124
68110,2018-10-28,2,13,78,91
68111,2018-10-28,3,7,22,29
68112,2018-10-28,4,1,7,8
68113,2018-10-28,5,1,21,22
68114,2018-10-28,6,12,50,62
68115,2018-10-28,7,30,114,144
68116,2018-10-28,8,73,216,289
68117,2018-10-28,9,121,322,443
68118,2018-10-28,10,141,483,624
68119,2018-10-28,11,204,526,730
68120,2018-10-28,12,176,585,761
68121,2018-10-28,13,216,520,736
68122,2018-10-28,14,182,585,767
68123,2018-10-28,15,241,595,836
68124,2018-10-28,16,189,615,804
68125,2018-10-28,17,149,565,714
68126,2018-10-28,18,95,390,485
68127,2018-10-28,19,30,205,235
68128,2018-10-28,20,25,152,177
68129,2018-10-28,21,35,145,180
68130,2018-10-28,22,36,105,141
68131,2018-10-28,23,11,54,65
68132,2018-10-29,0,2,20,22
68133,2018-10-29,1,0,28,28
68134,2018-10-29,2,0,8,8
68135,2018-10-29,3,0,7,7
68136,2018-10-29,4,0,19,19
68137,2018-10-29,5,4,85,89
68138,2018-10-29,6,6,309,315
68139,2018-10-29,7,18,701,719
68140,2018-10-29,8,31,1009,1040
68141,2018-10-29,9,39,460,499
68142,2018-10-29,10,63,255,318
68143,2018-10-29,11,57,262,319
68144,2018-10-29,12,81,364,445
68145,2018-10-29,13,75,262,337
68146,2018-10-29,14,99,333,432
68147,2018-10-29,15,103,459,562
68148,2018-10-29,16,70,694,764
68149,2018-10-29,17,102,1352,1454
68150,2018-10-29,18,54,936,990
68151,2018-10-29,19,41,545,586
68152,2018-10-29,20,40,365,405
68153,2018-10-29,21,19,236,255
68154,2018-10-29,22,15,156,171
68155,2018-10-29,23,12,68,80
68156,2018-10-30,0,7,28,35
68157,2018-10-30,1,3,13,16
68158,2018-10-30,2,1,3,4
68159,2018-10-30,3,0,8,8
68160,2018-10-30,4,0,16,16
68161,2018-10-30,5,6,106,112
68162,2018-10-30,6,5,322,327
68163,2018-10-30,7,17,792,809
68164,2018-10-30,8,28,1179,1207
68165,2018-10-30,9,31,540,571
68166,2018-10-30,10,54,274,328
68167,2018-10-30,11,70,354,424
68168,2018-10-30,12,69,392,461
68169,2018-10-30,13,81,425,506
68170,2018-10-30,14,73,371,444
68171,2018-10-30,15,87,506,593
68172,2018-10-30,16,121,832,953
68173,2018-10-30,17,108,1533,1641
68174,2018-10-30,18,65,1059,1124
68175,2018-10-30,19,47,611,658
68176,2018-10-30,20,31,400,431
68177,2018-10-30,21,35,324,359
68178,2018-10-30,22,10,212,222
68179,2018-10-30,23,17,98,115
68180,2018-10-31,0,9,52,61
68181,2018-10-31,1,3,14,17
68182,2018-10-31,2,0,5,5
68183,2018-10-31,3,0,7,7
68184,2018-10-31,4,1,12,13
68185,2018-10-31,5,3,105,108
68186,2018-10-31,6,8,354,362
68187,2018-10-31,7,15,773,788
68188,2018-10-31,8,25,1216,1241
68189,2018-10-31,9,40,534,574
68190,2018-10-31,10,46,312,358
68191,2018-10-31,11,73,303,376
68192,2018-10-31,12,77,384,461
68193,2018-10-31,13,72,382,454
68194,2018-10-31,14,85,455,540
68195,2018-10-31,15,116,561,677
68196,2018-10-31,16,108,955,1063
68197,2018-10-31,17,111,1402,1513
68198,2018-10-31,18,69,926,995
68199,2018-10-31,19,39,557,596
68200,2018-10-31,20,47,367,414
68201,2018-10-31,21,44,308,352
68202,2018-10-31,22,29,247,276
68203,2018-10-31,23,18,126,144
68204,2018-11-01,0,13,69,82
68205,2018-11-01,1,9,34,43
68206,2018-11-01,2,1,16,17
68207,2018-11-01,3,1,3,4
68208,2018-11-01,4,2,16,18
68209,2018-11-01,5,5,81,86
68210,2018-11-01,6,7,324,331
68211,2018-11-01,7,17,782,799
68212,2018-11-01,8,40,1337,1377
68213,2018-11-01,9,41,596,637
68214,2018-11-01,10,41,301,342
68215,2018-11-01,11,69,348,417
68216,2018-11-01,12,79,431,510
68217,2018-11-01,13,84,461,545
68218,2018-11-01,14,97,420,517
68219,2018-11-01,15,141,536,677
68220,2018-11-01,16,133,856,989
68221,2018-11-01,17,168,1470,1638
68222,2018-11-01,18,93,1104,1197
68223,2018-11-01,19,71,648,719
68224,2018-11-01,20,45,395,440
68225,2018-11-01,21,44,321,365
68226,2018-11-01,22,44,243,287
68227,2018-11-01,23,83,311,394
68228,2018-11-02,0,33,91,124
68229,2018-11-02,1,20,45,65
68230,2018-11-02,2,10,22,32
68231,2018-11-02,3,2,6,8
68232,2018-11-02,4,11,11,22
68233,2018-11-02,5,6,86,92
68234,2018-11-02,6,6,311,317
68235,2018-11-02,7,9,707,716
68236,2018-11-02,8,45,1258,1303
68237,2018-11-02,9,66,649,715
68238,2018-11-02,10,72,309,381
68239,2018-11-02,11,97,432,529
68240,2018-11-02,12,109,474,583
68241,2018-11-02,13,154,495,649
68242,2018-11-02,14,135,484,619
68243,2018-11-02,15,143,575,718
68244,2018-11-02,16,161,869,1030
68245,2018-11-02,17,86,960,1046
68246,2018-11-02,18,22,420,442
68247,2018-11-02,19,18,249,267
68248,2018-11-02,20,23,216,239
68249,2018-11-02,21,11,75,86
68250,2018-11-02,22,4,25,29
68251,2018-11-02,23,11,82,93
68252,2018-11-03,0,11,68,79
68253,2018-11-03,1,16,72,88
68254,2018-11-03,2,4,40,44
68255,2018-11-03,3,1,16,17
68256,2018-11-03,4,0,5,5
68257,2018-11-03,5,4,8,12
68258,2018-11-03,6,2,37,39
68259,2018-11-03,7,8,99,107
68260,2018-11-03,8,40,246,286
68261,2018-11-03,9,69,383,452
68262,2018-11-03,10,138,429,567
68263,2018-11-03,11,177,573,750
68264,2018-11-03,12,220,558,778
68265,2018-11-03,13,267,625,892
68266,2018-11-03,14,257,568,825
68267,2018-11-03,15,270,622,892
68268,2018-11-03,16,238,605,843
68269,2018-11-03,17,215,522,737
68270,2018-11-03,18,135,411,546
68271,2018-11-03,19,75,311,386
68272,2018-11-03,20,62,227,289
68273,2018-11-03,21,58,169,227
68274,2018-11-03,22,54,159,213
68275,2018-11-03,23,49,157,206
68276,2018-11-04,0,21,91,112
68277,2018-11-04,1,13,47,60
68278,2018-11-04,2,6,27,33
68279,2018-11-04,3,1,11,12
68280,2018-11-04,4,0,10,10
68281,2018-11-04,5,6,19,25
68282,2018-11-04,6,5,33,38
68283,2018-11-04,7,13,85,98
68284,2018-11-04,8,43,267,310
68285,2018-11-04,9,95,383,478
68286,2018-11-04,10,164,490,654
68287,2018-11-04,11,219,617,836
68288,2018-11-04,12,252,772,1024
68289,2018-11-04,13,261,682,943
68290,2018-11-04,14,276,607,883
68291,2018-11-04,15,272,612,884
68292,2018-11-04,16,252,616,868
68293,2018-11-04,17,109,476,585
68294,2018-11-04,18,70,327,397
68295,2018-11-04,19,35,189,224
68296,2018-11-04,20,43,177,220
68297,2018-11-04,21,29,138,167
68298,2018-11-04,22,24,100,124
68299,2018-11-04,23,21,76,97
68300,2018-11-05,0,6,22,28
68301,2018-11-05,1,8,20,28
68302,2018-11-05,2,9,5,14
68303,2018-11-05,3,1,1,2
68304,2018-11-05,4,4,13,17
68305,2018-11-05,5,1,22,23
68306,2018-11-05,6,0,77,77
68307,2018-11-05,7,3,189,192
68308,2018-11-05,8,10,236,246
68309,2018-11-05,9,5,74,79
68310,2018-11-05,10,6,45,51
68311,2018-11-05,11,12,130,142
68312,2018-11-05,12,25,182,207
68313,2018-11-05,13,29,192,221
68314,2018-11-05,14,19,178,197
68315,2018-11-05,15,31,203,234
68316,2018-11-05,16,25,392,417
68317,2018-11-05,17,29,673,702
68318,2018-11-05,18,15,510,525
68319,2018-11-05,19,18,352,370
68320,2018-11-05,20,16,227,243
68321,2018-11-05,21,17,166,183
68322,2018-11-05,22,6,110,116
68323,2018-11-05,23,11,74,85
68324,2018-11-06,0,2,19,21
68325,2018-11-06,1,9,6,15
68326,2018-11-06,2,1,7,8
68327,2018-11-06,3,1,3,4
68328,2018-11-06,4,1,14,15
68329,2018-11-06,5,3,89,92
68330,2018-11-06,6,4,245,249
68331,2018-11-06,7,12,386,398
68332,2018-11-06,8,4,155,159
68333,2018-11-06,9,6,129,135
68334,2018-11-06,10,3,76,79
68335,2018-11-06,11,8,57,65
68336,2018-11-06,12,26,224,250
68337,2018-11-06,13,14,251,265
68338,2018-11-06,14,22,201,223
68339,2018-11-06,15,21,329,350
68340,2018-11-06,16,31,603,634
68341,2018-11-06,17,30,964,994
68342,2018-11-06,18,16,692,708
68343,2018-11-06,19,23,479,502
68344,2018-11-06,20,17,289,306
68345,2018-11-06,21,19,202,221
68346,2018-11-06,22,17,175,192
68347,2018-11-06,23,8,130,138
68348,2018-11-07,0,4,59,63
68349,2018-11-07,1,0,17,17
68350,2018-11-07,2,1,12,13
68351,2018-11-07,3,0,6,6
68352,2018-11-07,4,2,15,17
68353,2018-11-07,5,6,103,109
68354,2018-11-07,6,5,306,311
68355,2018-11-07,7,19,776,795
68356,2018-11-07,8,25,1108,1133
68357,2018-11-07,9,31,486,517
68358,2018-11-07,10,34,278,312
68359,2018-11-07,11,71,334,405
68360,2018-11-07,12,58,382,440
68361,2018-11-07,13,63,361,424
68362,2018-11-07,14,63,370,433
68363,2018-11-07,15,56,465,521
68364,2018-11-07,16,60,730,790
68365,2018-11-07,17,76,1189,1265
68366,2018-11-07,18,44,827,871
68367,2018-11-07,19,31,494,525
68368,2018-11-07,20,30,303,333
68369,2018-11-07,21,30,252,282
68370,2018-11-07,22,16,204,220
68371,2018-11-07,23,21,94,115
68372,2018-11-08,0,2,40,42
68373,2018-11-08,1,1,16,17
68374,2018-11-08,2,1,9,10
68375,2018-11-08,3,2,5,7
68376,2018-11-08,4,2,6,8
68377,2018-11-08,5,2,88,90
68378,2018-11-08,6,17,321,338
68379,2018-11-08,7,21,798,819
68380,2018-11-08,8,34,1152,1186
68381,2018-11-08,9,19,527,546
68382,2018-11-08,10,45,267,312
68383,2018-11-08,11,56,327,383
68384,2018-11-08,12,65,448,513
68385,2018-11-08,13,83,424,507
68386,2018-11-08,14,98,395,493
68387,2018-11-08,15,107,474,581
68388,2018-11-08,16,75,790,865
68389,2018-11-08,17,73,1177,1250
68390,2018-11-08,18,42,852,894
68391,2018-11-08,19,32,493,525
68392,2018-11-08,20,33,354,387
68393,2018-11-08,21,37,244,281
68394,2018-11-08,22,23,195,218
68395,2018-11-08,23,14,129,143
68396,2018-11-09,0,16,76,92
68397,2018-11-09,1,4,28,32
68398,2018-11-09,2,1,9,10
68399,2018-11-09,3,1,10,11
68400,2018-11-09,4,3,7,10
68401,2018-11-09,5,4,88,92
68402,2018-11-09,6,4,198,202
68403,2018-11-09,7,10,409,419
68404,2018-11-09,8,21,910,931
68405,2018-11-09,9,31,485,516
68406,2018-11-09,10,39,258,297
68407,2018-11-09,11,47,207,254
68408,2018-11-09,12,34,184,218
68409,2018-11-09,13,14,132,146
68410,2018-11-09,14,5,58,63
68411,2018-11-09,15,12,139,151
68412,2018-11-09,16,28,290,318
68413,2018-11-09,17,20,348,368
68414,2018-11-09,18,26,335,361
68415,2018-11-09,19,15,231,246
68416,2018-11-09,20,11,176,187
68417,2018-11-09,21,16,162,178
68418,2018-11-09,22,23,130,153
68419,2018-11-09,23,33,142,175
68420,2018-11-10,0,9,68,77
68421,2018-11-10,1,11,56,67
68422,2018-11-10,2,9,34,43
68423,2018-11-10,3,5,20,25
68424,2018-11-10,4,2,7,9
68425,2018-11-10,5,1,21,22
68426,2018-11-10,6,4,31,35
68427,2018-11-10,7,12,99,111
68428,2018-11-10,8,17,195,212
68429,2018-11-10,9,39,323,362
68430,2018-11-10,10,72,376,448
68431,2018-11-10,11,123,400,523
68432,2018-11-10,12,138,425,563
68433,2018-11-10,13,102,416,518
68434,2018-11-10,14,136,436,572
68435,2018-11-10,15,155,438,593
68436,2018-11-10,16,86,391,477
68437,2018-11-10,17,60,326,386
68438,2018-11-10,18,22,263,285
68439,2018-11-10,19,35,197,232
68440,2018-11-10,20,25,132,157
68441,2018-11-10,21,25,117,142
68442,2018-11-10,22,14,91,105
68443,2018-11-10,23,17,100,117
68444,2018-11-11,0,10,69,79
68445,2018-11-11,1,8,59,67
68446,2018-11-11,2,4,36,40
68447,2018-11-11,3,1,14,15
68448,2018-11-11,4,0,7,7
68449,2018-11-11,5,2,6,8
68450,2018-11-11,6,4,30,34
68451,2018-11-11,7,11,73,84
68452,2018-11-11,8,23,135,158
68453,2018-11-11,9,41,259,300
68454,2018-11-11,10,97,372,469
68455,2018-11-11,11,121,408,529
68456,2018-11-11,12,133,447,580
68457,2018-11-11,13,191,461,652
68458,2018-11-11,14,174,460,634
68459,2018-11-11,15,161,462,623
68460,2018-11-11,16,118,456,574
68461,2018-11-11,17,71,317,388
68462,2018-11-11,18,21,269,290
68463,2018-11-11,19,30,219,249
68464,2018-11-11,20,17,175,192
68465,2018-11-11,21,15,115,130
68466,2018-11-11,22,17,99,116
68467,2018-11-11,23,12,88,100
68468,2018-11-12,0,14,32,46
68469,2018-11-12,1,5,22,27
68470,2018-11-12,2,1,6,7
68471,2018-11-12,3,1,4,5
68472,2018-11-12,4,0,16,16
68473,2018-11-12,5,2,41,43
68474,2018-11-12,6,10,123,133
68475,2018-11-12,7,10,288,298
68476,2018-11-12,8,21,545,566
68477,2018-11-12,9,36,419,455
68478,2018-11-12,10,44,271,315
68479,2018-11-12,11,62,360,422
68480,2018-11-12,12,83,369,452
68481,2018-11-12,13,84,358,442
68482,2018-11-12,14,93,415,508
68483,2018-11-12,15,108,408,516
68484,2018-11-12,16,69,482,551
68485,2018-11-12,17,13,264,277
68486,2018-11-12,18,5,104,109
68487,2018-11-12,19,4,84,88
68488,2018-11-12,20,3,65,68
68489,2018-11-12,21,6,54,60
68490,2018-11-12,22,2,23,25
68491,2018-11-12,23,2,13,15
68492,2018-11-13,0,1,6,7
68493,2018-11-13,1,1,8,9
68494,2018-11-13,2,0,1,1
68495,2018-11-13,3,0,1,1
68496,2018-11-13,4,0,4,4
68497,2018-11-13,5,0,43,43
68498,2018-11-13,6,2,180,182
68499,2018-11-13,7,12,509,521
68500,2018-11-13,8,30,738,768
68501,2018-11-13,9,23,353,376
68502,2018-11-13,10,16,199,215
68503,2018-11-13,11,18,174,192
68504,2018-11-13,12,34,233,267
68505,2018-11-13,13,23,241,264
68506,2018-11-13,14,33,206,239
68507,2018-11-13,15,23,266,289
68508,2018-11-13,16,11,480,491
68509,2018-11-13,17,28,877,905
68510,2018-11-13,18,18,731,749
68511,2018-11-13,19,30,442,472
68512,2018-11-13,20,25,341,366
68513,2018-11-13,21,19,237,256
68514,2018-11-13,22,6,142,148
68515,2018-11-13,23,11,88,99
68516,2018-11-14,0,6,29,35
68517,2018-11-14,1,0,14,14
68518,2018-11-14,2,3,6,9
68519,2018-11-14,3,0,5,5
68520,2018-11-14,4,2,9,11
68521,2018-11-14,5,4,79,83
68522,2018-11-14,6,5,299,304
68523,2018-11-14,7,12,712,724
68524,2018-11-14,8,23,971,994
68525,2018-11-14,9,19,481,500
68526,2018-11-14,10,19,211,230
68527,2018-11-14,11,24,210,234
68528,2018-11-14,12,33,265,298
68529,2018-11-14,13,26,276,302
68530,2018-11-14,14,33,249,282
68531,2018-11-14,15,40,343,383
68532,2018-11-14,16,52,565,617
68533,2018-11-14,17,48,945,993
68534,2018-11-14,18,29,739,768
68535,2018-11-14,19,16,415,431
68536,2018-11-14,20,10,328,338
68537,2018-11-14,21,10,227,237
68538,2018-11-14,22,8,154,162
68539,2018-11-14,23,11,84,95
68540,2018-11-15,0,6,38,44
68541,2018-11-15,1,1,17,18
68542,2018-11-15,2,0,8,8
68543,2018-11-15,3,0,5,5
68544,2018-11-15,4,0,11,11
68545,2018-11-15,5,2,55,57
68546,2018-11-15,6,2,140,142
68547,2018-11-15,7,6,174,180
68548,2018-11-15,8,4,244,248
68549,2018-11-15,9,6,122,128
68550,2018-11-15,10,1,59,60
68551,2018-11-15,11,0,52,52
68552,2018-11-15,12,0,38,38
68553,2018-11-15,13,0,30,30
68554,2018-11-15,14,2,26,28
68555,2018-11-15,15,2,53,55
68556,2018-11-15,16,1,116,117
68557,2018-11-15,17,4,288,292
68558,2018-11-15,18,6,231,237
68559,2018-11-15,19,2,126,128
68560,2018-11-15,20,3,89,92
68561,2018-11-15,21,4,72,76
68562,2018-11-15,22,2,75,77
68563,2018-11-15,23,1,31,32
68564,2018-11-16,0,0,21,21
68565,2018-11-16,1,0,7,7
68566,2018-11-16,2,2,4,6
68567,2018-11-16,3,3,5,8
68568,2018-11-16,4,1,8,9
68569,2018-11-16,5,2,54,56
68570,2018-11-16,6,3,177,180
68571,2018-11-16,7,12,462,474
68572,2018-11-16,8,21,814,835
68573,2018-11-16,9,17,439,456
68574,2018-11-16,10,32,241,273
68575,2018-11-16,11,33,246,279
68576,2018-11-16,12,54,337,391
68577,2018-11-16,13,49,368,417
68578,2018-11-16,14,68,334,402
68579,2018-11-16,15,57,418,475
68580,2018-11-16,16,67,637,704
68581,2018-11-16,17,46,858,904
68582,2018-11-16,18,32,642,674
68583,2018-11-16,19,25,414,439
68584,2018-11-16,20,17,214,231
68585,2018-11-16,21,16,181,197
68586,2018-11-16,22,8,141,149
68587,2018-11-16,23,12,102,114
68588,2018-11-17,0,20,75,95
68589,2018-11-17,1,15,57,72
68590,2018-11-17,2,9,36,45
68591,2018-11-17,3,13,16,29
68592,2018-11-17,4,2,4,6
68593,2018-11-17,5,1,22,23
68594,2018-11-17,6,2,38,40
68595,2018-11-17,7,8,123,131
68596,2018-11-17,8,24,219,243
68597,2018-11-17,9,50,330,380
68598,2018-11-17,10,82,370,452
68599,2018-11-17,11,92,455,547
68600,2018-11-17,12,118,497,615
68601,2018-11-17,13,143,440,583
68602,2018-11-17,14,176,542,718
68603,2018-11-17,15,212,529,741
68604,2018-11-17,16,162,475,637
68605,2018-11-17,17,112,400,512
68606,2018-11-17,18,63,295,358
68607,2018-11-17,19,53,231,284
68608,2018-11-17,20,30,183,213
68609,2018-11-17,21,30,144,174
68610,2018-11-17,22,28,120,148
68611,2018-11-17,23,16,98,114
68612,2018-11-18,0,22,79,101
68613,2018-11-18,1,5,63,68
68614,2018-11-18,2,2,44,46
68615,2018-11-18,3,2,19,21
68616,2018-11-18,4,0,7,7
68617,2018-11-18,5,1,9,10
68618,2018-11-18,6,5,31,36
68619,2018-11-18,7,12,56,68
68620,2018-11-18,8,19,141,160
68621,2018-11-18,9,50,265,315
68622,2018-11-18,10,81,402,483
68623,2018-11-18,11,94,455,549
68624,2018-11-18,12,135,507,642
68625,2018-11-18,13,140,474,614
68626,2018-11-18,14,145,479,624
68627,2018-11-18,15,175,432,607
68628,2018-11-18,16,135,450,585
68629,2018-11-18,17,70,361,431
68630,2018-11-18,18,42,321,363
68631,2018-11-18,19,36,222,258
68632,2018-11-18,20,12,141,153
68633,2018-11-18,21,14,125,139
68634,2018-11-18,22,7,106,113
68635,2018-11-18,23,5,54,59
68636,2018-11-19,0,4,19,23
68637,2018-11-19,1,2,15,17
68638,2018-11-19,2,3,8,11
68639,2018-11-19,3,0,6,6
68640,2018-11-19,4,1,7,8
68641,2018-11-19,5,2,71,73
68642,2018-11-19,6,8,261,269
68643,2018-11-19,7,14,630,644
68644,2018-11-19,8,28,935,963
68645,2018-11-19,9,22,453,475
68646,2018-11-19,10,41,231,272
68647,2018-11-19,11,86,313,399
68648,2018-11-19,12,68,375,443
68649,2018-11-19,13,103,313,416
68650,2018-11-19,14,123,331,454
68651,2018-11-19,15,103,394,497
68652,2018-11-19,16,94,685,779
68653,2018-11-19,17,74,1049,1123
68654,2018-11-19,18,42,804,846
68655,2018-11-19,19,41,547,588
68656,2018-11-19,20,19,312,331
68657,2018-11-19,21,17,225,242
68658,2018-11-19,22,10,118,128
68659,2018-11-19,23,6,61,67
68660,2018-11-20,0,9,45,54
68661,2018-11-20,1,3,11,14
68662,2018-11-20,2,3,7,10
68663,2018-11-20,3,4,7,11
68664,2018-11-20,4,2,12,14
68665,2018-11-20,5,2,88,90
68666,2018-11-20,6,5,280,285
68667,2018-11-20,7,18,678,696
68668,2018-11-20,8,18,1013,1031
68669,2018-11-20,9,43,520,563
68670,2018-11-20,10,55,269,324
68671,2018-11-20,11,63,277,340
68672,2018-11-20,12,39,366,405
68673,2018-11-20,13,76,342,418
68674,2018-11-20,14,96,316,412
68675,2018-11-20,15,68,444,512
68676,2018-11-20,16,44,574,618
68677,2018-11-20,17,46,881,927
68678,2018-11-20,18,19,578,597
68679,2018-11-20,19,24,326,350
68680,2018-11-20,20,29,243,272
68681,2018-11-20,21,11,197,208
68682,2018-11-20,22,11,121,132
68683,2018-11-20,23,11,60,71
68684,2018-11-21,0,9,32,41
68685,2018-11-21,1,4,14,18
68686,2018-11-21,2,1,4,5
68687,2018-11-21,3,0,5,5
68688,2018-11-21,4,4,9,13
68689,2018-11-21,5,2,78,80
68690,2018-11-21,6,4,189,193
68691,2018-11-21,7,10,393,403
68692,2018-11-21,8,15,677,692
68693,2018-11-21,9,19,379,398
68694,2018-11-21,10,42,250,292
68695,2018-11-21,11,66,300,366
68696,2018-11-21,12,60,365,425
68697,2018-11-21,13,106,429,535
68698,2018-11-21,14,89,497,586
68699,2018-11-21,15,105,585,690
68700,2018-11-21,16,92,504,596
68701,2018-11-21,17,73,405,478
68702,2018-11-21,18,23,301,324
68703,2018-11-21,19,11,183,194
68704,2018-11-21,20,12,114,126
68705,2018-11-21,21,16,102,118
68706,2018-11-21,22,11,91,102
68707,2018-11-21,23,5,60,65
68708,2018-11-22,0,7,39,46
68709,2018-11-22,1,3,31,34
68710,2018-11-22,2,6,14,20
68711,2018-11-22,3,0,11,11
68712,2018-11-22,4,1,8,9
68713,2018-11-22,5,4,14,18
68714,2018-11-22,6,0,25,25
68715,2018-11-22,7,5,69,74
68716,2018-11-22,8,8,90,98
68717,2018-11-22,9,18,135,153
68718,2018-11-22,10,30,141,171
68719,2018-11-22,11,30,149,179
68720,2018-11-22,12,39,150,189
68721,2018-11-22,13,43,142,185
68722,2018-11-22,14,34,106,140
68723,2018-11-22,15,32,116,148
68724,2018-11-22,16,42,84,126
68725,2018-11-22,17,22,40,62
68726,2018-11-22,18,6,46,52
68727,2018-11-22,19,4,46,50
68728,2018-11-22,20,7,36,43
68729,2018-11-22,21,5,28,33
68730,2018-11-22,22,4,40,44
68731,2018-11-22,23,2,21,23
68732,2018-11-23,0,0,12,12
68733,2018-11-23,1,2,2,4
68734,2018-11-23,2,0,6,6
68735,2018-11-23,3,0,3,3
68736,2018-11-23,4,1,5,6
68737,2018-11-23,5,0,13,13
68738,2018-11-23,6,1,41,42
68739,2018-11-23,7,5,78,83
68740,2018-11-23,8,8,114,122
68741,2018-11-23,9,25,112,137
68742,2018-11-23,10,36,135,171
68743,2018-11-23,11,34,143,177
68744,2018-11-23,12,46,146,192
68745,2018-11-23,13,49,168,217
68746,2018-11-23,14,71,182,253
68747,2018-11-23,15,49,189,238
68748,2018-11-23,16,65,221,286
68749,2018-11-23,17,42,183,225
68750,2018-11-23,18,27,132,159
68751,2018-11-23,19,10,111,121
68752,2018-11-23,20,18,71,89
68753,2018-11-23,21,9,82,91
68754,2018-11-23,22,2,49,51
68755,2018-11-23,23,4,48,52
68756,2018-11-24,0,6,29,35
68757,2018-11-24,1,5,20,25
68758,2018-11-24,2,3,13,16
68759,2018-11-24,3,1,19,20
68760,2018-11-24,4,1,4,5
68761,2018-11-24,5,1,17,18
68762,2018-11-24,6,6,31,37
68763,2018-11-24,7,6,56,62
68764,2018-11-24,8,4,112,116
68765,2018-11-24,9,19,159,178
68766,2018-11-24,10,25,164,189
68767,2018-11-24,11,34,190,224
68768,2018-11-24,12,2,53,55
68769,2018-11-24,13,7,34,41
68770,2018-11-24,14,0,16,16
68771,2018-11-24,15,1,10,11
68772,2018-11-24,16,3,28,31
68773,2018-11-24,17,6,17,23
68774,2018-11-24,18,3,45,48
68775,2018-11-24,19,3,59,62
68776,2018-11-24,20,3,58,61
68777,2018-11-24,21,3,71,74
68778,2018-11-24,22,2,74,76
68779,2018-11-24,23,9,67,76
68780,2018-11-25,0,2,42,44
68781,2018-11-25,1,4,20,24
68782,2018-11-25,2,3,24,27
68783,2018-11-25,3,4,16,20
68784,2018-11-25,4,5,7,12
68785,2018-11-25,5,7,8,15
68786,2018-11-25,6,5,22,27
68787,2018-11-25,7,3,44,47
68788,2018-11-25,8,11,109,120
68789,2018-11-25,9,29,190,219
68790,2018-11-25,10,71,317,388
68791,2018-11-25,11,100,399,499
68792,2018-11-25,12,148,424,572
68793,2018-11-25,13,174,533,707
68794,2018-11-25,14,192,536,728
68795,2018-11-25,15,203,536,739
68796,2018-11-25,16,160,540,700
68797,2018-11-25,17,96,324,420
68798,2018-11-25,18,43,271,314
68799,2018-11-25,19,23,195,218
68800,2018-11-25,20,19,145,164
68801,2018-11-25,21,14,115,129
68802,2018-11-25,22,13,71,84
68803,2018-11-25,23,11,58,69
68804,2018-11-26,0,6,30,36
68805,2018-11-26,1,10,11,21
68806,2018-11-26,2,11,9,20
68807,2018-11-26,3,11,10,21
68808,2018-11-26,4,0,13,13
68809,2018-11-26,5,1,82,83
68810,2018-11-26,6,2,255,257
68811,2018-11-26,7,6,450,456
68812,2018-11-26,8,14,663,677
68813,2018-11-26,9,17,351,368
68814,2018-11-26,10,2,38,40
68815,2018-11-26,11,1,38,39
68816,2018-11-26,12,9,85,94
68817,2018-11-26,13,8,182,190
68818,2018-11-26,14,23,173,196
68819,2018-11-26,15,33,260,293
68820,2018-11-26,16,21,417,438
68821,2018-11-26,17,21,789,810
68822,2018-11-26,18,16,649,665
68823,2018-11-26,19,14,406,420
68824,2018-11-26,20,15,272,287
68825,2018-11-26,21,10,178,188
68826,2018-11-26,22,6,130,136
68827,2018-11-26,23,4,57,61
68828,2018-11-27,0,5,21,26
68829,2018-11-27,1,4,15,19
68830,2018-11-27,2,0,2,2
68831,2018-11-27,3,0,7,7
68832,2018-11-27,4,1,11,12
68833,2018-11-27,5,2,72,74
68834,2018-11-27,6,1,285,286
68835,2018-11-27,7,12,584,596
68836,2018-11-27,8,14,922,936
68837,2018-11-27,9,23,404,427
68838,2018-11-27,10,21,171,192
68839,2018-11-27,11,18,185,203
68840,2018-11-27,12,17,271,288
68841,2018-11-27,13,23,191,214
68842,2018-11-27,14,21,194,215
68843,2018-11-27,15,13,266,279
68844,2018-11-27,16,11,465,476
68845,2018-11-27,17,14,783,797
68846,2018-11-27,18,15,586,601
68847,2018-11-27,19,8,393,401
68848,2018-11-27,20,4,216,220
68849,2018-11-27,21,8,178,186
68850,2018-11-27,22,2,99,101
68851,2018-11-27,23,4,48,52
68852,2018-11-28,0,2,20,22
68853,2018-11-28,1,0,6,6
68854,2018-11-28,2,0,3,3
68855,2018-11-28,3,0,2,2
68856,2018-11-28,4,1,14,15
68857,2018-11-28,5,1,70,71
68858,2018-11-28,6,1,230,231
68859,2018-11-28,7,8,492,500
68860,2018-11-28,8,8,755,763
68861,2018-11-28,9,7,393,400
68862,2018-11-28,10,17,158,175
68863,2018-11-28,11,12,165,177
68864,2018-11-28,12,20,214,234
68865,2018-11-28,13,8,203,211
68866,2018-11-28,14,16,199,215
68867,2018-11-28,15,16,286,302
68868,2018-11-28,16,17,448,465
68869,2018-11-28,17,19,783,802
68870,2018-11-28,18,14,627,641
68871,2018-11-28,19,8,344,352
68872,2018-11-28,20,2,216,218
68873,2018-11-28,21,4,169,173
68874,2018-11-28,22,1,105,106
68875,2018-11-28,23,4,52,56
68876,2018-11-29,0,1,22,23
68877,2018-11-29,1,0,7,7
68878,2018-11-29,2,2,4,6
68879,2018-11-29,3,0,1,1
68880,2018-11-29,4,0,6,6
68881,2018-11-29,5,1,49,50
68882,2018-11-29,6,2,212,214
68883,2018-11-29,7,10,531,541
68884,2018-11-29,8,11,775,786
68885,2018-11-29,9,15,426,441
68886,2018-11-29,10,10,163,173
68887,2018-11-29,11,11,201,212
68888,2018-11-29,12,23,237,260
68889,2018-11-29,13,28,241,269
68890,2018-11-29,14,20,238,258
68891,2018-11-29,15,30,326,356
68892,2018-11-29,16,21,503,524
68893,2018-11-29,17,35,814,849
68894,2018-11-29,18,17,628,645
68895,2018-11-29,19,15,433,448
68896,2018-11-29,20,9,266,275
68897,2018-11-29,21,13,204,217
68898,2018-11-29,22,7,152,159
68899,2018-11-29,23,6,102,108
68900,2018-11-30,0,4,36,40
68901,2018-11-30,1,0,13,13
68902,2018-11-30,2,0,5,5
68903,2018-11-30,3,0,7,7
68904,2018-11-30,4,0,8,8
68905,2018-11-30,5,1,67,68
68906,2018-11-30,6,2,222,224
68907,2018-11-30,7,4,467,471
68908,2018-11-30,8,11,818,829
68909,2018-11-30,9,13,471,484
68910,2018-11-30,10,26,210,236
68911,2018-11-30,11,14,177,191
68912,2018-11-30,12,33,275,308
68913,2018-11-30,13,40,293,333
68914,2018-11-30,14,48,287,335
68915,2018-11-30,15,49,355,404
68916,2018-11-30,16,53,532,585
68917,2018-11-30,17,35,793,828
68918,2018-11-30,18,26,586,612
68919,2018-11-30,19,25,326,351
68920,2018-11-30,20,20,207,227
68921,2018-11-30,21,18,170,188
68922,2018-11-30,22,17,139,156
68923,2018-11-30,23,9,104,113
68924,2018-12-01,0,24,162,186
68925,2018-12-01,1,42,118,160
68926,2018-12-01,2,10,94,104
68927,2018-12-01,3,4,38,42
68928,2018-12-01,4,0,18,18
68929,2018-12-01,5,6,34,40
68930,2018-12-01,6,10,76,86
68931,2018-12-01,7,18,168,186
68932,2018-12-01,8,32,416,448
68933,2018-12-01,9,52,584,636
68934,2018-12-01,10,90,650,740
68935,2018-12-01,11,66,486,552
68936,2018-12-01,12,14,172,186
68937,2018-12-01,13,34,212,246
68938,2018-12-01,14,20,332,352
68939,2018-12-01,15,44,350,394
68940,2018-12-01,16,72,308,380
68941,2018-12-01,17,58,300,358
68942,2018-12-01,18,42,294,336
68943,2018-12-01,19,30,292,322
68944,2018-12-01,20,24,196,220
68945,2018-12-01,21,14,182,196
68946,2018-12-01,22,36,136,172
68947,2018-12-01,23,12,96,108
68948,2018-12-02,0,14,104,118
68949,2018-12-02,1,6,50,56
68950,2018-12-02,2,4,42,46
68951,2018-12-02,3,2,40,42
68952,2018-12-02,4,0,14,14
68953,2018-12-02,5,0,22,22
68954,2018-12-02,6,4,58,62
68955,2018-12-02,7,12,110,122
68956,2018-12-02,8,8,226,234
68957,2018-12-02,9,32,394,426
68958,2018-12-02,10,90,526,616
68959,2018-12-02,11,120,620,740
68960,2018-12-02,12,94,776,870
68961,2018-12-02,13,150,822,972
68962,2018-12-02,14,92,768,860
68963,2018-12-02,15,104,756,860
68964,2018-12-02,16,102,846,948
68965,2018-12-02,17,74,646,720
68966,2018-12-02,18,44,538,582
68967,2018-12-02,19,28,374,402
68968,2018-12-02,20,42,264,306
68969,2018-12-02,21,30,278,308
68970,2018-12-02,22,30,180,210
68971,2018-12-02,23,18,110,128
68972,2018-12-03,0,10,62,72
68973,2018-12-03,1,4,16,20
68974,2018-12-03,2,0,18,18
68975,2018-12-03,3,0,22,22
68976,2018-12-03,4,4,20,24
68977,2018-12-03,5,2,140,142
68978,2018-12-03,6,4,488,492
68979,2018-12-03,7,22,1148,1170
68980,2018-12-03,8,28,1932,1960
68981,2018-12-03,9,44,844,888
68982,2018-12-03,10,58,454,512
68983,2018-12-03,11,76,480,556
68984,2018-12-03,12,74,626,700
68985,2018-12-03,13,112,692,804
68986,2018-12-03,14,84,642,726
68987,2018-12-03,15,106,798,904
68988,2018-12-03,16,72,1318,1390
68989,2018-12-03,17,56,1920,1976
68990,2018-12-03,18,59,1522,1581
68991,2018-12-03,19,26,902,928
68992,2018-12-03,20,22,584,606
68993,2018-12-03,21,30,410,440
68994,2018-12-03,22,24,242,266
68995,2018-12-03,23,18,139,157
68996,2018-12-04,0,7,42,49
68997,2018-12-04,1,2,12,14
68998,2018-12-04,2,2,8,10
68999,2018-12-04,3,0,6,6
69000,2018-12-04,4,0,12,12
69001,2018-12-04,5,2,130,132
69002,2018-12-04,6,6,484,490
69003,2018-12-04,7,34,1210,1244
69004,2018-12-04,8,38,1843,1881
69005,2018-12-04,9,54,848,902
69006,2018-12-04,10,18,284,302
69007,2018-12-04,11,21,188,209
69008,2018-12-04,12,24,238,262
69009,2018-12-04,13,19,237,256
69010,2018-12-04,14,17,212,229
69011,2018-12-04,15,22,282,304
69012,2018-12-04,16,24,491,515
69013,2018-12-04,17,22,852,874
69014,2018-12-04,18,16,650,666
69015,2018-12-04,19,14,380,394
69016,2018-12-04,20,19,271,290
69017,2018-12-04,21,12,206,218
69018,2018-12-04,22,6,137,143
69019,2018-12-04,23,4,71,75
69020,2018-12-05,0,7,53,60
69021,2018-12-05,1,3,23,26
69022,2018-12-05,2,4,6,10
69023,2018-12-05,3,0,5,5
69024,2018-12-05,4,0,10,10
69025,2018-12-05,5,2,65,67
69026,2018-12-05,6,6,154,160
69027,2018-12-05,7,12,417,429
69028,2018-12-05,8,22,674,696
69029,2018-12-05,9,29,410,439
69030,2018-12-05,10,18,264,282
69031,2018-12-05,11,17,259,276
69032,2018-12-05,12,27,298,325
69033,2018-12-05,13,48,358,406
69034,2018-12-05,14,37,295,332
69035,2018-12-05,15,48,326,374
69036,2018-12-05,16,38,371,409
69037,2018-12-05,17,24,666,690
69038,2018-12-05,18,13,544,557
69039,2018-12-05,19,9,348,357
69040,2018-12-05,20,15,200,215
69041,2018-12-05,21,9,173,182
69042,2018-12-05,22,13,114,127
69043,2018-12-05,23,4,67,71
69044,2018-12-06,0,3,29,32
69045,2018-12-06,1,1,12,13
69046,2018-12-06,2,1,8,9
69047,2018-12-06,3,0,1,1
69048,2018-12-06,4,0,5,5
69049,2018-12-06,5,1,60,61
69050,2018-12-06,6,4,233,237
69051,2018-12-06,7,9,587,596
69052,2018-12-06,8,12,853,865
69053,2018-12-06,9,10,392,402
69054,2018-12-06,10,26,175,201
69055,2018-12-06,11,24,200,224
69056,2018-12-06,12,31,254,285
69057,2018-12-06,13,38,249,287
69058,2018-12-06,14,26,200,226
69059,2018-12-06,15,23,309,332
69060,2018-12-06,16,25,525,550
69061,2018-12-06,17,18,820,838
69062,2018-12-06,18,21,607,628
69063,2018-12-06,19,14,409,423
69064,2018-12-06,20,4,278,282
69065,2018-12-06,21,22,212,234
69066,2018-12-06,22,7,142,149
69067,2018-12-06,23,6,66,72
69068,2018-12-07,0,1,38,39
69069,2018-12-07,1,2,18,20
69070,2018-12-07,2,1,13,14
69071,2018-12-07,3,0,6,6
69072,2018-12-07,4,0,9,9
69073,2018-12-07,5,0,67,67
69074,2018-12-07,6,3,213,216
69075,2018-12-07,7,6,476,482
69076,2018-12-07,8,14,791,805
69077,2018-12-07,9,21,396,417
69078,2018-12-07,10,19,229,248
69079,2018-12-07,11,16,237,253
69080,2018-12-07,12,31,289,320
69081,2018-12-07,13,27,276,303
69082,2018-12-07,14,21,257,278
69083,2018-12-07,15,28,336,364
69084,2018-12-07,16,25,521,546
69085,2018-12-07,17,34,704,738
69086,2018-12-07,18,17,513,530
69087,2018-12-07,19,9,314,323
69088,2018-12-07,20,10,177,187
69089,2018-12-07,21,13,136,149
69090,2018-12-07,22,17,126,143
69091,2018-12-07,23,12,97,109
69092,2018-12-08,0,4,79,83
69093,2018-12-08,1,7,55,62
69094,2018-12-08,2,2,27,29
69095,2018-12-08,3,1,16,17
69096,2018-12-08,4,1,3,4
69097,2018-12-08,5,1,8,9
69098,2018-12-08,6,0,32,32
69099,2018-12-08,7,14,72,86
69100,2018-12-08,8,11,151,162
69101,2018-12-08,9,22,246,268
69102,2018-12-08,10,32,316,348
69103,2018-12-08,11,53,315,368
69104,2018-12-08,12,62,339,401
69105,2018-12-08,13,63,290,353
69106,2018-12-08,14,48,345,393
69107,2018-12-08,15,55,314,369
69108,2018-12-08,16,47,292,339
69109,2018-12-08,17,21,240,261
69110,2018-12-08,18,13,230,243
69111,2018-12-08,19,6,192,198
69112,2018-12-08,20,5,119,124
69113,2018-12-08,21,4,105,109
69114,2018-12-08,22,7,75,82
69115,2018-12-08,23,7,70,77
69116,2018-12-09,0,4,55,59
69117,2018-12-09,1,3,52,55
69118,2018-12-09,2,1,34,35
69119,2018-12-09,3,2,11,13
69120,2018-12-09,4,0,4,4
69121,2018-12-09,5,1,8,9
69122,2018-12-09,6,0,25,25
69123,2018-12-09,7,14,64,78
69124,2018-12-09,8,9,92,101
69125,2018-12-09,9,25,157,182
69126,2018-12-09,10,35,235,270
69127,2018-12-09,11,27,282,309
69128,2018-12-09,12,34,296,330
69129,2018-12-09,13,41,296,337
69130,2018-12-09,14,41,299,340
69131,2018-12-09,15,25,267,292
69132,2018-12-09,16,22,237,259
69133,2018-12-09,17,22,211,233
69134,2018-12-09,18,9,150,159
69135,2018-12-09,19,5,146,151
69136,2018-12-09,20,9,118,127
69137,2018-12-09,21,9,81,90
69138,2018-12-09,22,6,54,60
69139,2018-12-09,23,0,29,29
69140,2018-12-10,0,1,23,24
69141,2018-12-10,1,3,9,12
69142,2018-12-10,2,1,5,6
69143,2018-12-10,3,0,3,3
69144,2018-12-10,4,0,6,6
69145,2018-12-10,5,3,51,54
69146,2018-12-10,6,1,183,184
69147,2018-12-10,7,8,464,472
69148,2018-12-10,8,14,787,801
69149,2018-12-10,9,19,383,402
69150,2018-12-10,10,14,155,169
69151,2018-12-10,11,14,167,181
69152,2018-12-10,12,13,209,222
69153,2018-12-10,13,17,196,213
69154,2018-12-10,14,16,217,233
69155,2018-12-10,15,20,271,291
69156,2018-12-10,16,18,469,487
69157,2018-12-10,17,28,791,819
69158,2018-12-10,18,21,576,597
69159,2018-12-10,19,15,360,375
69160,2018-12-10,20,10,223,233
69161,2018-12-10,21,13,149,162
69162,2018-12-10,22,15,86,101
69163,2018-12-10,23,3,55,58
69164,2018-12-11,0,7,24,31
69165,2018-12-11,1,2,5,7
69166,2018-12-11,2,1,4,5
69167,2018-12-11,3,0,4,4
69168,2018-12-11,4,0,9,9
69169,2018-12-11,5,0,58,58
69170,2018-12-11,6,1,202,203
69171,2018-12-11,7,16,529,545
69172,2018-12-11,8,14,832,846
69173,2018-12-11,9,19,402,421
69174,2018-12-11,10,10,183,193
69175,2018-12-11,11,21,230,251
69176,2018-12-11,12,30,276,306
69177,2018-12-11,13,32,243,275
69178,2018-12-11,14,32,221,253
69179,2018-12-11,15,37,313,350
69180,2018-12-11,16,30,513,543
69181,2018-12-11,17,36,805,841
69182,2018-12-11,18,39,717,756
69183,2018-12-11,19,17,383,400
69184,2018-12-11,20,20,242,262
69185,2018-12-11,21,9,172,181
69186,2018-12-11,22,14,163,177
69187,2018-12-11,23,12,66,78
69188,2018-12-12,0,5,31,36
69189,2018-12-12,1,3,13,16
69190,2018-12-12,2,0,8,8
69191,2018-12-12,3,3,5,8
69192,2018-12-12,4,1,4,5
69193,2018-12-12,5,0,100,100
69194,2018-12-12,6,4,258,262
69195,2018-12-12,7,14,585,599
69196,2018-12-12,8,23,944,967
69197,2018-12-12,9,19,425,444
69198,2018-12-12,10,25,197,222
69199,2018-12-12,11,14,223,237
69200,2018-12-12,12,25,301,326
69201,2018-12-12,13,28,286,314
69202,2018-12-12,14,29,240,269
69203,2018-12-12,15,41,314,355
69204,2018-12-12,16,33,545,578
69205,2018-12-12,17,37,852,889
69206,2018-12-12,18,27,705,732
69207,2018-12-12,19,19,402,421
69208,2018-12-12,20,21,279,300
69209,2018-12-12,21,14,218,232
69210,2018-12-12,22,22,145,167
69211,2018-12-12,23,15,72,87
69212,2018-12-13,0,5,28,33
69213,2018-12-13,1,0,18,18
69214,2018-12-13,2,0,2,2
69215,2018-12-13,3,0,7,7
69216,2018-12-13,4,3,8,11
69217,2018-12-13,5,1,72,73
69218,2018-12-13,6,0,220,220
69219,2018-12-13,7,11,590,601
69220,2018-12-13,8,24,1030,1054
69221,2018-12-13,9,22,450,472
69222,2018-12-13,10,26,224,250
69223,2018-12-13,11,30,254,284
69224,2018-12-13,12,30,339,369
69225,2018-12-13,13,39,306,345
69226,2018-12-13,14,54,303,357
69227,2018-12-13,15,50,374,424
69228,2018-12-13,16,38,572,610
69229,2018-12-13,17,38,896,934
69230,2018-12-13,18,45,749,794
69231,2018-12-13,19,31,427,458
69232,2018-12-13,20,19,283,302
69233,2018-12-13,21,22,239,261
69234,2018-12-13,22,14,191,205
69235,2018-12-13,23,8,112,120
69236,2018-12-14,0,11,43,54
69237,2018-12-14,1,7,23,30
69238,2018-12-14,2,1,18,19
69239,2018-12-14,3,1,13,14
69240,2018-12-14,4,0,12,12
69241,2018-12-14,5,0,71,71
69242,2018-12-14,6,1,229,230
69243,2018-12-14,7,12,509,521
69244,2018-12-14,8,28,950,978
69245,2018-12-14,9,18,511,529
69246,2018-12-14,10,26,267,293
69247,2018-12-14,11,36,297,333
69248,2018-12-14,12,40,318,358
69249,2018-12-14,13,35,346,381
69250,2018-12-14,14,42,324,366
69251,2018-12-14,15,44,443,487
69252,2018-12-14,16,42,516,558
69253,2018-12-14,17,25,488,513
69254,2018-12-14,18,12,235,247
69255,2018-12-14,19,5,119,124
69256,2018-12-14,20,2,52,54
69257,2018-12-14,21,1,57,58
69258,2018-12-14,22,11,85,96
69259,2018-12-14,23,7,83,90
69260,2018-12-15,0,2,72,74
69261,2018-12-15,1,5,37,42
69262,2018-12-15,2,6,43,49
69263,2018-12-15,3,0,12,12
69264,2018-12-15,4,0,4,4
69265,2018-12-15,5,0,11,11
69266,2018-12-15,6,1,14,15
69267,2018-12-15,7,3,39,42
69268,2018-12-15,8,6,81,87
69269,2018-12-15,9,2,51,53
69270,2018-12-15,10,7,59,66
69271,2018-12-15,11,5,56,61
69272,2018-12-15,12,3,75,78
69273,2018-12-15,13,14,134,148
69274,2018-12-15,14,12,68,80
69275,2018-12-15,15,7,73,80
69276,2018-12-15,16,6,56,62
69277,2018-12-15,17,0,48,48
69278,2018-12-15,18,4,37,41
69279,2018-12-15,19,1,48,49
69280,2018-12-15,20,3,24,27
69281,2018-12-15,21,0,18,18
69282,2018-12-15,22,2,21,23
69283,2018-12-15,23,5,33,38
69284,2018-12-16,0,1,22,23
69285,2018-12-16,1,1,32,33
69286,2018-12-16,2,1,38,39
69287,2018-12-16,3,2,6,8
69288,2018-12-16,4,0,10,10
69289,2018-12-16,5,4,4,8
69290,2018-12-16,6,3,19,22
69291,2018-12-16,7,0,28,28
69292,2018-12-16,8,1,47,48
69293,2018-12-16,9,1,90,91
69294,2018-12-16,10,4,75,79
69295,2018-12-16,11,1,59,60
69296,2018-12-16,12,4,71,75
69297,2018-12-16,13,9,112,121
69298,2018-12-16,14,13,178,191
69299,2018-12-16,15,27,222,249
69300,2018-12-16,16,30,260,290
69301,2018-12-16,17,20,213,233
69302,2018-12-16,18,9,174,183
69303,2018-12-16,19,10,161,171
69304,2018-12-16,20,7,124,131
69305,2018-12-16,21,15,109,124
69306,2018-12-16,22,3,85,88
69307,2018-12-16,23,7,51,58
69308,2018-12-17,0,2,18,20
69309,2018-12-17,1,4,19,23
69310,2018-12-17,2,0,6,6
69311,2018-12-17,3,1,13,14
69312,2018-12-17,4,1,10,11
69313,2018-12-17,5,3,68,71
69314,2018-12-17,6,2,237,239
69315,2018-12-17,7,10,586,596
69316,2018-12-17,8,15,868,883
69317,2018-12-17,9,27,441,468
69318,2018-12-17,10,40,182,222
69319,2018-12-17,11,55,230,285
69320,2018-12-17,12,68,279,347
69321,2018-12-17,13,47,279,326
69322,2018-12-17,14,56,293,349
69323,2018-12-17,15,66,379,445
69324,2018-12-17,16,55,598,653
69325,2018-12-17,17,50,884,934
69326,2018-12-17,18,38,714,752
69327,2018-12-17,19,16,437,453
69328,2018-12-17,20,25,278,303
69329,2018-12-17,21,10,165,175
69330,2018-12-17,22,10,119,129
69331,2018-12-17,23,13,55,68
69332,2018-12-18,0,6,29,35
69333,2018-12-18,1,1,7,8
69334,2018-12-18,2,0,7,7
69335,2018-12-18,3,0,4,4
69336,2018-12-18,4,0,11,11
69337,2018-12-18,5,0,71,71
69338,2018-12-18,6,6,264,270
69339,2018-12-18,7,5,609,614
69340,2018-12-18,8,23,931,954
69341,2018-12-18,9,14,431,445
69342,2018-12-18,10,19,207,226
69343,2018-12-18,11,34,210,244
69344,2018-12-18,12,30,249,279
69345,2018-12-18,13,41,275,316
69346,2018-12-18,14,22,280,302
69347,2018-12-18,15,32,334,366
69348,2018-12-18,16,35,567,602
69349,2018-12-18,17,44,856,900
69350,2018-12-18,18,23,706,729
69351,2018-12-18,19,10,403,413
69352,2018-12-18,20,13,286,299
69353,2018-12-18,21,7,199,206
69354,2018-12-18,22,8,121,129
69355,2018-12-18,23,7,77,84
69356,2018-12-19,0,5,32,37
69357,2018-12-19,1,1,9,10
69358,2018-12-19,2,1,11,12
69359,2018-12-19,3,0,7,7
69360,2018-12-19,4,0,10,10
69361,2018-12-19,5,1,81,82
69362,2018-12-19,6,2,230,232
69363,2018-12-19,7,6,588,594
69364,2018-12-19,8,14,905,919
69365,2018-12-19,9,19,422,441
69366,2018-12-19,10,22,222,244
69367,2018-12-19,11,28,230,258
69368,2018-12-19,12,27,232,259
69369,2018-12-19,13,53,295,348
69370,2018-12-19,14,40,296,336
69371,2018-12-19,15,44,346,390
69372,2018-12-19,16,39,592,631
69373,2018-12-19,17,29,835,864
69374,2018-12-19,18,20,684,704
69375,2018-12-19,19,13,429,442
69376,2018-12-19,20,10,238,248
69377,2018-12-19,21,15,179,194
69378,2018-12-19,22,3,117,120
69379,2018-12-19,23,7,76,83
69380,2018-12-20,0,4,29,33
69381,2018-12-20,1,6,23,29
69382,2018-12-20,2,0,9,9
69383,2018-12-20,3,1,8,9
69384,2018-12-20,4,0,13,13
69385,2018-12-20,5,1,64,65
69386,2018-12-20,6,1,216,217
69387,2018-12-20,7,5,520,525
69388,2018-12-20,8,22,910,932
69389,2018-12-20,9,24,419,443
69390,2018-12-20,10,9,208,217
69391,2018-12-20,11,15,166,181
69392,2018-12-20,12,23,252,275
69393,2018-12-20,13,7,178,185
69394,2018-12-20,14,5,133,138
69395,2018-12-20,15,4,138,142
69396,2018-12-20,16,3,164,167
69397,2018-12-20,17,12,285,297
69398,2018-12-20,18,1,155,156
69399,2018-12-20,19,3,92,95
69400,2018-12-20,20,1,80,81
69401,2018-12-20,21,4,84,88
69402,2018-12-20,22,4,66,70
69403,2018-12-20,23,1,31,32
69404,2018-12-21,0,9,26,35
69405,2018-12-21,1,1,22,23
69406,2018-12-21,2,0,9,9
69407,2018-12-21,3,0,2,2
69408,2018-12-21,4,0,8,8
69409,2018-12-21,5,0,51,51
69410,2018-12-21,6,5,134,139
69411,2018-12-21,7,5,176,181
69412,2018-12-21,8,26,521,547
69413,2018-12-21,9,21,414,435
69414,2018-12-21,10,28,231,259
69415,2018-12-21,11,41,273,314
69416,2018-12-21,12,41,354,395
69417,2018-12-21,13,46,370,416
69418,2018-12-21,14,57,393,450
69419,2018-12-21,15,29,296,325
69420,2018-12-21,16,52,450,502
69421,2018-12-21,17,17,495,512
69422,2018-12-21,18,18,315,333
69423,2018-12-21,19,15,241,256
69424,2018-12-21,20,19,159,178
69425,2018-12-21,21,19,133,152
69426,2018-12-21,22,18,105,123
69427,2018-12-21,23,2,49,51
69428,2018-12-22,0,4,22,26
69429,2018-12-22,1,4,24,28
69430,2018-12-22,2,2,18,20
69431,2018-12-22,3,6,14,20
69432,2018-12-22,4,2,9,11
69433,2018-12-22,5,1,11,12
69434,2018-12-22,6,1,31,32
69435,2018-12-22,7,3,68,71
69436,2018-12-22,8,16,116,132
69437,2018-12-22,9,34,220,254
69438,2018-12-22,10,33,231,264
69439,2018-12-22,11,68,268,336
69440,2018-12-22,12,71,292,363
69441,2018-12-22,13,46,275,321
69442,2018-12-22,14,68,304,372
69443,2018-12-22,15,70,283,353
69444,2018-12-22,16,62,230,292
69445,2018-12-22,17,30,183,213
69446,2018-12-22,18,22,135,157
69447,2018-12-22,19,16,111,127
69448,2018-12-22,20,21,80,101
69449,2018-12-22,21,11,77,88
69450,2018-12-22,22,5,68,73
69451,2018-12-22,23,6,37,43
69452,2018-12-23,0,5,39,44
69453,2018-12-23,1,0,17,17
69454,2018-12-23,2,6,23,29
69455,2018-12-23,3,4,15,19
69456,2018-12-23,4,4,4,8
69457,2018-12-23,5,1,10,11
69458,2018-12-23,6,2,23,25
69459,2018-12-23,7,1,50,51
69460,2018-12-23,8,3,81,84
69461,2018-12-23,9,24,146,170
69462,2018-12-23,10,57,192,249
69463,2018-12-23,11,68,218,286
69464,2018-12-23,12,75,253,328
69465,2018-12-23,13,97,228,325
69466,2018-12-23,14,99,248,347
69467,2018-12-23,15,74,244,318
69468,2018-12-23,16,74,212,286
69469,2018-12-23,17,33,157,190
69470,2018-12-23,18,23,101,124
69471,2018-12-23,19,16,95,111
69472,2018-12-23,20,20,85,105
69473,2018-12-23,21,6,44,50
69474,2018-12-23,22,7,47,54
69475,2018-12-23,23,4,35,39
69476,2018-12-24,0,0,26,26
69477,2018-12-24,1,2,15,17
69478,2018-12-24,2,0,8,8
69479,2018-12-24,3,1,6,7
69480,2018-12-24,4,0,4,4
69481,2018-12-24,5,1,16,17
69482,2018-12-24,6,1,33,34
69483,2018-12-24,7,3,64,67
69484,2018-12-24,8,6,93,99
69485,2018-12-24,9,15,129,144
69486,2018-12-24,10,38,140,178
69487,2018-12-24,11,39,179,218
69488,2018-12-24,12,54,151,205
69489,2018-12-24,13,44,189,233
69490,2018-12-24,14,51,221,272
69491,2018-12-24,15,57,196,253
69492,2018-12-24,16,44,173,217
69493,2018-12-24,17,23,137,160
69494,2018-12-24,18,11,97,108
69495,2018-12-24,19,13,51,64
69496,2018-12-24,20,5,34,39
69497,2018-12-24,21,6,33,39
69498,2018-12-24,22,15,34,49
69499,2018-12-24,23,6,28,34
69500,2018-12-25,0,1,19,20
69501,2018-12-25,1,2,10,12
69502,2018-12-25,2,1,2,3
69503,2018-12-25,3,0,1,1
69504,2018-12-25,4,0,7,7
69505,2018-12-25,5,0,9,9
69506,2018-12-25,6,4,7,11
69507,2018-12-25,7,2,16,18
69508,2018-12-25,8,5,31,36
69509,2018-12-25,9,10,53,63
69510,2018-12-25,10,66,63,129
69511,2018-12-25,11,63,119,182
69512,2018-12-25,12,77,122,199
69513,2018-12-25,13,58,102,160
69514,2018-12-25,14,61,117,178
69515,2018-12-25,15,55,116,171
69516,2018-12-25,16,57,118,175
69517,2018-12-25,17,31,70,101
69518,2018-12-25,18,10,54,64
69519,2018-12-25,19,11,42,53
69520,2018-12-25,20,11,37,48
69521,2018-12-25,21,12,30,42
69522,2018-12-25,22,5,36,41
69523,2018-12-25,23,6,15,21
69524,2018-12-26,0,1,12,13
69525,2018-12-26,1,0,14,14
69526,2018-12-26,2,0,3,3
69527,2018-12-26,4,0,4,4
69528,2018-12-26,5,0,18,18
69529,2018-12-26,6,3,73,76
69530,2018-12-26,7,2,118,120
69531,2018-12-26,8,15,172,187
69532,2018-12-26,9,33,180,213
69533,2018-12-26,10,26,146,172
69534,2018-12-26,11,59,184,243
69535,2018-12-26,12,66,239,305
69536,2018-12-26,13,86,235,321
69537,2018-12-26,14,81,208,289
69538,2018-12-26,15,102,220,322
69539,2018-12-26,16,70,264,334
69540,2018-12-26,17,51,308,359
69541,2018-12-26,18,55,223,278
69542,2018-12-26,19,40,134,174
69543,2018-12-26,20,13,106,119
69544,2018-12-26,21,18,70,88
69545,2018-12-26,22,14,51,65
69546,2018-12-26,23,8,27,35
69547,2018-12-27,0,2,18,20
69548,2018-12-27,1,0,10,10
69549,2018-12-27,2,2,10,12
69550,2018-12-27,3,1,5,6
69551,2018-12-27,4,1,8,9
69552,2018-12-27,5,2,29,31
69553,2018-12-27,6,0,86,86
69554,2018-12-27,7,14,179,193
69555,2018-12-27,8,31,296,327
69556,2018-12-27,9,39,218,257
69557,2018-12-27,10,60,194,254
69558,2018-12-27,11,91,241,332
69559,2018-12-27,12,81,288,369
69560,2018-12-27,13,141,318,459
69561,2018-12-27,14,143,338,481
69562,2018-12-27,15,188,355,543
69563,2018-12-27,16,110,353,463
69564,2018-12-27,17,83,432,515
69565,2018-12-27,18,38,301,339
69566,2018-12-27,19,33,214,247
69567,2018-12-27,20,30,146,176
69568,2018-12-27,21,20,128,148
69569,2018-12-27,22,19,79,98
69570,2018-12-27,23,21,34,55
69571,2018-12-28,0,6,24,30
69572,2018-12-28,1,5,9,14
69573,2018-12-28,2,0,8,8
69574,2018-12-28,3,0,1,1
69575,2018-12-28,4,0,1,1
69576,2018-12-28,5,0,8,8
69577,2018-12-28,6,3,33,36
69578,2018-12-28,7,2,46,48
69579,2018-12-28,8,1,75,76
69580,2018-12-28,9,2,49,51
69581,2018-12-28,10,3,63,66
69582,2018-12-28,11,2,55,57
69583,2018-12-28,12,2,62,64
69584,2018-12-28,13,8,114,122
69585,2018-12-28,14,16,109,125
69586,2018-12-28,15,15,110,125
69587,2018-12-28,16,21,201,222
69588,2018-12-28,17,18,269,287
69589,2018-12-28,18,12,251,263
69590,2018-12-28,19,14,156,170
69591,2018-12-28,20,14,106,120
69592,2018-12-28,21,7,89,96
69593,2018-12-28,22,10,57,67
69594,2018-12-28,23,5,63,68
69595,2018-12-29,0,8,45,53
69596,2018-12-29,1,5,30,35
69597,2018-12-29,2,3,20,23
69598,2018-12-29,3,2,8,10
69599,2018-12-29,4,1,9,10
69600,2018-12-29,5,0,10,10
69601,2018-12-29,6,3,26,29
69602,2018-12-29,7,7,55,62
69603,2018-12-29,8,17,159,176
69604,2018-12-29,9,55,225,280
69605,2018-12-29,10,131,286,417
69606,2018-12-29,11,132,378,510
69607,2018-12-29,12,195,379,574
69608,2018-12-29,13,220,442,662
69609,2018-12-29,14,247,433,680
69610,2018-12-29,15,250,489,739
69611,2018-12-29,16,182,345,527
69612,2018-12-29,17,106,253,359
69613,2018-12-29,18,38,167,205
69614,2018-12-29,19,44,150,194
69615,2018-12-29,20,37,96,133
69616,2018-12-29,21,19,111,130
69617,2018-12-29,22,36,74,110
69618,2018-12-29,23,17,62,79
69619,2018-12-30,0,14,46,60
69620,2018-12-30,1,1,33,34
69621,2018-12-30,2,11,26,37
69622,2018-12-30,3,0,14,14
69623,2018-12-30,4,3,9,12
69624,2018-12-30,5,1,6,7
69625,2018-12-30,6,2,31,33
69626,2018-12-30,7,2,43,45
69627,2018-12-30,8,27,92,119
69628,2018-12-30,9,58,172,230
69629,2018-12-30,10,92,252,344
69630,2018-12-30,11,110,282,392
69631,2018-12-30,12,118,347,465
69632,2018-12-30,13,135,350,485
69633,2018-12-30,14,170,323,493
69634,2018-12-30,15,147,375,522
69635,2018-12-30,16,145,341,486
69636,2018-12-30,17,82,251,333
69637,2018-12-30,18,51,186,237
69638,2018-12-30,19,41,155,196
69639,2018-12-30,20,22,107,129
69640,2018-12-30,21,22,82,104
69641,2018-12-30,22,22,73,95
69642,2018-12-30,23,19,37,56
69643,2018-12-31,0,4,25,29
69644,2018-12-31,1,0,18,18
69645,2018-12-31,2,3,16,19
69646,2018-12-31,3,1,6,7
69647,2018-12-31,4,0,2,2
69648,2018-12-31,5,1,19,20
69649,2018-12-31,6,0,93,93
69650,2018-12-31,7,6,182,188
69651,2018-12-31,8,25,311,336
69652,2018-12-31,9,24,250,274
69653,2018-12-31,10,46,216,262
69654,2018-12-31,11,39,171,210
69655,2018-12-31,12,10,61,71
69656,2018-12-31,13,5,57,62
69657,2018-12-31,14,5,41,46
69658,2018-12-31,15,9,123,132
69659,2018-12-31,16,13,141,154
69660,2018-12-31,17,13,130,143
69661,2018-12-31,18,2,67,69
69662,2018-12-31,19,2,67,69
69663,2018-12-31,20,7,47,54
69664,2018-12-31,21,4,58,62
69665,2018-12-31,22,4,46,50
69666,2018-12-31,23,6,25,31
69667,2019-01-01,0,7,53,60
69668,2019-01-01,1,6,101,107
69669,2019-01-01,2,24,78,102
69670,2019-01-01,3,1,24,25
69671,2019-01-01,4,0,14,14
69672,2019-01-01,5,0,25,25
69673,2019-01-01,6,2,29,31
69674,2019-01-01,7,4,40,44
69675,2019-01-01,8,3,73,76
69676,2019-01-01,9,15,117,132
69677,2019-01-01,10,39,180,219
69678,2019-01-01,11,54,253,307
69679,2019-01-01,12,140,303,443
69680,2019-01-01,13,151,305,456
69681,2019-01-01,14,146,321,467
69682,2019-01-01,15,151,359,510
69683,2019-01-01,16,120,355,475
69684,2019-01-01,17,86,259,345
69685,2019-01-01,18,35,178,213
69686,2019-01-01,19,25,133,158
69687,2019-01-01,20,32,102,134
69688,2019-01-01,21,15,72,87
69689,2019-01-01,22,16,44,60
69690,2019-01-01,23,11,38,49
69691,2019-01-02,0,3,16,19
69692,2019-01-02,1,4,7,11
69693,2019-01-02,2,1,8,9
69694,2019-01-02,3,1,9,10
69695,2019-01-02,4,0,11,11
69696,2019-01-02,5,0,77,77
69697,2019-01-02,6,3,232,235
69698,2019-01-02,7,9,440,449
69699,2019-01-02,8,22,709,731
69700,2019-01-02,9,17,342,359
69701,2019-01-02,10,48,198,246
69702,2019-01-02,11,39,193,232
69703,2019-01-02,12,52,256,308
69704,2019-01-02,13,56,262,318
69705,2019-01-02,14,75,229,304
69706,2019-01-02,15,81,312,393
69707,2019-01-02,16,80,461,541
69708,2019-01-02,17,55,771,826
69709,2019-01-02,18,29,593,622
69710,2019-01-02,19,28,332,360
69711,2019-01-02,20,23,198,221
69712,2019-01-02,21,15,120,135
69713,2019-01-02,22,16,78,94
69714,2019-01-02,23,3,53,56
69715,2019-01-03,0,7,17,24
69716,2019-01-03,1,7,6,13
69717,2019-01-03,2,8,4,12
69718,2019-01-03,3,1,4,5
69719,2019-01-03,4,0,12,12
69720,2019-01-03,5,3,69,72
69721,2019-01-03,6,2,200,202
69722,2019-01-03,7,7,460,467
69723,2019-01-03,8,28,886,914
69724,2019-01-03,9,35,412,447
69725,2019-01-03,10,58,205,263
69726,2019-01-03,11,101,227,328
69727,2019-01-03,12,92,288,380
69728,2019-01-03,13,103,295,398
69729,2019-01-03,14,71,280,351
69730,2019-01-03,15,82,325,407
69731,2019-01-03,16,125,519,644
69732,2019-01-03,17,86,852,938
69733,2019-01-03,18,39,664,703
69734,2019-01-03,19,23,396,419
69735,2019-01-03,20,20,221,241
69736,2019-01-03,21,17,147,164
69737,2019-01-03,22,16,115,131
69738,2019-01-03,23,7,61,68
69739,2019-01-04,0,6,29,35
69740,2019-01-04,1,3,16,19
69741,2019-01-04,2,2,6,8
69742,2019-01-04,3,0,3,3
69743,2019-01-04,4,0,8,8
69744,2019-01-04,5,1,64,65
69745,2019-01-04,6,0,204,204
69746,2019-01-04,7,9,434,443
69747,2019-01-04,8,21,872,893
69748,2019-01-04,9,13,428,441
69749,2019-01-04,10,34,264,298
69750,2019-01-04,11,62,282,344
69751,2019-01-04,12,96,305,401
69752,2019-01-04,13,135,311,446
69753,2019-01-04,14,117,318,435
69754,2019-01-04,15,107,367,474
69755,2019-01-04,16,98,516,614
69756,2019-01-04,17,60,766,826
69757,2019-01-04,18,40,562,602
69758,2019-01-04,19,18,347,365
69759,2019-01-04,20,9,172,181
69760,2019-01-04,21,7,71,78
69761,2019-01-04,22,5,86,91
69762,2019-01-04,23,5,83,88
69763,2019-01-05,0,2,61,63
69764,2019-01-05,1,3,29,32
69765,2019-01-05,2,1,21,22
69766,2019-01-05,3,0,13,13
69767,2019-01-05,4,0,3,3
69768,2019-01-05,5,2,11,13
69769,2019-01-05,6,1,31,32
69770,2019-01-05,7,4,56,60
69771,2019-01-05,8,6,146,152
69772,2019-01-05,9,15,217,232
69773,2019-01-05,10,35,241,276
69774,2019-01-05,11,34,327,361
69775,2019-01-05,12,75,376,451
69776,2019-01-05,13,61,392,453
69777,2019-01-05,14,47,275,322
69778,2019-01-05,15,89,365,454
69779,2019-01-05,16,112,386,498
69780,2019-01-05,17,72,410,482
69781,2019-01-05,18,38,275,313
69782,2019-01-05,19,45,215,260
69783,2019-01-05,20,21,157,178
69784,2019-01-05,21,10,148,158
69785,2019-01-05,22,14,135,149
69786,2019-01-05,23,14,114,128
69787,2019-01-06,0,16,77,93
69788,2019-01-06,1,24,60,84
69789,2019-01-06,2,5,28,33
69790,2019-01-06,3,3,17,20
69791,2019-01-06,4,2,9,11
69792,2019-01-06,5,0,7,7
69793,2019-01-06,6,3,19,22
69794,2019-01-06,7,3,51,54
69795,2019-01-06,8,8,129,137
69796,2019-01-06,9,28,224,252
69797,2019-01-06,10,61,363,424
69798,2019-01-06,11,101,425,526
69799,2019-01-06,12,130,522,652
69800,2019-01-06,13,161,510,671
69801,2019-01-06,14,171,517,688
69802,2019-01-06,15,167,491,658
69803,2019-01-06,16,117,436,553
69804,2019-01-06,17,64,305,369
69805,2019-01-06,18,39,232,271
69806,2019-01-06,19,25,166,191
69807,2019-01-06,20,5,129,134
69808,2019-01-06,21,6,71,77
69809,2019-01-06,22,6,67,73
69810,2019-01-06,23,4,46,50
69811,2019-01-07,0,1,11,12
69812,2019-01-07,1,2,8,10
69813,2019-01-07,2,1,8,9
69814,2019-01-07,3,0,3,3
69815,2019-01-07,4,0,7,7
69816,2019-01-07,5,4,71,75
69817,2019-01-07,6,0,231,231
69818,2019-01-07,7,5,482,487
69819,2019-01-07,8,19,824,843
69820,2019-01-07,9,19,367,386
69821,2019-01-07,10,12,155,167
69822,2019-01-07,11,19,195,214
69823,2019-01-07,12,13,211,224
69824,2019-01-07,13,18,231,249
69825,2019-01-07,14,26,240,266
69826,2019-01-07,15,21,282,303
69827,2019-01-07,16,19,469,488
69828,2019-01-07,17,21,750,771
69829,2019-01-07,18,7,592,599
69830,2019-01-07,19,8,362,370
69831,2019-01-07,20,7,206,213
69832,2019-01-07,21,9,133,142
69833,2019-01-07,22,3,94,97
69834,2019-01-07,23,2,48,50
69835,2019-01-08,0,1,13,14
69836,2019-01-08,1,0,3,3
69837,2019-01-08,2,0,4,4
69838,2019-01-08,3,0,3,3
69839,2019-01-08,4,0,8,8
69840,2019-01-08,5,2,68,70
69841,2019-01-08,6,1,235,236
69842,2019-01-08,7,8,516,524
69843,2019-01-08,8,16,887,903
69844,2019-01-08,9,6,400,406
69845,2019-01-08,10,14,186,200
69846,2019-01-08,11,48,205,253
69847,2019-01-08,12,31,288,319
69848,2019-01-08,13,45,297,342
69849,2019-01-08,14,56,312,368
69850,2019-01-08,15,54,361,415
69851,2019-01-08,16,73,611,684
69852,2019-01-08,17,59,961,1020
69853,2019-01-08,18,33,752,785
69854,2019-01-08,19,21,476,497
69855,2019-01-08,20,11,301,312
69856,2019-01-08,21,5,120,125
69857,2019-01-08,22,3,96,99
69858,2019-01-08,23,3,62,65
69859,2019-01-09,0,5,21,26
69860,2019-01-09,1,9,10,19
69861,2019-01-09,2,0,4,4
69862,2019-01-09,3,0,4,4
69863,2019-01-09,4,0,10,10
69864,2019-01-09,5,4,99,103
69865,2019-01-09,6,0,252,252
69866,2019-01-09,7,12,569,581
69867,2019-01-09,8,22,899,921
69868,2019-01-09,9,18,467,485
69869,2019-01-09,10,8,224,232
69870,2019-01-09,11,25,198,223
69871,2019-01-09,12,27,259,286
69872,2019-01-09,13,29,229,258
69873,2019-01-09,14,24,186,210
69874,2019-01-09,15,11,214,225
69875,2019-01-09,16,18,378,396
69876,2019-01-09,17,16,702,718
69877,2019-01-09,18,14,568,582
69878,2019-01-09,19,17,348,365
69879,2019-01-09,20,6,194,200
69880,2019-01-09,21,8,163,171
69881,2019-01-09,22,5,86,91
69882,2019-01-09,23,2,44,46
69883,2019-01-10,0,0,16,16
69884,2019-01-10,1,0,6,6
69885,2019-01-10,2,0,10,10
69886,2019-01-10,3,1,4,5
69887,2019-01-10,4,0,8,8
69888,2019-01-10,5,0,61,61
69889,2019-01-10,6,2,183,185
69890,2019-01-10,7,9,433,442
69891,2019-01-10,8,11,779,790
69892,2019-01-10,9,12,370,382
69893,2019-01-10,10,7,173,180
69894,2019-01-10,11,15,180,195
69895,2019-01-10,12,14,200,214
69896,2019-01-10,13,14,224,238
69897,2019-01-10,14,19,204,223
69898,2019-01-10,15,17,263,280
69899,2019-01-10,16,11,343,354
69900,2019-01-10,17,9,672,681
69901,2019-01-10,18,12,495,507
69902,2019-01-10,19,14,293,307
69903,2019-01-10,20,4,211,215
69904,2019-01-10,21,2,120,122
69905,2019-01-10,22,0,98,98
69906,2019-01-10,23,3,40,43
69907,2019-01-11,0,0,26,26
69908,2019-01-11,1,0,6,6
69909,2019-01-11,2,1,3,4
69910,2019-01-11,3,0,4,4
69911,2019-01-11,4,0,7,7
69912,2019-01-11,5,1,64,65
69913,2019-01-11,6,0,178,178
69914,2019-01-11,7,2,356,358
69915,2019-01-11,8,12,671,683
69916,2019-01-11,9,6,404,410
69917,2019-01-11,10,8,187,195
69918,2019-01-11,11,15,193,208
69919,2019-01-11,12,17,212,229
69920,2019-01-11,13,24,244,268
69921,2019-01-11,14,40,250,290
69922,2019-01-11,15,24,300,324
69923,2019-01-11,16,19,456,475
69924,2019-01-11,17,14,656,670
69925,2019-01-11,18,15,469,484
69926,2019-01-11,19,12,297,309
69927,2019-01-11,20,9,175,184
69928,2019-01-11,21,8,119,127
69929,2019-01-11,22,4,86,90
69930,2019-01-11,23,9,73,82
69931,2019-01-12,0,8,54,62
69932,2019-01-12,1,3,42,45
69933,2019-01-12,2,1,33,34
69934,2019-01-12,3,0,13,13
69935,2019-01-12,4,0,4,4
69936,2019-01-12,5,2,6,8
69937,2019-01-12,6,2,21,23
69938,2019-01-12,7,5,72,77
69939,2019-01-12,8,7,168,175
69940,2019-01-12,9,23,260,283
69941,2019-01-12,10,23,301,324
69942,2019-01-12,11,37,314,351
69943,2019-01-12,12,45,330,375
69944,2019-01-12,13,48,305,353
69945,2019-01-12,14,58,287,345
69946,2019-01-12,15,42,310,352
69947,2019-01-12,16,32,241,273
69948,2019-01-12,17,17,171,188
69949,2019-01-12,18,5,118,123
69950,2019-01-12,19,2,62,64
69951,2019-01-12,20,2,50,52
69952,2019-01-12,21,1,43,44
69953,2019-01-12,22,2,27,29
69954,2019-01-12,23,0,31,31
69955,2019-01-13,0,1,22,23
69956,2019-01-13,1,0,17,17
69957,2019-01-13,2,0,14,14
69958,2019-01-13,3,0,5,5
69959,2019-01-13,5,0,3,3
69960,2019-01-13,6,0,9,9
69961,2019-01-13,7,1,15,16
69962,2019-01-13,8,0,18,18
69963,2019-01-13,9,2,28,30
69964,2019-01-13,10,2,44,46
69965,2019-01-13,11,2,51,53
69966,2019-01-13,12,2,66,68
69967,2019-01-13,13,7,54,61
69968,2019-01-13,14,6,56,62
69969,2019-01-13,15,5,48,53
69970,2019-01-13,16,2,34,36
69971,2019-01-13,17,2,20,22
69972,2019-01-13,18,0,24,24
69973,2019-01-13,19,2,10,12
69974,2019-01-13,20,0,16,16
69975,2019-01-13,21,4,9,13
69976,2019-01-13,22,1,14,15
69977,2019-01-13,23,2,10,12
69978,2019-01-14,0,1,3,4
69979,2019-01-14,1,0,1,1
69980,2019-01-14,3,0,1,1
69981,2019-01-14,4,0,6,6
69982,2019-01-14,5,1,6,7
69983,2019-01-14,6,3,16,19
69984,2019-01-14,7,1,20,21
69985,2019-01-14,8,1,45,46
69986,2019-01-14,9,1,52,53
69987,2019-01-14,10,1,34,35
69988,2019-01-14,11,2,59,61
69989,2019-01-14,12,2,75,77
69990,2019-01-14,13,4,102,106
69991,2019-01-14,14,5,80,85
69992,2019-01-14,15,7,126,133
69993,2019-01-14,16,14,137,151
69994,2019-01-14,17,9,197,206
69995,2019-01-14,18,4,155,159
69996,2019-01-14,19,3,124,127
69997,2019-01-14,20,2,65,67
69998,2019-01-14,21,3,70,73
69999,2019-01-14,22,6,52,58
70000,2019-01-14,23,0,26,26
70001,2019-01-15,0,0,13,13
70002,2019-01-15,1,0,3,3
70003,2019-01-15,2,0,8,8
70004,2019-01-15,3,0,2,2
70005,2019-01-15,4,0,5,5
70006,2019-01-15,5,0,37,37
70007,2019-01-15,6,2,112,114
70008,2019-01-15,7,4,191,195
70009,2019-01-15,8,7,316,323
70010,2019-01-15,9,6,265,271
70011,2019-01-15,10,4,160,164
70012,2019-01-15,11,9,129,138
70013,2019-01-15,12,10,152,162
70014,2019-01-15,13,3,132,135
70015,2019-01-15,14,4,149,153
70016,2019-01-15,15,9,159,168
70017,2019-01-15,16,11,279,290
70018,2019-01-15,17,11,456,467
70019,2019-01-15,18,7,439,446
70020,2019-01-15,19,4,283,287
70021,2019-01-15,20,4,154,158
70022,2019-01-15,21,2,112,114
70023,2019-01-15,22,2,78,80
70024,2019-01-15,23,6,40,46
70025,2019-01-16,0,1,15,16
70026,2019-01-16,1,1,11,12
70027,2019-01-16,2,0,5,5
70028,2019-01-16,3,0,5,5
70029,2019-01-16,4,1,6,7
70030,2019-01-16,5,0,63,63
70031,2019-01-16,6,2,165,167
70032,2019-01-16,7,6,331,337
70033,2019-01-16,8,9,553,562
70034,2019-01-16,9,8,298,306
70035,2019-01-16,10,7,139,146
70036,2019-01-16,11,6,136,142
70037,2019-01-16,12,7,169,176
70038,2019-01-16,13,11,184,195
70039,2019-01-16,14,13,156,169
70040,2019-01-16,15,18,214,232
70041,2019-01-16,16,16,334,350
70042,2019-01-16,17,10,625,635
70043,2019-01-16,18,13,549,562
70044,2019-01-16,19,14,321,335
70045,2019-01-16,20,7,211,218
70046,2019-01-16,21,11,141,152
70047,2019-01-16,22,4,87,91
70048,2019-01-16,23,2,55,57
70049,2019-01-17,0,2,19,21
70050,2019-01-17,1,0,11,11
70051,2019-01-17,2,0,4,4
70052,2019-01-17,3,0,4,4
70053,2019-01-17,4,0,9,9
70054,2019-01-17,5,0,60,60
70055,2019-01-17,6,2,194,196
70056,2019-01-17,7,5,394,399
70057,2019-01-17,8,20,743,763
70058,2019-01-17,9,13,343,356
70059,2019-01-17,10,3,163,166
70060,2019-01-17,11,9,188,197
70061,2019-01-17,12,21,220,241
70062,2019-01-17,13,10,176,186
70063,2019-01-17,14,7,213,220
70064,2019-01-17,15,12,253,265
70065,2019-01-17,16,10,371,381
70066,2019-01-17,17,16,652,668
70067,2019-01-17,18,15,415,430
70068,2019-01-17,19,6,179,185
70069,2019-01-17,20,1,115,116
70070,2019-01-17,21,1,99,100
70071,2019-01-17,22,5,65,70
70072,2019-01-17,23,0,37,37
70073,2019-01-18,0,0,18,18
70074,2019-01-18,1,0,13,13
70075,2019-01-18,2,1,6,7
70076,2019-01-18,3,1,5,6
70077,2019-01-18,4,1,9,10
70078,2019-01-18,5,1,42,43
70079,2019-01-18,6,1,147,148
70080,2019-01-18,7,5,297,302
70081,2019-01-18,8,10,569,579
70082,2019-01-18,9,8,345,353
70083,2019-01-18,10,28,189,217
70084,2019-01-18,11,14,209,223
70085,2019-01-18,12,13,234,247
70086,2019-01-18,13,34,272,306
70087,2019-01-18,14,41,257,298
70088,2019-01-18,15,49,356,405
70089,2019-01-18,16,86,444,530
70090,2019-01-18,17,31,644,675
70091,2019-01-18,18,22,489,511
70092,2019-01-18,19,9,281,290
70093,2019-01-18,20,6,169,175
70094,2019-01-18,21,5,138,143
70095,2019-01-18,22,18,108,126
70096,2019-01-18,23,12,95,107
70097,2019-01-19,0,9,58,67
70098,2019-01-19,1,6,46,52
70099,2019-01-19,2,5,32,37
70100,2019-01-19,3,9,23,32
70101,2019-01-19,4,0,15,15
70102,2019-01-19,5,0,14,14
70103,2019-01-19,6,3,35,38
70104,2019-01-19,7,6,74,80
70105,2019-01-19,8,12,167,179
70106,2019-01-19,9,21,251,272
70107,2019-01-19,10,35,260,295
70108,2019-01-19,11,56,335,391
70109,2019-01-19,12,49,320,369
70110,2019-01-19,13,87,319,406
70111,2019-01-19,14,60,265,325
70112,2019-01-19,15,55,223,278
70113,2019-01-19,16,56,213,269
70114,2019-01-19,17,31,147,178
70115,2019-01-19,18,10,115,125
70116,2019-01-19,19,7,44,51
70117,2019-01-19,20,0,31,31
70118,2019-01-19,21,0,14,14
70119,2019-01-19,22,2,23,25
70120,2019-01-19,23,0,22,22
70121,2019-01-20,0,1,20,21
70122,2019-01-20,1,0,12,12
70123,2019-01-20,2,2,15,17
70124,2019-01-20,3,2,7,9
70125,2019-01-20,4,0,10,10
70126,2019-01-20,5,0,5,5
70127,2019-01-20,6,0,20,20
70128,2019-01-20,7,2,35,37
70129,2019-01-20,8,2,84,86
70130,2019-01-20,9,8,166,174
70131,2019-01-20,10,36,212,248
70132,2019-01-20,11,31,215,246
70133,2019-01-20,12,29,248,277
70134,2019-01-20,13,28,214,242
70135,2019-01-20,14,31,217,248
70136,2019-01-20,15,20,187,207
70137,2019-01-20,16,23,160,183
70138,2019-01-20,17,14,132,146
70139,2019-01-20,18,5,130,135
70140,2019-01-20,19,5,84,89
70141,2019-01-20,20,0,47,47
70142,2019-01-20,21,0,36,36
70143,2019-01-20,22,5,59,64
70144,2019-01-20,23,2,29,31
70145,2019-01-21,0,0,30,30
70146,2019-01-21,1,0,15,15
70147,2019-01-21,2,0,6,6
70148,2019-01-21,3,0,1,1
70149,2019-01-21,4,0,4,4
70150,2019-01-21,5,0,10,10
70151,2019-01-21,6,0,22,22
70152,2019-01-21,7,0,47,47
70153,2019-01-21,8,1,68,69
70154,2019-01-21,9,1,63,64
70155,2019-01-21,10,2,65,67
70156,2019-01-21,11,7,96,103
70157,2019-01-21,12,2,96,98
70158,2019-01-21,13,4,122,126
70159,2019-01-21,14,6,110,116
70160,2019-01-21,15,10,129,139
70161,2019-01-21,16,9,144,153
70162,2019-01-21,17,6,139,145
70163,2019-01-21,18,1,148,149
70164,2019-01-21,19,0,80,80
70165,2019-01-21,20,1,60,61
70166,2019-01-21,21,1,45,46
70167,2019-01-21,22,2,27,29
70168,2019-01-21,23,0,12,12
70169,2019-01-22,0,0,10,10
70170,2019-01-22,1,0,4,4
70171,2019-01-22,2,0,2,2
70172,2019-01-22,3,0,1,1
70173,2019-01-22,4,1,7,8
70174,2019-01-22,5,1,43,44
70175,2019-01-22,6,1,127,128
70176,2019-01-22,7,0,282,282
70177,2019-01-22,8,6,540,546
70178,2019-01-22,9,4,299,303
70179,2019-01-22,10,4,112,116
70180,2019-01-22,11,6,113,119
70181,2019-01-22,12,10,172,182
70182,2019-01-22,13,15,149,164
70183,2019-01-22,14,19,178,197
70184,2019-01-22,15,12,239,251
70185,2019-01-22,16,20,351,371
70186,2019-01-22,17,11,566,577
70187,2019-01-22,18,9,513,522
70188,2019-01-22,19,11,294,305
70189,2019-01-22,20,3,188,191
70190,2019-01-22,21,2,141,143
70191,2019-01-22,22,3,85,88
70192,2019-01-22,23,1,30,31
70193,2019-01-23,0,1,16,17
70194,2019-01-23,1,0,10,10
70195,2019-01-23,2,0,3,3
70196,2019-01-23,3,0,2,2
70197,2019-01-23,4,1,7,8
70198,2019-01-23,5,1,82,83
70199,2019-01-23,6,0,226,226
70200,2019-01-23,7,3,466,469
70201,2019-01-23,8,12,770,782
70202,2019-01-23,9,5,439,444
70203,2019-01-23,10,18,185,203
70204,2019-01-23,11,6,173,179
70205,2019-01-23,12,14,215,229
70206,2019-01-23,13,9,208,217
70207,2019-01-23,14,11,219,230
70208,2019-01-23,15,52,279,331
70209,2019-01-23,16,31,471,502
70210,2019-01-23,17,32,854,886
70211,2019-01-23,18,20,678,698
70212,2019-01-23,19,15,433,448
70213,2019-01-23,20,5,280,285
70214,2019-01-23,21,9,229,238
70215,2019-01-23,22,9,125,134
70216,2019-01-23,23,10,73,83
70217,2019-01-24,0,2,30,32
70218,2019-01-24,1,1,7,8
70219,2019-01-24,2,0,6,6
70220,2019-01-24,3,0,3,3
70221,2019-01-24,4,0,6,6
70222,2019-01-24,5,0,32,32
70223,2019-01-24,6,2,96,98
70224,2019-01-24,7,4,156,160
70225,2019-01-24,8,5,241,246
70226,2019-01-24,9,1,184,185
70227,2019-01-24,10,5,80,85
70228,2019-01-24,11,0,21,21
70229,2019-01-24,12,1,41,42
70230,2019-01-24,13,2,52,54
70231,2019-01-24,14,0,111,111
70232,2019-01-24,15,7,209,216
70233,2019-01-24,16,13,387,400
70234,2019-01-24,17,17,716,733
70235,2019-01-24,18,8,526,534
70236,2019-01-24,19,5,325,330
70237,2019-01-24,20,1,239,240
70238,2019-01-24,21,2,164,166
70239,2019-01-24,22,1,109,110
70240,2019-01-24,23,5,53,58
70241,2019-01-25,0,2,31,33
70242,2019-01-25,1,5,15,20
70243,2019-01-25,2,1,7,8
70244,2019-01-25,3,0,6,6
70245,2019-01-25,4,1,5,6
70246,2019-01-25,5,2,58,60
70247,2019-01-25,6,1,192,193
70248,2019-01-25,7,5,407,412
70249,2019-01-25,8,15,822,837
70250,2019-01-25,9,10,456,466
70251,2019-01-25,10,17,216,233
70252,2019-01-25,11,25,220,245
70253,2019-01-25,12,30,282,312
70254,2019-01-25,13,18,251,269
70255,2019-01-25,14,33,256,289
70256,2019-01-25,15,39,326,365
70257,2019-01-25,16,27,462,489
70258,2019-01-25,17,20,705,725
70259,2019-01-25,18,5,512,517
70260,2019-01-25,19,8,297,305
70261,2019-01-25,20,5,158,163
70262,2019-01-25,21,8,128,136
70263,2019-01-25,22,6,82,88
70264,2019-01-25,23,11,75,86
70265,2019-01-26,0,11,54,65
70266,2019-01-26,1,7,36,43
70267,2019-01-26,2,1,26,27
70268,2019-01-26,3,0,7,7
70269,2019-01-26,4,0,7,7
70270,2019-01-26,5,1,11,12
70271,2019-01-26,6,0,24,24
70272,2019-01-26,7,4,78,82
70273,2019-01-26,8,6,137,143
70274,2019-01-26,9,8,255,263
70275,2019-01-26,10,21,301,322
70276,2019-01-26,11,50,310,360
70277,2019-01-26,12,55,359,414
70278,2019-01-26,13,60,313,373
70279,2019-01-26,14,70,302,372
70280,2019-01-26,15,66,311,377
70281,2019-01-26,16,69,334,403
70282,2019-01-26,17,61,285,346
70283,2019-01-26,18,21,230,251
70284,2019-01-26,19,24,168,192
70285,2019-01-26,20,4,147,151
70286,2019-01-26,21,12,82,94
70287,2019-01-26,22,6,72,78
70288,2019-01-26,23,2,85,87
70289,2019-01-27,0,2,60,62
70290,2019-01-27,1,4,56,60
70291,2019-01-27,2,5,37,42
70292,2019-01-27,3,1,12,13
70293,2019-01-27,4,0,10,10
70294,2019-01-27,5,2,6,8
70295,2019-01-27,6,1,22,23
70296,2019-01-27,7,9,50,59
70297,2019-01-27,8,6,112,118
70298,2019-01-27,9,17,198,215
70299,2019-01-27,10,36,250,286
70300,2019-01-27,11,48,329,377
70301,2019-01-27,12,45,354,399
70302,2019-01-27,13,72,352,424
70303,2019-01-27,14,79,389,468
70304,2019-01-27,15,72,326,398
70305,2019-01-27,16,73,350,423
70306,2019-01-27,17,33,314,347
70307,2019-01-27,18,15,252,267
70308,2019-01-27,19,6,167,173
70309,2019-01-27,20,5,104,109
70310,2019-01-27,21,7,101,108
70311,2019-01-27,22,8,57,65
70312,2019-01-27,23,5,40,45
70313,2019-01-28,0,5,25,30
70314,2019-01-28,1,2,9,11
70315,2019-01-28,2,2,5,7
70316,2019-01-28,3,3,4,7
70317,2019-01-28,4,1,8,9
70318,2019-01-28,5,1,77,78
70319,2019-01-28,6,3,236,239
70320,2019-01-28,7,6,530,536
70321,2019-01-28,8,11,823,834
70322,2019-01-28,9,3,389,392
70323,2019-01-28,10,9,141,150
70324,2019-01-28,11,14,145,159
70325,2019-01-28,12,27,222,249
70326,2019-01-28,13,26,214,240
70327,2019-01-28,14,30,189,219
70328,2019-01-28,15,27,282,309
70329,2019-01-28,16,19,502,521
70330,2019-01-28,17,14,827,841
70331,2019-01-28,18,11,649,660
70332,2019-01-28,19,8,333,341
70333,2019-01-28,20,4,202,206
70334,2019-01-28,21,5,158,163
70335,2019-01-28,22,5,81,86
70336,2019-01-28,23,3,35,38
70337,2019-01-29,0,1,15,16
70338,2019-01-29,1,0,9,9
70339,2019-01-29,2,0,5,5
70340,2019-01-29,3,0,3,3
70341,2019-01-29,4,1,10,11
70342,2019-01-29,5,1,66,67
70343,2019-01-29,6,2,240,242
70344,2019-01-29,7,10,537,547
70345,2019-01-29,8,17,919,936
70346,2019-01-29,9,14,399,413
70347,2019-01-29,10,15,142,157
70348,2019-01-29,11,11,179,190
70349,2019-01-29,12,6,200,206
70350,2019-01-29,13,5,116,121
70351,2019-01-29,14,13,124,137
70352,2019-01-29,15,4,133,137
70353,2019-01-29,16,4,190,194
70354,2019-01-29,17,3,209,212
70355,2019-01-29,18,2,219,221
70356,2019-01-29,19,4,177,181
70357,2019-01-29,20,5,119,124
70358,2019-01-29,21,4,107,111
70359,2019-01-29,22,3,57,60
70360,2019-01-29,23,2,33,35
70361,2019-01-30,0,0,10,10
70362,2019-01-30,1,1,3,4
70363,2019-01-30,2,0,7,7
70364,2019-01-30,3,0,2,2
70365,2019-01-30,4,0,10,10
70366,2019-01-30,5,0,44,44
70367,2019-01-30,6,1,137,138
70368,2019-01-30,7,5,258,263
70369,2019-01-30,8,8,522,530
70370,2019-01-30,9,8,356,364
70371,2019-01-30,10,8,251,259
70372,2019-01-30,11,6,173,179
70373,2019-01-30,12,9,186,195
70374,2019-01-30,13,4,145,149
70375,2019-01-30,14,4,117,121
70376,2019-01-30,15,6,144,150
70377,2019-01-30,16,5,234,239
70378,2019-01-30,17,3,509,512
70379,2019-01-30,18,3,368,371
70380,2019-01-30,19,4,187,191
70381,2019-01-30,20,0,124,124
70382,2019-01-30,21,1,90,91
70383,2019-01-30,22,1,42,43
70384,2019-01-30,23,1,23,24
70385,2019-01-31,0,0,9,9
70386,2019-01-31,1,0,6,6
70387,2019-01-31,2,0,5,5
70388,2019-01-31,3,0,3,3
70389,2019-01-31,4,0,5,5
70390,2019-01-31,5,1,45,46
70391,2019-01-31,6,0,110,110
70392,2019-01-31,7,4,250,254
70393,2019-01-31,8,10,455,465
70394,2019-01-31,9,11,306,317
70395,2019-01-31,10,3,128,131
70396,2019-01-31,11,4,102,106
70397,2019-01-31,12,2,148,150
70398,2019-01-31,13,4,132,136
70399,2019-01-31,14,6,139,145
70400,2019-01-31,15,3,165,168
70401,2019-01-31,16,5,280,285
70402,2019-01-31,17,15,500,515
70403,2019-01-31,18,4,427,431
70404,2019-01-31,19,6,226,232
70405,2019-01-31,20,3,133,136
70406,2019-01-31,21,0,99,99
70407,2019-01-31,22,2,77,79
70408,2019-01-31,23,0,29,29
70409,2019-02-01,0,0,17,17
70410,2019-02-01,1,1,8,9
70411,2019-02-01,2,0,6,6
70412,2019-02-01,3,0,2,2
70413,2019-02-01,4,0,7,7
70414,2019-02-01,5,0,45,45
70415,2019-02-01,6,2,148,150
70416,2019-02-01,7,1,239,240
70417,2019-02-01,8,6,278,284
70418,2019-02-01,9,4,160,164
70419,2019-02-01,10,3,51,54
70420,2019-02-01,11,0,46,46
70421,2019-02-01,12,0,77,77
70422,2019-02-01,13,5,88,93
70423,2019-02-01,14,1,74,75
70424,2019-02-01,15,1,127,128
70425,2019-02-01,16,4,212,216
70426,2019-02-01,17,3,297,300
70427,2019-02-01,18,3,221,224
70428,2019-02-01,19,2,116,118
70429,2019-02-01,20,1,69,70
70430,2019-02-01,21,6,55,61
70431,2019-02-01,22,0,44,44
70432,2019-02-01,23,0,37,37
70433,2019-02-02,0,4,27,31
70434,2019-02-02,1,0,21,21
70435,2019-02-02,2,2,6,8
70436,2019-02-02,3,0,4,4
70437,2019-02-02,4,0,6,6
70438,2019-02-02,5,0,5,5
70439,2019-02-02,6,1,15,16
70440,2019-02-02,7,0,47,47
70441,2019-02-02,8,1,91,92
70442,2019-02-02,9,6,172,178
70443,2019-02-02,10,7,203,210
70444,2019-02-02,11,14,208,222
70445,2019-02-02,12,19,232,251
70446,2019-02-02,13,48,282,330
70447,2019-02-02,14,58,274,332
70448,2019-02-02,15,47,241,288
70449,2019-02-02,16,53,281,334
70450,2019-02-02,17,37,260,297
70451,2019-02-02,18,26,206,232
70452,2019-02-02,19,13,130,143
70453,2019-02-02,20,10,104,114
70454,2019-02-02,21,8,100,108
70455,2019-02-02,22,9,77,86
70456,2019-02-02,23,4,61,65
70457,2019-02-03,0,5,61,66
70458,2019-02-03,1,3,38,41
70459,2019-02-03,2,4,35,39
70460,2019-02-03,3,1,15,16
70461,2019-02-03,4,3,5,8
70462,2019-02-03,5,0,6,6
70463,2019-02-03,6,1,15,16
70464,2019-02-03,7,1,44,45
70465,2019-02-03,8,4,121,125
70466,2019-02-03,9,20,179,199
70467,2019-02-03,10,45,281,326
70468,2019-02-03,11,37,337,374
70469,2019-02-03,12,51,372,423
70470,2019-02-03,13,76,382,458
70471,2019-02-03,14,86,404,490
70472,2019-02-03,15,93,414,507
70473,2019-02-03,16,82,387,469
70474,2019-02-03,17,59,447,506
70475,2019-02-03,18,38,286,324
70476,2019-02-03,19,10,106,116
70477,2019-02-03,20,16,86,102
70478,2019-02-03,21,15,83,98
70479,2019-02-03,22,28,214,242
70480,2019-02-03,23,3,53,56
70481,2019-02-04,0,0,9,9
70482,2019-02-04,1,0,10,10
70483,2019-02-04,2,1,3,4
70484,2019-02-04,3,0,6,6
70485,2019-02-04,4,1,13,14
70486,2019-02-04,5,3,69,72
70487,2019-02-04,6,1,222,223
70488,2019-02-04,7,8,524,532
70489,2019-02-04,8,19,916,935
70490,2019-02-04,9,23,471,494
70491,2019-02-04,10,28,173,201
70492,2019-02-04,11,29,180,209
70493,2019-02-04,12,33,266,299
70494,2019-02-04,13,48,249,297
70495,2019-02-04,14,59,237,296
70496,2019-02-04,15,68,369,437
70497,2019-02-04,16,53,617,670
70498,2019-02-04,17,75,1035,1110
70499,2019-02-04,18,33,791,824
70500,2019-02-04,19,25,457,482
70501,2019-02-04,20,9,293,302
70502,2019-02-04,21,15,206,221
70503,2019-02-04,22,17,82,99
70504,2019-02-04,23,2,49,51
70505,2019-02-05,0,2,15,17
70506,2019-02-05,1,1,4,5
70507,2019-02-05,2,1,5,6
70508,2019-02-05,3,0,7,7
70509,2019-02-05,4,1,12,13
70510,2019-02-05,5,3,80,83
70511,2019-02-05,6,4,265,269
70512,2019-02-05,7,10,646,656
70513,2019-02-05,8,23,1062,1085
70514,2019-02-05,9,17,470,487
70515,2019-02-05,10,14,188,202
70516,2019-02-05,11,23,212,235
70517,2019-02-05,12,35,343,378
70518,2019-02-05,13,62,317,379
70519,2019-02-05,14,65,300,365
70520,2019-02-05,15,66,399,465
70521,2019-02-05,16,96,657,753
70522,2019-02-05,17,94,1141,1235
70523,2019-02-05,18,79,932,1011
70524,2019-02-05,19,44,552,596
70525,2019-02-05,20,41,351,392
70526,2019-02-05,21,33,269,302
70527,2019-02-05,22,14,160,174
70528,2019-02-05,23,14,81,95
70529,2019-02-06,0,2,26,28
70530,2019-02-06,1,1,11,12
70531,2019-02-06,2,0,7,7
70532,2019-02-06,3,0,5,5
70533,2019-02-06,4,0,14,14
70534,2019-02-06,5,0,80,80
70535,2019-02-06,6,4,284,288
70536,2019-02-06,7,17,674,691
70537,2019-02-06,8,17,1120,1137
70538,2019-02-06,9,28,510,538
70539,2019-02-06,10,37,202,239
70540,2019-02-06,11,55,235,290
70541,2019-02-06,12,36,287,323
70542,2019-02-06,13,39,246,285
70543,2019-02-06,14,39,219,258
70544,2019-02-06,15,22,298,320
70545,2019-02-06,16,30,498,528
70546,2019-02-06,17,22,584,606
70547,2019-02-06,18,10,361,371
70548,2019-02-06,19,9,288,297
70549,2019-02-06,20,13,239,252
70550,2019-02-06,21,7,166,173
70551,2019-02-06,22,8,133,141
70552,2019-02-06,23,1,60,61
70553,2019-02-07,0,2,29,31
70554,2019-02-07,1,0,9,9
70555,2019-02-07,2,0,8,8
70556,2019-02-07,3,0,2,2
70557,2019-02-07,4,1,15,16
70558,2019-02-07,5,1,64,65
70559,2019-02-07,6,0,277,277
70560,2019-02-07,7,8,615,623
70561,2019-02-07,8,20,1017,1037
70562,2019-02-07,9,31,394,425
70563,2019-02-07,10,22,164,186
70564,2019-02-07,11,18,223,241
70565,2019-02-07,12,35,246,281
70566,2019-02-07,13,30,266,296
70567,2019-02-07,14,64,231,295
70568,2019-02-07,15,52,330,382
70569,2019-02-07,16,52,585,637
70570,2019-02-07,17,59,942,1001
70571,2019-02-07,18,49,710,759
70572,2019-02-07,19,24,455,479
70573,2019-02-07,20,12,318,330
70574,2019-02-07,21,21,218,239
70575,2019-02-07,22,13,151,164
70576,2019-02-07,23,9,59,68
70577,2019-02-08,0,7,34,41
70578,2019-02-08,1,3,21,24
70579,2019-02-08,2,2,4,6
70580,2019-02-08,3,0,2,2
70581,2019-02-08,4,0,20,20
70582,2019-02-08,5,1,72,73
70583,2019-02-08,6,6,189,195
70584,2019-02-08,7,6,476,482
70585,2019-02-08,8,13,675,688
70586,2019-02-08,9,14,353,367
70587,2019-02-08,10,21,209,230
70588,2019-02-08,11,39,221,260
70589,2019-02-08,12,34,300,334
70590,2019-02-08,13,50,281,331
70591,2019-02-08,14,33,305,338
70592,2019-02-08,15,55,379,434
70593,2019-02-08,16,43,565,608
70594,2019-02-08,17,27,862,889
70595,2019-02-08,18,21,505,526
70596,2019-02-08,19,20,327,347
70597,2019-02-08,20,3,162,165
70598,2019-02-08,21,5,112,117
70599,2019-02-08,22,9,87,96
70600,2019-02-08,23,4,73,77
70601,2019-02-09,0,7,50,57
70602,2019-02-09,1,1,22,23
70603,2019-02-09,2,3,21,24
70604,2019-02-09,3,4,13,17
70605,2019-02-09,4,0,6,6
70606,2019-02-09,5,1,9,10
70607,2019-02-09,6,1,14,15
70608,2019-02-09,7,1,60,61
70609,2019-02-09,8,4,130,134
70610,2019-02-09,9,12,183,195
70611,2019-02-09,10,29,238,267
70612,2019-02-09,11,29,291,320
70613,2019-02-09,12,35,305,340
70614,2019-02-09,13,58,300,358
70615,2019-02-09,14,40,298,338
70616,2019-02-09,15,53,308,361
70617,2019-02-09,16,52,292,344
70618,2019-02-09,17,45,259,304
70619,2019-02-09,18,16,215,231
70620,2019-02-09,19,13,172,185
70621,2019-02-09,20,12,125,137
70622,2019-02-09,21,21,104,125
70623,2019-02-09,22,10,88,98
70624,2019-02-09,23,9,68,77
70625,2019-02-10,0,3,67,70
70626,2019-02-10,1,3,47,50
70627,2019-02-10,2,7,31,38
70628,2019-02-10,3,2,9,11
70629,2019-02-10,4,0,6,6
70630,2019-02-10,5,0,8,8
70631,2019-02-10,6,0,12,12
70632,2019-02-10,7,1,44,45
70633,2019-02-10,8,6,108,114
70634,2019-02-10,9,15,174,189
70635,2019-02-10,10,31,279,310
70636,2019-02-10,11,33,274,307
70637,2019-02-10,12,53,293,346
70638,2019-02-10,13,82,334,416
70639,2019-02-10,14,63,341,404
70640,2019-02-10,15,55,330,385
70641,2019-02-10,16,37,271,308
70642,2019-02-10,17,32,240,272
70643,2019-02-10,18,17,211,228
70644,2019-02-10,19,10,168,178
70645,2019-02-10,20,10,107,117
70646,2019-02-10,21,6,69,75
70647,2019-02-10,22,2,14,16
70648,2019-02-10,23,0,19,19
70649,2019-02-11,0,0,5,5
70650,2019-02-11,1,0,4,4
70651,2019-02-11,2,0,3,3
70652,2019-02-11,3,0,2,2
70653,2019-02-11,4,0,6,6
70654,2019-02-11,5,0,31,31
70655,2019-02-11,6,0,55,55
70656,2019-02-11,7,0,115,115
70657,2019-02-11,8,8,208,216
70658,2019-02-11,9,5,222,227
70659,2019-02-11,10,8,133,141
70660,2019-02-11,11,1,128,129
70661,2019-02-11,12,6,66,72
70662,2019-02-11,13,5,75,80
70663,2019-02-11,14,4,58,62
70664,2019-02-11,15,3,98,101
70665,2019-02-11,16,6,270,276
70666,2019-02-11,17,9,535,544
70667,2019-02-11,18,4,484,488
70668,2019-02-11,19,5,286,291
70669,2019-02-11,20,3,196,199
70670,2019-02-11,21,3,111,114
70671,2019-02-11,22,2,48,50
70672,2019-02-11,23,0,32,32
70673,2019-02-12,0,0,22,22
70674,2019-02-12,1,0,5,5
70675,2019-02-12,2,0,7,7
70676,2019-02-12,3,0,3,3
70677,2019-02-12,4,0,9,9
70678,2019-02-12,5,0,49,49
70679,2019-02-12,6,2,107,109
70680,2019-02-12,7,1,174,175
70681,2019-02-12,8,4,213,217
70682,2019-02-12,9,0,108,108
70683,2019-02-12,10,2,59,61
70684,2019-02-12,11,1,52,53
70685,2019-02-12,12,4,70,74
70686,2019-02-12,13,4,73,77
70687,2019-02-12,14,3,69,72
70688,2019-02-12,15,1,95,96
70689,2019-02-12,16,2,217,219
70690,2019-02-12,17,2,355,357
70691,2019-02-12,18,3,300,303
70692,2019-02-12,19,5,200,205
70693,2019-02-12,20,1,147,148
70694,2019-02-12,21,3,105,108
70695,2019-02-12,22,1,70,71
70696,2019-02-12,23,1,36,37
70697,2019-02-13,0,3,14,17
70698,2019-02-13,1,0,11,11
70699,2019-02-13,2,0,9,9
70700,2019-02-13,3,0,3,3
70701,2019-02-13,4,1,11,12
70702,2019-02-13,5,0,88,88
70703,2019-02-13,6,1,244,245
70704,2019-02-13,7,6,549,555
70705,2019-02-13,8,18,931,949
70706,2019-02-13,9,14,487,501
70707,2019-02-13,10,11,188,199
70708,2019-02-13,11,9,206,215
70709,2019-02-13,12,21,277,298
70710,2019-02-13,13,28,280,308
70711,2019-02-13,14,24,243,267
70712,2019-02-13,15,19,308,327
70713,2019-02-13,16,30,513,543
70714,2019-02-13,17,31,922,953
70715,2019-02-13,18,26,665,691
70716,2019-02-13,19,12,444,456
70717,2019-02-13,20,10,284,294
70718,2019-02-13,21,2,196,198
70719,2019-02-13,22,3,107,110
70720,2019-02-13,23,1,52,53
70721,2019-02-14,0,2,22,24
70722,2019-02-14,1,2,3,5
70723,2019-02-14,2,0,7,7
70724,2019-02-14,3,0,3,3
70725,2019-02-14,4,1,9,10
70726,2019-02-14,5,2,75,77
70727,2019-02-14,6,1,207,208
70728,2019-02-14,7,5,567,572
70729,2019-02-14,8,19,1004,1023
70730,2019-02-14,9,9,462,471
70731,2019-02-14,10,20,210,230
70732,2019-02-14,11,15,219,234
70733,2019-02-14,12,26,290,316
70734,2019-02-14,13,24,285,309
70735,2019-02-14,14,35,240,275
70736,2019-02-14,15,45,323,368
70737,2019-02-14,16,57,547,604
70738,2019-02-14,17,56,956,1012
70739,2019-02-14,18,45,684,729
70740,2019-02-14,19,15,376,391
70741,2019-02-14,20,10,203,213
70742,2019-02-14,21,5,159,164
70743,2019-02-14,22,4,122,126
70744,2019-02-14,23,8,73,81
70745,2019-02-15,0,4,32,36
70746,2019-02-15,1,7,20,27
70747,2019-02-15,2,0,14,14
70748,2019-02-15,3,0,4,4
70749,2019-02-15,4,0,9,9
70750,2019-02-15,5,1,72,73
70751,2019-02-15,6,3,203,206
70752,2019-02-15,7,15,482,497
70753,2019-02-15,8,27,950,977
70754,2019-02-15,9,17,504,521
70755,2019-02-15,10,24,260,284
70756,2019-02-15,11,48,340,388
70757,2019-02-15,12,85,382,467
70758,2019-02-15,13,113,418,531
70759,2019-02-15,14,164,414,578
70760,2019-02-15,15,148,527,675
70761,2019-02-15,16,96,695,791
70762,2019-02-15,17,126,948,1074
70763,2019-02-15,18,73,658,731
70764,2019-02-15,19,59,430,489
70765,2019-02-15,20,42,241,283
70766,2019-02-15,21,35,163,198
70767,2019-02-15,22,30,160,190
70768,2019-02-15,23,30,102,132
70769,2019-02-16,0,10,73,83
70770,2019-02-16,1,5,45,50
70771,2019-02-16,2,13,35,48
70772,2019-02-16,3,1,8,9
70773,2019-02-16,4,2,7,9
70774,2019-02-16,5,4,17,21
70775,2019-02-16,6,0,23,23
70776,2019-02-16,7,5,89,94
70777,2019-02-16,8,19,149,168
70778,2019-02-16,9,33,250,283
70779,2019-02-16,10,63,318,381
70780,2019-02-16,11,86,326,412
70781,2019-02-16,12,99,381,480
70782,2019-02-16,13,97,355,452
70783,2019-02-16,14,171,416,587
70784,2019-02-16,15,200,388,588
70785,2019-02-16,16,145,374,519
70786,2019-02-16,17,112,334,446
70787,2019-02-16,18,59,245,304
70788,2019-02-16,19,33,213,246
70789,2019-02-16,20,26,127,153
70790,2019-02-16,21,18,126,144
70791,2019-02-16,22,23,90,113
70792,2019-02-16,23,11,77,88
70793,2019-02-17,0,8,62,70
70794,2019-02-17,1,1,38,39
70795,2019-02-17,2,5,22,27
70796,2019-02-17,3,0,17,17
70797,2019-02-17,4,1,9,10
70798,2019-02-17,5,0,8,8
70799,2019-02-17,6,2,27,29
70800,2019-02-17,7,4,42,46
70801,2019-02-17,8,14,109,123
70802,2019-02-17,9,44,226,270
70803,2019-02-17,10,83,232,315
70804,2019-02-17,11,112,268,380
70805,2019-02-17,12,99,332,431
70806,2019-02-17,13,86,353,439
70807,2019-02-17,14,92,282,374
70808,2019-02-17,15,95,331,426
70809,2019-02-17,16,79,318,397
70810,2019-02-17,17,49,181,230
70811,2019-02-17,18,14,168,182
70812,2019-02-17,19,0,59,59
70813,2019-02-17,20,0,47,47
70814,2019-02-17,21,7,29,36
70815,2019-02-17,22,1,22,23
70816,2019-02-17,23,0,13,13
70817,2019-02-18,0,0,15,15
70818,2019-02-18,1,0,13,13
70819,2019-02-18,2,0,1,1
70820,2019-02-18,4,0,2,2
70821,2019-02-18,5,1,16,17
70822,2019-02-18,6,2,49,51
70823,2019-02-18,7,5,85,90
70824,2019-02-18,8,12,185,197
70825,2019-02-18,9,36,250,286
70826,2019-02-18,10,71,212,283
70827,2019-02-18,11,62,325,387
70828,2019-02-18,12,77,308,385
70829,2019-02-18,13,81,357,438
70830,2019-02-18,14,93,336,429
70831,2019-02-18,15,45,296,341
70832,2019-02-18,16,46,290,336
70833,2019-02-18,17,44,371,415
70834,2019-02-18,18,16,303,319
70835,2019-02-18,19,17,190,207
70836,2019-02-18,20,10,132,142
70837,2019-02-18,21,9,102,111
70838,2019-02-18,22,9,69,78
70839,2019-02-18,23,3,43,46
70840,2019-02-19,0,0,14,14
70841,2019-02-19,1,0,4,4
70842,2019-02-19,2,0,5,5
70843,2019-02-19,3,0,3,3
70844,2019-02-19,4,1,6,7
70845,2019-02-19,5,0,70,70
70846,2019-02-19,6,2,222,224
70847,2019-02-19,7,4,512,516
70848,2019-02-19,8,17,809,826
70849,2019-02-19,9,15,412,427
70850,2019-02-19,10,16,183,199
70851,2019-02-19,11,30,179,209
70852,2019-02-19,12,19,218,237
70853,2019-02-19,13,23,225,248
70854,2019-02-19,14,30,204,234
70855,2019-02-19,15,21,211,232
70856,2019-02-19,16,41,412,453
70857,2019-02-19,17,34,754,788
70858,2019-02-19,18,19,627,646
70859,2019-02-19,19,17,370,387
70860,2019-02-19,20,3,260,263
70861,2019-02-19,21,8,159,167
70862,2019-02-19,22,5,98,103
70863,2019-02-19,23,3,54,57
70864,2019-02-20,0,4,22,26
70865,2019-02-20,1,1,16,17
70866,2019-02-20,2,0,16,16
70867,2019-02-20,3,0,1,1
70868,2019-02-20,4,0,11,11
70869,2019-02-20,5,1,40,41
70870,2019-02-20,6,0,59,59
70871,2019-02-20,7,2,53,55
70872,2019-02-20,8,3,54,57
70873,2019-02-20,9,1,40,41
70874,2019-02-20,10,1,34,35
70875,2019-02-20,11,0,23,23
70876,2019-02-20,12,1,21,22
70877,2019-02-20,13,2,26,28
70878,2019-02-20,14,1,38,39
70879,2019-02-20,15,2,39,41
70880,2019-02-20,16,2,55,57
70881,2019-02-20,17,4,74,78
70882,2019-02-20,18,5,87,92
70883,2019-02-20,19,0,57,57
70884,2019-02-20,20,0,53,53
70885,2019-02-20,21,2,31,33
70886,2019-02-20,22,0,39,39
70887,2019-02-20,23,0,20,20
70888,2019-02-21,0,0,14,14
70889,2019-02-21,1,0,5,5
70890,2019-02-21,2,0,5,5
70891,2019-02-21,3,0,2,2
70892,2019-02-21,4,0,4,4
70893,2019-02-21,5,1,50,51
70894,2019-02-21,6,3,131,134
70895,2019-02-21,7,2,329,331
70896,2019-02-21,8,12,624,636
70897,2019-02-21,9,3,365,368
70898,2019-02-21,10,15,158,173
70899,2019-02-21,11,19,182,201
70900,2019-02-21,12,18,212,230
70901,2019-02-21,13,31,244,275
70902,2019-02-21,14,35,217,252
70903,2019-02-21,15,51,294,345
70904,2019-02-21,16,37,461,498
70905,2019-02-21,17,98,890,988
70906,2019-02-21,18,55,724,779
70907,2019-02-21,19,46,449,495
70908,2019-02-21,20,47,301,348
70909,2019-02-21,21,13,212,225
70910,2019-02-21,22,5,142,147
70911,2019-02-21,23,9,76,85
70912,2019-02-22,0,6,27,33
70913,2019-02-22,1,4,20,24
70914,2019-02-22,2,1,10,11
70915,2019-02-22,3,0,4,4
70916,2019-02-22,4,1,10,11
70917,2019-02-22,5,1,73,74
70918,2019-02-22,6,0,191,191
70919,2019-02-22,7,6,478,484
70920,2019-02-22,8,26,874,900
70921,2019-02-22,9,23,443,466
70922,2019-02-22,10,39,217,256
70923,2019-02-22,11,47,211,258
70924,2019-02-22,12,33,264,297
70925,2019-02-22,13,45,275,320
70926,2019-02-22,14,56,242,298
70927,2019-02-22,15,77,341,418
70928,2019-02-22,16,67,497,564
70929,2019-02-22,17,66,817,883
70930,2019-02-22,18,34,557,591
70931,2019-02-22,19,22,381,403
70932,2019-02-22,20,32,248,280
70933,2019-02-22,21,14,159,173
70934,2019-02-22,22,10,139,149
70935,2019-02-22,23,9,86,95
70936,2019-02-23,0,8,64,72
70937,2019-02-23,1,2,52,54
70938,2019-02-23,2,3,49,52
70939,2019-02-23,3,5,16,21
70940,2019-02-23,4,3,12,15
70941,2019-02-23,5,2,13,15
70942,2019-02-23,6,2,28,30
70943,2019-02-23,7,2,66,68
70944,2019-02-23,8,11,192,203
70945,2019-02-23,9,23,266,289
70946,2019-02-23,10,34,276,310
70947,2019-02-23,11,32,237,269
70948,2019-02-23,12,17,183,200
70949,2019-02-23,13,7,154,161
70950,2019-02-23,14,14,107,121
70951,2019-02-23,15,18,98,116
70952,2019-02-23,16,11,152,163
70953,2019-02-23,17,18,147,165
70954,2019-02-23,18,9,97,106
70955,2019-02-23,19,5,73,78
70956,2019-02-23,20,2,77,79
70957,2019-02-23,21,6,46,52
70958,2019-02-23,22,7,55,62
70959,2019-02-23,23,1,52,53
70960,2019-02-24,0,5,45,50
70961,2019-02-24,1,5,42,47
70962,2019-02-24,2,3,14,17
70963,2019-02-24,3,0,7,7
70964,2019-02-24,4,0,4,4
70965,2019-02-24,5,0,4,4
70966,2019-02-24,6,3,7,10
70967,2019-02-24,7,2,24,26
70968,2019-02-24,8,3,42,45
70969,2019-02-24,9,4,135,139
70970,2019-02-24,10,13,213,226
70971,2019-02-24,11,40,270,310
70972,2019-02-24,12,72,320,392
70973,2019-02-24,13,70,353,423
70974,2019-02-24,14,102,470,572
70975,2019-02-24,15,140,572,712
70976,2019-02-24,16,145,518,663
70977,2019-02-24,17,108,491,599
70978,2019-02-24,18,45,323,368
70979,2019-02-24,19,19,197,216
70980,2019-02-24,20,14,133,147
70981,2019-02-24,21,12,89,101
70982,2019-02-24,22,4,51,55
70983,2019-02-24,23,0,64,64
70984,2019-02-25,0,0,24,24
70985,2019-02-25,1,0,6,6
70986,2019-02-25,2,0,2,2
70987,2019-02-25,3,0,5,5
70988,2019-02-25,4,0,13,13
70989,2019-02-25,5,1,67,68
70990,2019-02-25,6,0,181,181
70991,2019-02-25,7,4,486,490
70992,2019-02-25,8,16,740,756
70993,2019-02-25,9,13,330,343
70994,2019-02-25,10,18,170,188
70995,2019-02-25,11,10,139,149
70996,2019-02-25,12,12,187,199
70997,2019-02-25,13,12,164,176
70998,2019-02-25,14,17,185,202
70999,2019-02-25,15,25,241,266
71000,2019-02-25,16,18,418,436
71001,2019-02-25,17,25,812,837
71002,2019-02-25,18,17,626,643
71003,2019-02-25,19,14,372,386
71004,2019-02-25,20,3,256,259
71005,2019-02-25,21,12,151,163
71006,2019-02-25,22,15,72,87
71007,2019-02-25,23,7,36,43
71008,2019-02-26,0,3,15,18
71009,2019-02-26,1,0,7,7
71010,2019-02-26,2,0,4,4
71011,2019-02-26,3,1,3,4
71012,2019-02-26,4,1,14,15
71013,2019-02-26,5,2,88,90
71014,2019-02-26,6,5,233,238
71015,2019-02-26,7,10,613,623
71016,2019-02-26,8,12,962,974
71017,2019-02-26,9,15,443,458
71018,2019-02-26,10,10,186,196
71019,2019-02-26,11,16,237,253
71020,2019-02-26,12,24,283,307
71021,2019-02-26,13,25,244,269
71022,2019-02-26,14,36,228,264
71023,2019-02-26,15,42,323,365
71024,2019-02-26,16,36,540,576
71025,2019-02-26,17,71,1015,1086
71026,2019-02-26,18,27,730,757
71027,2019-02-26,19,17,414,431
71028,2019-02-26,20,17,262,279
71029,2019-02-26,21,12,182,194
71030,2019-02-26,22,6,100,106
71031,2019-02-26,23,2,42,44
71032,2019-02-27,0,2,24,26
71033,2019-02-27,1,0,6,6
71034,2019-02-27,2,1,6,7
71035,2019-02-27,3,0,2,2
71036,2019-02-27,4,1,14,15
71037,2019-02-27,5,1,73,74
71038,2019-02-27,6,3,243,246
71039,2019-02-27,7,5,556,561
71040,2019-02-27,8,21,969,990
71041,2019-02-27,9,16,484,500
71042,2019-02-27,10,14,178,192
71043,2019-02-27,11,13,176,189
71044,2019-02-27,12,17,231,248
71045,2019-02-27,13,23,223,246
71046,2019-02-27,14,22,189,211
71047,2019-02-27,15,10,235,245
71048,2019-02-27,16,15,466,481
71049,2019-02-27,17,40,813,853
71050,2019-02-27,18,18,652,670
71051,2019-02-27,19,15,416,431
71052,2019-02-27,20,9,255,264
71053,2019-02-27,21,8,189,197
71054,2019-02-27,22,12,111,123
71055,2019-02-27,23,4,50,54
71056,2019-02-28,0,7,26,33
71057,2019-02-28,1,0,11,11
71058,2019-02-28,2,0,2,2
71059,2019-02-28,4,1,11,12
71060,2019-02-28,5,1,70,71
71061,2019-02-28,6,4,227,231
71062,2019-02-28,7,8,586,594
71063,2019-02-28,8,20,1000,1020
71064,2019-02-28,9,16,458,474
71065,2019-02-28,10,35,193,228
71066,2019-02-28,11,27,228,255
71067,2019-02-28,12,26,291,317
71068,2019-02-28,13,41,240,281
71069,2019-02-28,14,40,242,282
71070,2019-02-28,15,47,312,359
71071,2019-02-28,16,53,496,549
71072,2019-02-28,17,45,909,954
71073,2019-02-28,18,25,692,717
71074,2019-02-28,19,12,388,400
71075,2019-02-28,20,9,272,281
71076,2019-02-28,21,9,176,185
71077,2019-02-28,22,4,107,111
71078,2019-02-28,23,3,73,76
71079,2019-03-01,0,1,21,22
71080,2019-03-01,1,0,10,10
71081,2019-03-01,2,0,1,1
71082,2019-03-01,3,0,3,3
71083,2019-03-01,4,3,5,8
71084,2019-03-01,5,0,37,37
71085,2019-03-01,6,1,117,118
71086,2019-03-01,7,7,266,273
71087,2019-03-01,8,8,576,584
71088,2019-03-01,9,10,320,330
71089,2019-03-01,10,9,143,152
71090,2019-03-01,11,19,200,219
71091,2019-03-01,12,12,226,238
71092,2019-03-01,13,17,219,236
71093,2019-03-01,14,22,204,226
71094,2019-03-01,15,15,254,269
71095,2019-03-01,16,20,384,404
71096,2019-03-01,17,26,426,452
71097,2019-03-01,18,13,240,253
71098,2019-03-01,19,6,94,100
71099,2019-03-01,20,2,50,52
71100,2019-03-01,21,3,25,28
71101,2019-03-01,22,2,20,22
71102,2019-03-01,23,1,31,32
71103,2019-03-02,0,2,24,26
71104,2019-03-02,1,0,19,19
71105,2019-03-02,2,4,19,23
71106,2019-03-02,3,0,7,7
71107,2019-03-02,4,0,2,2
71108,2019-03-02,5,1,7,8
71109,2019-03-02,6,1,19,20
71110,2019-03-02,7,5,70,75
71111,2019-03-02,8,14,142,156
71112,2019-03-02,9,29,221,250
71113,2019-03-02,10,50,313,363
71114,2019-03-02,11,59,353,412
71115,2019-03-02,12,76,377,453
71116,2019-03-02,13,86,373,459
71117,2019-03-02,14,119,394,513
71118,2019-03-02,15,133,414,547
71119,2019-03-02,16,120,390,510
71120,2019-03-02,17,124,345,469
71121,2019-03-02,18,56,245,301
71122,2019-03-02,19,25,208,233
71123,2019-03-02,20,21,133,154
71124,2019-03-02,21,17,114,131
71125,2019-03-02,22,22,107,129
71126,2019-03-02,23,17,93,110
71127,2019-03-03,0,5,63,68
71128,2019-03-03,1,12,59,71
71129,2019-03-03,2,11,36,47
71130,2019-03-03,3,2,25,27
71131,2019-03-03,4,0,6,6
71132,2019-03-03,5,0,17,17
71133,2019-03-03,6,3,30,33
71134,2019-03-03,7,6,38,44
71135,2019-03-03,8,14,111,125
71136,2019-03-03,9,17,180,197
71137,2019-03-03,10,35,274,309
71138,2019-03-03,11,53,321,374
71139,2019-03-03,12,26,294,320
71140,2019-03-03,13,27,158,185
71141,2019-03-03,14,6,94,100
71142,2019-03-03,15,2,84,86
71143,2019-03-03,16,9,65,74
71144,2019-03-03,17,2,69,71
71145,2019-03-03,18,2,42,44
71146,2019-03-03,19,1,30,31
71147,2019-03-03,20,0,21,21
71148,2019-03-03,21,1,18,19
71149,2019-03-03,22,0,25,25
71150,2019-03-03,23,0,14,14
71151,2019-03-04,0,0,9,9
71152,2019-03-04,1,0,7,7
71153,2019-03-04,2,0,2,2
71154,2019-03-04,3,0,1,1
71155,2019-03-04,4,0,12,12
71156,2019-03-04,5,4,70,74
71157,2019-03-04,6,3,218,221
71158,2019-03-04,7,11,490,501
71159,2019-03-04,8,19,865,884
71160,2019-03-04,9,23,427,450
71161,2019-03-04,10,25,148,173
71162,2019-03-04,11,27,150,177
71163,2019-03-04,12,27,202,229
71164,2019-03-04,13,34,207,241
71165,2019-03-04,14,31,195,226
71166,2019-03-04,15,36,239,275
71167,2019-03-04,16,46,432,478
71168,2019-03-04,17,40,887,927
71169,2019-03-04,18,24,608,632
71170,2019-03-04,19,3,334,337
71171,2019-03-04,20,8,175,183
71172,2019-03-04,21,0,140,140
71173,2019-03-04,22,4,63,67
71174,2019-03-04,23,0,19,19
71175,2019-03-05,0,4,13,17
71176,2019-03-05,1,6,7,13
71177,2019-03-05,2,4,3,7
71178,2019-03-05,3,0,4,4
71179,2019-03-05,4,0,11,11
71180,2019-03-05,5,1,77,78
71181,2019-03-05,6,3,201,204
71182,2019-03-05,7,8,543,551
71183,2019-03-05,8,22,913,935
71184,2019-03-05,9,13,444,457
71185,2019-03-05,10,21,165,186
71186,2019-03-05,11,21,156,177
71187,2019-03-05,12,32,236,268
71188,2019-03-05,13,31,222,253
71189,2019-03-05,14,46,204,250
71190,2019-03-05,15,65,289,354
71191,2019-03-05,16,63,470,533
71192,2019-03-05,17,69,897,966
71193,2019-03-05,18,25,618,643
71194,2019-03-05,19,11,352,363
71195,2019-03-05,20,5,226,231
71196,2019-03-05,21,4,126,130
71197,2019-03-05,22,3,74,77
71198,2019-03-05,23,5,46,51
71199,2019-03-06,0,1,13,14
71200,2019-03-06,1,0,11,11
71201,2019-03-06,2,0,3,3
71202,2019-03-06,4,0,11,11
71203,2019-03-06,5,0,61,61
71204,2019-03-06,6,3,212,215
71205,2019-03-06,7,4,441,445
71206,2019-03-06,8,19,782,801
71207,2019-03-06,9,19,371,390
71208,2019-03-06,10,9,160,169
71209,2019-03-06,11,9,168,177
71210,2019-03-06,12,17,194,211
71211,2019-03-06,13,10,178,188
71212,2019-03-06,14,7,165,172
71213,2019-03-06,15,13,235,248
71214,2019-03-06,16,18,369,387
71215,2019-03-06,17,25,733,758
71216,2019-03-06,18,19,505,524
71217,2019-03-06,19,7,297,304
71218,2019-03-06,20,3,201,204
71219,2019-03-06,21,3,130,133
71220,2019-03-06,22,3,75,78
71221,2019-03-06,23,1,32,33
71222,2019-03-07,0,1,19,20
71223,2019-03-07,1,0,7,7
71224,2019-03-07,3,0,2,2
71225,2019-03-07,4,0,11,11
71226,2019-03-07,5,2,66,68
71227,2019-03-07,6,2,173,175
71228,2019-03-07,7,6,506,512
71229,2019-03-07,8,22,815,837
71230,2019-03-07,9,24,431,455
71231,2019-03-07,10,18,160,178
71232,2019-03-07,11,16,195,211
71233,2019-03-07,12,24,234,258
71234,2019-03-07,13,29,256,285
71235,2019-03-07,14,39,204,243
71236,2019-03-07,15,34,285,319
71237,2019-03-07,16,39,484,523
71238,2019-03-07,17,47,820,867
71239,2019-03-07,18,33,606,639
71240,2019-03-07,19,8,390,398
71241,2019-03-07,20,10,246,256
71242,2019-03-07,21,10,170,180
71243,2019-03-07,22,10,120,130
71244,2019-03-07,23,7,48,55
71245,2019-03-08,0,0,35,35
71246,2019-03-08,1,3,13,16
71247,2019-03-08,2,7,4,11
71248,2019-03-08,3,2,4,6
71249,2019-03-08,4,1,6,7
71250,2019-03-08,5,1,78,79
71251,2019-03-08,6,3,181,184
71252,2019-03-08,7,8,486,494
71253,2019-03-08,8,18,843,861
71254,2019-03-08,9,22,475,497
71255,2019-03-08,10,35,221,256
71256,2019-03-08,11,34,260,294
71257,2019-03-08,12,29,242,271
71258,2019-03-08,13,16,229,245
71259,2019-03-08,14,11,149,160
71260,2019-03-08,15,7,115,122
71261,2019-03-08,16,9,158,167
71262,2019-03-08,17,9,263,272
71263,2019-03-08,18,11,201,212
71264,2019-03-08,19,3,129,132
71265,2019-03-08,20,6,123,129
71266,2019-03-08,21,5,79,84
71267,2019-03-08,22,11,85,96
71268,2019-03-08,23,0,65,65
71269,2019-03-09,0,4,40,44
71270,2019-03-09,1,2,31,33
71271,2019-03-09,2,2,15,17
71272,2019-03-09,3,7,9,16
71273,2019-03-09,4,0,6,6
71274,2019-03-09,5,3,18,21
71275,2019-03-09,6,7,50,57
71276,2019-03-09,7,17,135,152
71277,2019-03-09,8,39,210,249
71278,2019-03-09,9,39,336,375
71279,2019-03-09,10,85,391,476
71280,2019-03-09,11,94,410,504
71281,2019-03-09,12,109,412,521
71282,2019-03-09,13,101,355,456
71283,2019-03-09,14,101,312,413
71284,2019-03-09,15,103,358,461
71285,2019-03-09,16,122,362,484
71286,2019-03-09,17,71,318,389
71287,2019-03-09,18,34,245,279
71288,2019-03-09,19,24,210,234
71289,2019-03-09,20,21,145,166
71290,2019-03-09,21,18,116,134
71291,2019-03-09,22,8,70,78
71292,2019-03-09,23,3,35,38
71293,2019-03-10,0,0,35,35
71294,2019-03-10,1,1,13,14
71295,2019-03-10,3,1,13,14
71296,2019-03-10,4,1,8,9
71297,2019-03-10,5,0,7,7
71298,2019-03-10,6,1,16,17
71299,2019-03-10,7,3,39,42
71300,2019-03-10,8,4,82,86
71301,2019-03-10,9,11,124,135
71302,2019-03-10,10,30,236,266
71303,2019-03-10,11,59,312,371
71304,2019-03-10,12,83,341,424
71305,2019-03-10,13,114,394,508
71306,2019-03-10,14,130,439,569
71307,2019-03-10,15,189,534,723
71308,2019-03-10,16,239,555,794
71309,2019-03-10,17,207,510,717
71310,2019-03-10,18,180,476,656
71311,2019-03-10,19,99,275,374
71312,2019-03-10,20,70,204,274
71313,2019-03-10,21,50,161,211
71314,2019-03-10,22,51,142,193
71315,2019-03-10,23,10,81,91
71316,2019-03-11,0,4,36,40
71317,2019-03-11,1,7,15,22
71318,2019-03-11,2,4,13,17
71319,2019-03-11,3,0,4,4
71320,2019-03-11,4,4,9,13
71321,2019-03-11,5,3,72,75
71322,2019-03-11,6,5,230,235
71323,2019-03-11,7,13,571,584
71324,2019-03-11,8,34,1098,1132
71325,2019-03-11,9,37,507,544
71326,2019-03-11,10,31,227,258
71327,2019-03-11,11,50,228,278
71328,2019-03-11,12,60,285,345
71329,2019-03-11,13,81,300,381
71330,2019-03-11,14,76,303,379
71331,2019-03-11,15,115,348,463
71332,2019-03-11,16,129,609,738
71333,2019-03-11,17,150,1201,1351
71334,2019-03-11,18,103,1084,1187
71335,2019-03-11,19,75,581,656
71336,2019-03-11,20,47,372,419
71337,2019-03-11,21,30,238,268
71338,2019-03-11,22,17,129,146
71339,2019-03-11,23,13,67,80
71340,2019-03-12,0,15,24,39
71341,2019-03-12,1,3,16,19
71342,2019-03-12,2,0,6,6
71343,2019-03-12,3,1,2,3
71344,2019-03-12,4,1,10,11
71345,2019-03-12,5,1,85,86
71346,2019-03-12,6,5,245,250
71347,2019-03-12,7,11,650,661
71348,2019-03-12,8,35,1086,1121
71349,2019-03-12,9,25,540,565
71350,2019-03-12,10,25,226,251
71351,2019-03-12,11,46,262,308
71352,2019-03-12,12,34,282,316
71353,2019-03-12,13,64,283,347
71354,2019-03-12,14,67,251,318
71355,2019-03-12,15,73,333,406
71356,2019-03-12,16,82,598,680
71357,2019-03-12,17,89,1087,1176
71358,2019-03-12,18,64,937,1001
71359,2019-03-12,19,46,555,601
71360,2019-03-12,20,29,305,334
71361,2019-03-12,21,13,202,215
71362,2019-03-12,22,12,120,132
71363,2019-03-12,23,7,82,89
71364,2019-03-13,0,1,39,40
71365,2019-03-13,1,0,4,4
71366,2019-03-13,2,0,4,4
71367,2019-03-13,3,1,3,4
71368,2019-03-13,4,1,12,13
71369,2019-03-13,5,2,81,83
71370,2019-03-13,6,3,235,238
71371,2019-03-13,7,14,602,616
71372,2019-03-13,8,35,1033,1068
71373,2019-03-13,9,39,550,589
71374,2019-03-13,10,30,240,270
71375,2019-03-13,11,47,233,280
71376,2019-03-13,12,88,286,374
71377,2019-03-13,13,91,284,375
71378,2019-03-13,14,99,302,401
71379,2019-03-13,15,79,392,471
71380,2019-03-13,16,89,586,675
71381,2019-03-13,17,116,1120,1236
71382,2019-03-13,18,92,936,1028
71383,2019-03-13,19,54,508,562
71384,2019-03-13,20,32,302,334
71385,2019-03-13,21,31,261,292
71386,2019-03-13,22,23,151,174
71387,2019-03-13,23,9,66,75
71388,2019-03-14,0,6,26,32
71389,2019-03-14,1,7,13,20
71390,2019-03-14,2,4,2,6
71391,2019-03-14,3,0,3,3
71392,2019-03-14,4,0,11,11
71393,2019-03-14,5,4,93,97
71394,2019-03-14,6,1,245,246
71395,2019-03-14,7,13,594,607
71396,2019-03-14,8,32,1134,1166
71397,2019-03-14,9,36,587,623
71398,2019-03-14,10,55,249,304
71399,2019-03-14,11,106,299,405
71400,2019-03-14,12,113,374,487
71401,2019-03-14,13,123,364,487
71402,2019-03-14,14,124,356,480
71403,2019-03-14,15,173,477,650
71404,2019-03-14,16,186,747,933
71405,2019-03-14,17,234,1341,1575
71406,2019-03-14,18,177,1078,1255
71407,2019-03-14,19,125,683,808
71408,2019-03-14,20,128,445,573
71409,2019-03-14,21,81,314,395
71410,2019-03-14,22,62,211,273
71411,2019-03-14,23,33,108,141
71412,2019-03-15,0,24,63,87
71413,2019-03-15,1,4,21,25
71414,2019-03-15,2,0,11,11
71415,2019-03-15,3,3,4,7
71416,2019-03-15,4,3,15,18
71417,2019-03-15,5,2,90,92
71418,2019-03-15,6,2,188,190
71419,2019-03-15,7,12,555,567
71420,2019-03-15,8,48,1112,1160
71421,2019-03-15,9,55,629,684
71422,2019-03-15,10,53,345,398
71423,2019-03-15,11,83,361,444
71424,2019-03-15,12,107,470,577
71425,2019-03-15,13,139,413,552
71426,2019-03-15,14,145,405,550
71427,2019-03-15,15,206,561,767
71428,2019-03-15,16,186,773,959
71429,2019-03-15,17,205,1243,1448
71430,2019-03-15,18,176,996,1172
71431,2019-03-15,19,120,564,684
71432,2019-03-15,20,113,359,472
71433,2019-03-15,21,93,247,340
71434,2019-03-15,22,65,214,279
71435,2019-03-15,23,42,147,189
71436,2019-03-16,0,29,91,120
71437,2019-03-16,1,22,61,83
71438,2019-03-16,2,28,36,64
71439,2019-03-16,3,23,15,38
71440,2019-03-16,4,5,8,13
71441,2019-03-16,5,2,20,22
71442,2019-03-16,6,2,45,47
71443,2019-03-16,7,4,87,91
71444,2019-03-16,8,17,195,212
71445,2019-03-16,9,47,339,386
71446,2019-03-16,10,90,379,469
71447,2019-03-16,11,131,476,607
71448,2019-03-16,12,191,544,735
71449,2019-03-16,13,194,573,767
71450,2019-03-16,14,230,604,834
71451,2019-03-16,15,286,611,897
71452,2019-03-16,16,242,553,795
71453,2019-03-16,17,220,589,809
71454,2019-03-16,18,139,494,633
71455,2019-03-16,19,65,314,379
71456,2019-03-16,20,34,207,241
71457,2019-03-16,21,56,155,211
71458,2019-03-16,22,26,126,152
71459,2019-03-16,23,25,92,117
71460,2019-03-17,0,7,84,91
71461,2019-03-17,1,2,50,52
71462,2019-03-17,2,3,37,40
71463,2019-03-17,3,4,16,20
71464,2019-03-17,4,2,12,14
71465,2019-03-17,5,2,9,11
71466,2019-03-17,6,6,32,38
71467,2019-03-17,7,12,75,87
71468,2019-03-17,8,14,145,159
71469,2019-03-17,9,49,262,311
71470,2019-03-17,10,84,338,422
71471,2019-03-17,11,145,431,576
71472,2019-03-17,12,197,523,720
71473,2019-03-17,13,188,535,723
71474,2019-03-17,14,229,545,774
71475,2019-03-17,15,232,507,739
71476,2019-03-17,16,231,553,784
71477,2019-03-17,17,186,525,711
71478,2019-03-17,18,130,421,551
71479,2019-03-17,19,78,259,337
71480,2019-03-17,20,29,172,201
71481,2019-03-17,21,22,123,145
71482,2019-03-17,22,8,84,92
71483,2019-03-17,23,8,52,60
71484,2019-03-18,0,7,20,27
71485,2019-03-18,1,1,8,9
71486,2019-03-18,2,0,4,4
71487,2019-03-18,3,0,3,3
71488,2019-03-18,4,0,12,12
71489,2019-03-18,5,2,74,76
71490,2019-03-18,6,2,222,224
71491,2019-03-18,7,12,507,519
71492,2019-03-18,8,8,947,955
71493,2019-03-18,9,28,438,466
71494,2019-03-18,10,30,191,221
71495,2019-03-18,11,38,192,230
71496,2019-03-18,12,48,277,325
71497,2019-03-18,13,36,269,305
71498,2019-03-18,14,53,223,276
71499,2019-03-18,15,52,318,370
71500,2019-03-18,16,75,563,638
71501,2019-03-18,17,69,1071,1140
71502,2019-03-18,18,52,901,953
71503,2019-03-18,19,40,501,541
71504,2019-03-18,20,22,315,337
71505,2019-03-18,21,19,189,208
71506,2019-03-18,22,9,101,110
71507,2019-03-18,23,5,65,70
71508,2019-03-19,0,3,25,28
71509,2019-03-19,1,1,10,11
71510,2019-03-19,2,0,10,10
71511,2019-03-19,3,1,3,4
71512,2019-03-19,4,2,14,16
71513,2019-03-19,5,4,84,88
71514,2019-03-19,6,1,241,242
71515,2019-03-19,7,4,629,633
71516,2019-03-19,8,14,1078,1092
71517,2019-03-19,9,24,567,591
71518,2019-03-19,10,35,217,252
71519,2019-03-19,11,52,261,313
71520,2019-03-19,12,60,349,409
71521,2019-03-19,13,42,371,413
71522,2019-03-19,14,84,323,407
71523,2019-03-19,15,109,356,465
71524,2019-03-19,16,107,640,747
71525,2019-03-19,17,102,1204,1306
71526,2019-03-19,18,95,965,1060
71527,2019-03-19,19,50,574,624
71528,2019-03-19,20,26,314,340
71529,2019-03-19,21,12,201,213
71530,2019-03-19,22,14,135,149
71531,2019-03-19,23,5,52,57
71532,2019-03-20,0,5,22,27
71533,2019-03-20,1,3,15,18
71534,2019-03-20,2,0,7,7
71535,2019-03-20,3,0,4,4
71536,2019-03-20,4,0,13,13
71537,2019-03-20,5,1,91,92
71538,2019-03-20,6,2,250,252
71539,2019-03-20,7,9,610,619
71540,2019-03-20,8,26,1160,1186
71541,2019-03-20,9,33,595,628
71542,2019-03-20,10,31,248,279
71543,2019-03-20,11,40,267,307
71544,2019-03-20,12,43,351,394
71545,2019-03-20,13,60,341,401
71546,2019-03-20,14,93,330,423
71547,2019-03-20,15,89,443,532
71548,2019-03-20,16,100,671,771
71549,2019-03-20,17,131,1223,1354
71550,2019-03-20,18,113,1002,1115
71551,2019-03-20,19,56,620,676
71552,2019-03-20,20,17,343,360
71553,2019-03-20,21,17,269,286
71554,2019-03-20,22,21,148,169
71555,2019-03-20,23,6,68,74
71556,2019-03-21,0,5,32,37
71557,2019-03-21,1,1,2,3
71558,2019-03-21,2,2,8,10
71559,2019-03-21,3,1,2,3
71560,2019-03-21,4,1,9,10
71561,2019-03-21,5,0,48,48
71562,2019-03-21,6,1,139,140
71563,2019-03-21,7,1,208,209
71564,2019-03-21,8,7,295,302
71565,2019-03-21,9,1,119,120
71566,2019-03-21,10,1,35,36
71567,2019-03-21,11,2,35,37
71568,2019-03-21,12,8,79,87
71569,2019-03-21,13,2,57,59
71570,2019-03-21,14,2,39,41
71571,2019-03-21,15,3,81,84
71572,2019-03-21,16,1,89,90
71573,2019-03-21,17,3,139,142
71574,2019-03-21,18,1,129,130
71575,2019-03-21,19,0,145,145
71576,2019-03-21,20,4,149,153
71577,2019-03-21,21,2,87,89
71578,2019-03-21,22,0,58,58
71579,2019-03-21,23,1,19,20
71580,2019-03-22,0,1,17,18
71581,2019-03-22,1,0,3,3
71582,2019-03-22,2,1,2,3
71583,2019-03-22,3,2,3,5
71584,2019-03-22,4,0,13,13
71585,2019-03-22,5,0,68,68
71586,2019-03-22,6,1,177,178
71587,2019-03-22,7,10,457,467
71588,2019-03-22,8,19,861,880
71589,2019-03-22,9,17,461,478
71590,2019-03-22,10,28,264,292
71591,2019-03-22,11,43,304,347
71592,2019-03-22,12,41,339,380
71593,2019-03-22,13,54,342,396
71594,2019-03-22,14,78,327,405
71595,2019-03-22,15,32,358,390
71596,2019-03-22,16,13,280,293
71597,2019-03-22,17,37,601,638
71598,2019-03-22,18,23,579,602
71599,2019-03-22,19,24,389,413
71600,2019-03-22,20,13,236,249
71601,2019-03-22,21,11,158,169
71602,2019-03-22,22,9,94,103
71603,2019-03-22,23,3,97,100
71604,2019-03-23,0,10,59,69
71605,2019-03-23,1,0,33,33
71606,2019-03-23,2,5,21,26
71607,2019-03-23,3,5,11,16
71608,2019-03-23,4,0,2,2
71609,2019-03-23,5,1,10,11
71610,2019-03-23,6,1,22,23
71611,2019-03-23,7,5,77,82
71612,2019-03-23,8,17,193,210
71613,2019-03-23,9,16,299,315
71614,2019-03-23,10,51,393,444
71615,2019-03-23,11,91,464,555
71616,2019-03-23,12,133,517,650
71617,2019-03-23,13,177,469,646
71618,2019-03-23,14,202,512,714
71619,2019-03-23,15,222,582,804
71620,2019-03-23,16,228,495,723
71621,2019-03-23,17,227,471,698
71622,2019-03-23,18,128,419,547
71623,2019-03-23,19,89,284,373
71624,2019-03-23,20,48,191,239
71625,2019-03-23,21,39,165,204
71626,2019-03-23,22,27,125,152
71627,2019-03-23,23,15,121,136
71628,2019-03-24,0,13,77,90
71629,2019-03-24,1,11,57,68
71630,2019-03-24,2,15,39,54
71631,2019-03-24,3,6,22,28
71632,2019-03-24,4,2,10,12
71633,2019-03-24,5,2,12,14
71634,2019-03-24,6,4,33,37
71635,2019-03-24,7,18,67,85
71636,2019-03-24,8,30,183,213
71637,2019-03-24,9,64,296,360
71638,2019-03-24,10,133,502,635
71639,2019-03-24,11,213,606,819
71640,2019-03-24,12,249,739,988
71641,2019-03-24,13,346,739,1085
71642,2019-03-24,14,350,768,1118
71643,2019-03-24,15,413,848,1261
71644,2019-03-24,16,315,751,1066
71645,2019-03-24,17,296,702,998
71646,2019-03-24,18,246,499,745
71647,2019-03-24,19,134,374,508
71648,2019-03-24,20,60,210,270
71649,2019-03-24,21,54,146,200
71650,2019-03-24,22,36,116,152
71651,2019-03-24,23,15,62,77
71652,2019-03-25,0,18,46,64
71653,2019-03-25,1,5,13,18
71654,2019-03-25,2,1,7,8
71655,2019-03-25,3,0,5,5
71656,2019-03-25,4,1,18,19
71657,2019-03-25,5,2,98,100
71658,2019-03-25,6,9,286,295
71659,2019-03-25,7,19,618,637
71660,2019-03-25,8,32,1113,1145
71661,2019-03-25,9,38,492,530
71662,2019-03-25,10,58,233,291
71663,2019-03-25,11,51,249,300
71664,2019-03-25,12,77,341,418
71665,2019-03-25,13,101,317,418
71666,2019-03-25,14,77,320,397
71667,2019-03-25,15,68,411,479
71668,2019-03-25,16,77,561,638
71669,2019-03-25,17,114,1056,1170
71670,2019-03-25,18,59,741,800
71671,2019-03-25,19,12,457,469
71672,2019-03-25,20,18,294,312
71673,2019-03-25,21,18,205,223
71674,2019-03-25,22,8,94,102
71675,2019-03-25,23,13,71,84
71676,2019-03-26,0,3,24,27
71677,2019-03-26,1,1,13,14
71678,2019-03-26,2,0,5,5
71679,2019-03-26,3,1,3,4
71680,2019-03-26,4,0,15,15
71681,2019-03-26,5,2,82,84
71682,2019-03-26,6,1,255,256
71683,2019-03-26,7,10,687,697
71684,2019-03-26,8,31,1071,1102
71685,2019-03-26,9,29,493,522
71686,2019-03-26,10,40,192,232
71687,2019-03-26,11,50,261,311
71688,2019-03-26,12,46,287,333
71689,2019-03-26,13,48,309,357
71690,2019-03-26,14,78,308,386
71691,2019-03-26,15,78,405,483
71692,2019-03-26,16,91,646,737
71693,2019-03-26,17,144,1188,1332
71694,2019-03-26,18,85,942,1027
71695,2019-03-26,19,48,547,595
71696,2019-03-26,20,19,292,311
71697,2019-03-26,21,15,224,239
71698,2019-03-26,22,13,115,128
71699,2019-03-26,23,2,69,71
71700,2019-03-27,0,2,30,32
71701,2019-03-27,1,1,8,9
71702,2019-03-27,2,0,8,8
71703,2019-03-27,3,1,2,3
71704,2019-03-27,4,0,13,13
71705,2019-03-27,5,6,87,93
71706,2019-03-27,6,4,242,246
71707,2019-03-27,7,14,634,648
71708,2019-03-27,8,26,1124,1150
71709,2019-03-27,9,30,529,559
71710,2019-03-27,10,35,250,285
71711,2019-03-27,11,57,260,317
71712,2019-03-27,12,52,360,412
71713,2019-03-27,13,66,332,398
71714,2019-03-27,14,64,304,368
71715,2019-03-27,15,85,446,531
71716,2019-03-27,16,139,695,834
71717,2019-03-27,17,124,1201,1325
71718,2019-03-27,18,91,965,1056
71719,2019-03-27,19,60,588,648
71720,2019-03-27,20,26,348,374
71721,2019-03-27,21,26,230,256
71722,2019-03-27,22,7,138,145
71723,2019-03-27,23,14,77,91
71724,2019-03-28,0,2,27,29
71725,2019-03-28,1,1,10,11
71726,2019-03-28,2,6,8,14
71727,2019-03-28,3,1,0,1
71728,2019-03-28,4,1,15,16
71729,2019-03-28,5,2,89,91
71730,2019-03-28,6,6,231,237
71731,2019-03-28,7,15,665,680
71732,2019-03-28,8,27,1095,1122
71733,2019-03-28,9,25,539,564
71734,2019-03-28,10,41,275,316
71735,2019-03-28,11,73,332,405
71736,2019-03-28,12,103,438,541
71737,2019-03-28,13,96,368,464
71738,2019-03-28,14,115,361,476
71739,2019-03-28,15,117,450,567
71740,2019-03-28,16,169,876,1045
71741,2019-03-28,17,183,1333,1516
71742,2019-03-28,18,168,1148,1316
71743,2019-03-28,19,93,700,793
71744,2019-03-28,20,56,436,492
71745,2019-03-28,21,46,351,397
71746,2019-03-28,22,44,211,255
71747,2019-03-28,23,19,110,129
71748,2019-03-29,0,17,45,62
71749,2019-03-29,1,6,26,32
71750,2019-03-29,2,3,15,18
71751,2019-03-29,3,0,5,5
71752,2019-03-29,4,1,7,8
71753,2019-03-29,5,2,93,95
71754,2019-03-29,6,11,208,219
71755,2019-03-29,7,30,640,670
71756,2019-03-29,8,49,1118,1167
71757,2019-03-29,9,68,694,762
71758,2019-03-29,10,82,377,459
71759,2019-03-29,11,115,408,523
71760,2019-03-29,12,132,522,654
71761,2019-03-29,13,166,523,689
71762,2019-03-29,14,181,503,684
71763,2019-03-29,15,169,631,800
71764,2019-03-29,16,184,881,1065
71765,2019-03-29,17,221,1305,1526
71766,2019-03-29,18,164,966,1130
71767,2019-03-29,19,119,630,749
71768,2019-03-29,20,77,390,467
71769,2019-03-29,21,55,281,336
71770,2019-03-29,22,88,272,360
71771,2019-03-29,23,47,182,229
71772,2019-03-30,0,42,222,264
71773,2019-03-30,1,16,66,82
71774,2019-03-30,2,16,48,64
71775,2019-03-30,3,8,17,25
71776,2019-03-30,4,1,13,14
71777,2019-03-30,5,7,25,32
71778,2019-03-30,6,11,82,93
71779,2019-03-30,7,20,179,199
71780,2019-03-30,8,54,363,417
71781,2019-03-30,9,121,576,697
71782,2019-03-30,10,209,758,967
71783,2019-03-30,11,404,844,1248
71784,2019-03-30,12,454,1003,1457
71785,2019-03-30,13,511,1019,1530
71786,2019-03-30,14,563,1132,1695
71787,2019-03-30,15,646,1012,1658
71788,2019-03-30,16,634,1041,1675
71789,2019-03-30,17,666,1002,1668
71790,2019-03-30,18,523,920,1443
71791,2019-03-30,19,332,682,1014
71792,2019-03-30,20,167,324,491
71793,2019-03-30,21,155,315,470
71794,2019-03-30,22,119,249,368
71795,2019-03-30,23,102,230,332
71796,2019-03-31,0,75,164,239
71797,2019-03-31,1,29,94,123
71798,2019-03-31,2,18,71,89
71799,2019-03-31,3,23,25,48
71800,2019-03-31,4,13,16,29
71801,2019-03-31,5,8,18,26
71802,2019-03-31,6,9,50,59
71803,2019-03-31,7,18,66,84
71804,2019-03-31,8,24,113,137
71805,2019-03-31,9,28,155,183
71806,2019-03-31,10,69,293,362
71807,2019-03-31,11,109,411,520
71808,2019-03-31,12,136,478,614
71809,2019-03-31,13,111,541,652
71810,2019-03-31,14,177,558,735
71811,2019-03-31,15,196,572,768
71812,2019-03-31,16,222,590,812
71813,2019-03-31,17,140,613,753
71814,2019-03-31,18,107,428,535
71815,2019-03-31,19,52,317,369
71816,2019-03-31,20,12,171,183
71817,2019-03-31,21,11,126,137
71818,2019-03-31,22,9,69,78
71819,2019-03-31,23,1,34,35
71820,2019-04-01,0,1,19,20
71821,2019-04-01,1,0,12,12
71822,2019-04-01,2,0,4,4
71823,2019-04-01,3,0,2,2
71824,2019-04-01,4,1,20,21
71825,2019-04-01,5,4,78,82
71826,2019-04-01,6,13,229,242
71827,2019-04-01,7,4,546,550
71828,2019-04-01,8,23,913,936
71829,2019-04-01,9,23,405,428
71830,2019-04-01,10,47,183,230
71831,2019-04-01,11,40,202,242
71832,2019-04-01,12,49,319,368
71833,2019-04-01,13,46,302,348
71834,2019-04-01,14,91,310,401
71835,2019-04-01,15,79,393,472
71836,2019-04-01,16,91,613,704
71837,2019-04-01,17,119,1145,1264
71838,2019-04-01,18,86,1034,1120
71839,2019-04-01,19,57,557,614
71840,2019-04-01,20,23,312,335
71841,2019-04-01,21,12,228,240
71842,2019-04-01,22,13,138,151
71843,2019-04-01,23,4,75,79
71844,2019-04-02,0,3,31,34
71845,2019-04-02,1,0,9,9
71846,2019-04-02,2,0,5,5
71847,2019-04-02,3,1,6,7
71848,2019-04-02,4,5,12,17
71849,2019-04-02,5,2,85,87
71850,2019-04-02,6,8,296,304
71851,2019-04-02,7,13,681,694
71852,2019-04-02,8,33,1146,1179
71853,2019-04-02,9,32,588,620
71854,2019-04-02,10,41,273,314
71855,2019-04-02,11,45,294,339
71856,2019-04-02,12,53,351,404
71857,2019-04-02,13,62,276,338
71858,2019-04-02,14,56,282,338
71859,2019-04-02,15,53,367,420
71860,2019-04-02,16,43,469,512
71861,2019-04-02,17,46,805,851
71862,2019-04-02,18,26,523,549
71863,2019-04-02,19,16,295,311
71864,2019-04-02,20,7,165,172
71865,2019-04-02,21,7,147,154
71866,2019-04-02,22,12,139,151
71867,2019-04-02,23,12,73,85
71868,2019-04-03,0,3,26,29
71869,2019-04-03,1,1,7,8
71870,2019-04-03,2,0,2,2
71871,2019-04-03,3,0,5,5
71872,2019-04-03,4,2,19,21
71873,2019-04-03,5,2,83,85
71874,2019-04-03,6,6,300,306
71875,2019-04-03,7,24,778,802
71876,2019-04-03,8,42,1107,1149
71877,2019-04-03,9,41,537,578
71878,2019-04-03,10,64,307,371
71879,2019-04-03,11,106,387,493
71880,2019-04-03,12,131,515,646
71881,2019-04-03,13,148,464,612
71882,2019-04-03,14,167,472,639
71883,2019-04-03,15,183,556,739
71884,2019-04-03,16,191,843,1034
71885,2019-04-03,17,278,1538,1816
71886,2019-04-03,18,214,1354,1568
71887,2019-04-03,19,145,853,998
71888,2019-04-03,20,58,505,563
71889,2019-04-03,21,53,329,382
71890,2019-04-03,22,18,177,195
71891,2019-04-03,23,10,90,100
71892,2019-04-04,0,8,21,29
71893,2019-04-04,1,3,12,15
71894,2019-04-04,2,0,12,12
71895,2019-04-04,3,0,5,5
71896,2019-04-04,4,0,8,8
71897,2019-04-04,5,2,76,78
71898,2019-04-04,6,11,293,304
71899,2019-04-04,7,40,784,824
71900,2019-04-04,8,59,1242,1301
71901,2019-04-04,9,56,602,658
71902,2019-04-04,10,75,291,366
71903,2019-04-04,11,87,350,437
71904,2019-04-04,12,130,472,602
71905,2019-04-04,13,120,448,568
71906,2019-04-04,14,192,425,617
71907,2019-04-04,15,200,583,783
71908,2019-04-04,16,205,790,995
71909,2019-04-04,17,258,1440,1698
71910,2019-04-04,18,257,1268,1525
71911,2019-04-04,19,195,812,1007
71912,2019-04-04,20,93,513,606
71913,2019-04-04,21,62,333,395
71914,2019-04-04,22,39,223,262
71915,2019-04-04,23,15,132,147
71916,2019-04-05,0,20,67,87
71917,2019-04-05,1,9,23,32
71918,2019-04-05,2,7,16,23
71919,2019-04-05,3,3,10,13
71920,2019-04-05,4,1,15,16
71921,2019-04-05,5,4,61,65
71922,2019-04-05,6,1,109,110
71923,2019-04-05,7,12,261,273
71924,2019-04-05,8,24,567,591
71925,2019-04-05,9,12,339,351
71926,2019-04-05,10,23,163,186
71927,2019-04-05,11,14,154,168
71928,2019-04-05,12,23,204,227
71929,2019-04-05,13,36,247,283
71930,2019-04-05,14,60,294,354
71931,2019-04-05,15,65,311,376
71932,2019-04-05,16,45,453,498
71933,2019-04-05,17,48,530,578
71934,2019-04-05,18,32,500,532
71935,2019-04-05,19,33,361,394
71936,2019-04-05,20,15,237,252
71937,2019-04-05,21,21,164,185
71938,2019-04-05,22,18,142,160
71939,2019-04-05,23,11,142,153
71940,2019-04-06,0,6,73,79
71941,2019-04-06,1,14,57,71
71942,2019-04-06,2,7,40,47
71943,2019-04-06,3,5,17,22
71944,2019-04-06,4,2,13,15
71945,2019-04-06,5,3,20,23
71946,2019-04-06,6,17,56,73
71947,2019-04-06,7,15,152,167
71948,2019-04-06,8,61,259,320
71949,2019-04-06,9,140,518,658
71950,2019-04-06,10,296,655,951
71951,2019-04-06,11,337,893,1230
71952,2019-04-06,12,415,1026,1441
71953,2019-04-06,13,469,1100,1569
71954,2019-04-06,14,615,1095,1710
71955,2019-04-06,15,657,1104,1761
71956,2019-04-06,16,662,1101,1763
71957,2019-04-06,17,664,1080,1744
71958,2019-04-06,18,598,878,1476
71959,2019-04-06,19,447,695,1142
71960,2019-04-06,20,263,489,752
71961,2019-04-06,21,258,368,626
71962,2019-04-06,22,90,299,389
71963,2019-04-06,23,79,234,313
71964,2019-04-07,0,37,124,161
71965,2019-04-07,1,37,86,123
71966,2019-04-07,2,25,60,85
71967,2019-04-07,3,10,32,42
71968,2019-04-07,4,5,20,25
71969,2019-04-07,5,10,36,46
71970,2019-04-07,6,82,273,355
71971,2019-04-07,7,76,207,283
71972,2019-04-07,8,71,305,376
71973,2019-04-07,9,156,498,654
71974,2019-04-07,10,217,696,913
71975,2019-04-07,11,333,770,1103
71976,2019-04-07,12,406,894,1300
71977,2019-04-07,13,498,1035,1533
71978,2019-04-07,14,544,1061,1605
71979,2019-04-07,15,530,963,1493
71980,2019-04-07,16,473,831,1304
71981,2019-04-07,17,355,799,1154
71982,2019-04-07,18,261,627,888
71983,2019-04-07,19,144,472,616
71984,2019-04-07,20,82,238,320
71985,2019-04-07,21,82,178,260
71986,2019-04-07,22,44,109,153
71987,2019-04-07,23,29,70,99
71988,2019-04-08,0,14,31,45
71989,2019-04-08,1,3,9,12
71990,2019-04-08,2,4,8,12
71991,2019-04-08,3,2,6,8
71992,2019-04-08,4,2,14,16
71993,2019-04-08,5,9,100,109
71994,2019-04-08,6,8,296,304
71995,2019-04-08,7,25,782,807
71996,2019-04-08,8,56,1195,1251
71997,2019-04-08,9,76,549,625
71998,2019-04-08,10,68,297,365
71999,2019-04-08,11,104,400,504
72000,2019-04-08,12,118,490,608
72001,2019-04-08,13,128,512,640
72002,2019-04-08,14,141,468,609
72003,2019-04-08,15,150,547,697
72004,2019-04-08,16,122,797,919
72005,2019-04-08,17,87,933,1020
72006,2019-04-08,18,105,789,894
72007,2019-04-08,19,57,533,590
72008,2019-04-08,20,35,320,355
72009,2019-04-08,21,30,240,270
72010,2019-04-08,22,29,148,177
72011,2019-04-08,23,17,101,118
72012,2019-04-09,0,10,48,58
72013,2019-04-09,1,3,5,8
72014,2019-04-09,2,5,14,19
72015,2019-04-09,3,0,3,3
72016,2019-04-09,4,2,17,19
72017,2019-04-09,5,6,99,105
72018,2019-04-09,6,11,339,350
72019,2019-04-09,7,31,858,889
72020,2019-04-09,8,44,1330,1374
72021,2019-04-09,9,55,647,702
72022,2019-04-09,10,59,324,383
72023,2019-04-09,11,81,345,426
72024,2019-04-09,12,72,412,484
72025,2019-04-09,13,86,419,505
72026,2019-04-09,14,90,399,489
72027,2019-04-09,15,107,523,630
72028,2019-04-09,16,165,835,1000
72029,2019-04-09,17,141,1480,1621
72030,2019-04-09,18,187,1274,1461
72031,2019-04-09,19,116,847,963
72032,2019-04-09,20,62,542,604
72033,2019-04-09,21,55,403,458
72034,2019-04-09,22,57,292,349
72035,2019-04-09,23,27,97,124
72036,2019-04-10,0,20,40,60
72037,2019-04-10,1,15,19,34
72038,2019-04-10,2,3,2,5
72039,2019-04-10,3,1,2,3
72040,2019-04-10,4,1,12,13
72041,2019-04-10,5,4,104,108
72042,2019-04-10,6,14,356,370
72043,2019-04-10,7,33,920,953
72044,2019-04-10,8,64,1375,1439
72045,2019-04-10,9,49,667,716
72046,2019-04-10,10,78,315,393
72047,2019-04-10,11,86,374,460
72048,2019-04-10,12,84,445,529
72049,2019-04-10,13,89,448,537
72050,2019-04-10,14,103,393,496
72051,2019-04-10,15,97,508,605
72052,2019-04-10,16,85,804,889
72053,2019-04-10,17,131,1442,1573
72054,2019-04-10,18,147,1245,1392
72055,2019-04-10,19,121,793,914
72056,2019-04-10,20,60,483,543
72057,2019-04-10,21,34,337,371
72058,2019-04-10,22,20,198,218
72059,2019-04-10,23,6,94,100
72060,2019-04-11,0,6,45,51
72061,2019-04-11,1,1,10,11
72062,2019-04-11,2,0,7,7
72063,2019-04-11,3,0,4,4
72064,2019-04-11,4,2,12,14
72065,2019-04-11,5,5,98,103
72066,2019-04-11,6,10,300,310
72067,2019-04-11,7,28,783,811
72068,2019-04-11,8,40,1275,1315
72069,2019-04-11,9,56,635,691
72070,2019-04-11,10,53,375,428
72071,2019-04-11,11,86,354,440
72072,2019-04-11,12,75,423,498
72073,2019-04-11,13,65,468,533
72074,2019-04-11,14,82,385,467
72075,2019-04-11,15,91,536,627
72076,2019-04-11,16,80,771,851
72077,2019-04-11,17,154,1318,1472
72078,2019-04-11,18,139,1173,1312
72079,2019-04-11,19,72,658,730
72080,2019-04-11,20,42,432,474
72081,2019-04-11,21,24,319,343
72082,2019-04-11,22,29,206,235
72083,2019-04-11,23,13,110,123
72084,2019-04-12,0,6,49,55
72085,2019-04-12,1,2,15,17
72086,2019-04-12,2,5,13,18
72087,2019-04-12,3,2,5,7
72088,2019-04-12,4,0,14,14
72089,2019-04-12,5,3,97,100
72090,2019-04-12,6,7,270,277
72091,2019-04-12,7,17,660,677
72092,2019-04-12,8,42,1249,1291
72093,2019-04-12,9,62,667,729
72094,2019-04-12,10,93,412,505
72095,2019-04-12,11,92,445,537
72096,2019-04-12,12,94,494,588
72097,2019-04-12,13,34,196,230
72098,2019-04-12,14,27,283,310
72099,2019-04-12,15,73,464,537
72100,2019-04-12,16,88,591,679
72101,2019-04-12,17,83,878,961
72102,2019-04-12,18,87,702,789
72103,2019-04-12,19,38,427,465
72104,2019-04-12,20,11,246,257
72105,2019-04-12,21,11,169,180
72106,2019-04-12,22,22,191,213
72107,2019-04-12,23,30,162,192
72108,2019-04-13,0,18,112,130
72109,2019-04-13,1,14,63,77
72110,2019-04-13,2,11,47,58
72111,2019-04-13,3,8,22,30
72112,2019-04-13,4,0,2,2
72113,2019-04-13,5,1,15,16
72114,2019-04-13,6,0,36,36
72115,2019-04-13,7,8,115,123
72116,2019-04-13,8,38,264,302
72117,2019-04-13,9,81,393,474
72118,2019-04-13,10,157,618,775
72119,2019-04-13,11,272,837,1109
72120,2019-04-13,12,367,888,1255
72121,2019-04-13,13,387,938,1325
72122,2019-04-13,14,487,1006,1493
72123,2019-04-13,15,477,1023,1500
72124,2019-04-13,16,425,804,1229
72125,2019-04-13,17,450,732,1182
72126,2019-04-13,18,329,777,1106
72127,2019-04-13,19,223,577,800
72128,2019-04-13,20,141,383,524
72129,2019-04-13,21,111,313,424
72130,2019-04-13,22,102,246,348
72131,2019-04-13,23,96,201,297
72132,2019-04-14,0,62,159,221
72133,2019-04-14,1,41,116,157
72134,2019-04-14,2,30,76,106
72135,2019-04-14,3,25,30,55
72136,2019-04-14,4,7,13,20
72137,2019-04-14,5,6,16,22
72138,2019-04-14,6,2,39,41
72139,2019-04-14,7,18,84,102
72140,2019-04-14,8,53,213,266
72141,2019-04-14,9,108,334,442
72142,2019-04-14,10,170,434,604
72143,2019-04-14,11,209,573,782
72144,2019-04-14,12,210,596,806
72145,2019-04-14,13,242,595,837
72146,2019-04-14,14,284,589,873
72147,2019-04-14,15,294,617,911
72148,2019-04-14,16,268,612,880
72149,2019-04-14,17,309,560,869
72150,2019-04-14,18,200,482,682
72151,2019-04-14,19,117,327,444
72152,2019-04-14,20,58,284,342
72153,2019-04-14,21,36,104,140
72154,2019-04-14,22,35,186,221
72155,2019-04-14,23,13,75,88
72156,2019-04-15,0,9,21,30
72157,2019-04-15,1,1,5,6
72158,2019-04-15,2,0,3,3
72159,2019-04-15,3,0,6,6
72160,2019-04-15,4,4,13,17
72161,2019-04-15,5,1,72,73
72162,2019-04-15,6,6,236,242
72163,2019-04-15,7,11,501,512
72164,2019-04-15,8,25,735,760
72165,2019-04-15,9,53,504,557
72166,2019-04-15,10,72,273,345
72167,2019-04-15,11,100,275,375
72168,2019-04-15,12,91,353,444
72169,2019-04-15,13,86,334,420
72170,2019-04-15,14,93,264,357
72171,2019-04-15,15,100,347,447
72172,2019-04-15,16,101,530,631
72173,2019-04-15,17,130,947,1077
72174,2019-04-15,18,94,727,821
72175,2019-04-15,19,47,421,468
72176,2019-04-15,20,28,292,320
72177,2019-04-15,21,21,169,190
72178,2019-04-15,22,8,100,108
72179,2019-04-15,23,3,57,60
72180,2019-04-16,0,3,27,30
72181,2019-04-16,1,1,16,17
72182,2019-04-16,2,0,6,6
72183,2019-04-16,3,2,2,4
72184,2019-04-16,4,2,20,22
72185,2019-04-16,5,4,88,92
72186,2019-04-16,6,3,272,275
72187,2019-04-16,7,21,661,682
72188,2019-04-16,8,34,1047,1081
72189,2019-04-16,9,53,536,589
72190,2019-04-16,10,78,291,369
72191,2019-04-16,11,142,323,465
72192,2019-04-16,12,117,383,500
72193,2019-04-16,13,139,394,533
72194,2019-04-16,14,189,359,548
72195,2019-04-16,15,186,483,669
72196,2019-04-16,16,162,719,881
72197,2019-04-16,17,234,1365,1599
72198,2019-04-16,18,183,1175,1358
72199,2019-04-16,19,144,713,857
72200,2019-04-16,20,66,480,546
72201,2019-04-16,21,46,343,389
72202,2019-04-16,22,37,226,263
72203,2019-04-16,23,15,106,121
72204,2019-04-17,0,15,34,49
72205,2019-04-17,1,5,9,14
72206,2019-04-17,2,2,2,4
72207,2019-04-17,3,2,6,8
72208,2019-04-17,4,4,8,12
72209,2019-04-17,5,5,100,105
72210,2019-04-17,6,7,334,341
72211,2019-04-17,7,27,755,782
72212,2019-04-17,8,40,1260,1300
72213,2019-04-17,9,62,624,686
72214,2019-04-17,10,134,302,436
72215,2019-04-17,11,135,370,505
72216,2019-04-17,12,127,433,560
72217,2019-04-17,13,159,469,628
72218,2019-04-17,14,183,421,604
72219,2019-04-17,15,170,468,638
72220,2019-04-17,16,163,717,880
72221,2019-04-17,17,189,1405,1594
72222,2019-04-17,18,185,1139,1324
72223,2019-04-17,19,108,715,823
72224,2019-04-17,20,87,424,511
72225,2019-04-17,21,35,290,325
72226,2019-04-17,22,31,190,221
72227,2019-04-17,23,13,84,97
72228,2019-04-18,0,8,30,38
72229,2019-04-18,1,6,14,20
72230,2019-04-18,2,5,17,22
72231,2019-04-18,3,0,4,4
72232,2019-04-18,4,0,14,14
72233,2019-04-18,5,4,84,88
72234,2019-04-18,6,5,281,286
72235,2019-04-18,7,18,700,718
72236,2019-04-18,8,34,1173,1207
72237,2019-04-18,9,76,600,676
72238,2019-04-18,10,115,311,426
72239,2019-04-18,11,148,357,505
72240,2019-04-18,12,197,426,623
72241,2019-04-18,13,191,468,659
72242,2019-04-18,14,160,426,586
72243,2019-04-18,15,198,561,759
72244,2019-04-18,16,238,803,1041
72245,2019-04-18,17,229,1331,1560
72246,2019-04-18,18,247,1115,1362
72247,2019-04-18,19,148,718,866
72248,2019-04-18,20,105,511,616
72249,2019-04-18,21,62,352,414
72250,2019-04-18,22,65,226,291
72251,2019-04-18,23,19,150,169
72252,2019-04-19,0,31,64,95
72253,2019-04-19,1,12,40,52
72254,2019-04-19,2,9,16,25
72255,2019-04-19,3,2,4,6
72256,2019-04-19,4,0,10,10
72257,2019-04-19,5,5,73,78
72258,2019-04-19,6,7,227,234
72259,2019-04-19,7,15,573,588
72260,2019-04-19,8,53,1038,1091
72261,2019-04-19,9,105,683,788
72262,2019-04-19,10,116,376,492
72263,2019-04-19,11,179,444,623
72264,2019-04-19,12,149,510,659
72265,2019-04-19,13,101,363,464
72266,2019-04-19,14,43,116,159
72267,2019-04-19,15,34,204,238
72268,2019-04-19,16,60,479,539
72269,2019-04-19,17,159,706,865
72270,2019-04-19,18,106,454,560
72271,2019-04-19,19,50,271,321
72272,2019-04-19,20,25,139,164
72273,2019-04-19,21,8,83,91
72274,2019-04-19,22,17,78,95
72275,2019-04-19,23,22,111,133
72276,2019-04-20,0,31,80,111
72277,2019-04-20,1,14,48,62
72278,2019-04-20,2,15,48,63
72279,2019-04-20,3,1,17,18
72280,2019-04-20,4,0,7,7
72281,2019-04-20,5,2,11,13
72282,2019-04-20,6,7,32,39
72283,2019-04-20,7,17,117,134
72284,2019-04-20,8,48,276,324
72285,2019-04-20,9,110,463,573
72286,2019-04-20,10,194,621,815
72287,2019-04-20,11,361,754,1115
72288,2019-04-20,12,447,772,1219
72289,2019-04-20,13,491,859,1350
72290,2019-04-20,14,470,817,1287
72291,2019-04-20,15,518,880,1398
72292,2019-04-20,16,530,790,1320
72293,2019-04-20,17,414,784,1198
72294,2019-04-20,18,326,682,1008
72295,2019-04-20,19,266,525,791
72296,2019-04-20,20,180,332,512
72297,2019-04-20,21,127,236,363
72298,2019-04-20,22,132,199,331
72299,2019-04-20,23,81,175,256
72300,2019-04-21,0,80,105,185
72301,2019-04-21,1,33,84,117
72302,2019-04-21,2,47,49,96
72303,2019-04-21,3,34,26,60
72304,2019-04-21,4,10,16,26
72305,2019-04-21,5,21,27,48
72306,2019-04-21,6,12,61,73
72307,2019-04-21,7,18,108,126
72308,2019-04-21,8,44,184,228
72309,2019-04-21,9,131,332,463
72310,2019-04-21,10,194,493,687
72311,2019-04-21,11,225,528,753
72312,2019-04-21,12,307,656,963
72313,2019-04-21,13,312,667,979
72314,2019-04-21,14,324,671,995
72315,2019-04-21,15,298,748,1046
72316,2019-04-21,16,371,644,1015
72317,2019-04-21,17,324,564,888
72318,2019-04-21,18,251,521,772
72319,2019-04-21,19,153,402,555
72320,2019-04-21,20,90,309,399
72321,2019-04-21,21,47,156,203
72322,2019-04-21,22,54,177,231
72323,2019-04-21,23,20,67,87
72324,2019-04-22,0,17,26,43
72325,2019-04-22,1,8,21,29
72326,2019-04-22,2,2,5,7
72327,2019-04-22,3,2,3,5
72328,2019-04-22,4,1,13,14
72329,2019-04-22,5,4,83,87
72330,2019-04-22,6,8,288,296
72331,2019-04-22,7,29,679,708
72332,2019-04-22,8,47,1069,1116
72333,2019-04-22,9,58,550,608
72334,2019-04-22,10,90,337,427
72335,2019-04-22,11,101,346,447
72336,2019-04-22,12,123,431,554
72337,2019-04-22,13,116,435,551
72338,2019-04-22,14,150,366,516
72339,2019-04-22,15,172,499,671
72340,2019-04-22,16,197,760,957
72341,2019-04-22,17,187,1503,1690
72342,2019-04-22,18,158,1217,1375
72343,2019-04-22,19,105,796,901
72344,2019-04-22,20,64,479,543
72345,2019-04-22,21,43,298,341
72346,2019-04-22,22,38,183,221
72347,2019-04-22,23,16,86,102
72348,2019-04-23,0,7,29,36
72349,2019-04-23,1,3,4,7
72350,2019-04-23,2,0,5,5
72351,2019-04-23,3,3,3,6
72352,2019-04-23,4,3,14,17
72353,2019-04-23,5,5,103,108
72354,2019-04-23,6,16,361,377
72355,2019-04-23,7,30,916,946
72356,2019-04-23,8,44,1363,1407
72357,2019-04-23,9,39,632,671
72358,2019-04-23,10,55,326,381
72359,2019-04-23,11,84,355,439
72360,2019-04-23,12,126,451,577
72361,2019-04-23,13,121,432,553
72362,2019-04-23,14,126,393,519
72363,2019-04-23,15,131,545,676
72364,2019-04-23,16,144,814,958
72365,2019-04-23,17,178,1551,1729
72366,2019-04-23,18,142,1252,1394
72367,2019-04-23,19,135,849,984
72368,2019-04-23,20,85,541,626
72369,2019-04-23,21,46,377,423
72370,2019-04-23,22,46,234,280
72371,2019-04-23,23,19,103,122
72372,2019-04-24,0,18,38,56
72373,2019-04-24,1,7,12,19
72374,2019-04-24,2,2,7,9
72375,2019-04-24,3,4,4,8
72376,2019-04-24,4,4,17,21
72377,2019-04-24,5,3,106,109
72378,2019-04-24,6,11,364,375
72379,2019-04-24,7,28,919,947
72380,2019-04-24,8,42,1416,1458
72381,2019-04-24,9,39,654,693
72382,2019-04-24,10,73,327,400
72383,2019-04-24,11,99,382,481
72384,2019-04-24,12,91,426,517
72385,2019-04-24,13,121,448,569
72386,2019-04-24,14,131,425,556
72387,2019-04-24,15,130,541,671
72388,2019-04-24,16,141,798,939
72389,2019-04-24,17,143,1560,1703
72390,2019-04-24,18,195,1221,1416
72391,2019-04-24,19,122,769,891
72392,2019-04-24,20,44,576,620
72393,2019-04-24,21,38,310,348
72394,2019-04-24,22,35,193,228
72395,2019-04-24,23,23,175,198
72396,2019-04-25,0,19,68,87
72397,2019-04-25,1,6,13,19
72398,2019-04-25,2,4,11,15
72399,2019-04-25,3,1,7,8
72400,2019-04-25,4,3,16,19
72401,2019-04-25,5,4,110,114
72402,2019-04-25,6,16,312,328
72403,2019-04-25,7,12,767,779
72404,2019-04-25,8,51,1304,1355
72405,2019-04-25,9,62,604,666
72406,2019-04-25,10,77,317,394
72407,2019-04-25,11,92,315,407
72408,2019-04-25,12,100,413,513
72409,2019-04-25,13,139,409,548
72410,2019-04-25,14,124,314,438
72411,2019-04-25,15,128,497,625
72412,2019-04-25,16,182,808,990
72413,2019-04-25,17,162,1363,1525
72414,2019-04-25,18,158,1157,1315
72415,2019-04-25,19,174,664,838
72416,2019-04-25,20,78,475,553
72417,2019-04-25,21,65,370,435
72418,2019-04-25,22,35,202,237
72419,2019-04-25,23,19,111,130
72420,2019-04-26,0,6,33,39
72421,2019-04-26,1,1,22,23
72422,2019-04-26,2,2,8,10
72423,2019-04-26,3,2,10,12
72424,2019-04-26,4,3,15,18
72425,2019-04-26,5,1,94,95
72426,2019-04-26,6,14,262,276
72427,2019-04-26,7,20,610,630
72428,2019-04-26,8,41,1186,1227
72429,2019-04-26,9,48,590,638
72430,2019-04-26,10,59,271,330
72431,2019-04-26,11,88,383,471
72432,2019-04-26,12,118,465,583
72433,2019-04-26,13,106,515,621
72434,2019-04-26,14,41,236,277
72435,2019-04-26,15,22,195,217
72436,2019-04-26,16,52,467,519
72437,2019-04-26,17,69,695,764
72438,2019-04-26,18,59,590,649
72439,2019-04-26,19,75,444,519
72440,2019-04-26,20,24,239,263
72441,2019-04-26,21,37,218,255
72442,2019-04-26,22,18,191,209
72443,2019-04-26,23,23,138,161
72444,2019-04-27,0,11,93,104
72445,2019-04-27,1,17,47,64
72446,2019-04-27,2,3,50,53
72447,2019-04-27,3,6,28,34
72448,2019-04-27,4,0,10,10
72449,2019-04-27,5,7,17,24
72450,2019-04-27,6,6,50,56
72451,2019-04-27,7,18,149,167
72452,2019-04-27,8,53,282,335
72453,2019-04-27,9,80,434,514
72454,2019-04-27,10,152,560,712
72455,2019-04-27,11,196,650,846
72456,2019-04-27,12,259,699,958
72457,2019-04-27,13,290,790,1080
72458,2019-04-27,14,306,777,1083
72459,2019-04-27,15,322,785,1107
72460,2019-04-27,16,297,650,947
72461,2019-04-27,17,356,605,961
72462,2019-04-27,18,274,665,939
72463,2019-04-27,19,182,533,715
72464,2019-04-27,20,129,343,472
72465,2019-04-27,21,111,230,341
72466,2019-04-27,22,73,245,318
72467,2019-04-27,23,40,169,209
72468,2019-04-28,0,14,46,60
72469,2019-04-28,1,15,50,65
72470,2019-04-28,2,6,38,44
72471,2019-04-28,3,9,20,29
72472,2019-04-28,4,2,14,16
72473,2019-04-28,5,6,33,39
72474,2019-04-28,6,8,59,67
72475,2019-04-28,7,13,101,114
72476,2019-04-28,8,21,187,208
72477,2019-04-28,9,87,317,404
72478,2019-04-28,10,121,453,574
72479,2019-04-28,11,175,604,779
72480,2019-04-28,12,220,658,878
72481,2019-04-28,13,314,699,1013
72482,2019-04-28,14,307,663,970
72483,2019-04-28,15,225,690,915
72484,2019-04-28,16,247,606,853
72485,2019-04-28,17,199,632,831
72486,2019-04-28,18,160,532,692
72487,2019-04-28,19,100,422,522
72488,2019-04-28,20,44,287,331
72489,2019-04-28,21,38,145,183
72490,2019-04-28,22,28,155,183
72491,2019-04-28,23,22,81,103
72492,2019-04-29,0,6,22,28
72493,2019-04-29,1,1,15,16
72494,2019-04-29,2,4,11,15
72495,2019-04-29,3,5,8,13
72496,2019-04-29,4,3,16,19
72497,2019-04-29,5,3,84,87
72498,2019-04-29,6,8,283,291
72499,2019-04-29,7,19,629,648
72500,2019-04-29,8,50,1062,1112
72501,2019-04-29,9,57,487,544
72502,2019-04-29,10,95,231,326
72503,2019-04-29,11,94,303,397
72504,2019-04-29,12,70,406,476
72505,2019-04-29,13,74,357,431
72506,2019-04-29,14,84,327,411
72507,2019-04-29,15,80,448,528
72508,2019-04-29,16,109,689,798
72509,2019-04-29,17,136,1250,1386
72510,2019-04-29,18,83,1001,1084
72511,2019-04-29,19,71,572,643
72512,2019-04-29,20,30,344,374
72513,2019-04-29,21,17,245,262
72514,2019-04-29,22,25,171,196
72515,2019-04-29,23,10,74,84
72516,2019-04-30,0,19,28,47
72517,2019-04-30,1,14,13,27
72518,2019-04-30,2,4,5,9
72519,2019-04-30,3,0,7,7
72520,2019-04-30,4,1,14,15
72521,2019-04-30,5,6,107,113
72522,2019-04-30,6,4,372,376
72523,2019-04-30,7,17,854,871
72524,2019-04-30,8,32,1315,1347
72525,2019-04-30,9,35,571,606
72526,2019-04-30,10,43,270,313
72527,2019-04-30,11,41,326,367
72528,2019-04-30,12,68,413,481
72529,2019-04-30,13,102,352,454
72530,2019-04-30,14,64,359,423
72531,2019-04-30,15,86,484,570
72532,2019-04-30,16,99,744,843
72533,2019-04-30,17,165,1453,1618
72534,2019-04-30,18,114,1194,1308
72535,2019-04-30,19,92,668,760
72536,2019-04-30,20,49,446,495
72537,2019-04-30,21,37,293,330
72538,2019-04-30,22,58,248,306
72539,2019-04-30,23,16,98,114
72540,2019-05-01,0,17,40,57
72541,2019-05-01,1,17,25,42
72542,2019-05-01,2,7,14,21
72543,2019-05-01,3,5,5,10
72544,2019-05-01,4,5,14,19
72545,2019-05-01,5,3,100,103
72546,2019-05-01,6,10,337,347
72547,2019-05-01,7,26,830,856
72548,2019-05-01,8,34,1296,1330
72549,2019-05-01,9,39,676,715
72550,2019-05-01,10,55,306,361
72551,2019-05-01,11,83,367,450
72552,2019-05-01,12,72,426,498
72553,2019-05-01,13,87,407,494
72554,2019-05-01,14,83,391,474
72555,2019-05-01,15,71,490,561
72556,2019-05-01,16,79,720,799
72557,2019-05-01,17,133,1360,1493
72558,2019-05-01,18,126,1078,1204
72559,2019-05-01,19,104,716,820
72560,2019-05-01,20,59,470,529
72561,2019-05-01,21,66,331,397
72562,2019-05-01,22,37,216,253
72563,2019-05-01,23,27,80,107
72564,2019-05-02,0,10,49,59
72565,2019-05-02,1,4,15,19
72566,2019-05-02,2,6,4,10
72567,2019-05-02,3,0,5,5
72568,2019-05-02,4,0,14,14
72569,2019-05-02,5,2,106,108
72570,2019-05-02,6,6,374,380
72571,2019-05-02,7,21,803,824
72572,2019-05-02,8,35,1334,1369
72573,2019-05-02,9,87,676,763
72574,2019-05-02,10,89,315,404
72575,2019-05-02,11,94,345,439
72576,2019-05-02,12,103,393,496
72577,2019-05-02,13,76,374,450
72578,2019-05-02,14,108,357,465
72579,2019-05-02,15,121,477,598
72580,2019-05-02,16,20,161,181
72581,2019-05-02,17,74,847,921
72582,2019-05-02,18,66,602,668
72583,2019-05-02,19,57,515,572
72584,2019-05-02,20,53,422,475
72585,2019-05-02,21,38,269,307
72586,2019-05-02,22,38,231,269
72587,2019-05-02,23,17,80,97
72588,2019-05-03,0,6,46,52
72589,2019-05-03,1,10,23,33
72590,2019-05-03,2,4,11,15
72591,2019-05-03,3,2,9,11
72592,2019-05-03,4,3,17,20
72593,2019-05-03,5,2,77,79
72594,2019-05-03,6,13,264,277
72595,2019-05-03,7,20,656,676
72596,2019-05-03,8,47,1220,1267
72597,2019-05-03,9,71,697,768
72598,2019-05-03,10,77,356,433
72599,2019-05-03,11,102,397,499
72600,2019-05-03,12,126,519,645
72601,2019-05-03,13,156,495,651
72602,2019-05-03,14,130,430,560
72603,2019-05-03,15,134,585,719
72604,2019-05-03,16,159,848,1007
72605,2019-05-03,17,137,1195,1332
72606,2019-05-03,18,144,1035,1179
72607,2019-05-03,19,142,704,846
72608,2019-05-03,20,100,434,534
72609,2019-05-03,21,67,336,403
72610,2019-05-03,22,46,201,247
72611,2019-05-03,23,20,189,209
72612,2019-05-04,0,39,103,142
72613,2019-05-04,1,24,86,110
72614,2019-05-04,2,17,55,72
72615,2019-05-04,3,16,29,45
72616,2019-05-04,4,5,9,14
72617,2019-05-04,5,2,15,17
72618,2019-05-04,6,12,54,66
72619,2019-05-04,7,12,143,155
72620,2019-05-04,8,49,288,337
72621,2019-05-04,9,101,513,614
72622,2019-05-04,10,161,605,766
72623,2019-05-04,11,199,666,865
72624,2019-05-04,12,239,754,993
72625,2019-05-04,13,273,684,957
72626,2019-05-04,14,267,726,993
72627,2019-05-04,15,257,690,947
72628,2019-05-04,16,251,610,861
72629,2019-05-04,17,255,663,918
72630,2019-05-04,18,210,544,754
72631,2019-05-04,19,108,400,508
72632,2019-05-04,20,77,273,350
72633,2019-05-04,21,48,168,216
72634,2019-05-04,22,43,215,258
72635,2019-05-04,23,12,63,75
72636,2019-05-05,0,5,40,45
72637,2019-05-05,1,5,33,38
72638,2019-05-05,2,6,22,28
72639,2019-05-05,3,2,14,16
72640,2019-05-05,4,3,7,10
72641,2019-05-05,5,3,10,13
72642,2019-05-05,6,5,40,45
72643,2019-05-05,7,7,52,59
72644,2019-05-05,8,13,75,88
72645,2019-05-05,9,14,130,144
72646,2019-05-05,10,8,97,105
72647,2019-05-05,11,27,231,258
72648,2019-05-05,12,37,262,299
72649,2019-05-05,13,30,147,177
72650,2019-05-05,14,17,115,132
72651,2019-05-05,15,16,122,138
72652,2019-05-05,16,12,111,123
72653,2019-05-05,17,14,78,92
72654,2019-05-05,18,11,105,116
72655,2019-05-05,19,22,176,198
72656,2019-05-05,20,27,199,226
72657,2019-05-05,21,16,113,129
72658,2019-05-05,22,13,106,119
72659,2019-05-05,23,5,86,91
72660,2019-05-06,0,3,32,35
72661,2019-05-06,1,2,14,16
72662,2019-05-06,2,1,9,10
72663,2019-05-06,3,0,11,11
72664,2019-05-06,4,2,11,13
72665,2019-05-06,5,6,86,92
72666,2019-05-06,6,8,320,328
72667,2019-05-06,7,22,758,780
72668,2019-05-06,8,34,1226,1260
72669,2019-05-06,9,43,567,610
72670,2019-05-06,10,53,270,323
72671,2019-05-06,11,78,309,387
72672,2019-05-06,12,73,392,465
72673,2019-05-06,13,104,379,483
72674,2019-05-06,14,95,366,461
72675,2019-05-06,15,114,524,638
72676,2019-05-06,16,133,713,846
72677,2019-05-06,17,151,1407,1558
72678,2019-05-06,18,147,1187,1334
72679,2019-05-06,19,99,721,820
72680,2019-05-06,20,75,477,552
72681,2019-05-06,21,62,313,375
72682,2019-05-06,22,37,177,214
72683,2019-05-06,23,16,74,90
72684,2019-05-07,0,21,43,64
72685,2019-05-07,1,8,19,27
72686,2019-05-07,2,11,8,19
72687,2019-05-07,3,2,7,9
72688,2019-05-07,4,3,18,21
72689,2019-05-07,5,6,115,121
72690,2019-05-07,6,12,379,391
72691,2019-05-07,7,27,869,896
72692,2019-05-07,8,30,1271,1301
72693,2019-05-07,9,47,584,631
72694,2019-05-07,10,56,255,311
72695,2019-05-07,11,62,338,400
72696,2019-05-07,12,84,404,488
72697,2019-05-07,13,73,396,469
72698,2019-05-07,14,100,369,469
72699,2019-05-07,15,83,466,549
72700,2019-05-07,16,152,782,934
72701,2019-05-07,17,163,1478,1641
72702,2019-05-07,18,119,1183,1302
72703,2019-05-07,19,117,770,887
72704,2019-05-07,20,91,481,572
72705,2019-05-07,21,59,357,416
72706,2019-05-07,22,33,187,220
72707,2019-05-07,23,23,119,142
72708,2019-05-08,0,5,43,48
72709,2019-05-08,1,17,16,33
72710,2019-05-08,2,3,8,11
72711,2019-05-08,3,1,5,6
72712,2019-05-08,4,1,21,22
72713,2019-05-08,5,5,108,113
72714,2019-05-08,6,17,390,407
72715,2019-05-08,7,34,928,962
72716,2019-05-08,8,46,1336,1382
72717,2019-05-08,9,56,546,602
72718,2019-05-08,10,77,270,347
72719,2019-05-08,11,75,333,408
72720,2019-05-08,12,78,397,475
72721,2019-05-08,13,68,385,453
72722,2019-05-08,14,96,368,464
72723,2019-05-08,15,93,464,557
72724,2019-05-08,16,85,694,779
72725,2019-05-08,17,126,1324,1450
72726,2019-05-08,18,115,1063,1178
72727,2019-05-08,19,88,651,739
72728,2019-05-08,20,47,424,471
72729,2019-05-08,21,41,308,349
72730,2019-05-08,22,31,208,239
72731,2019-05-08,23,29,95,124
72732,2019-05-09,0,12,48,60
72733,2019-05-09,1,4,21,25
72734,2019-05-09,2,0,11,11
72735,2019-05-09,3,2,2,4
72736,2019-05-09,4,1,18,19
72737,2019-05-09,5,7,95,102
72738,2019-05-09,6,19,315,334
72739,2019-05-09,7,32,795,827
72740,2019-05-09,8,38,1277,1315
72741,2019-05-09,9,42,546,588
72742,2019-05-09,10,37,305,342
72743,2019-05-09,11,52,331,383
72744,2019-05-09,12,69,375,444
72745,2019-05-09,13,78,375,453
72746,2019-05-09,14,72,320,392
72747,2019-05-09,15,71,433,504
72748,2019-05-09,16,76,712,788
72749,2019-05-09,17,88,1338,1426
72750,2019-05-09,18,113,1157,1270
72751,2019-05-09,19,67,708,775
72752,2019-05-09,20,48,533,581
72753,2019-05-09,21,45,332,377
72754,2019-05-09,22,39,205,244
72755,2019-05-09,23,26,148,174
72756,2019-05-10,0,8,84,92
72757,2019-05-10,1,7,28,35
72758,2019-05-10,2,3,11,14
72759,2019-05-10,3,6,7,13
72760,2019-05-10,4,4,11,15
72761,2019-05-10,5,7,88,95
72762,2019-05-10,6,11,276,287
72763,2019-05-10,7,17,631,648
72764,2019-05-10,8,43,1186,1229
72765,2019-05-10,9,34,646,680
72766,2019-05-10,10,60,353,413
72767,2019-05-10,11,71,402,473
72768,2019-05-10,12,108,518,626
72769,2019-05-10,13,127,484,611
72770,2019-05-10,14,113,432,545
72771,2019-05-10,15,126,536,662
72772,2019-05-10,16,61,452,513
72773,2019-05-10,17,101,1011,1112
72774,2019-05-10,18,116,812,928
72775,2019-05-10,19,98,604,702
72776,2019-05-10,20,56,389,445
72777,2019-05-10,21,33,154,187
72778,2019-05-10,22,11,104,115
72779,2019-05-10,23,15,121,136
72780,2019-05-11,0,18,98,116
72781,2019-05-11,1,22,67,89
72782,2019-05-11,2,20,57,77
72783,2019-05-11,3,10,37,47
72784,2019-05-11,4,6,16,22
72785,2019-05-11,5,3,21,24
72786,2019-05-11,6,11,54,65
72787,2019-05-11,7,11,150,161
72788,2019-05-11,8,41,271,312
72789,2019-05-11,9,99,507,606
72790,2019-05-11,10,154,573,727
72791,2019-05-11,11,186,650,836
72792,2019-05-11,12,222,722,944
72793,2019-05-11,13,217,711,928
72794,2019-05-11,14,236,679,915
72795,2019-05-11,15,190,502,692
72796,2019-05-11,16,175,463,638
72797,2019-05-11,17,98,329,427
72798,2019-05-11,18,14,93,107
72799,2019-05-11,19,43,165,208
72800,2019-05-11,20,18,100,118
72801,2019-05-11,21,6,43,49
72802,2019-05-11,22,3,77,80
72803,2019-05-11,23,6,43,49
72804,2019-05-12,0,2,36,38
72805,2019-05-12,1,3,32,35
72806,2019-05-12,2,1,22,23
72807,2019-05-12,3,6,14,20
72808,2019-05-12,4,3,5,8
72809,2019-05-12,5,0,10,10
72810,2019-05-12,6,3,29,32
72811,2019-05-12,7,6,43,49
72812,2019-05-12,8,5,55,60
72813,2019-05-12,9,9,108,117
72814,2019-05-12,10,18,193,211
72815,2019-05-12,11,8,68,76
72816,2019-05-12,12,8,78,86
72817,2019-05-12,13,22,148,170
72818,2019-05-12,14,16,137,153
72819,2019-05-12,15,42,256,298
72820,2019-05-12,16,44,328,372
72821,2019-05-12,17,80,340,420
72822,2019-05-12,18,64,317,381
72823,2019-05-12,19,45,253,298
72824,2019-05-12,20,27,184,211
72825,2019-05-12,21,10,66,76
72826,2019-05-12,22,9,72,81
72827,2019-05-12,23,14,68,82
72828,2019-05-13,0,6,25,31
72829,2019-05-13,1,3,8,11
72830,2019-05-13,2,0,4,4
72831,2019-05-13,3,1,4,5
72832,2019-05-13,4,0,5,5
72833,2019-05-13,5,7,66,73
72834,2019-05-13,6,6,225,231
72835,2019-05-13,7,2,290,292
72836,2019-05-13,8,9,418,427
72837,2019-05-13,9,6,136,142
72838,2019-05-13,10,15,109,124
72839,2019-05-13,11,33,128,161
72840,2019-05-13,12,11,85,96
72841,2019-05-13,13,20,146,166
72842,2019-05-13,14,40,242,282
72843,2019-05-13,15,47,294,341
72844,2019-05-13,16,36,450,486
72845,2019-05-13,17,70,1027,1097
72846,2019-05-13,18,83,945,1028
72847,2019-05-13,19,61,630,691
72848,2019-05-13,20,39,364,403
72849,2019-05-13,21,38,250,288
72850,2019-05-13,22,25,124,149
72851,2019-05-13,23,9,63,72
72852,2019-05-14,0,6,30,36
72853,2019-05-14,1,0,10,10
72854,2019-05-14,2,7,3,10
72855,2019-05-14,3,2,5,7
72856,2019-05-14,4,2,11,13
72857,2019-05-14,5,6,99,105
72858,2019-05-14,6,8,341,349
72859,2019-05-14,7,15,831,846
72860,2019-05-14,8,39,1281,1320
72861,2019-05-14,9,30,614,644
72862,2019-05-14,10,52,279,331
72863,2019-05-14,11,64,295,359
72864,2019-05-14,12,58,349,407
72865,2019-05-14,13,81,329,410
72866,2019-05-14,14,96,315,411
72867,2019-05-14,15,88,451,539
72868,2019-05-14,16,110,708,818
72869,2019-05-14,17,112,1271,1383
72870,2019-05-14,18,110,1054,1164
72871,2019-05-14,19,69,651,720
72872,2019-05-14,20,36,436,472
72873,2019-05-14,21,35,276,311
72874,2019-05-14,22,27,148,175
72875,2019-05-14,23,15,69,84
72876,2019-05-15,0,6,38,44
72877,2019-05-15,1,3,16,19
72878,2019-05-15,2,1,8,9
72879,2019-05-15,3,3,4,7
72880,2019-05-15,4,1,7,8
72881,2019-05-15,5,4,85,89
72882,2019-05-15,6,13,339,352
72883,2019-05-15,7,23,821,844
72884,2019-05-15,8,56,1356,1412
72885,2019-05-15,9,30,631,661
72886,2019-05-15,10,49,298,347
72887,2019-05-15,11,68,308,376
72888,2019-05-15,12,63,420,483
72889,2019-05-15,13,72,390,462
72890,2019-05-15,14,118,391,509
72891,2019-05-15,15,126,477,603
72892,2019-05-15,16,98,788,886
72893,2019-05-15,17,177,1435,1612
72894,2019-05-15,18,157,1210,1367
72895,2019-05-15,19,107,733,840
72896,2019-05-15,20,67,487,554
72897,2019-05-15,21,62,364,426
72898,2019-05-15,22,38,212,250
72899,2019-05-15,23,30,135,165
72900,2019-05-16,0,13,49,62
72901,2019-05-16,1,3,29,32
72902,2019-05-16,2,11,11,22
72903,2019-05-16,3,6,5,11
72904,2019-05-16,4,4,18,22
72905,2019-05-16,5,6,79,85
72906,2019-05-16,6,8,314,322
72907,2019-05-16,7,18,557,575
72908,2019-05-16,8,30,927,957
72909,2019-05-16,9,44,666,710
72910,2019-05-16,10,86,343,429
72911,2019-05-16,11,96,390,486
72912,2019-05-16,12,111,440,551
72913,2019-05-16,13,90,469,559
72914,2019-05-16,14,111,388,499
72915,2019-05-16,15,122,512,634
72916,2019-05-16,16,143,791,934
72917,2019-05-16,17,161,1452,1613
72918,2019-05-16,18,171,1184,1355
72919,2019-05-16,19,137,766,903
72920,2019-05-16,20,85,502,587
72921,2019-05-16,21,58,361,419
72922,2019-05-16,22,52,245,297
72923,2019-05-16,23,38,144,182
72924,2019-05-17,0,26,70,96
72925,2019-05-17,1,6,32,38
72926,2019-05-17,2,5,17,22
72927,2019-05-17,3,0,6,6
72928,2019-05-17,4,3,11,14
72929,2019-05-17,5,5,87,92
72930,2019-05-17,6,18,349,367
72931,2019-05-17,7,45,908,953
72932,2019-05-17,8,66,1315,1381
72933,2019-05-17,9,68,697,765
72934,2019-05-17,10,57,368,425
72935,2019-05-17,11,76,409,485
72936,2019-05-17,12,126,490,616
72937,2019-05-17,13,148,476,624
72938,2019-05-17,14,148,471,619
72939,2019-05-17,15,176,578,754
72940,2019-05-17,16,186,886,1072
72941,2019-05-17,17,229,1331,1560
72942,2019-05-17,18,164,1076,1240
72943,2019-05-17,19,144,651,795
72944,2019-05-17,20,112,422,534
72945,2019-05-17,21,92,331,423
72946,2019-05-17,22,83,276,359
72947,2019-05-17,23,68,230,298
72948,2019-05-18,0,45,163,208
72949,2019-05-18,1,13,101,114
72950,2019-05-18,2,18,50,68
72951,2019-05-18,3,18,27,45
72952,2019-05-18,4,8,15,23
72953,2019-05-18,5,14,26,40
72954,2019-05-18,6,16,75,91
72955,2019-05-18,7,32,174,206
72956,2019-05-18,8,45,303,348
72957,2019-05-18,9,101,487,588
72958,2019-05-18,10,167,603,770
72959,2019-05-18,11,283,660,943
72960,2019-05-18,12,259,785,1044
72961,2019-05-18,13,263,743,1006
72962,2019-05-18,14,291,678,969
72963,2019-05-18,15,347,706,1053
72964,2019-05-18,16,270,766,1036
72965,2019-05-18,17,272,691,963
72966,2019-05-18,18,284,582,866
72967,2019-05-18,19,221,495,716
72968,2019-05-18,20,162,362,524
72969,2019-05-18,21,110,284,394
72970,2019-05-18,22,135,372,507
72971,2019-05-18,23,86,238,324
72972,2019-05-19,0,70,151,221
72973,2019-05-19,1,27,53,80
72974,2019-05-19,2,22,70,92
72975,2019-05-19,3,10,33,43
72976,2019-05-19,4,6,12,18
72977,2019-05-19,5,1,13,14
72978,2019-05-19,6,16,45,61
72979,2019-05-19,7,24,148,172
72980,2019-05-19,8,70,309,379
72981,2019-05-19,9,124,436,560
72982,2019-05-19,10,206,599,805
72983,2019-05-19,11,257,695,952
72984,2019-05-19,12,221,726,947
72985,2019-05-19,13,247,701,948
72986,2019-05-19,14,314,715,1029
72987,2019-05-19,15,235,644,879
72988,2019-05-19,16,223,599,822
72989,2019-05-19,17,203,556,759
72990,2019-05-19,18,162,508,670
72991,2019-05-19,19,156,454,610
72992,2019-05-19,20,109,387,496
72993,2019-05-19,21,66,210,276
72994,2019-05-19,22,58,213,271
72995,2019-05-19,23,39,165,204
72996,2019-05-20,0,11,42,53
72997,2019-05-20,1,9,18,27
72998,2019-05-20,2,6,5,11
72999,2019-05-20,3,4,5,9
73000,2019-05-20,4,1,12,13
73001,2019-05-20,5,13,83,96
73002,2019-05-20,6,16,333,349
73003,2019-05-20,7,28,783,811
73004,2019-05-20,8,45,1174,1219
73005,2019-05-20,9,69,555,624
73006,2019-05-20,10,96,295,391
73007,2019-05-20,11,99,301,400
73008,2019-05-20,12,107,367,474
73009,2019-05-20,13,97,336,433
73010,2019-05-20,14,102,350,452
73011,2019-05-20,15,111,460,571
73012,2019-05-20,16,96,714,810
73013,2019-05-20,17,141,1307,1448
73014,2019-05-20,18,129,1029,1158
73015,2019-05-20,19,126,707,833
73016,2019-05-20,20,96,480,576
73017,2019-05-20,21,49,311,360
73018,2019-05-20,22,55,178,233
73019,2019-05-20,23,23,112,135
73020,2019-05-21,0,22,43,65
73021,2019-05-21,1,4,16,20
73022,2019-05-21,2,2,13,15
73023,2019-05-21,3,0,5,5
73024,2019-05-21,4,3,11,14
73025,2019-05-21,5,1,94,95
73026,2019-05-21,6,12,379,391
73027,2019-05-21,7,28,937,965
73028,2019-05-21,8,57,1306,1363
73029,2019-05-21,9,46,686,732
73030,2019-05-21,10,52,260,312
73031,2019-05-21,11,57,356,413
73032,2019-05-21,12,84,474,558
73033,2019-05-21,13,58,408,466
73034,2019-05-21,14,96,399,495
73035,2019-05-21,15,124,502,626
73036,2019-05-21,16,111,776,887
73037,2019-05-21,17,156,1467,1623
73038,2019-05-21,18,145,1252,1397
73039,2019-05-21,19,132,825,957
73040,2019-05-21,20,67,557,624
73041,2019-05-21,21,52,339,391
73042,2019-05-21,22,48,229,277
73043,2019-05-21,23,23,95,118
73044,2019-05-22,0,13,37,50
73045,2019-05-22,1,6,11,17
73046,2019-05-22,2,1,3,4
73047,2019-05-22,3,2,4,6
73048,2019-05-22,4,2,16,18
73049,2019-05-22,5,3,110,113
73050,2019-05-22,6,10,369,379
73051,2019-05-22,7,20,837,857
73052,2019-05-22,8,42,1368,1410
73053,2019-05-22,9,54,654,708
73054,2019-05-22,10,66,318,384
73055,2019-05-22,11,61,337,398
73056,2019-05-22,12,78,478,556
73057,2019-05-22,13,71,446,517
73058,2019-05-22,14,74,384,458
73059,2019-05-22,15,90,522,612
73060,2019-05-22,16,134,782,916
73061,2019-05-22,17,153,1459,1612
73062,2019-05-22,18,171,1253,1424
73063,2019-05-22,19,126,734,860
73064,2019-05-22,20,82,500,582
73065,2019-05-22,21,50,359,409
73066,2019-05-22,22,47,234,281
73067,2019-05-22,23,26,102,128
73068,2019-05-23,0,7,49,56
73069,2019-05-23,1,6,13,19
73070,2019-05-23,2,4,13,17
73071,2019-05-23,3,1,2,3
73072,2019-05-23,4,3,15,18
73073,2019-05-23,5,6,115,121
73074,2019-05-23,6,6,359,365
73075,2019-05-23,7,23,842,865
73076,2019-05-23,8,44,1333,1377
73077,2019-05-23,9,49,654,703
73078,2019-05-23,10,67,349,416
73079,2019-05-23,11,102,382,484
73080,2019-05-23,12,71,471,542
73081,2019-05-23,13,89,421,510
73082,2019-05-23,14,93,375,468
73083,2019-05-23,15,70,376,446
73084,2019-05-23,16,64,480,544
73085,2019-05-23,17,90,1187,1277
73086,2019-05-23,18,101,1009,1110
73087,2019-05-23,19,75,642,717
73088,2019-05-23,20,83,472,555
73089,2019-05-23,21,39,306,345
73090,2019-05-23,22,37,232,269
73091,2019-05-23,23,23,111,134
73092,2019-05-24,0,14,66,80
73093,2019-05-24,1,7,35,42
73094,2019-05-24,2,10,11,21
73095,2019-05-24,3,2,7,9
73096,2019-05-24,4,3,25,28
73097,2019-05-24,5,7,100,107
73098,2019-05-24,6,16,272,288
73099,2019-05-24,7,24,631,655
73100,2019-05-24,8,62,1065,1127
73101,2019-05-24,9,64,671,735
73102,2019-05-24,10,82,458,540
73103,2019-05-24,11,104,443,547
73104,2019-05-24,12,146,522,668
73105,2019-05-24,13,142,577,719
73106,2019-05-24,14,140,643,783
73107,2019-05-24,15,153,832,985
73108,2019-05-24,16,151,923,1074
73109,2019-05-24,17,189,972,1161
73110,2019-05-24,18,138,747,885
73111,2019-05-24,19,144,559,703
73112,2019-05-24,20,106,396,502
73113,2019-05-24,21,69,276,345
73114,2019-05-24,22,71,264,335
73115,2019-05-24,23,43,179,222
73116,2019-05-25,0,62,139,201
73117,2019-05-25,1,34,74,108
73118,2019-05-25,2,16,50,66
73119,2019-05-25,3,14,24,38
73120,2019-05-25,4,3,25,28
73121,2019-05-25,5,3,14,17
73122,2019-05-25,6,11,54,65
73123,2019-05-25,7,21,122,143
73124,2019-05-25,8,52,283,335
73125,2019-05-25,9,110,438,548
73126,2019-05-25,10,184,579,763
73127,2019-05-25,11,238,653,891
73128,2019-05-25,12,275,658,933
73129,2019-05-25,13,293,723,1016
73130,2019-05-25,14,355,714,1069
73131,2019-05-25,15,328,610,938
73132,2019-05-25,16,320,597,917
73133,2019-05-25,17,366,640,1006
73134,2019-05-25,18,256,554,810
73135,2019-05-25,19,207,408,615
73136,2019-05-25,20,184,348,532
73137,2019-05-25,21,143,252,395
73138,2019-05-25,22,97,179,276
73139,2019-05-25,23,43,116,159
73140,2019-05-26,0,24,65,89
73141,2019-05-26,1,26,43,69
73142,2019-05-26,2,9,55,64
73143,2019-05-26,3,13,19,32
73144,2019-05-26,4,5,17,22
73145,2019-05-26,5,5,17,22
73146,2019-05-26,6,17,53,70
73147,2019-05-26,7,32,115,147
73148,2019-05-26,8,77,273,350
73149,2019-05-26,9,179,427,606
73150,2019-05-26,10,253,543,796
73151,2019-05-26,11,308,655,963
73152,2019-05-26,12,286,626,912
73153,2019-05-26,13,305,635,940
73154,2019-05-26,14,346,547,893
73155,2019-05-26,15,307,552,859
73156,2019-05-26,16,272,516,788
73157,2019-05-26,17,268,580,848
73158,2019-05-26,18,225,503,728
73159,2019-05-26,19,213,438,651
73160,2019-05-26,20,173,337,510
73161,2019-05-26,21,125,295,420
73162,2019-05-26,22,93,193,286
73163,2019-05-26,23,46,149,195
73164,2019-05-27,0,36,112,148
73165,2019-05-27,1,34,55,89
73166,2019-05-27,2,9,25,34
73167,2019-05-27,3,19,8,27
73168,2019-05-27,4,8,17,25
73169,2019-05-27,5,10,15,25
73170,2019-05-27,6,14,60,74
73171,2019-05-27,7,45,122,167
73172,2019-05-27,8,53,256,309
73173,2019-05-27,9,130,406,536
73174,2019-05-27,10,187,495,682
73175,2019-05-27,11,226,608,834
73176,2019-05-27,12,309,690,999
73177,2019-05-27,13,298,694,992
73178,2019-05-27,14,293,601,894
73179,2019-05-27,15,263,652,915
73180,2019-05-27,16,278,596,874
73181,2019-05-27,17,273,633,906
73182,2019-05-27,18,229,562,791
73183,2019-05-27,19,188,496,684
73184,2019-05-27,20,128,373,501
73185,2019-05-27,21,120,266,386
73186,2019-05-27,22,53,187,240
73187,2019-05-27,23,22,101,123
73188,2019-05-28,0,15,41,56
73189,2019-05-28,1,7,12,19
73190,2019-05-28,2,6,10,16
73191,2019-05-28,3,3,9,12
73192,2019-05-28,4,0,16,16
73193,2019-05-28,5,8,88,96
73194,2019-05-28,6,9,212,221
73195,2019-05-28,7,6,220,226
73196,2019-05-28,8,31,725,756
73197,2019-05-28,9,30,523,553
73198,2019-05-28,10,47,294,341
73199,2019-05-28,11,67,274,341
73200,2019-05-28,12,74,349,423
73201,2019-05-28,13,99,373,472
73202,2019-05-28,14,100,334,434
73203,2019-05-28,15,101,445,546
73204,2019-05-28,16,114,692,806
73205,2019-05-28,17,132,1361,1493
73206,2019-05-28,18,120,1021,1141
73207,2019-05-28,19,79,683,762
73208,2019-05-28,20,80,469,549
73209,2019-05-28,21,65,307,372
73210,2019-05-28,22,36,201,237
73211,2019-05-28,23,33,90,123
73212,2019-05-29,0,19,41,60
73213,2019-05-29,1,15,17,32
73214,2019-05-29,2,3,4,7
73215,2019-05-29,3,1,5,6
73216,2019-05-29,4,2,28,30
73217,2019-05-29,5,9,162,171
73218,2019-05-29,6,22,411,433
73219,2019-05-29,7,26,933,959
73220,2019-05-29,8,48,1294,1342
73221,2019-05-29,9,56,588,644
73222,2019-05-29,10,62,323,385
73223,2019-05-29,11,60,338,398
73224,2019-05-29,12,62,387,449
73225,2019-05-29,13,62,361,423
73226,2019-05-29,14,76,324,400
73227,2019-05-29,15,89,453,542
73228,2019-05-29,16,67,700,767
73229,2019-05-29,17,113,1298,1411
73230,2019-05-29,18,110,1046,1156
73231,2019-05-29,19,103,824,927
73232,2019-05-29,20,89,524,613
73233,2019-05-29,21,42,334,376
73234,2019-05-29,22,48,263,311
73235,2019-05-29,23,22,136,158
73236,2019-05-30,0,7,71,78
73237,2019-05-30,1,8,18,26
73238,2019-05-30,2,3,13,16
73239,2019-05-30,3,2,8,10
73240,2019-05-30,4,1,27,28
73241,2019-05-30,5,6,118,124
73242,2019-05-30,6,8,393,401
73243,2019-05-30,7,19,859,878
73244,2019-05-30,8,60,1292,1352
73245,2019-05-30,9,59,642,701
73246,2019-05-30,10,54,318,372
73247,2019-05-30,11,66,316,382
73248,2019-05-30,12,68,421,489
73249,2019-05-30,13,80,414,494
73250,2019-05-30,14,74,361,435
73251,2019-05-30,15,49,260,309
73252,2019-05-30,16,39,372,411
73253,2019-05-30,17,75,1207,1282
73254,2019-05-30,18,132,1042,1174
73255,2019-05-30,19,67,543,610
73256,2019-05-30,20,40,296,336
73257,2019-05-30,21,36,220,256
73258,2019-05-30,22,21,192,213
73259,2019-05-30,23,18,138,156
73260,2019-05-31,0,17,66,83
73261,2019-05-31,1,6,25,31
73262,2019-05-31,2,2,16,18
73263,2019-05-31,3,1,3,4
73264,2019-05-31,4,2,20,22
73265,2019-05-31,5,5,93,98
73266,2019-05-31,6,18,317,335
73267,2019-05-31,7,24,748,772
73268,2019-05-31,8,67,1183,1250
73269,2019-05-31,9,69,684,753
73270,2019-05-31,10,122,390,512
73271,2019-05-31,11,100,436,536
73272,2019-05-31,12,95,495,590
73273,2019-05-31,13,98,516,614
73274,2019-05-31,14,148,472,620
73275,2019-05-31,15,131,574,705
73276,2019-05-31,16,176,811,987
73277,2019-05-31,17,159,1263,1422
73278,2019-05-31,18,179,943,1122
73279,2019-05-31,19,95,668,763
73280,2019-05-31,20,101,497,598
73281,2019-05-31,21,62,357,419
73282,2019-05-31,22,63,254,317
73283,2019-05-31,23,49,206,255
73284,2019-06-01,0,34,121,155
73285,2019-06-01,1,39,79,118
73286,2019-06-01,2,31,49,80
73287,2019-06-01,3,13,22,35
73288,2019-06-01,4,4,13,17
73289,2019-06-01,5,8,32,40
73290,2019-06-01,6,11,80,91
73291,2019-06-01,7,23,182,205
73292,2019-06-01,8,47,320,367
73293,2019-06-01,9,106,487,593
73294,2019-06-01,10,163,648,811
73295,2019-06-01,11,202,718,920
73296,2019-06-01,12,230,731,961
73297,2019-06-01,13,239,713,952
73298,2019-06-01,14,264,678,942
73299,2019-06-01,15,254,642,896
73300,2019-06-01,16,227,572,799
73301,2019-06-01,17,249,727,976
73302,2019-06-01,18,249,557,806
73303,2019-06-01,19,189,554,743
73304,2019-06-01,20,152,393,545
73305,2019-06-01,21,130,310,440
73306,2019-06-01,22,132,301,433
73307,2019-06-01,23,108,198,306
73308,2019-06-02,0,41,137,178
73309,2019-06-02,1,40,104,144
73310,2019-06-02,2,34,70,104
73311,2019-06-02,3,9,28,37
73312,2019-06-02,4,12,10,22
73313,2019-06-02,5,0,25,25
73314,2019-06-02,6,10,49,59
73315,2019-06-02,7,20,154,174
73316,2019-06-02,8,38,312,350
73317,2019-06-02,9,117,425,542
73318,2019-06-02,10,169,612,781
73319,2019-06-02,11,192,704,896
73320,2019-06-02,12,257,703,960
73321,2019-06-02,13,258,703,961
73322,2019-06-02,14,272,745,1017
73323,2019-06-02,15,243,679,922
73324,2019-06-02,16,224,619,843
73325,2019-06-02,17,120,345,465
73326,2019-06-02,18,54,176,230
73327,2019-06-02,19,53,201,254
73328,2019-06-02,20,67,261,328
73329,2019-06-02,21,50,185,235
73330,2019-06-02,22,52,122,174
73331,2019-06-02,23,36,87,123
73332,2019-06-03,0,14,36,50
73333,2019-06-03,1,6,26,32
73334,2019-06-03,2,3,5,8
73335,2019-06-03,3,2,6,8
73336,2019-06-03,4,1,19,20
73337,2019-06-03,5,1,103,104
73338,2019-06-03,6,9,364,373
73339,2019-06-03,7,23,836,859
73340,2019-06-03,8,61,1166,1227
73341,2019-06-03,9,52,555,607
73342,2019-06-03,10,91,296,387
73343,2019-06-03,11,108,342,450
73344,2019-06-03,12,118,417,535
73345,2019-06-03,13,116,424,540
73346,2019-06-03,14,125,409,534
73347,2019-06-03,15,130,520,650
73348,2019-06-03,16,163,802,965
73349,2019-06-03,17,183,1474,1657
73350,2019-06-03,18,177,1179,1356
73351,2019-06-03,19,140,868,1008
73352,2019-06-03,20,94,597,691
73353,2019-06-03,21,57,315,372
73354,2019-06-03,22,34,165,199
73355,2019-06-03,23,22,92,114
73356,2019-06-04,0,16,43,59
73357,2019-06-04,1,1,17,18
73358,2019-06-04,2,6,8,14
73359,2019-06-04,3,2,7,9
73360,2019-06-04,4,1,22,23
73361,2019-06-04,5,4,124,128
73362,2019-06-04,6,8,409,417
73363,2019-06-04,7,31,989,1020
73364,2019-06-04,8,48,1349,1397
73365,2019-06-04,9,51,609,660
73366,2019-06-04,10,75,315,390
73367,2019-06-04,11,79,347,426
73368,2019-06-04,12,82,472,554
73369,2019-06-04,13,74,479,553
73370,2019-06-04,14,106,473,579
73371,2019-06-04,15,129,550,679
73372,2019-06-04,16,140,897,1037
73373,2019-06-04,17,219,1602,1821
73374,2019-06-04,18,181,1229,1410
73375,2019-06-04,19,137,800,937
73376,2019-06-04,20,105,495,600
73377,2019-06-04,21,44,322,366
73378,2019-06-04,22,55,296,351
73379,2019-06-04,23,39,122,161
73380,2019-06-05,0,14,54,68
73381,2019-06-05,1,6,25,31
73382,2019-06-05,2,3,12,15
73383,2019-06-05,3,0,5,5
73384,2019-06-05,4,3,24,27
73385,2019-06-05,5,7,121,128
73386,2019-06-05,6,13,416,429
73387,2019-06-05,7,40,981,1021
73388,2019-06-05,8,75,1403,1478
73389,2019-06-05,9,54,625,679
73390,2019-06-05,10,61,346,407
73391,2019-06-05,11,78,311,389
73392,2019-06-05,12,79,391,470
73393,2019-06-05,13,74,351,425
73394,2019-06-05,14,88,410,498
73395,2019-06-05,15,59,508,567
73396,2019-06-05,16,107,730,837
73397,2019-06-05,17,142,1336,1478
73398,2019-06-05,18,124,1168,1292
73399,2019-06-05,19,93,715,808
73400,2019-06-05,20,69,541,610
73401,2019-06-05,21,47,386,433
73402,2019-06-05,22,22,135,157
73403,2019-06-05,23,7,119,126
73404,2019-06-06,0,8,50,58
73405,2019-06-06,1,1,11,12
73406,2019-06-06,2,4,12,16
73407,2019-06-06,3,4,5,9
73408,2019-06-06,4,4,24,28
73409,2019-06-06,5,7,111,118
73410,2019-06-06,6,12,366,378
73411,2019-06-06,7,33,818,851
73412,2019-06-06,8,62,1351,1413
73413,2019-06-06,9,37,639,676
73414,2019-06-06,10,50,313,363
73415,2019-06-06,11,81,298,379
73416,2019-06-06,12,91,424,515
73417,2019-06-06,13,91,387,478
73418,2019-06-06,14,67,397,464
73419,2019-06-06,15,108,552,660
73420,2019-06-06,16,91,763,854
73421,2019-06-06,17,186,1402,1588
73422,2019-06-06,18,104,1081,1185
73423,2019-06-06,19,127,746,873
73424,2019-06-06,20,94,553,647
73425,2019-06-06,21,69,413,482
73426,2019-06-06,22,41,340,381
73427,2019-06-06,23,20,160,180
73428,2019-06-07,0,18,68,86
73429,2019-06-07,1,5,30,35
73430,2019-06-07,2,8,23,31
73431,2019-06-07,3,4,11,15
73432,2019-06-07,4,4,26,30
73433,2019-06-07,5,8,109,117
73434,2019-06-07,6,12,335,347
73435,2019-06-07,7,28,758,786
73436,2019-06-07,8,57,1180,1237
73437,2019-06-07,9,65,679,744
73438,2019-06-07,10,65,416,481
73439,2019-06-07,11,89,446,535
73440,2019-06-07,12,103,542,645
73441,2019-06-07,13,134,539,673
73442,2019-06-07,14,135,518,653
73443,2019-06-07,15,134,680,814
73444,2019-06-07,16,157,945,1102
73445,2019-06-07,17,202,1309,1511
73446,2019-06-07,18,153,998,1151
73447,2019-06-07,19,154,660,814
73448,2019-06-07,20,134,486,620
73449,2019-06-07,21,92,364,456
73450,2019-06-07,22,72,294,366
73451,2019-06-07,23,69,229,298
73452,2019-06-08,0,53,164,217
73453,2019-06-08,1,38,90,128
73454,2019-06-08,2,22,74,96
73455,2019-06-08,3,7,35,42
73456,2019-06-08,4,4,12,16
73457,2019-06-08,5,5,38,43
73458,2019-06-08,6,11,124,135
73459,2019-06-08,7,18,201,219
73460,2019-06-08,8,68,439,507
73461,2019-06-08,9,93,511,604
73462,2019-06-08,10,180,699,879
73463,2019-06-08,11,184,786,970
73464,2019-06-08,12,248,799,1047
73465,2019-06-08,13,265,852,1117
73466,2019-06-08,14,279,738,1017
73467,2019-06-08,15,315,777,1092
73468,2019-06-08,16,293,690,983
73469,2019-06-08,17,251,651,902
73470,2019-06-08,18,250,638,888
73471,2019-06-08,19,235,555,790
73472,2019-06-08,20,206,474,680
73473,2019-06-08,21,145,379,524
73474,2019-06-08,22,145,365,510
73475,2019-06-08,23,65,257,322
73476,2019-06-09,0,63,196,259
73477,2019-06-09,1,43,107,150
73478,2019-06-09,2,28,76,104
73479,2019-06-09,3,14,46,60
73480,2019-06-09,4,4,20,24
73481,2019-06-09,5,5,26,31
73482,2019-06-09,6,10,50,60
73483,2019-06-09,7,29,106,135
73484,2019-06-09,8,24,224,248
73485,2019-06-09,9,90,354,444
73486,2019-06-09,10,99,440,539
73487,2019-06-09,11,59,362,421
73488,2019-06-09,12,29,205,234
73489,2019-06-09,13,75,296,371
73490,2019-06-09,14,120,435,555
73491,2019-06-09,15,112,402,514
73492,2019-06-09,16,112,383,495
73493,2019-06-09,17,107,336,443
73494,2019-06-09,18,34,194,228
73495,2019-06-09,19,34,182,216
73496,2019-06-09,20,20,178,198
73497,2019-06-09,21,36,177,213
73498,2019-06-09,22,23,120,143
73499,2019-06-09,23,24,73,97
73500,2019-06-10,0,3,32,35
73501,2019-06-10,1,1,6,7
73502,2019-06-10,2,1,3,4
73503,2019-06-10,3,0,6,6
73504,2019-06-10,4,2,18,20
73505,2019-06-10,5,3,71,74
73506,2019-06-10,6,2,188,190
73507,2019-06-10,7,11,241,252
73508,2019-06-10,8,18,735,753
73509,2019-06-10,9,42,493,535
73510,2019-06-10,10,33,260,293
73511,2019-06-10,11,14,88,102
73512,2019-06-10,12,4,91,95
73513,2019-06-10,13,35,198,233
73514,2019-06-10,14,58,275,333
73515,2019-06-10,15,73,444,517
73516,2019-06-10,16,91,636,727
73517,2019-06-10,17,108,1252,1360
73518,2019-06-10,18,75,938,1013
73519,2019-06-10,19,71,636,707
73520,2019-06-10,20,39,498,537
73521,2019-06-10,21,27,265,292
73522,2019-06-10,22,27,130,157
73523,2019-06-10,23,9,90,99
73524,2019-06-11,0,5,27,32
73525,2019-06-11,1,1,9,10
73526,2019-06-11,2,2,5,7
73527,2019-06-11,3,4,5,9
73528,2019-06-11,4,5,18,23
73529,2019-06-11,5,3,106,109
73530,2019-06-11,6,8,353,361
73531,2019-06-11,7,35,892,927
73532,2019-06-11,8,41,1358,1399
73533,2019-06-11,9,36,670,706
73534,2019-06-11,10,55,325,380
73535,2019-06-11,11,73,364,437
73536,2019-06-11,12,95,452,547
73537,2019-06-11,13,96,438,534
73538,2019-06-11,14,102,436,538
73539,2019-06-11,15,147,486,633
73540,2019-06-11,16,133,731,864
73541,2019-06-11,17,156,1503,1659
73542,2019-06-11,18,152,1218,1370
73543,2019-06-11,19,138,806,944
73544,2019-06-11,20,105,588,693
73545,2019-06-11,21,69,354,423
73546,2019-06-11,22,43,210,253
73547,2019-06-11,23,34,89,123
73548,2019-06-12,0,19,55,74
73549,2019-06-12,1,10,25,35
73550,2019-06-12,2,1,6,7
73551,2019-06-12,3,4,5,9
73552,2019-06-12,4,2,23,25
73553,2019-06-12,5,7,128,135
73554,2019-06-12,6,8,383,391
73555,2019-06-12,7,28,850,878
73556,2019-06-12,8,47,1324,1371
73557,2019-06-12,9,57,659,716
73558,2019-06-12,10,76,293,369
73559,2019-06-12,11,98,402,500
73560,2019-06-12,12,94,455,549
73561,2019-06-12,13,104,450,554
73562,2019-06-12,14,98,411,509
73563,2019-06-12,15,150,533,683
73564,2019-06-12,16,95,817,912
73565,2019-06-12,17,136,1444,1580
73566,2019-06-12,18,162,1219,1381
73567,2019-06-12,19,137,757,894
73568,2019-06-12,20,71,547,618
73569,2019-06-12,21,22,224,246
73570,2019-06-12,22,15,103,118
73571,2019-06-12,23,9,57,66
73572,2019-06-13,0,9,32,41
73573,2019-06-13,1,3,16,19
73574,2019-06-13,2,0,1,1
73575,2019-06-13,3,1,5,6
73576,2019-06-13,4,1,17,18
73577,2019-06-13,5,0,30,30
73578,2019-06-13,6,3,119,122
73579,2019-06-13,7,8,488,496
73580,2019-06-13,8,20,1093,1113
73581,2019-06-13,9,32,649,681
73582,2019-06-13,10,34,237,271
73583,2019-06-13,11,58,267,325
73584,2019-06-13,12,42,357,399
73585,2019-06-13,13,36,301,337
73586,2019-06-13,14,52,332,384
73587,2019-06-13,15,69,439,508
73588,2019-06-13,16,84,782,866
73589,2019-06-13,17,83,940,1023
73590,2019-06-13,18,68,852,920
73591,2019-06-13,19,89,644,733
73592,2019-06-13,20,75,462,537
73593,2019-06-13,21,28,261,289
73594,2019-06-13,22,29,190,219
73595,2019-06-13,23,14,136,150
73596,2019-06-14,0,18,70,88
73597,2019-06-14,1,8,26,34
73598,2019-06-14,2,3,20,23
73599,2019-06-14,3,1,7,8
73600,2019-06-14,4,4,16,20
73601,2019-06-14,5,2,100,102
73602,2019-06-14,6,11,291,302
73603,2019-06-14,7,20,707,727
73604,2019-06-14,8,58,1198,1256
73605,2019-06-14,9,61,669,730
73606,2019-06-14,10,86,415,501
73607,2019-06-14,11,111,421,532
73608,2019-06-14,12,145,551,696
73609,2019-06-14,13,135,538,673
73610,2019-06-14,14,121,553,674
73611,2019-06-14,15,176,657,833
73612,2019-06-14,16,201,907,1108
73613,2019-06-14,17,196,1335,1531
73614,2019-06-14,18,174,1050,1224
73615,2019-06-14,19,146,667,813
73616,2019-06-14,20,136,499,635
73617,2019-06-14,21,96,357,453
73618,2019-06-14,22,75,310,385
73619,2019-06-14,23,51,246,297
73620,2019-06-15,0,34,131,165
73621,2019-06-15,1,24,84,108
73622,2019-06-15,2,21,60,81
73623,2019-06-15,3,9,36,45
73624,2019-06-15,4,4,19,23
73625,2019-06-15,5,2,34,36
73626,2019-06-15,6,6,74,80
73627,2019-06-15,7,16,169,185
73628,2019-06-15,8,30,302,332
73629,2019-06-15,9,137,498,635
73630,2019-06-15,10,133,621,754
73631,2019-06-15,11,181,722,903
73632,2019-06-15,12,244,839,1083
73633,2019-06-15,13,251,855,1106
73634,2019-06-15,14,222,774,996
73635,2019-06-15,15,267,735,1002
73636,2019-06-15,16,261,653,914
73637,2019-06-15,17,273,663,936
73638,2019-06-15,18,264,536,800
73639,2019-06-15,19,239,553,792
73640,2019-06-15,20,154,476,630
73641,2019-06-15,21,142,376,518
73642,2019-06-15,22,115,308,423
73643,2019-06-15,23,68,216,284
73644,2019-06-16,0,39,162,201
73645,2019-06-16,1,30,107,137
73646,2019-06-16,2,38,63,101
73647,2019-06-16,3,14,27,41
73648,2019-06-16,4,4,16,20
73649,2019-06-16,5,4,22,26
73650,2019-06-16,6,7,45,52
73651,2019-06-16,7,19,125,144
73652,2019-06-16,8,33,215,248
73653,2019-06-16,9,90,416,506
73654,2019-06-16,10,154,527,681
73655,2019-06-16,11,228,697,925
73656,2019-06-16,12,225,685,910
73657,2019-06-16,13,221,680,901
73658,2019-06-16,14,217,608,825
73659,2019-06-16,15,160,600,760
73660,2019-06-16,16,191,632,823
73661,2019-06-16,17,176,573,749
73662,2019-06-16,18,167,507,674
73663,2019-06-16,19,133,392,525
73664,2019-06-16,20,121,316,437
73665,2019-06-16,21,78,245,323
73666,2019-06-16,22,52,161,213
73667,2019-06-16,23,26,89,115
73668,2019-06-17,0,11,46,57
73669,2019-06-17,1,2,19,21
73670,2019-06-17,2,4,13,17
73671,2019-06-17,3,0,6,6
73672,2019-06-17,4,4,14,18
73673,2019-06-17,5,3,113,116
73674,2019-06-17,6,12,345,357
73675,2019-06-17,7,20,784,804
73676,2019-06-17,8,49,1223,1272
73677,2019-06-17,9,58,550,608
73678,2019-06-17,10,67,298,365
73679,2019-06-17,11,73,326,399
73680,2019-06-17,12,56,444,500
73681,2019-06-17,13,83,361,444
73682,2019-06-17,14,93,325,418
73683,2019-06-17,15,73,408,481
73684,2019-06-17,16,98,664,762
73685,2019-06-17,17,109,1100,1209
73686,2019-06-17,18,51,666,717
73687,2019-06-17,19,72,531,603
73688,2019-06-17,20,59,393,452
73689,2019-06-17,21,37,186,223
73690,2019-06-17,22,4,89,93
73691,2019-06-17,23,1,77,78
73692,2019-06-18,0,7,24,31
73693,2019-06-18,1,0,7,7
73694,2019-06-18,2,1,6,7
73695,2019-06-18,3,1,7,8
73696,2019-06-18,4,3,23,26
73697,2019-06-18,5,4,127,131
73698,2019-06-18,6,6,368,374
73699,2019-06-18,7,25,841,866
73700,2019-06-18,8,46,1304,1350
73701,2019-06-18,9,44,633,677
73702,2019-06-18,10,65,240,305
73703,2019-06-18,11,75,315,390
73704,2019-06-18,12,74,397,471
73705,2019-06-18,13,66,424,490
73706,2019-06-18,14,60,338,398
73707,2019-06-18,15,74,401,475
73708,2019-06-18,16,95,699,794
73709,2019-06-18,17,110,1369,1479
73710,2019-06-18,18,48,584,632
73711,2019-06-18,19,7,150,157
73712,2019-06-18,20,14,193,207
73713,2019-06-18,21,9,130,139
73714,2019-06-18,22,6,116,122
73715,2019-06-18,23,11,65,76
73716,2019-06-19,0,7,40,47
73717,2019-06-19,1,2,17,19
73718,2019-06-19,2,2,8,10
73719,2019-06-19,3,3,5,8
73720,2019-06-19,4,3,20,23
73721,2019-06-19,5,6,114,120
73722,2019-06-19,6,15,358,373
73723,2019-06-19,7,30,806,836
73724,2019-06-19,8,40,1210,1250
73725,2019-06-19,9,41,590,631
73726,2019-06-19,10,38,271,309
73727,2019-06-19,11,64,360,424
73728,2019-06-19,12,69,390,459
73729,2019-06-19,13,88,386,474
73730,2019-06-19,14,82,324,406
73731,2019-06-19,15,82,480,562
73732,2019-06-19,16,110,732,842
73733,2019-06-19,17,140,1479,1619
73734,2019-06-19,18,124,1164,1288
73735,2019-06-19,19,104,770,874
73736,2019-06-19,20,93,554,647
73737,2019-06-19,21,78,384,462
73738,2019-06-19,22,55,307,362
73739,2019-06-19,23,27,166,193
73740,2019-06-20,0,23,64,87
73741,2019-06-20,1,10,28,38
73742,2019-06-20,2,6,8,14
73743,2019-06-20,3,3,8,11
73744,2019-06-20,4,4,22,26
73745,2019-06-20,5,7,110,117
73746,2019-06-20,6,12,356,368
73747,2019-06-20,7,23,825,848
73748,2019-06-20,8,36,1339,1375
73749,2019-06-20,9,55,672,727
73750,2019-06-20,10,55,316,371
73751,2019-06-20,11,79,302,381
73752,2019-06-20,12,89,400,489
73753,2019-06-20,13,83,350,433
73754,2019-06-20,14,73,328,401
73755,2019-06-20,15,81,428,509
73756,2019-06-20,16,137,710,847
73757,2019-06-20,17,135,1282,1417
73758,2019-06-20,18,100,885,985
73759,2019-06-20,19,57,595,652
73760,2019-06-20,20,88,490,578
73761,2019-06-20,21,37,251,288
73762,2019-06-20,22,27,202,229
73763,2019-06-20,23,26,140,166
73764,2019-06-21,0,12,74,86
73765,2019-06-21,1,8,19,27
73766,2019-06-21,2,7,16,23
73767,2019-06-21,3,2,8,10
73768,2019-06-21,4,6,17,23
73769,2019-06-21,5,10,78,88
73770,2019-06-21,6,10,292,302
73771,2019-06-21,7,25,656,681
73772,2019-06-21,8,66,1197,1263
73773,2019-06-21,9,56,667,723
73774,2019-06-21,10,83,395,478
73775,2019-06-21,11,97,399,496
73776,2019-06-21,12,108,496,604
73777,2019-06-21,13,174,550,724
73778,2019-06-21,14,187,515,702
73779,2019-06-21,15,144,626,770
73780,2019-06-21,16,182,931,1113
73781,2019-06-21,17,186,1284,1470
73782,2019-06-21,18,204,1025,1229
73783,2019-06-21,19,173,639,812
73784,2019-06-21,20,160,538,698
73785,2019-06-21,21,79,341,420
73786,2019-06-21,22,85,335,420
73787,2019-06-21,23,63,222,285
73788,2019-06-22,0,57,150,207
73789,2019-06-22,1,22,74,96
73790,2019-06-22,2,25,72,97
73791,2019-06-22,3,12,26,38
73792,2019-06-22,4,1,14,15
73793,2019-06-22,5,2,29,31
73794,2019-06-22,6,10,70,80
73795,2019-06-22,7,32,133,165
73796,2019-06-22,8,62,320,382
73797,2019-06-22,9,95,514,609
73798,2019-06-22,10,143,730,873
73799,2019-06-22,11,290,768,1058
73800,2019-06-22,12,250,722,972
73801,2019-06-22,13,254,816,1070
73802,2019-06-22,14,309,764,1073
73803,2019-06-22,15,299,789,1088
73804,2019-06-22,16,316,767,1083
73805,2019-06-22,17,272,771,1043
73806,2019-06-22,18,251,681,932
73807,2019-06-22,19,209,601,810
73808,2019-06-22,20,193,481,674
73809,2019-06-22,21,192,377,569
73810,2019-06-22,22,105,325,430
73811,2019-06-22,23,130,297,427
73812,2019-06-23,0,82,159,241
73813,2019-06-23,1,42,116,158
73814,2019-06-23,2,28,96,124
73815,2019-06-23,3,34,39,73
73816,2019-06-23,4,5,12,17
73817,2019-06-23,5,4,16,20
73818,2019-06-23,6,4,65,69
73819,2019-06-23,7,17,116,133
73820,2019-06-23,8,35,277,312
73821,2019-06-23,9,95,395,490
73822,2019-06-23,10,164,572,736
73823,2019-06-23,11,201,646,847
73824,2019-06-23,12,220,754,974
73825,2019-06-23,13,221,767,988
73826,2019-06-23,14,249,759,1008
73827,2019-06-23,15,207,713,920
73828,2019-06-23,16,232,701,933
73829,2019-06-23,17,211,629,840
73830,2019-06-23,18,236,660,896
73831,2019-06-23,19,209,537,746
73832,2019-06-23,20,175,445,620
73833,2019-06-23,21,90,360,450
73834,2019-06-23,22,62,189,251
73835,2019-06-23,23,34,110,144
73836,2019-06-24,0,47,45,92
73837,2019-06-24,1,22,23,45
73838,2019-06-24,2,9,12,21
73839,2019-06-24,3,0,10,10
73840,2019-06-24,4,3,15,18
73841,2019-06-24,5,7,97,104
73842,2019-06-24,6,1,321,322
73843,2019-06-24,7,31,777,808
73844,2019-06-24,8,45,1275,1320
73845,2019-06-24,9,63,537,600
73846,2019-06-24,10,72,286,358
73847,2019-06-24,11,97,355,452
73848,2019-06-24,12,90,428,518
73849,2019-06-24,13,63,374,437
73850,2019-06-24,14,101,379,480
73851,2019-06-24,15,163,450,613
73852,2019-06-24,16,106,653,759
73853,2019-06-24,17,77,943,1020
73854,2019-06-24,18,73,810,883
73855,2019-06-24,19,84,589,673
73856,2019-06-24,20,97,498,595
73857,2019-06-24,21,58,351,409
73858,2019-06-24,22,49,217,266
73859,2019-06-24,23,36,88,124
73860,2019-06-25,0,12,42,54
73861,2019-06-25,1,5,20,25
73862,2019-06-25,2,0,1,1
73863,2019-06-25,3,0,3,3
73864,2019-06-25,4,2,19,21
73865,2019-06-25,5,5,105,110
73866,2019-06-25,6,10,386,396
73867,2019-06-25,7,26,890,916
73868,2019-06-25,8,39,1271,1310
73869,2019-06-25,9,47,593,640
73870,2019-06-25,10,62,301,363
73871,2019-06-25,11,58,363,421
73872,2019-06-25,12,82,411,493
73873,2019-06-25,13,84,365,449
73874,2019-06-25,14,98,348,446
73875,2019-06-25,15,83,483,566
73876,2019-06-25,16,101,759,860
73877,2019-06-25,17,136,1405,1541
73878,2019-06-25,18,108,1132,1240
73879,2019-06-25,19,137,783,920
73880,2019-06-25,20,124,573,697
73881,2019-06-25,21,72,423,495
73882,2019-06-25,22,41,204,245
73883,2019-06-25,23,18,104,122
73884,2019-06-26,0,8,55,63
73885,2019-06-26,1,0,14,14
73886,2019-06-26,2,1,11,12
73887,2019-06-26,3,1,6,7
73888,2019-06-26,4,1,20,21
73889,2019-06-26,5,9,123,132
73890,2019-06-26,6,12,391,403
73891,2019-06-26,7,32,899,931
73892,2019-06-26,8,48,1275,1323
73893,2019-06-26,9,42,600,642
73894,2019-06-26,10,53,291,344
73895,2019-06-26,11,67,341,408
73896,2019-06-26,12,80,417,497
73897,2019-06-26,13,61,379,440
73898,2019-06-26,14,75,352,427
73899,2019-06-26,15,83,437,520
73900,2019-06-26,16,81,708,789
73901,2019-06-26,17,117,1331,1448
73902,2019-06-26,18,147,1168,1315
73903,2019-06-26,19,159,875,1034
73904,2019-06-26,20,94,587,681
73905,2019-06-26,21,68,420,488
73906,2019-06-26,22,78,364,442
73907,2019-06-26,23,36,162,198
73908,2019-06-27,0,8,72,80
73909,2019-06-27,1,5,35,40
73910,2019-06-27,2,3,6,9
73911,2019-06-27,3,1,10,11
73912,2019-06-27,4,2,21,23
73913,2019-06-27,5,5,115,120
73914,2019-06-27,6,9,374,383
73915,2019-06-27,7,25,822,847
73916,2019-06-27,8,29,1224,1253
73917,2019-06-27,9,45,566,611
73918,2019-06-27,10,61,320,381
73919,2019-06-27,11,69,336,405
73920,2019-06-27,12,69,347,416
73921,2019-06-27,13,92,360,452
73922,2019-06-27,14,81,324,405
73923,2019-06-27,15,75,422,497
73924,2019-06-27,16,93,725,818
73925,2019-06-27,17,107,1313,1420
73926,2019-06-27,18,114,1037,1151
73927,2019-06-27,19,64,561,625
73928,2019-06-27,20,62,410,472
73929,2019-06-27,21,76,284,360
73930,2019-06-27,22,43,238,281
73931,2019-06-27,23,31,187,218
73932,2019-06-28,0,19,57,76
73933,2019-06-28,1,8,23,31
73934,2019-06-28,2,3,19,22
73935,2019-06-28,3,6,10,16
73936,2019-06-28,4,0,16,16
73937,2019-06-28,5,9,90,99
73938,2019-06-28,6,13,308,321
73939,2019-06-28,7,35,672,707
73940,2019-06-28,8,49,1143,1192
73941,2019-06-28,9,73,675,748
73942,2019-06-28,10,89,388,477
73943,2019-06-28,11,114,406,520
73944,2019-06-28,12,96,416,512
73945,2019-06-28,13,98,503,601
73946,2019-06-28,14,105,531,636
73947,2019-06-28,15,125,526,651
73948,2019-06-28,16,121,698,819
73949,2019-06-28,17,160,1165,1325
73950,2019-06-28,18,122,785,907
73951,2019-06-28,19,118,578,696
73952,2019-06-28,20,100,452,552
73953,2019-06-28,21,75,371,446
73954,2019-06-28,22,53,265,318
73955,2019-06-28,23,46,194,240
73956,2019-06-29,0,30,114,144
73957,2019-06-29,1,35,88,123
73958,2019-06-29,2,26,74,100
73959,2019-06-29,3,4,38,42
73960,2019-06-29,4,7,19,26
73961,2019-06-29,5,5,32,37
73962,2019-06-29,6,12,84,96
73963,2019-06-29,7,30,184,214
73964,2019-06-29,8,61,361,422
73965,2019-06-29,9,79,458,537
73966,2019-06-29,10,131,584,715
73967,2019-06-29,11,133,626,759
73968,2019-06-29,12,163,663,826
73969,2019-06-29,13,176,553,729
73970,2019-06-29,14,157,501,658
73971,2019-06-29,15,169,553,722
73972,2019-06-29,16,171,565,736
73973,2019-06-29,17,259,560,819
73974,2019-06-29,18,193,535,728
73975,2019-06-29,19,154,468,622
73976,2019-06-29,20,165,438,603
73977,2019-06-29,21,112,356,468
73978,2019-06-29,22,120,356,476
73979,2019-06-29,23,33,201,234
73980,2019-06-30,0,24,112,136
73981,2019-06-30,1,12,106,118
73982,2019-06-30,2,29,65,94
73983,2019-06-30,3,19,51,70
73984,2019-06-30,4,9,20,29
73985,2019-06-30,5,2,31,33
73986,2019-06-30,6,13,55,68
73987,2019-06-30,7,37,136,173
73988,2019-06-30,8,58,234,292
73989,2019-06-30,9,100,431,531
73990,2019-06-30,10,131,563,694
73991,2019-06-30,11,163,612,775
73992,2019-06-30,12,176,668,844
73993,2019-06-30,13,172,608,780
73994,2019-06-30,14,159,650,809
73995,2019-06-30,15,194,652,846
73996,2019-06-30,16,169,607,776
73997,2019-06-30,17,177,584,761
73998,2019-06-30,18,200,572,772
73999,2019-06-30,19,147,480,627
74000,2019-06-30,20,149,425,574
74001,2019-06-30,21,101,312,413
74002,2019-06-30,22,82,178,260
74003,2019-06-30,23,50,102,152
74004,2019-07-01,0,7,58,65
74005,2019-07-01,1,6,24,30
74006,2019-07-01,2,3,18,21
74007,2019-07-01,3,4,14,18
74008,2019-07-01,4,1,18,19
74009,2019-07-01,5,5,95,100
74010,2019-07-01,6,9,344,353
74011,2019-07-01,7,27,807,834
74012,2019-07-01,8,56,1155,1211
74013,2019-07-01,9,75,531,606
74014,2019-07-01,10,77,277,354
74015,2019-07-01,11,77,385,462
74016,2019-07-01,12,71,391,462
74017,2019-07-01,13,93,409,502
74018,2019-07-01,14,106,416,522
74019,2019-07-01,15,102,544,646
74020,2019-07-01,16,110,773,883
74021,2019-07-01,17,137,1386,1523
74022,2019-07-01,18,142,1161,1303
74023,2019-07-01,19,162,793,955
74024,2019-07-01,20,122,585,707
74025,2019-07-01,21,62,354,416
74026,2019-07-01,22,59,197,256
74027,2019-07-01,23,19,119,138
74028,2019-07-02,0,22,41,63
74029,2019-07-02,1,8,28,36
74030,2019-07-02,2,2,16,18
74031,2019-07-02,3,1,7,8
74032,2019-07-02,4,5,30,35
74033,2019-07-02,5,8,124,132
74034,2019-07-02,6,7,384,391
74035,2019-07-02,7,31,858,889
74036,2019-07-02,8,41,1248,1289
74037,2019-07-02,9,54,619,673
74038,2019-07-02,10,66,307,373
74039,2019-07-02,11,79,323,402
74040,2019-07-02,12,65,418,483
74041,2019-07-02,13,80,386,466
74042,2019-07-02,14,111,407,518
74043,2019-07-02,15,80,408,488
74044,2019-07-02,16,90,644,734
74045,2019-07-02,17,134,1023,1157
74046,2019-07-02,18,137,998,1135
74047,2019-07-02,19,118,637,755
74048,2019-07-02,20,19,116,135
74049,2019-07-02,21,27,240,267
74050,2019-07-02,22,22,180,202
74051,2019-07-02,23,20,108,128
74052,2019-07-03,0,9,52,61
74053,2019-07-03,1,10,16,26
74054,2019-07-03,2,5,9,14
74055,2019-07-03,3,4,6,10
74056,2019-07-03,4,1,29,30
74057,2019-07-03,5,3,91,94
74058,2019-07-03,6,16,342,358
74059,2019-07-03,7,39,741,780
74060,2019-07-03,8,56,1158,1214
74061,2019-07-03,9,63,613,676
74062,2019-07-03,10,84,409,493
74063,2019-07-03,11,114,445,559
74064,2019-07-03,12,117,503,620
74065,2019-07-03,13,100,518,618
74066,2019-07-03,14,107,581,688
74067,2019-07-03,15,96,715,811
74068,2019-07-03,16,112,825,937
74069,2019-07-03,17,145,1045,1190
74070,2019-07-03,18,118,876,994
74071,2019-07-03,19,112,625,737
74072,2019-07-03,20,130,470,600
74073,2019-07-03,21,91,408,499
74074,2019-07-03,22,60,249,309
74075,2019-07-03,23,56,202,258
74076,2019-07-04,0,26,92,118
74077,2019-07-04,1,27,75,102
74078,2019-07-04,2,16,52,68
74079,2019-07-04,3,2,28,30
74080,2019-07-04,4,2,25,27
74081,2019-07-04,5,3,41,44
74082,2019-07-04,6,12,83,95
74083,2019-07-04,7,25,141,166
74084,2019-07-04,8,51,258,309
74085,2019-07-04,9,127,423,550
74086,2019-07-04,10,176,584,760
74087,2019-07-04,11,170,581,751
74088,2019-07-04,12,199,610,809
74089,2019-07-04,13,222,643,865
74090,2019-07-04,14,268,593,861
74091,2019-07-04,15,184,468,652
74092,2019-07-04,16,136,269,405
74093,2019-07-04,17,204,355,559
74094,2019-07-04,18,142,275,417
74095,2019-07-04,19,144,301,445
74096,2019-07-04,20,265,431,696
74097,2019-07-04,21,242,545,787
74098,2019-07-04,22,173,405,578
74099,2019-07-04,23,48,188,236
74100,2019-07-05,0,23,116,139
74101,2019-07-05,1,14,38,52
74102,2019-07-05,2,15,29,44
74103,2019-07-05,3,4,8,12
74104,2019-07-05,4,2,10,12
74105,2019-07-05,5,6,47,53
74106,2019-07-05,6,9,131,140
74107,2019-07-05,7,18,298,316
74108,2019-07-05,8,36,470,506
74109,2019-07-05,9,89,510,599
74110,2019-07-05,10,144,421,565
74111,2019-07-05,11,188,545,733
74112,2019-07-05,12,230,611,841
74113,2019-07-05,13,234,614,848
74114,2019-07-05,14,271,590,861
74115,2019-07-05,15,266,662,928
74116,2019-07-05,16,156,763,919
74117,2019-07-05,17,181,777,958
74118,2019-07-05,18,202,654,856
74119,2019-07-05,19,199,546,745
74120,2019-07-05,20,228,514,742
74121,2019-07-05,21,158,383,541
74122,2019-07-05,22,131,317,448
74123,2019-07-05,23,74,211,285
74124,2019-07-06,0,48,153,201
74125,2019-07-06,1,26,81,107
74126,2019-07-06,2,13,43,56
74127,2019-07-06,3,10,33,43
74128,2019-07-06,4,7,10,17
74129,2019-07-06,5,9,41,50
74130,2019-07-06,6,6,77,83
74131,2019-07-06,7,14,182,196
74132,2019-07-06,8,47,324,371
74133,2019-07-06,9,136,483,619
74134,2019-07-06,10,172,598,770
74135,2019-07-06,11,214,590,804
74136,2019-07-06,12,232,615,847
74137,2019-07-06,13,227,611,838
74138,2019-07-06,14,290,678,968
74139,2019-07-06,15,252,566,818
74140,2019-07-06,16,243,604,847
74141,2019-07-06,17,208,579,787
74142,2019-07-06,18,232,521,753
74143,2019-07-06,19,77,232,309
74144,2019-07-06,20,73,153,226
74145,2019-07-06,21,57,141,198
74146,2019-07-06,22,21,97,118
74147,2019-07-06,23,35,104,139
74148,2019-07-07,0,21,104,125
74149,2019-07-07,1,27,73,100
74150,2019-07-07,2,9,42,51
74151,2019-07-07,3,5,27,32
74152,2019-07-07,4,2,16,18
74153,2019-07-07,5,6,23,29
74154,2019-07-07,6,9,46,55
74155,2019-07-07,7,24,98,122
74156,2019-07-07,8,48,241,289
74157,2019-07-07,9,101,405,506
74158,2019-07-07,10,142,672,814
74159,2019-07-07,11,160,518,678
74160,2019-07-07,12,142,523,665
74161,2019-07-07,13,164,634,798
74162,2019-07-07,14,192,627,819
74163,2019-07-07,15,169,618,787
74164,2019-07-07,16,174,578,752
74165,2019-07-07,17,186,567,753
74166,2019-07-07,18,152,538,690
74167,2019-07-07,19,172,467,639
74168,2019-07-07,20,108,424,532
74169,2019-07-07,21,100,301,401
74170,2019-07-07,22,47,185,232
74171,2019-07-07,23,38,116,154
74172,2019-07-08,0,17,46,63
74173,2019-07-08,1,10,33,43
74174,2019-07-08,2,3,13,16
74175,2019-07-08,3,3,11,14
74176,2019-07-08,4,0,19,19
74177,2019-07-08,5,3,103,106
74178,2019-07-08,6,12,280,292
74179,2019-07-08,7,20,612,632
74180,2019-07-08,8,15,423,438
74181,2019-07-08,9,3,40,43
74182,2019-07-08,10,7,62,69
74183,2019-07-08,11,10,131,141
74184,2019-07-08,12,17,174,191
74185,2019-07-08,13,12,129,141
74186,2019-07-08,14,35,249,284
74187,2019-07-08,15,82,398,480
74188,2019-07-08,16,102,659,761
74189,2019-07-08,17,114,1226,1340
74190,2019-07-08,18,103,1046,1149
74191,2019-07-08,19,80,766,846
74192,2019-07-08,20,86,525,611
74193,2019-07-08,21,64,297,361
74194,2019-07-08,22,53,193,246
74195,2019-07-08,23,17,115,132
74196,2019-07-09,0,3,39,42
74197,2019-07-09,1,6,13,19
74198,2019-07-09,2,1,6,7
74199,2019-07-09,3,0,9,9
74200,2019-07-09,4,1,18,19
74201,2019-07-09,5,6,114,120
74202,2019-07-09,6,11,410,421
74203,2019-07-09,7,21,905,926
74204,2019-07-09,8,44,1287,1331
74205,2019-07-09,9,51,698,749
74206,2019-07-09,10,70,332,402
74207,2019-07-09,11,79,362,441
74208,2019-07-09,12,108,425,533
74209,2019-07-09,13,80,396,476
74210,2019-07-09,14,100,378,478
74211,2019-07-09,15,88,459,547
74212,2019-07-09,16,99,785,884
74213,2019-07-09,17,116,1403,1519
74214,2019-07-09,18,121,1272,1393
74215,2019-07-09,19,116,874,990
74216,2019-07-09,20,116,619,735
74217,2019-07-09,21,72,405,477
74218,2019-07-09,22,48,243,291
74219,2019-07-09,23,24,136,160
74220,2019-07-10,0,5,52,57
74221,2019-07-10,1,14,25,39
74222,2019-07-10,2,0,20,20
74223,2019-07-10,3,0,9,9
74224,2019-07-10,4,1,17,18
74225,2019-07-10,5,7,123,130
74226,2019-07-10,6,20,411,431
74227,2019-07-10,7,26,845,871
74228,2019-07-10,8,46,1364,1410
74229,2019-07-10,9,48,587,635
74230,2019-07-10,10,50,287,337
74231,2019-07-10,11,78,348,426
74232,2019-07-10,12,83,433,516
74233,2019-07-10,13,68,401,469
74234,2019-07-10,14,76,375,451
74235,2019-07-10,15,61,471,532
74236,2019-07-10,16,97,669,766
74237,2019-07-10,17,138,1409,1547
74238,2019-07-10,18,151,1145,1296
74239,2019-07-10,19,129,849,978
74240,2019-07-10,20,94,612,706
74241,2019-07-10,21,81,431,512
74242,2019-07-10,22,45,260,305
74243,2019-07-10,23,27,141,168
74244,2019-07-11,0,21,51,72
74245,2019-07-11,1,7,22,29
74246,2019-07-11,2,5,14,19
74247,2019-07-11,3,0,6,6
74248,2019-07-11,4,1,20,21
74249,2019-07-11,5,2,116,118
74250,2019-07-11,6,20,354,374
74251,2019-07-11,7,32,841,873
74252,2019-07-11,8,47,1282,1329
74253,2019-07-11,9,57,593,650
74254,2019-07-11,10,46,224,270
74255,2019-07-11,11,45,287,332
74256,2019-07-11,12,65,424,489
74257,2019-07-11,13,59,397,456
74258,2019-07-11,14,87,333,420
74259,2019-07-11,15,62,345,407
74260,2019-07-11,16,40,334,374
74261,2019-07-11,17,71,1012,1083
74262,2019-07-11,18,14,251,265
74263,2019-07-11,19,4,163,167
74264,2019-07-11,20,24,257,281
74265,2019-07-11,21,24,264,288
74266,2019-07-11,22,26,184,210
74267,2019-07-11,23,17,118,135
74268,2019-07-12,0,21,72,93
74269,2019-07-12,1,12,31,43
74270,2019-07-12,2,5,24,29
74271,2019-07-12,3,1,12,13
74272,2019-07-12,4,5,22,27
74273,2019-07-12,5,5,94,99
74274,2019-07-12,6,10,322,332
74275,2019-07-12,7,17,716,733
74276,2019-07-12,8,53,1216,1269
74277,2019-07-12,9,54,606,660
74278,2019-07-12,10,107,391,498
74279,2019-07-12,11,102,450,552
74280,2019-07-12,12,128,530,658
74281,2019-07-12,13,132,514,646
74282,2019-07-12,14,111,513,624
74283,2019-07-12,15,109,551,660
74284,2019-07-12,16,154,848,1002
74285,2019-07-12,17,153,1222,1375
74286,2019-07-12,18,118,982,1100
74287,2019-07-12,19,144,772,916
74288,2019-07-12,20,132,547,679
74289,2019-07-12,21,117,500,617
74290,2019-07-12,22,106,306,412
74291,2019-07-12,23,67,239,306
74292,2019-07-13,0,53,185,238
74293,2019-07-13,1,43,109,152
74294,2019-07-13,2,29,80,109
74295,2019-07-13,3,15,42,57
74296,2019-07-13,4,2,17,19
74297,2019-07-13,5,14,31,45
74298,2019-07-13,6,5,75,80
74299,2019-07-13,7,27,179,206
74300,2019-07-13,8,60,420,480
74301,2019-07-13,9,119,506,625
74302,2019-07-13,10,174,641,815
74303,2019-07-13,11,195,710,905
74304,2019-07-13,12,194,756,950
74305,2019-07-13,13,218,789,1007
74306,2019-07-13,14,241,689,930
74307,2019-07-13,15,246,681,927
74308,2019-07-13,16,248,661,909
74309,2019-07-13,17,246,677,923
74310,2019-07-13,18,200,628,828
74311,2019-07-13,19,229,579,808
74312,2019-07-13,20,147,538,685
74313,2019-07-13,21,124,418,542
74314,2019-07-13,22,77,319,396
74315,2019-07-13,23,53,255,308
74316,2019-07-14,0,59,201,260
74317,2019-07-14,1,44,126,170
74318,2019-07-14,2,34,79,113
74319,2019-07-14,3,15,57,72
74320,2019-07-14,4,6,22,28
74321,2019-07-14,5,4,26,30
74322,2019-07-14,6,18,60,78
74323,2019-07-14,7,27,119,146
74324,2019-07-14,8,48,283,331
74325,2019-07-14,9,120,459,579
74326,2019-07-14,10,122,566,688
74327,2019-07-14,11,161,686,847
74328,2019-07-14,12,172,638,810
74329,2019-07-14,13,154,646,800
74330,2019-07-14,14,198,655,853
74331,2019-07-14,15,212,614,826
74332,2019-07-14,16,161,662,823
74333,2019-07-14,17,186,579,765
74334,2019-07-14,18,181,523,704
74335,2019-07-14,19,165,501,666
74336,2019-07-14,20,148,408,556
74337,2019-07-14,21,99,269,368
74338,2019-07-14,22,66,167,233
74339,2019-07-14,23,41,98,139
74340,2019-07-15,0,24,54,78
74341,2019-07-15,1,11,19,30
74342,2019-07-15,2,1,11,12
74343,2019-07-15,3,2,6,8
74344,2019-07-15,4,2,14,16
74345,2019-07-15,5,4,96,100
74346,2019-07-15,6,8,337,345
74347,2019-07-15,7,19,816,835
74348,2019-07-15,8,50,1233,1283
74349,2019-07-15,9,66,564,630
74350,2019-07-15,10,85,316,401
74351,2019-07-15,11,73,337,410
74352,2019-07-15,12,112,392,504
74353,2019-07-15,13,107,384,491
74354,2019-07-15,14,145,366,511
74355,2019-07-15,15,114,481,595
74356,2019-07-15,16,111,693,804
74357,2019-07-15,17,153,1334,1487
74358,2019-07-15,18,100,1131,1231
74359,2019-07-15,19,108,824,932
74360,2019-07-15,20,128,580,708
74361,2019-07-15,21,80,365,445
74362,2019-07-15,22,57,202,259
74363,2019-07-15,23,41,110,151
74364,2019-07-16,0,22,27,49
74365,2019-07-16,1,11,16,27
74366,2019-07-16,2,2,12,14
74367,2019-07-16,3,0,9,9
74368,2019-07-16,4,2,18,20
74369,2019-07-16,5,3,117,120
74370,2019-07-16,6,5,409,414
74371,2019-07-16,7,20,881,901
74372,2019-07-16,8,38,1273,1311
74373,2019-07-16,9,68,622,690
74374,2019-07-16,10,57,250,307
74375,2019-07-16,11,89,290,379
74376,2019-07-16,12,104,363,467
74377,2019-07-16,13,84,386,470
74378,2019-07-16,14,107,323,430
74379,2019-07-16,15,72,394,466
74380,2019-07-16,16,98,731,829
74381,2019-07-16,17,124,1327,1451
74382,2019-07-16,18,134,1167,1301
74383,2019-07-16,19,90,709,799
74384,2019-07-16,20,106,602,708
74385,2019-07-16,21,73,416,489
74386,2019-07-16,22,41,270,311
74387,2019-07-16,23,20,148,168
74388,2019-07-17,0,26,49,75
74389,2019-07-17,1,7,18,25
74390,2019-07-17,2,4,7,11
74391,2019-07-17,3,0,5,5
74392,2019-07-17,4,1,26,27
74393,2019-07-17,5,4,124,128
74394,2019-07-17,6,10,398,408
74395,2019-07-17,7,32,838,870
74396,2019-07-17,8,46,1224,1270
74397,2019-07-17,9,43,611,654
74398,2019-07-17,10,67,251,318
74399,2019-07-17,11,77,314,391
74400,2019-07-17,12,59,337,396
74401,2019-07-17,13,75,328,403
74402,2019-07-17,14,55,297,352
74403,2019-07-17,15,61,381,442
74404,2019-07-17,16,73,684,757
74405,2019-07-17,17,78,972,1050
74406,2019-07-17,18,45,623,668
74407,2019-07-17,19,49,432,481
74408,2019-07-17,20,78,495,573
74409,2019-07-17,21,53,414,467
74410,2019-07-17,22,36,314,350
74411,2019-07-17,23,21,154,175
74412,2019-07-18,0,9,67,76
74413,2019-07-18,1,2,30,32
74414,2019-07-18,2,1,20,21
74415,2019-07-18,3,0,9,9
74416,2019-07-18,4,2,29,31
74417,2019-07-18,5,3,118,121
74418,2019-07-18,6,10,358,368
74419,2019-07-18,7,35,819,854
74420,2019-07-18,8,54,1228,1282
74421,2019-07-18,9,61,619,680
74422,2019-07-18,10,107,303,410
74423,2019-07-18,11,79,329,408
74424,2019-07-18,12,101,420,521
74425,2019-07-18,13,106,332,438
74426,2019-07-18,14,105,332,437
74427,2019-07-18,15,77,415,492
74428,2019-07-18,16,119,661,780
74429,2019-07-18,17,157,1250,1407
74430,2019-07-18,18,155,1121,1276
74431,2019-07-18,19,125,810,935
74432,2019-07-18,20,113,607,720
74433,2019-07-18,21,90,452,542
74434,2019-07-18,22,65,374,439
74435,2019-07-18,23,44,208,252
74436,2019-07-19,0,21,88,109
74437,2019-07-19,1,10,40,50
74438,2019-07-19,2,0,19,19
74439,2019-07-19,3,1,8,9
74440,2019-07-19,4,1,13,14
74441,2019-07-19,5,4,95,99
74442,2019-07-19,6,12,297,309
74443,2019-07-19,7,29,674,703
74444,2019-07-19,8,68,1086,1154
74445,2019-07-19,9,53,551,604
74446,2019-07-19,10,70,347,417
74447,2019-07-19,11,88,347,435
74448,2019-07-19,12,70,388,458
74449,2019-07-19,13,90,412,502
74450,2019-07-19,14,91,393,484
74451,2019-07-19,15,80,463,543
74452,2019-07-19,16,73,676,749
74453,2019-07-19,17,112,1047,1159
74454,2019-07-19,18,103,737,840
74455,2019-07-19,19,152,580,732
74456,2019-07-19,20,168,615,783
74457,2019-07-19,21,139,574,713
74458,2019-07-19,22,140,542,682
74459,2019-07-19,23,106,400,506
74460,2019-07-20,0,62,215,277
74461,2019-07-20,1,21,116,137
74462,2019-07-20,2,21,62,83
74463,2019-07-20,3,9,32,41
74464,2019-07-20,4,5,14,19
74465,2019-07-20,5,5,34,39
74466,2019-07-20,6,15,67,82
74467,2019-07-20,7,23,156,179
74468,2019-07-20,8,82,318,400
74469,2019-07-20,9,117,472,589
74470,2019-07-20,10,140,534,674
74471,2019-07-20,11,104,534,638
74472,2019-07-20,12,131,557,688
74473,2019-07-20,13,101,477,578
74474,2019-07-20,14,131,442,573
74475,2019-07-20,15,139,454,593
74476,2019-07-20,16,142,452,594
74477,2019-07-20,17,170,436,606
74478,2019-07-20,18,160,424,584
74479,2019-07-20,19,163,381,544
74480,2019-07-20,20,158,551,709
74481,2019-07-20,21,138,473,611
74482,2019-07-20,22,118,473,591
74483,2019-07-20,23,140,482,622
74484,2019-07-21,0,84,289,373
74485,2019-07-21,1,42,117,159
74486,2019-07-21,2,20,78,98
74487,2019-07-21,3,10,40,50
74488,2019-07-21,4,4,20,24
74489,2019-07-21,5,7,26,33
74490,2019-07-21,6,11,44,55
74491,2019-07-21,7,22,125,147
74492,2019-07-21,8,47,246,293
74493,2019-07-21,9,85,331,416
74494,2019-07-21,10,124,432,556
74495,2019-07-21,11,105,457,562
74496,2019-07-21,12,134,497,631
74497,2019-07-21,13,130,496,626
74498,2019-07-21,14,106,415,521
74499,2019-07-21,15,111,437,548
74500,2019-07-21,16,92,377,469
74501,2019-07-21,17,91,457,548
74502,2019-07-21,18,84,442,526
74503,2019-07-21,19,94,391,485
74504,2019-07-21,20,56,249,305
74505,2019-07-21,21,57,240,297
74506,2019-07-21,22,34,171,205
74507,2019-07-21,23,29,94,123
74508,2019-07-22,0,13,53,66
74509,2019-07-22,1,15,10,25
74510,2019-07-22,2,1,13,14
74511,2019-07-22,3,0,6,6
74512,2019-07-22,4,0,13,13
74513,2019-07-22,5,5,113,118
74514,2019-07-22,6,14,357,371
74515,2019-07-22,7,28,822,850
74516,2019-07-22,8,39,1140,1179
74517,2019-07-22,9,49,506,555
74518,2019-07-22,10,48,274,322
74519,2019-07-22,11,61,364,425
74520,2019-07-22,12,61,327,388
74521,2019-07-22,13,62,371,433
74522,2019-07-22,14,78,321,399
74523,2019-07-22,15,86,393,479
74524,2019-07-22,16,73,714,787
74525,2019-07-22,17,111,1293,1404
74526,2019-07-22,18,78,1001,1079
74527,2019-07-22,19,68,695,763
74528,2019-07-22,20,48,376,424
74529,2019-07-22,21,31,234,265
74530,2019-07-22,22,28,153,181
74531,2019-07-22,23,25,89,114
74532,2019-07-23,0,6,41,47
74533,2019-07-23,1,3,13,16
74534,2019-07-23,2,2,13,15
74535,2019-07-23,3,1,8,9
74536,2019-07-23,4,1,20,21
74537,2019-07-23,5,4,124,128
74538,2019-07-23,6,11,312,323
74539,2019-07-23,7,15,481,496
74540,2019-07-23,8,14,647,661
74541,2019-07-23,9,7,248,255
74542,2019-07-23,10,19,160,179
74543,2019-07-23,11,49,213,262
74544,2019-07-23,12,38,232,270
74545,2019-07-23,13,94,309,403
74546,2019-07-23,14,62,311,373
74547,2019-07-23,15,119,468,587
74548,2019-07-23,16,106,725,831
74549,2019-07-23,17,128,1356,1484
74550,2019-07-23,18,115,1042,1157
74551,2019-07-23,19,79,675,754
74552,2019-07-23,20,75,498,573
74553,2019-07-23,21,58,365,423
74554,2019-07-23,22,33,245,278
74555,2019-07-23,23,33,165,198
74556,2019-07-24,0,18,53,71
74557,2019-07-24,1,5,20,25
74558,2019-07-24,2,8,10,18
74559,2019-07-24,3,5,6,11
74560,2019-07-24,4,3,22,25
74561,2019-07-24,5,5,123,128
74562,2019-07-24,6,14,411,425
74563,2019-07-24,7,23,922,945
74564,2019-07-24,8,44,1311,1355
74565,2019-07-24,9,36,655,691
74566,2019-07-24,10,53,342,395
74567,2019-07-24,11,102,395,497
74568,2019-07-24,12,106,442,548
74569,2019-07-24,13,123,437,560
74570,2019-07-24,14,78,368,446
74571,2019-07-24,15,114,507,621
74572,2019-07-24,16,114,826,940
74573,2019-07-24,17,173,1472,1645
74574,2019-07-24,18,150,1048,1198
74575,2019-07-24,19,43,403,446
74576,2019-07-24,20,71,476,547
74577,2019-07-24,21,43,309,352
74578,2019-07-24,22,40,275,315
74579,2019-07-24,23,39,128,167
74580,2019-07-25,0,22,64,86
74581,2019-07-25,1,3,29,32
74582,2019-07-25,2,3,15,18
74583,2019-07-25,3,7,11,18
74584,2019-07-25,4,0,26,26
74585,2019-07-25,5,2,102,104
74586,2019-07-25,6,10,387,397
74587,2019-07-25,7,27,840,867
74588,2019-07-25,8,38,1380,1418
74589,2019-07-25,9,48,676,724
74590,2019-07-25,10,57,312,369
74591,2019-07-25,11,76,386,462
74592,2019-07-25,12,85,490,575
74593,2019-07-25,13,87,420,507
74594,2019-07-25,14,104,422,526
74595,2019-07-25,15,125,555,680
74596,2019-07-25,16,147,778,925
74597,2019-07-25,17,172,1354,1526
74598,2019-07-25,18,203,1131,1334
74599,2019-07-25,19,123,832,955
74600,2019-07-25,20,98,591,689
74601,2019-07-25,21,71,432,503
74602,2019-07-25,22,67,347,414
74603,2019-07-25,23,30,195,225
74604,2019-07-26,0,26,69,95
74605,2019-07-26,1,7,45,52
74606,2019-07-26,2,9,24,33
74607,2019-07-26,3,4,9,13
74608,2019-07-26,4,1,17,18
74609,2019-07-26,5,4,95,99
74610,2019-07-26,6,10,295,305
74611,2019-07-26,7,29,688,717
74612,2019-07-26,8,49,1176,1225
74613,2019-07-26,9,52,703,755
74614,2019-07-26,10,82,434,516
74615,2019-07-26,11,143,472,615
74616,2019-07-26,12,141,467,608
74617,2019-07-26,13,155,558,713
74618,2019-07-26,14,158,588,746
74619,2019-07-26,15,119,631,750
74620,2019-07-26,16,150,851,1001
74621,2019-07-26,17,160,1250,1410
74622,2019-07-26,18,143,993,1136
74623,2019-07-26,19,158,677,835
74624,2019-07-26,20,135,535,670
74625,2019-07-26,21,107,371,478
74626,2019-07-26,22,91,368,459
74627,2019-07-26,23,53,236,289
74628,2019-07-27,0,37,193,230
74629,2019-07-27,1,26,115,141
74630,2019-07-27,2,26,85,111
74631,2019-07-27,3,19,33,52
74632,2019-07-27,4,4,19,23
74633,2019-07-27,5,4,29,33
74634,2019-07-27,6,14,91,105
74635,2019-07-27,7,25,164,189
74636,2019-07-27,8,48,383,431
74637,2019-07-27,9,106,535,641
74638,2019-07-27,10,165,696,861
74639,2019-07-27,11,197,653,850
74640,2019-07-27,12,219,743,962
74641,2019-07-27,13,257,674,931
74642,2019-07-27,14,247,745,992
74643,2019-07-27,15,256,757,1013
74644,2019-07-27,16,258,680,938
74645,2019-07-27,17,262,705,967
74646,2019-07-27,18,283,647,930
74647,2019-07-27,19,221,537,758
74648,2019-07-27,20,159,507,666
74649,2019-07-27,21,104,405,509
74650,2019-07-27,22,128,309,437
74651,2019-07-27,23,79,225,304
74652,2019-07-28,0,56,172,228
74653,2019-07-28,1,48,133,181
74654,2019-07-28,2,25,83,108
74655,2019-07-28,3,22,36,58
74656,2019-07-28,4,5,15,20
74657,2019-07-28,5,8,26,34
74658,2019-07-28,6,5,59,64
74659,2019-07-28,7,26,129,155
74660,2019-07-28,8,53,256,309
74661,2019-07-28,9,85,437,522
74662,2019-07-28,10,106,581,687
74663,2019-07-28,11,159,660,819
74664,2019-07-28,12,171,712,883
74665,2019-07-28,13,189,688,877
74666,2019-07-28,14,195,682,877
74667,2019-07-28,15,164,650,814
74668,2019-07-28,16,196,623,819
74669,2019-07-28,17,159,687,846
74670,2019-07-28,18,209,627,836
74671,2019-07-28,19,144,490,634
74672,2019-07-28,20,146,351,497
74673,2019-07-28,21,77,292,369
74674,2019-07-28,22,72,190,262
74675,2019-07-28,23,21,105,126
74676,2019-07-29,0,13,41,54
74677,2019-07-29,1,12,34,46
74678,2019-07-29,2,8,11,19
74679,2019-07-29,3,5,13,18
74680,2019-07-29,4,0,14,14
74681,2019-07-29,5,7,95,102
74682,2019-07-29,6,11,315,326
74683,2019-07-29,7,20,805,825
74684,2019-07-29,8,45,1232,1277
74685,2019-07-29,9,55,600,655
74686,2019-07-29,10,69,330,399
74687,2019-07-29,11,102,307,409
74688,2019-07-29,12,97,375,472
74689,2019-07-29,13,78,378,456
74690,2019-07-29,14,98,332,430
74691,2019-07-29,15,76,461,537
74692,2019-07-29,16,120,706,826
74693,2019-07-29,17,139,1418,1557
74694,2019-07-29,18,147,1216,1363
74695,2019-07-29,19,124,769,893
74696,2019-07-29,20,83,545,628
74697,2019-07-29,21,67,348,415
74698,2019-07-29,22,46,219,265
74699,2019-07-29,23,45,121,166
74700,2019-07-30,0,15,41,56
74701,2019-07-30,1,4,22,26
74702,2019-07-30,2,7,11,18
74703,2019-07-30,3,1,4,5
74704,2019-07-30,4,4,36,40
74705,2019-07-30,5,8,108,116
74706,2019-07-30,6,9,402,411
74707,2019-07-30,7,22,923,945
74708,2019-07-30,8,51,1325,1376
74709,2019-07-30,9,41,567,608
74710,2019-07-30,10,83,283,366
74711,2019-07-30,11,88,326,414
74712,2019-07-30,12,100,384,484
74713,2019-07-30,13,81,326,407
74714,2019-07-30,14,56,332,388
74715,2019-07-30,15,93,461,554
74716,2019-07-30,16,86,798,884
74717,2019-07-30,17,124,1407,1531
74718,2019-07-30,18,131,1225,1356
74719,2019-07-30,19,125,769,894
74720,2019-07-30,20,115,507,622
74721,2019-07-30,21,60,350,410
74722,2019-07-30,22,31,285,316
74723,2019-07-30,23,32,191,223
74724,2019-07-31,0,8,69,77
74725,2019-07-31,1,4,20,24
74726,2019-07-31,2,4,11,15
74727,2019-07-31,3,0,8,8
74728,2019-07-31,4,1,24,25
74729,2019-07-31,5,4,120,124
74730,2019-07-31,6,11,369,380
74731,2019-07-31,7,20,906,926
74732,2019-07-31,8,47,1306,1353
74733,2019-07-31,9,54,648,702
74734,2019-07-31,10,70,316,386
74735,2019-07-31,11,85,394,479
74736,2019-07-31,12,109,443,552
74737,2019-07-31,13,81,412,493
74738,2019-07-31,14,97,413,510
74739,2019-07-31,15,104,531,635
74740,2019-07-31,16,111,759,870
74741,2019-07-31,17,133,1317,1450
74742,2019-07-31,18,109,1088,1197
74743,2019-07-31,19,77,562,639
74744,2019-07-31,20,38,445,483
74745,2019-07-31,21,58,291,349
74746,2019-07-31,22,51,238,289
74747,2019-07-31,23,10,139,149
74748,2019-08-01,0,12,48,60
74749,2019-08-01,1,6,23,29
74750,2019-08-01,2,4,18,22
74751,2019-08-01,3,1,15,16
74752,2019-08-01,4,0,30,30
74753,2019-08-01,5,8,114,122
74754,2019-08-01,6,11,392,403
74755,2019-08-01,7,19,834,853
74756,2019-08-01,8,61,1357,1418
74757,2019-08-01,9,66,671,737
74758,2019-08-01,10,88,287,375
74759,2019-08-01,11,87,326,413
74760,2019-08-01,12,110,432,542
74761,2019-08-01,13,112,452,564
74762,2019-08-01,14,114,383,497
74763,2019-08-01,15,93,469,562
74764,2019-08-01,16,116,773,889
74765,2019-08-01,17,140,1371,1511
74766,2019-08-01,18,109,1176,1285
74767,2019-08-01,19,101,750,851
74768,2019-08-01,20,90,601,691
74769,2019-08-01,21,77,374,451
74770,2019-08-01,22,44,269,313
74771,2019-08-01,23,34,154,188
74772,2019-08-02,0,20,80,100
74773,2019-08-02,1,14,50,64
74774,2019-08-02,2,5,24,29
74775,2019-08-02,3,10,15,25
74776,2019-08-02,4,1,24,25
74777,2019-08-02,5,6,72,78
74778,2019-08-02,6,4,272,276
74779,2019-08-02,7,24,601,625
74780,2019-08-02,8,36,1165,1201
74781,2019-08-02,9,55,620,675
74782,2019-08-02,10,79,388,467
74783,2019-08-02,11,105,402,507
74784,2019-08-02,12,85,523,608
74785,2019-08-02,13,92,486,578
74786,2019-08-02,14,97,472,569
74787,2019-08-02,15,105,571,676
74788,2019-08-02,16,120,775,895
74789,2019-08-02,17,173,1151,1324
74790,2019-08-02,18,120,942,1062
74791,2019-08-02,19,154,689,843
74792,2019-08-02,20,120,485,605
74793,2019-08-02,21,88,368,456
74794,2019-08-02,22,66,265,331
74795,2019-08-02,23,43,204,247
74796,2019-08-03,0,34,166,200
74797,2019-08-03,1,33,103,136
74798,2019-08-03,2,18,62,80
74799,2019-08-03,3,11,34,45
74800,2019-08-03,4,7,14,21
74801,2019-08-03,5,3,28,31
74802,2019-08-03,6,10,81,91
74803,2019-08-03,7,17,193,210
74804,2019-08-03,8,42,386,428
74805,2019-08-03,9,89,525,614
74806,2019-08-03,10,97,593,690
74807,2019-08-03,11,165,648,813
74808,2019-08-03,12,216,680,896
74809,2019-08-03,13,186,644,830
74810,2019-08-03,14,209,601,810
74811,2019-08-03,15,238,673,911
74812,2019-08-03,16,237,646,883
74813,2019-08-03,17,198,637,835
74814,2019-08-03,18,225,586,811
74815,2019-08-03,19,184,573,757
74816,2019-08-03,20,172,460,632
74817,2019-08-03,21,139,324,463
74818,2019-08-03,22,99,293,392
74819,2019-08-03,23,97,238,335
74820,2019-08-04,0,62,143,205
74821,2019-08-04,1,32,118,150
74822,2019-08-04,2,32,87,119
74823,2019-08-04,3,32,39,71
74824,2019-08-04,4,4,19,23
74825,2019-08-04,5,4,20,24
74826,2019-08-04,6,7,46,53
74827,2019-08-04,7,25,159,184
74828,2019-08-04,8,49,283,332
74829,2019-08-04,9,108,463,571
74830,2019-08-04,10,163,575,738
74831,2019-08-04,11,175,632,807
74832,2019-08-04,12,213,655,868
74833,2019-08-04,13,203,688,891
74834,2019-08-04,14,207,618,825
74835,2019-08-04,15,186,645,831
74836,2019-08-04,16,217,692,909
74837,2019-08-04,17,149,618,767
74838,2019-08-04,18,155,607,762
74839,2019-08-04,19,179,560,739
74840,2019-08-04,20,115,413,528
74841,2019-08-04,21,100,353,453
74842,2019-08-04,22,53,254,307
74843,2019-08-04,23,38,141,179
74844,2019-08-05,0,14,57,71
74845,2019-08-05,1,8,17,25
74846,2019-08-05,2,2,16,18
74847,2019-08-05,3,2,6,8
74848,2019-08-05,4,0,32,32
74849,2019-08-05,5,4,104,108
74850,2019-08-05,6,11,320,331
74851,2019-08-05,7,16,794,810
74852,2019-08-05,8,53,1206,1259
74853,2019-08-05,9,67,595,662
74854,2019-08-05,10,90,303,393
74855,2019-08-05,11,82,306,388
74856,2019-08-05,12,91,402,493
74857,2019-08-05,13,75,385,460
74858,2019-08-05,14,111,362,473
74859,2019-08-05,15,101,423,524
74860,2019-08-05,16,129,720,849
74861,2019-08-05,17,163,1428,1591
74862,2019-08-05,18,125,1167,1292
74863,2019-08-05,19,130,806,936
74864,2019-08-05,20,68,468,536
74865,2019-08-05,21,47,314,361
74866,2019-08-05,22,38,186,224
74867,2019-08-05,23,27,88,115
74868,2019-08-06,0,16,63,79
74869,2019-08-06,1,5,26,31
74870,2019-08-06,2,1,15,16
74871,2019-08-06,3,1,7,8
74872,2019-08-06,4,1,33,34
74873,2019-08-06,5,2,118,120
74874,2019-08-06,6,5,418,423
74875,2019-08-06,7,22,841,863
74876,2019-08-06,8,52,1277,1329
74877,2019-08-06,9,60,617,677
74878,2019-08-06,10,95,320,415
74879,2019-08-06,11,97,394,491
74880,2019-08-06,12,84,398,482
74881,2019-08-06,13,82,387,469
74882,2019-08-06,14,89,383,472
74883,2019-08-06,15,106,436,542
74884,2019-08-06,16,99,765,864
74885,2019-08-06,17,119,1366,1485
74886,2019-08-06,18,115,1142,1257
74887,2019-08-06,19,112,789,901
74888,2019-08-06,20,73,398,471
74889,2019-08-06,21,41,267,308
74890,2019-08-06,22,38,179,217
74891,2019-08-06,23,19,101,120
74892,2019-08-07,0,6,49,55
74893,2019-08-07,1,7,23,30
74894,2019-08-07,2,6,19,25
74895,2019-08-07,3,1,8,9
74896,2019-08-07,4,2,27,29
74897,2019-08-07,5,4,133,137
74898,2019-08-07,6,11,374,385
74899,2019-08-07,7,16,859,875
74900,2019-08-07,8,70,1340,1410
74901,2019-08-07,9,42,667,709
74902,2019-08-07,10,64,298,362
74903,2019-08-07,11,98,358,456
74904,2019-08-07,12,103,392,495
74905,2019-08-07,13,97,405,502
74906,2019-08-07,14,105,341,446
74907,2019-08-07,15,91,403,494
74908,2019-08-07,16,31,294,325
74909,2019-08-07,17,85,1078,1163
74910,2019-08-07,18,104,1042,1146
74911,2019-08-07,19,114,791,905
74912,2019-08-07,20,88,528,616
74913,2019-08-07,21,52,331,383
74914,2019-08-07,22,34,229,263
74915,2019-08-07,23,26,112,138
74916,2019-08-08,0,7,43,50
74917,2019-08-08,1,2,22,24
74918,2019-08-08,2,8,12,20
74919,2019-08-08,3,1,6,7
74920,2019-08-08,4,2,34,36
74921,2019-08-08,5,1,110,111
74922,2019-08-08,6,11,368,379
74923,2019-08-08,7,29,821,850
74924,2019-08-08,8,49,1275,1324
74925,2019-08-08,9,50,666,716
74926,2019-08-08,10,70,312,382
74927,2019-08-08,11,111,343,454
74928,2019-08-08,12,84,368,452
74929,2019-08-08,13,95,400,495
74930,2019-08-08,14,115,386,501
74931,2019-08-08,15,119,489,608
74932,2019-08-08,16,131,719,850
74933,2019-08-08,17,149,1412,1561
74934,2019-08-08,18,122,1245,1367
74935,2019-08-08,19,118,785,903
74936,2019-08-08,20,80,616,696
74937,2019-08-08,21,62,371,433
74938,2019-08-08,22,64,275,339
74939,2019-08-08,23,36,185,221
74940,2019-08-09,0,22,104,126
74941,2019-08-09,1,11,37,48
74942,2019-08-09,2,7,22,29
74943,2019-08-09,3,0,12,12
74944,2019-08-09,4,2,29,31
74945,2019-08-09,5,5,78,83
74946,2019-08-09,6,10,273,283
74947,2019-08-09,7,22,653,675
74948,2019-08-09,8,55,1190,1245
74949,2019-08-09,9,58,684,742
74950,2019-08-09,10,83,398,481
74951,2019-08-09,11,105,478,583
74952,2019-08-09,12,95,502,597
74953,2019-08-09,13,120,544,664
74954,2019-08-09,14,144,514,658
74955,2019-08-09,15,129,647,776
74956,2019-08-09,16,139,842,981
74957,2019-08-09,17,148,1151,1299
74958,2019-08-09,18,157,921,1078
74959,2019-08-09,19,162,686,848
74960,2019-08-09,20,123,489,612
74961,2019-08-09,21,100,342,442
74962,2019-08-09,22,90,248,338
74963,2019-08-09,23,52,239,291
74964,2019-08-10,0,27,174,201
74965,2019-08-10,1,26,96,122
74966,2019-08-10,2,19,75,94
74967,2019-08-10,3,23,40,63
74968,2019-08-10,4,12,14,26
74969,2019-08-10,5,1,28,29
74970,2019-08-10,6,7,92,99
74971,2019-08-10,7,26,187,213
74972,2019-08-10,8,54,290,344
74973,2019-08-10,9,92,510,602
74974,2019-08-10,10,181,626,807
74975,2019-08-10,11,239,676,915
74976,2019-08-10,12,263,779,1042
74977,2019-08-10,13,301,711,1012
74978,2019-08-10,14,241,714,955
74979,2019-08-10,15,280,701,981
74980,2019-08-10,16,207,752,959
74981,2019-08-10,17,238,711,949
74982,2019-08-10,18,229,621,850
74983,2019-08-10,19,215,558,773
74984,2019-08-10,20,142,453,595
74985,2019-08-10,21,111,320,431
74986,2019-08-10,22,102,260,362
74987,2019-08-10,23,56,227,283
74988,2019-08-11,0,45,163,208
74989,2019-08-11,1,17,107,124
74990,2019-08-11,2,16,71,87
74991,2019-08-11,3,10,51,61
74992,2019-08-11,4,3,21,24
74993,2019-08-11,5,6,26,32
74994,2019-08-11,6,5,61,66
74995,2019-08-11,7,20,117,137
74996,2019-08-11,8,68,261,329
74997,2019-08-11,9,131,447,578
74998,2019-08-11,10,142,665,807
74999,2019-08-11,11,218,703,921
75000,2019-08-11,12,237,726,963
75001,2019-08-11,13,243,721,964
75002,2019-08-11,14,205,708,913
75003,2019-08-11,15,247,650,897
75004,2019-08-11,16,232,681,913
75005,2019-08-11,17,219,692,911
75006,2019-08-11,18,173,692,865
75007,2019-08-11,19,182,529,711
75008,2019-08-11,20,119,368,487
75009,2019-08-11,21,73,339,412
75010,2019-08-11,22,56,268,324
75011,2019-08-11,23,31,97,128
75012,2019-08-12,0,19,65,84
75013,2019-08-12,1,11,38,49
75014,2019-08-12,2,3,17,20
75015,2019-08-12,3,4,10,14
75016,2019-08-12,4,1,28,29
75017,2019-08-12,5,5,118,123
75018,2019-08-12,6,12,312,324
75019,2019-08-12,7,21,727,748
75020,2019-08-12,8,47,1077,1124
75021,2019-08-12,9,56,475,531
75022,2019-08-12,10,112,284,396
75023,2019-08-12,11,119,326,445
75024,2019-08-12,12,120,393,513
75025,2019-08-12,13,109,357,466
75026,2019-08-12,14,110,390,500
75027,2019-08-12,15,111,488,599
75028,2019-08-12,16,102,784,886
75029,2019-08-12,17,167,1418,1585
75030,2019-08-12,18,142,1172,1314
75031,2019-08-12,19,128,762,890
75032,2019-08-12,20,109,494,603
75033,2019-08-12,21,59,328,387
75034,2019-08-12,22,57,190,247
75035,2019-08-12,23,37,99,136
75036,2019-08-13,0,16,45,61
75037,2019-08-13,1,5,26,31
75038,2019-08-13,2,1,20,21
75039,2019-08-13,3,1,5,6
75040,2019-08-13,4,2,25,27
75041,2019-08-13,5,3,112,115
75042,2019-08-13,6,9,396,405
75043,2019-08-13,7,29,907,936
75044,2019-08-13,8,55,1268,1323
75045,2019-08-13,9,64,647,711
75046,2019-08-13,10,69,338,407
75047,2019-08-13,11,51,247,298
75048,2019-08-13,12,26,148,174
75049,2019-08-13,13,46,245,291
75050,2019-08-13,14,67,346,413
75051,2019-08-13,15,78,450,528
75052,2019-08-13,16,82,722,804
75053,2019-08-13,17,120,1313,1433
75054,2019-08-13,18,119,1121,1240
75055,2019-08-13,19,111,798,909
75056,2019-08-13,20,57,499,556
75057,2019-08-13,21,44,350,394
75058,2019-08-13,22,12,112,124
75059,2019-08-13,23,4,80,84
75060,2019-08-14,0,11,45,56
75061,2019-08-14,1,6,24,30
75062,2019-08-14,2,1,9,10
75063,2019-08-14,3,0,7,7
75064,2019-08-14,4,0,15,15
75065,2019-08-14,5,1,108,109
75066,2019-08-14,6,5,382,387
75067,2019-08-14,7,28,838,866
75068,2019-08-14,8,37,1254,1291
75069,2019-08-14,9,68,601,669
75070,2019-08-14,10,89,308,397
75071,2019-08-14,11,65,340,405
75072,2019-08-14,12,121,400,521
75073,2019-08-14,13,109,402,511
75074,2019-08-14,14,80,315,395
75075,2019-08-14,15,90,468,558
75076,2019-08-14,16,104,716,820
75077,2019-08-14,17,146,1312,1458
75078,2019-08-14,18,134,1208,1342
75079,2019-08-14,19,127,877,1004
75080,2019-08-14,20,69,608,677
75081,2019-08-14,21,65,357,422
75082,2019-08-14,22,52,216,268
75083,2019-08-14,23,16,123,139
75084,2019-08-15,0,8,52,60
75085,2019-08-15,1,4,24,28
75086,2019-08-15,2,3,13,16
75087,2019-08-15,3,1,3,4
75088,2019-08-15,4,1,24,25
75089,2019-08-15,5,6,104,110
75090,2019-08-15,6,6,338,344
75091,2019-08-15,7,19,810,829
75092,2019-08-15,8,36,1250,1286
75093,2019-08-15,9,33,638,671
75094,2019-08-15,10,64,326,390
75095,2019-08-15,11,92,355,447
75096,2019-08-15,12,86,440,526
75097,2019-08-15,13,93,404,497
75098,2019-08-15,14,116,380,496
75099,2019-08-15,15,115,472,587
75100,2019-08-15,16,63,479,542
75101,2019-08-15,17,57,738,795
75102,2019-08-15,18,87,1022,1109
75103,2019-08-15,19,94,704,798
75104,2019-08-15,20,64,523,587
75105,2019-08-15,21,48,309,357
75106,2019-08-15,22,33,229,262
75107,2019-08-15,23,28,178,206
75108,2019-08-16,0,14,71,85
75109,2019-08-16,1,14,37,51
75110,2019-08-16,2,4,18,22
75111,2019-08-16,3,2,6,8
75112,2019-08-16,4,1,29,30
75113,2019-08-16,5,1,99,100
75114,2019-08-16,6,3,282,285
75115,2019-08-16,7,22,658,680
75116,2019-08-16,8,28,1100,1128
75117,2019-08-16,9,50,670,720
75118,2019-08-16,10,100,387,487
75119,2019-08-16,11,100,464,564
75120,2019-08-16,12,100,473,573
75121,2019-08-16,13,121,465,586
75122,2019-08-16,14,123,490,613
75123,2019-08-16,15,130,569,699
75124,2019-08-16,16,98,876,974
75125,2019-08-16,17,148,1142,1290
75126,2019-08-16,18,133,944,1077
75127,2019-08-16,19,112,649,761
75128,2019-08-16,20,88,459,547
75129,2019-08-16,21,84,317,401
75130,2019-08-16,22,69,297,366
75131,2019-08-16,23,54,205,259
75132,2019-08-17,0,36,153,189
75133,2019-08-17,1,28,98,126
75134,2019-08-17,2,18,74,92
75135,2019-08-17,3,9,34,43
75136,2019-08-17,4,2,11,13
75137,2019-08-17,5,0,29,29
75138,2019-08-17,6,9,67,76
75139,2019-08-17,7,25,195,220
75140,2019-08-17,8,54,299,353
75141,2019-08-17,9,94,538,632
75142,2019-08-17,10,137,549,686
75143,2019-08-17,11,219,631,850
75144,2019-08-17,12,220,642,862
75145,2019-08-17,13,210,616,826
75146,2019-08-17,14,197,615,812
75147,2019-08-17,15,177,572,749
75148,2019-08-17,16,197,574,771
75149,2019-08-17,17,220,579,799
75150,2019-08-17,18,210,560,770
75151,2019-08-17,19,187,470,657
75152,2019-08-17,20,105,370,475
75153,2019-08-17,21,86,284,370
75154,2019-08-17,22,98,251,349
75155,2019-08-17,23,70,180,250
75156,2019-08-18,0,46,171,217
75157,2019-08-18,1,35,133,168
75158,2019-08-18,2,14,63,77
75159,2019-08-18,3,8,37,45
75160,2019-08-18,4,5,17,22
75161,2019-08-18,5,3,16,19
75162,2019-08-18,6,11,52,63
75163,2019-08-18,7,20,101,121
75164,2019-08-18,8,57,254,311
75165,2019-08-18,9,101,418,519
75166,2019-08-18,10,134,577,711
75167,2019-08-18,11,145,617,762
75168,2019-08-18,12,135,612,747
75169,2019-08-18,13,136,597,733
75170,2019-08-18,14,132,582,714
75171,2019-08-18,15,140,561,701
75172,2019-08-18,16,138,506,644
75173,2019-08-18,17,151,580,731
75174,2019-08-18,18,107,532,639
75175,2019-08-18,19,132,476,608
75176,2019-08-18,20,61,362,423
75177,2019-08-18,21,48,266,314
75178,2019-08-18,22,32,157,189
75179,2019-08-18,23,23,88,111
75180,2019-08-19,0,15,41,56
75181,2019-08-19,1,4,12,16
75182,2019-08-19,2,6,14,20
75183,2019-08-19,3,1,7,8
75184,2019-08-19,4,0,16,16
75185,2019-08-19,5,5,100,105
75186,2019-08-19,6,9,315,324
75187,2019-08-19,7,22,744,766
75188,2019-08-19,8,25,1186,1211
75189,2019-08-19,9,40,593,633
75190,2019-08-19,10,57,313,370
75191,2019-08-19,11,65,267,332
75192,2019-08-19,12,76,346,422
75193,2019-08-19,13,76,313,389
75194,2019-08-19,14,54,316,370
75195,2019-08-19,15,98,393,491
75196,2019-08-19,16,93,613,706
75197,2019-08-19,17,121,1178,1299
75198,2019-08-19,18,115,1029,1144
75199,2019-08-19,19,63,700,763
75200,2019-08-19,20,67,402,469
75201,2019-08-19,21,36,300,336
75202,2019-08-19,22,28,173,201
75203,2019-08-19,23,19,79,98
75204,2019-08-20,0,6,35,41
75205,2019-08-20,1,3,24,27
75206,2019-08-20,2,2,14,16
75207,2019-08-20,3,4,6,10
75208,2019-08-20,4,0,19,19
75209,2019-08-20,5,1,116,117
75210,2019-08-20,6,7,369,376
75211,2019-08-20,7,24,862,886
75212,2019-08-20,8,40,1245,1285
75213,2019-08-20,9,38,588,626
75214,2019-08-20,10,59,275,334
75215,2019-08-20,11,58,308,366
75216,2019-08-20,12,69,379,448
75217,2019-08-20,13,52,350,402
75218,2019-08-20,14,51,320,371
75219,2019-08-20,15,54,403,457
75220,2019-08-20,16,63,596,659
75221,2019-08-20,17,14,384,398
75222,2019-08-20,18,46,581,627
75223,2019-08-20,19,36,540,576
75224,2019-08-20,20,19,304,323
75225,2019-08-20,21,22,198,220
75226,2019-08-20,22,23,170,193
75227,2019-08-20,23,17,94,111
75228,2019-08-21,0,12,48,60
75229,2019-08-21,1,3,12,15
75230,2019-08-21,2,1,10,11
75231,2019-08-21,3,0,6,6
75232,2019-08-21,4,0,22,22
75233,2019-08-21,5,4,110,114
75234,2019-08-21,6,8,383,391
75235,2019-08-21,7,23,835,858
75236,2019-08-21,8,38,1319,1357
75237,2019-08-21,9,40,614,654
75238,2019-08-21,10,41,320,361
75239,2019-08-21,11,57,378,435
75240,2019-08-21,12,66,440,506
75241,2019-08-21,13,65,370,435
75242,2019-08-21,14,79,361,440
75243,2019-08-21,15,81,439,520
75244,2019-08-21,16,102,706,808
75245,2019-08-21,17,101,1299,1400
75246,2019-08-21,18,107,963,1070
75247,2019-08-21,19,87,691,778
75248,2019-08-21,20,63,504,567
75249,2019-08-21,21,56,350,406
75250,2019-08-21,22,32,272,304
75251,2019-08-21,23,24,123,147
75252,2019-08-22,0,14,49,63
75253,2019-08-22,1,12,26,38
75254,2019-08-22,2,3,8,11
75255,2019-08-22,3,3,9,12
75256,2019-08-22,4,2,21,23
75257,2019-08-22,5,4,102,106
75258,2019-08-22,6,15,375,390
75259,2019-08-22,7,16,785,801
75260,2019-08-22,8,47,1218,1265
75261,2019-08-22,9,41,634,675
75262,2019-08-22,10,73,318,391
75263,2019-08-22,11,68,313,381
75264,2019-08-22,12,68,412,480
75265,2019-08-22,13,88,379,467
75266,2019-08-22,14,71,353,424
75267,2019-08-22,15,73,417,490
75268,2019-08-22,16,78,730,808
75269,2019-08-22,17,87,1276,1363
75270,2019-08-22,18,134,1166,1300
75271,2019-08-22,19,91,746,837
75272,2019-08-22,20,49,504,553
75273,2019-08-22,21,47,322,369
75274,2019-08-22,22,51,249,300
75275,2019-08-22,23,19,156,175
75276,2019-08-23,0,24,91,115
75277,2019-08-23,1,25,30,55
75278,2019-08-23,2,15,23,38
75279,2019-08-23,3,16,5,21
75280,2019-08-23,4,2,22,24
75281,2019-08-23,5,5,70,75
75282,2019-08-23,6,13,322,335
75283,2019-08-23,7,25,690,715
75284,2019-08-23,8,45,1171,1216
75285,2019-08-23,9,39,593,632
75286,2019-08-23,10,31,195,226
75287,2019-08-23,11,36,212,248
75288,2019-08-23,12,29,108,137
75289,2019-08-23,13,16,98,114
75290,2019-08-23,14,16,82,98
75291,2019-08-23,15,25,257,282
75292,2019-08-23,16,32,360,392
75293,2019-08-23,17,50,813,863
75294,2019-08-23,18,64,731,795
75295,2019-08-23,19,67,590,657
75296,2019-08-23,20,59,359,418
75297,2019-08-23,21,36,263,299
75298,2019-08-23,22,34,186,220
75299,2019-08-23,23,28,173,201
75300,2019-08-24,0,14,131,145
75301,2019-08-24,1,14,92,106
75302,2019-08-24,2,10,66,76
75303,2019-08-24,3,8,35,43
75304,2019-08-24,4,1,15,16
75305,2019-08-24,5,2,25,27
75306,2019-08-24,6,8,65,73
75307,2019-08-24,7,28,168,196
75308,2019-08-24,8,40,323,363
75309,2019-08-24,9,92,499,591
75310,2019-08-24,10,137,676,813
75311,2019-08-24,11,139,760,899
75312,2019-08-24,12,231,795,1026
75313,2019-08-24,13,232,806,1038
75314,2019-08-24,14,203,789,992
75315,2019-08-24,15,221,783,1004
75316,2019-08-24,16,234,846,1080
75317,2019-08-24,17,226,745,971
75318,2019-08-24,18,178,621,799
75319,2019-08-24,19,175,528,703
75320,2019-08-24,20,94,342,436
75321,2019-08-24,21,104,334,438
75322,2019-08-24,22,69,304,373
75323,2019-08-24,23,56,250,306
75324,2019-08-25,0,37,171,208
75325,2019-08-25,1,23,125,148
75326,2019-08-25,2,29,76,105
75327,2019-08-25,3,11,50,61
75328,2019-08-25,4,1,27,28
75329,2019-08-25,5,2,17,19
75330,2019-08-25,6,4,48,52
75331,2019-08-25,7,12,108,120
75332,2019-08-25,8,52,264,316
75333,2019-08-25,9,80,434,514
75334,2019-08-25,10,148,579,727
75335,2019-08-25,11,173,713,886
75336,2019-08-25,12,195,790,985
75337,2019-08-25,13,224,703,927
75338,2019-08-25,14,222,798,1020
75339,2019-08-25,15,208,703,911
75340,2019-08-25,16,191,810,1001
75341,2019-08-25,17,218,718,936
75342,2019-08-25,18,174,649,823
75343,2019-08-25,19,146,564,710
75344,2019-08-25,20,50,314,364
75345,2019-08-25,21,58,235,293
75346,2019-08-25,22,37,180,217
75347,2019-08-25,23,39,132,171
75348,2019-08-26,0,20,75,95
75349,2019-08-26,1,6,39,45
75350,2019-08-26,2,4,37,41
75351,2019-08-26,3,4,16,20
75352,2019-08-26,4,0,23,23
75353,2019-08-26,5,4,105,109
75354,2019-08-26,6,15,333,348
75355,2019-08-26,7,22,832,854
75356,2019-08-26,8,48,1222,1270
75357,2019-08-26,9,66,564,630
75358,2019-08-26,10,68,287,355
75359,2019-08-26,11,80,337,417
75360,2019-08-26,12,92,366,458
75361,2019-08-26,13,101,417,518
75362,2019-08-26,14,95,354,449
75363,2019-08-26,15,86,453,539
75364,2019-08-26,16,95,749,844
75365,2019-08-26,17,98,1434,1532
75366,2019-08-26,18,85,1185,1270
75367,2019-08-26,19,71,705,776
75368,2019-08-26,20,56,439,495
75369,2019-08-26,21,35,304,339
75370,2019-08-26,22,22,147,169
75371,2019-08-26,23,9,80,89
75372,2019-08-27,0,13,39,52
75373,2019-08-27,1,4,10,14
75374,2019-08-27,2,1,4,5
75375,2019-08-27,3,1,6,7
75376,2019-08-27,4,1,19,20
75377,2019-08-27,5,1,106,107
75378,2019-08-27,6,6,395,401
75379,2019-08-27,7,21,931,952
75380,2019-08-27,8,36,1395,1431
75381,2019-08-27,9,44,538,582
75382,2019-08-27,10,46,286,332
75383,2019-08-27,11,61,302,363
75384,2019-08-27,12,55,389,444
75385,2019-08-27,13,59,378,437
75386,2019-08-27,14,89,336,425
75387,2019-08-27,15,72,457,529
75388,2019-08-27,16,69,834,903
75389,2019-08-27,17,99,1517,1616
75390,2019-08-27,18,131,1202,1333
75391,2019-08-27,19,66,815,881
75392,2019-08-27,20,42,516,558
75393,2019-08-27,21,53,337,390
75394,2019-08-27,22,38,282,320
75395,2019-08-27,23,27,101,128
75396,2019-08-28,0,11,54,65
75397,2019-08-28,1,8,25,33
75398,2019-08-28,2,2,15,17
75399,2019-08-28,3,0,11,11
75400,2019-08-28,4,0,12,12
75401,2019-08-28,5,4,137,141
75402,2019-08-28,6,8,414,422
75403,2019-08-28,7,23,904,927
75404,2019-08-28,8,41,1299,1340
75405,2019-08-28,9,41,587,628
75406,2019-08-28,10,59,308,367
75407,2019-08-28,11,50,351,401
75408,2019-08-28,12,67,402,469
75409,2019-08-28,13,70,406,476
75410,2019-08-28,14,77,388,465
75411,2019-08-28,15,72,463,535
75412,2019-08-28,16,35,432,467
75413,2019-08-28,17,70,1263,1333
75414,2019-08-28,18,94,1087,1181
75415,2019-08-28,19,80,703,783
75416,2019-08-28,20,64,496,560
75417,2019-08-28,21,50,280,330
75418,2019-08-28,22,54,247,301
75419,2019-08-28,23,26,105,131
75420,2019-08-29,0,15,42,57
75421,2019-08-29,1,7,19,26
75422,2019-08-29,2,5,9,14
75423,2019-08-29,3,1,13,14
75424,2019-08-29,4,1,15,16
75425,2019-08-29,5,1,101,102
75426,2019-08-29,6,13,361,374
75427,2019-08-29,7,24,913,937
75428,2019-08-29,8,39,1292,1331
75429,2019-08-29,9,47,618,665
75430,2019-08-29,10,35,335,370
75431,2019-08-29,11,79,366,445
75432,2019-08-29,12,84,462,546
75433,2019-08-29,13,92,461,553
75434,2019-08-29,14,112,411,523
75435,2019-08-29,15,118,522,640
75436,2019-08-29,16,107,840,947
75437,2019-08-29,17,149,1422,1571
75438,2019-08-29,18,111,1154,1265
75439,2019-08-29,19,93,764,857
75440,2019-08-29,20,104,534,638
75441,2019-08-29,21,29,344,373
75442,2019-08-29,22,31,234,265
75443,2019-08-29,23,19,152,171
75444,2019-08-30,0,17,80,97
75445,2019-08-30,1,21,36,57
75446,2019-08-30,2,7,16,23
75447,2019-08-30,3,2,6,8
75448,2019-08-30,4,2,20,22
75449,2019-08-30,5,7,86,93
75450,2019-08-30,6,12,243,255
75451,2019-08-30,7,29,617,646
75452,2019-08-30,8,39,1086,1125
75453,2019-08-30,9,64,645,709
75454,2019-08-30,10,67,383,450
75455,2019-08-30,11,94,478,572
75456,2019-08-30,12,115,589,704
75457,2019-08-30,13,82,629,711
75458,2019-08-30,14,102,596,698
75459,2019-08-30,15,109,747,856
75460,2019-08-30,16,92,830,922
75461,2019-08-30,17,107,947,1054
75462,2019-08-30,18,107,820,927
75463,2019-08-30,19,144,625,769
75464,2019-08-30,20,82,427,509
75465,2019-08-30,21,66,280,346
75466,2019-08-30,22,66,240,306
75467,2019-08-30,23,44,230,274
75468,2019-08-31,0,30,118,148
75469,2019-08-31,1,31,78,109
75470,2019-08-31,2,13,69,82
75471,2019-08-31,3,9,14,23
75472,2019-08-31,4,6,9,15
75473,2019-08-31,5,7,31,38
75474,2019-08-31,6,11,73,84
75475,2019-08-31,7,24,139,163
75476,2019-08-31,8,67,278,345
75477,2019-08-31,9,112,488,600
75478,2019-08-31,10,174,592,766
75479,2019-08-31,11,170,665,835
75480,2019-08-31,12,226,699,925
75481,2019-08-31,13,197,605,802
75482,2019-08-31,14,213,689,902
75483,2019-08-31,15,232,679,911
75484,2019-08-31,16,211,589,800
75485,2019-08-31,17,260,599,859
75486,2019-08-31,18,212,546,758
75487,2019-08-31,19,161,491,652
75488,2019-08-31,20,111,377,488
75489,2019-08-31,21,100,281,381
75490,2019-08-31,22,83,242,325
75491,2019-08-31,23,69,183,252
75492,2019-09-01,0,44,145,189
75493,2019-09-01,1,39,89,128
75494,2019-09-01,2,8,61,69
75495,2019-09-01,3,12,35,47
75496,2019-09-01,4,10,13,23
75497,2019-09-01,5,12,20,32
75498,2019-09-01,6,9,42,51
75499,2019-09-01,7,30,103,133
75500,2019-09-01,8,57,227,284
75501,2019-09-01,9,114,453,567
75502,2019-09-01,10,155,602,757
75503,2019-09-01,11,231,638,869
75504,2019-09-01,12,256,678,934
75505,2019-09-01,13,238,657,895
75506,2019-09-01,14,239,712,951
75507,2019-09-01,15,290,669,959
75508,2019-09-01,16,251,716,967
75509,2019-09-01,17,270,674,944
75510,2019-09-01,18,209,640,849
75511,2019-09-01,19,154,585,739
75512,2019-09-01,20,128,384,512
75513,2019-09-01,21,148,360,508
75514,2019-09-01,22,106,254,360
75515,2019-09-01,23,59,174,233
75516,2019-09-02,0,48,129,177
75517,2019-09-02,1,16,54,70
75518,2019-09-02,2,13,41,54
75519,2019-09-02,3,9,18,27
75520,2019-09-02,4,2,18,20
75521,2019-09-02,5,1,28,29
75522,2019-09-02,6,6,48,54
75523,2019-09-02,7,18,90,108
75524,2019-09-02,8,39,244,283
75525,2019-09-02,9,73,380,453
75526,2019-09-02,10,128,544,672
75527,2019-09-02,11,143,627,770
75528,2019-09-02,12,188,643,831
75529,2019-09-02,13,231,645,876
75530,2019-09-02,14,163,613,776
75531,2019-09-02,15,171,601,772
75532,2019-09-02,16,168,573,741
75533,2019-09-02,17,122,525,647
75534,2019-09-02,18,86,353,439
75535,2019-09-02,19,71,390,461
75536,2019-09-02,20,50,273,323
75537,2019-09-02,21,34,196,230
75538,2019-09-02,22,33,147,180
75539,2019-09-02,23,12,75,87
75540,2019-09-03,0,11,43,54
75541,2019-09-03,1,6,21,27
75542,2019-09-03,2,1,10,11
75543,2019-09-03,3,2,11,13
75544,2019-09-03,4,2,17,19
75545,2019-09-03,5,7,111,118
75546,2019-09-03,6,6,380,386
75547,2019-09-03,7,16,843,859
75548,2019-09-03,8,47,1277,1324
75549,2019-09-03,9,42,536,578
75550,2019-09-03,10,75,324,399
75551,2019-09-03,11,72,310,382
75552,2019-09-03,12,85,437,522
75553,2019-09-03,13,77,416,493
75554,2019-09-03,14,87,308,395
75555,2019-09-03,15,52,448,500
75556,2019-09-03,16,68,739,807
75557,2019-09-03,17,83,1447,1530
75558,2019-09-03,18,98,1213,1311
75559,2019-09-03,19,53,783,836
75560,2019-09-03,20,43,533,576
75561,2019-09-03,21,33,324,357
75562,2019-09-03,22,22,234,256
75563,2019-09-03,23,8,110,118
75564,2019-09-04,0,10,54,64
75565,2019-09-04,1,5,24,29
75566,2019-09-04,2,3,10,13
75567,2019-09-04,3,1,11,12
75568,2019-09-04,4,0,18,18
75569,2019-09-04,5,4,131,135
75570,2019-09-04,6,7,417,424
75571,2019-09-04,7,16,924,940
75572,2019-09-04,8,48,1383,1431
75573,2019-09-04,9,39,596,635
75574,2019-09-04,10,49,324,373
75575,2019-09-04,11,54,300,354
75576,2019-09-04,12,61,430,491
75577,2019-09-04,13,52,371,423
75578,2019-09-04,14,39,323,362
75579,2019-09-04,15,53,438,491
75580,2019-09-04,16,90,752,842
75581,2019-09-04,17,96,1404,1500
75582,2019-09-04,18,67,1186,1253
75583,2019-09-04,19,78,777,855
75584,2019-09-04,20,40,495,535
75585,2019-09-04,21,29,253,282
75586,2019-09-04,22,19,166,185
75587,2019-09-04,23,9,88,97
75588,2019-09-05,0,5,47,52
75589,2019-09-05,1,1,17,18
75590,2019-09-05,2,6,20,26
75591,2019-09-05,3,0,8,8
75592,2019-09-05,4,1,23,24
75593,2019-09-05,5,9,126,135
75594,2019-09-05,6,6,375,381
75595,2019-09-05,7,22,931,953
75596,2019-09-05,8,35,1425,1460
75597,2019-09-05,9,41,605,646
75598,2019-09-05,10,48,328,376
75599,2019-09-05,11,68,361,429
75600,2019-09-05,12,48,438,486
75601,2019-09-05,13,93,404,497
75602,2019-09-05,14,71,424,495
75603,2019-09-05,15,95,501,596
75604,2019-09-05,16,75,815,890
75605,2019-09-05,17,127,1425,1552
75606,2019-09-05,18,98,1150,1248
75607,2019-09-05,19,78,793,871
75608,2019-09-05,20,35,515,550
75609,2019-09-05,21,34,360,394
75610,2019-09-05,22,18,264,282
75611,2019-09-05,23,14,174,188
75612,2019-09-06,0,6,60,66
75613,2019-09-06,1,6,29,35
75614,2019-09-06,2,6,18,24
75615,2019-09-06,3,4,11,15
75616,2019-09-06,4,2,25,27
75617,2019-09-06,5,2,91,93
75618,2019-09-06,6,10,326,336
75619,2019-09-06,7,25,826,851
75620,2019-09-06,8,40,1339,1379
75621,2019-09-06,9,58,644,702
75622,2019-09-06,10,48,339,387
75623,2019-09-06,11,63,405,468
75624,2019-09-06,12,77,487,564
75625,2019-09-06,13,70,483,553
75626,2019-09-06,14,95,434,529
75627,2019-09-06,15,118,604,722
75628,2019-09-06,16,121,821,942
75629,2019-09-06,17,107,1319,1426
75630,2019-09-06,18,105,995,1100
75631,2019-09-06,19,72,717,789
75632,2019-09-06,20,65,469,534
75633,2019-09-06,21,59,327,386
75634,2019-09-06,22,39,260,299
75635,2019-09-06,23,36,236,272
75636,2019-09-07,0,30,157,187
75637,2019-09-07,1,49,114,163
75638,2019-09-07,2,15,80,95
75639,2019-09-07,3,1,32,33
75640,2019-09-07,4,2,19,21
75641,2019-09-07,5,6,26,32
75642,2019-09-07,6,8,73,81
75643,2019-09-07,7,17,181,198
75644,2019-09-07,8,34,356,390
75645,2019-09-07,9,99,560,659
75646,2019-09-07,10,142,717,859
75647,2019-09-07,11,189,756,945
75648,2019-09-07,12,174,821,995
75649,2019-09-07,13,211,777,988
75650,2019-09-07,14,190,748,938
75651,2019-09-07,15,168,754,922
75652,2019-09-07,16,177,810,987
75653,2019-09-07,17,201,727,928
75654,2019-09-07,18,169,726,895
75655,2019-09-07,19,124,585,709
75656,2019-09-07,20,67,384,451
75657,2019-09-07,21,69,322,391
75658,2019-09-07,22,92,221,313
75659,2019-09-07,23,55,254,309
75660,2019-09-08,0,44,188,232
75661,2019-09-08,1,36,105,141
75662,2019-09-08,2,16,80,96
75663,2019-09-08,3,8,34,42
75664,2019-09-08,4,10,29,39
75665,2019-09-08,5,4,22,26
75666,2019-09-08,6,13,35,48
75667,2019-09-08,7,13,111,124
75668,2019-09-08,8,42,254,296
75669,2019-09-08,9,68,431,499
75670,2019-09-08,10,145,598,743
75671,2019-09-08,11,145,681,826
75672,2019-09-08,12,177,789,966
75673,2019-09-08,13,163,740,903
75674,2019-09-08,14,204,669,873
75675,2019-09-08,15,181,705,886
75676,2019-09-08,16,171,719,890
75677,2019-09-08,17,150,678,828
75678,2019-09-08,18,137,586,723
75679,2019-09-08,19,94,543,637
75680,2019-09-08,20,58,309,367
75681,2019-09-08,21,51,217,268
75682,2019-09-08,22,32,149,181
75683,2019-09-08,23,18,82,100
75684,2019-09-09,0,10,35,45
75685,2019-09-09,1,6,19,25
75686,2019-09-09,2,0,7,7
75687,2019-09-09,3,1,5,6
75688,2019-09-09,4,2,18,20
75689,2019-09-09,5,8,105,113
75690,2019-09-09,6,2,354,356
75691,2019-09-09,7,27,842,869
75692,2019-09-09,8,39,1245,1284
75693,2019-09-09,9,34,538,572
75694,2019-09-09,10,39,276,315
75695,2019-09-09,11,52,320,372
75696,2019-09-09,12,65,432,497
75697,2019-09-09,13,75,440,515
75698,2019-09-09,14,74,399,473
75699,2019-09-09,15,76,509,585
75700,2019-09-09,16,94,808,902
75701,2019-09-09,17,103,1465,1568
75702,2019-09-09,18,94,1220,1314
75703,2019-09-09,19,82,764,846
75704,2019-09-09,20,43,486,529
75705,2019-09-09,21,28,312,340
75706,2019-09-09,22,22,192,214
75707,2019-09-09,23,24,100,124
75708,2019-09-10,0,7,34,41
75709,2019-09-10,1,3,19,22
75710,2019-09-10,2,2,11,13
75711,2019-09-10,3,1,7,8
75712,2019-09-10,4,0,21,21
75713,2019-09-10,5,1,106,107
75714,2019-09-10,6,7,414,421
75715,2019-09-10,7,26,965,991
75716,2019-09-10,8,38,1425,1463
75717,2019-09-10,9,27,634,661
75718,2019-09-10,10,56,330,386
75719,2019-09-10,11,48,359,407
75720,2019-09-10,12,59,402,461
75721,2019-09-10,13,63,423,486
75722,2019-09-10,14,43,356,399
75723,2019-09-10,15,83,520,603
75724,2019-09-10,16,86,818,904
75725,2019-09-10,17,138,1477,1615
75726,2019-09-10,18,108,1214,1322
75727,2019-09-10,19,67,792,859
75728,2019-09-10,20,65,507,572
75729,2019-09-10,21,30,355,385
75730,2019-09-10,22,21,243,264
75731,2019-09-10,23,8,119,127
75732,2019-09-11,0,7,57,64
75733,2019-09-11,1,5,22,27
75734,2019-09-11,2,4,15,19
75735,2019-09-11,3,4,6,10
75736,2019-09-11,4,3,13,16
75737,2019-09-11,5,7,109,116
75738,2019-09-11,6,11,407,418
75739,2019-09-11,7,32,935,967
75740,2019-09-11,8,44,1368,1412
75741,2019-09-11,9,40,671,711
75742,2019-09-11,10,54,329,383
75743,2019-09-11,11,61,305,366
75744,2019-09-11,12,70,394,464
75745,2019-09-11,13,59,372,431
75746,2019-09-11,14,62,375,437
75747,2019-09-11,15,68,471,539
75748,2019-09-11,16,64,774,838
75749,2019-09-11,17,89,1160,1249
75750,2019-09-11,18,82,906,988
75751,2019-09-11,19,59,739,798
75752,2019-09-11,20,32,475,507
75753,2019-09-11,21,19,340,359
75754,2019-09-11,22,16,221,237
75755,2019-09-11,23,10,94,104
75756,2019-09-12,0,2,57,59
75757,2019-09-12,1,2,16,18
75758,2019-09-12,2,5,11,16
75759,2019-09-12,3,4,4,8
75760,2019-09-12,4,0,20,20
75761,2019-09-12,5,2,100,102
75762,2019-09-12,6,14,368,382
75763,2019-09-12,7,22,913,935
75764,2019-09-12,8,43,1476,1519
75765,2019-09-12,9,33,621,654
75766,2019-09-12,10,66,298,364
75767,2019-09-12,11,59,301,360
75768,2019-09-12,12,53,378,431
75769,2019-09-12,13,63,389,452
75770,2019-09-12,14,68,345,413
75771,2019-09-12,15,52,466,518
75772,2019-09-12,16,45,759,804
75773,2019-09-12,17,105,1331,1436
75774,2019-09-12,18,103,1165,1268
75775,2019-09-12,19,61,798,859
75776,2019-09-12,20,40,497,537
75777,2019-09-12,21,27,299,326
75778,2019-09-12,22,32,226,258
75779,2019-09-12,23,18,136,154
75780,2019-09-13,0,11,69,80
75781,2019-09-13,1,1,37,38
75782,2019-09-13,2,5,13,18
75783,2019-09-13,3,1,6,7
75784,2019-09-13,4,0,12,12
75785,2019-09-13,5,3,79,82
75786,2019-09-13,6,12,278,290
75787,2019-09-13,7,17,735,752
75788,2019-09-13,8,44,1334,1378
75789,2019-09-13,9,40,688,728
75790,2019-09-13,10,41,399,440
75791,2019-09-13,11,78,375,453
75792,2019-09-13,12,67,482,549
75793,2019-09-13,13,86,485,571
75794,2019-09-13,14,91,495,586
75795,2019-09-13,15,99,602,701
75796,2019-09-13,16,111,957,1068
75797,2019-09-13,17,107,1350,1457
75798,2019-09-13,18,86,1021,1107
75799,2019-09-13,19,61,635,696
75800,2019-09-13,20,52,387,439
75801,2019-09-13,21,59,351,410
75802,2019-09-13,22,47,319,366
75803,2019-09-13,23,36,232,268
75804,2019-09-14,0,21,183,204
75805,2019-09-14,1,21,116,137
75806,2019-09-14,2,15,70,85
75807,2019-09-14,3,5,39,44
75808,2019-09-14,4,3,18,21
75809,2019-09-14,5,2,24,26
75810,2019-09-14,6,7,62,69
75811,2019-09-14,7,15,174,189
75812,2019-09-14,8,37,330,367
75813,2019-09-14,9,70,525,595
75814,2019-09-14,10,111,680,791
75815,2019-09-14,11,127,649,776
75816,2019-09-14,12,196,791,987
75817,2019-09-14,13,200,792,992
75818,2019-09-14,14,175,737,912
75819,2019-09-14,15,211,746,957
75820,2019-09-14,16,175,661,836
75821,2019-09-14,17,211,690,901
75822,2019-09-14,18,200,628,828
75823,2019-09-14,19,141,548,689
75824,2019-09-14,20,86,398,484
75825,2019-09-14,21,88,324,412
75826,2019-09-14,22,62,281,343
75827,2019-09-14,23,52,251,303
75828,2019-09-15,0,38,210,248
75829,2019-09-15,1,46,154,200
75830,2019-09-15,2,23,125,148
75831,2019-09-15,3,15,46,61
75832,2019-09-15,4,9,17,26
75833,2019-09-15,5,4,18,22
75834,2019-09-15,6,9,41,50
75835,2019-09-15,7,16,112,128
75836,2019-09-15,8,32,263,295
75837,2019-09-15,9,70,482,552
75838,2019-09-15,10,132,613,745
75839,2019-09-15,11,151,730,881
75840,2019-09-15,12,182,756,938
75841,2019-09-15,13,181,710,891
75842,2019-09-15,14,178,709,887
75843,2019-09-15,15,185,656,841
75844,2019-09-15,16,197,714,911
75845,2019-09-15,17,149,729,878
75846,2019-09-15,18,154,614,768
75847,2019-09-15,19,95,473,568
75848,2019-09-15,20,43,309,352
75849,2019-09-15,21,49,239,288
75850,2019-09-15,22,8,138,146
75851,2019-09-15,23,30,85,115
75852,2019-09-16,0,18,47,65
75853,2019-09-16,1,6,29,35
75854,2019-09-16,2,1,9,10
75855,2019-09-16,3,1,4,5
75856,2019-09-16,4,1,18,19
75857,2019-09-16,5,5,107,112
75858,2019-09-16,6,9,344,353
75859,2019-09-16,7,13,884,897
75860,2019-09-16,8,31,1335,1366
75861,2019-09-16,9,40,528,568
75862,2019-09-16,10,63,264,327
75863,2019-09-16,11,72,299,371
75864,2019-09-16,12,54,396,450
75865,2019-09-16,13,59,363,422
75866,2019-09-16,14,80,365,445
75867,2019-09-16,15,71,465,536
75868,2019-09-16,16,71,750,821
75869,2019-09-16,17,111,1460,1571
75870,2019-09-16,18,75,1176,1251
75871,2019-09-16,19,76,818,894
75872,2019-09-16,20,31,444,475
75873,2019-09-16,21,34,329,363
75874,2019-09-16,22,18,206,224
75875,2019-09-16,23,8,124,132
75876,2019-09-17,0,12,34,46
75877,2019-09-17,1,3,16,19
75878,2019-09-17,2,6,12,18
75879,2019-09-17,3,0,3,3
75880,2019-09-17,4,1,20,21
75881,2019-09-17,5,4,120,124
75882,2019-09-17,6,6,391,397
75883,2019-09-17,7,20,929,949
75884,2019-09-17,8,50,1415,1465
75885,2019-09-17,9,34,634,668
75886,2019-09-17,10,26,322,348
75887,2019-09-17,11,35,337,372
75888,2019-09-17,12,66,402,468
75889,2019-09-17,13,63,367,430
75890,2019-09-17,14,62,324,386
75891,2019-09-17,15,71,516,587
75892,2019-09-17,16,66,802,868
75893,2019-09-17,17,110,1494,1604
75894,2019-09-17,18,100,1301,1401
75895,2019-09-17,19,57,788,845
75896,2019-09-17,20,38,485,523
75897,2019-09-17,21,23,373,396
75898,2019-09-17,22,32,237,269
75899,2019-09-17,23,22,133,155
75900,2019-09-18,0,11,56,67
75901,2019-09-18,1,1,15,16
75902,2019-09-18,2,5,3,8
75903,2019-09-18,4,3,18,21
75904,2019-09-18,5,7,136,143
75905,2019-09-18,6,13,408,421
75906,2019-09-18,7,27,938,965
75907,2019-09-18,8,48,1513,1561
75908,2019-09-18,9,42,643,685
75909,2019-09-18,10,52,323,375
75910,2019-09-18,11,61,378,439
75911,2019-09-18,12,71,433,504
75912,2019-09-18,13,51,432,483
75913,2019-09-18,14,69,409,478
75914,2019-09-18,15,88,505,593
75915,2019-09-18,16,84,896,980
75916,2019-09-18,17,128,1552,1680
75917,2019-09-18,18,92,1264,1356
75918,2019-09-18,19,70,777,847
75919,2019-09-18,20,39,475,514
75920,2019-09-18,21,33,338,371
75921,2019-09-18,22,22,235,257
75922,2019-09-18,23,15,107,122
75923,2019-09-19,0,5,58,63
75924,2019-09-19,1,3,22,25
75925,2019-09-19,2,9,16,25
75926,2019-09-19,3,0,5,5
75927,2019-09-19,4,0,15,15
75928,2019-09-19,5,5,98,103
75929,2019-09-19,6,4,388,392
75930,2019-09-19,7,14,972,986
75931,2019-09-19,8,54,1498,1552
75932,2019-09-19,9,49,642,691
75933,2019-09-19,10,49,377,426
75934,2019-09-19,11,49,420,469
75935,2019-09-19,12,52,461,513
75936,2019-09-19,13,57,480,537
75937,2019-09-19,14,76,415,491
75938,2019-09-19,15,85,573,658
75939,2019-09-19,16,110,895,1005
75940,2019-09-19,17,138,1533,1671
75941,2019-09-19,18,107,1252,1359
75942,2019-09-19,19,70,798,868
75943,2019-09-19,20,52,522,574
75944,2019-09-19,21,18,395,413
75945,2019-09-19,22,23,262,285
75946,2019-09-19,23,22,157,179
75947,2019-09-20,0,10,76,86
75948,2019-09-20,1,7,26,33
75949,2019-09-20,2,2,11,13
75950,2019-09-20,3,1,10,11
75951,2019-09-20,4,1,19,20
75952,2019-09-20,5,5,108,113
75953,2019-09-20,6,10,331,341
75954,2019-09-20,7,14,741,755
75955,2019-09-20,8,51,1388,1439
75956,2019-09-20,9,80,755,835
75957,2019-09-20,10,71,447,518
75958,2019-09-20,11,116,471,587
75959,2019-09-20,12,150,574,724
75960,2019-09-20,13,131,588,719
75961,2019-09-20,14,124,570,694
75962,2019-09-20,15,124,671,795
75963,2019-09-20,16,118,950,1068
75964,2019-09-20,17,155,1323,1478
75965,2019-09-20,18,138,1074,1212
75966,2019-09-20,19,79,776,855
75967,2019-09-20,20,49,422,471
75968,2019-09-20,21,61,350,411
75969,2019-09-20,22,48,327,375
75970,2019-09-20,23,78,234,312
75971,2019-09-21,0,49,169,218
75972,2019-09-21,1,24,105,129
75973,2019-09-21,2,16,66,82
75974,2019-09-21,3,8,25,33
75975,2019-09-21,4,3,15,18
75976,2019-09-21,5,2,26,28
75977,2019-09-21,6,7,71,78
75978,2019-09-21,7,19,162,181
75979,2019-09-21,8,52,387,439
75980,2019-09-21,9,96,671,767
75981,2019-09-21,10,167,724,891
75982,2019-09-21,11,186,777,963
75983,2019-09-21,12,204,917,1121
75984,2019-09-21,13,231,840,1071
75985,2019-09-21,14,215,814,1029
75986,2019-09-21,15,218,829,1047
75987,2019-09-21,16,282,748,1030
75988,2019-09-21,17,218,754,972
75989,2019-09-21,18,192,694,886
75990,2019-09-21,19,145,595,740
75991,2019-09-21,20,80,411,491
75992,2019-09-21,21,74,319,393
75993,2019-09-21,22,72,266,338
75994,2019-09-21,23,41,242,283
75995,2019-09-22,0,56,179,235
75996,2019-09-22,1,17,122,139
75997,2019-09-22,2,25,75,100
75998,2019-09-22,3,12,27,39
75999,2019-09-22,4,12,16,28
76000,2019-09-22,5,1,29,30
76001,2019-09-22,6,5,45,50
76002,2019-09-22,7,20,122,142
76003,2019-09-22,8,40,299,339
76004,2019-09-22,9,97,465,562
76005,2019-09-22,10,143,684,827
76006,2019-09-22,11,166,731,897
76007,2019-09-22,12,174,776,950
76008,2019-09-22,13,152,699,851
76009,2019-09-22,14,148,645,793
76010,2019-09-22,15,192,642,834
76011,2019-09-22,16,197,665,862
76012,2019-09-22,17,159,669,828
76013,2019-09-22,18,135,621,756
76014,2019-09-22,19,112,560,672
76015,2019-09-22,20,55,354,409
76016,2019-09-22,21,40,265,305
76017,2019-09-22,22,35,234,269
76018,2019-09-22,23,30,104,134
76019,2019-09-23,0,10,36,46
76020,2019-09-23,1,5,16,21
76021,2019-09-23,2,3,10,13
76022,2019-09-23,3,2,10,12
76023,2019-09-23,4,4,24,28
76024,2019-09-23,5,2,112,114
76025,2019-09-23,6,10,371,381
76026,2019-09-23,7,28,849,877
76027,2019-09-23,8,38,1277,1315
76028,2019-09-23,9,51,573,624
76029,2019-09-23,10,61,268,329
76030,2019-09-23,11,72,330,402
76031,2019-09-23,12,54,417,471
76032,2019-09-23,13,35,368,403
76033,2019-09-23,14,73,327,400
76034,2019-09-23,15,61,460,521
76035,2019-09-23,16,97,736,833
76036,2019-09-23,17,77,1409,1486
76037,2019-09-23,18,89,1233,1322
76038,2019-09-23,19,83,722,805
76039,2019-09-23,20,39,434,473
76040,2019-09-23,21,29,328,357
76041,2019-09-23,22,19,215,234
76042,2019-09-23,23,13,112,125
76043,2019-09-24,0,7,49,56
76044,2019-09-24,1,2,16,18
76045,2019-09-24,2,2,11,13
76046,2019-09-24,3,1,9,10
76047,2019-09-24,4,2,32,34
76048,2019-09-24,5,5,115,120
76049,2019-09-24,6,15,395,410
76050,2019-09-24,7,20,1010,1030
76051,2019-09-24,8,28,1511,1539
76052,2019-09-24,9,76,598,674
76053,2019-09-24,10,87,339,426
76054,2019-09-24,11,85,361,446
76055,2019-09-24,12,92,467,559
76056,2019-09-24,13,67,428,495
76057,2019-09-24,14,64,381,445
76058,2019-09-24,15,79,493,572
76059,2019-09-24,16,102,908,1010
76060,2019-09-24,17,118,1566,1684
76061,2019-09-24,18,103,1310,1413
76062,2019-09-24,19,56,796,852
76063,2019-09-24,20,38,475,513
76064,2019-09-24,21,35,310,345
76065,2019-09-24,22,36,269,305
76066,2019-09-24,23,17,127,144
76067,2019-09-25,0,8,59,67
76068,2019-09-25,1,1,17,18
76069,2019-09-25,2,1,8,9
76070,2019-09-25,3,0,6,6
76071,2019-09-25,4,2,23,25
76072,2019-09-25,5,3,121,124
76073,2019-09-25,6,8,416,424
76074,2019-09-25,7,20,952,972
76075,2019-09-25,8,42,1534,1576
76076,2019-09-25,9,57,647,704
76077,2019-09-25,10,64,351,415
76078,2019-09-25,11,81,340,421
76079,2019-09-25,12,57,440,497
76080,2019-09-25,13,49,404,453
76081,2019-09-25,14,84,406,490
76082,2019-09-25,15,100,500,600
76083,2019-09-25,16,91,858,949
76084,2019-09-25,17,108,1485,1593
76085,2019-09-25,18,100,1271,1371
76086,2019-09-25,19,48,805,853
76087,2019-09-25,20,29,499,528
76088,2019-09-25,21,30,349,379
76089,2019-09-25,22,39,249,288
76090,2019-09-25,23,40,162,202
76091,2019-09-26,0,16,68,84
76092,2019-09-26,1,3,31,34
76093,2019-09-26,2,5,15,20
76094,2019-09-26,3,0,11,11
76095,2019-09-26,4,0,25,25
76096,2019-09-26,5,0,111,111
76097,2019-09-26,6,8,388,396
76098,2019-09-26,7,25,856,881
76099,2019-09-26,8,53,1424,1477
76100,2019-09-26,9,53,670,723
76101,2019-09-26,10,86,371,457
76102,2019-09-26,11,81,356,437
76103,2019-09-26,12,110,546,656
76104,2019-09-26,13,60,505,565
76105,2019-09-26,14,91,409,500
76106,2019-09-26,15,67,521,588
76107,2019-09-26,16,85,785,870
76108,2019-09-26,17,87,1415,1502
76109,2019-09-26,18,105,1216,1321
76110,2019-09-26,19,73,744,817
76111,2019-09-26,20,57,504,561
76112,2019-09-26,21,52,361,413
76113,2019-09-26,22,37,270,307
76114,2019-09-26,23,19,193,212
76115,2019-09-27,0,15,82,97
76116,2019-09-27,1,8,35,43
76117,2019-09-27,2,1,21,22
76118,2019-09-27,3,6,4,10
76119,2019-09-27,4,0,23,23
76120,2019-09-27,5,3,95,98
76121,2019-09-27,6,4,321,325
76122,2019-09-27,7,19,722,741
76123,2019-09-27,8,36,1430,1466
76124,2019-09-27,9,51,702,753
76125,2019-09-27,10,72,376,448
76126,2019-09-27,11,66,482,548
76127,2019-09-27,12,86,532,618
76128,2019-09-27,13,95,552,647
76129,2019-09-27,14,101,524,625
76130,2019-09-27,15,101,599,700
76131,2019-09-27,16,116,882,998
76132,2019-09-27,17,146,1385,1531
76133,2019-09-27,18,144,1076,1220
76134,2019-09-27,19,94,674,768
76135,2019-09-27,20,73,414,487
76136,2019-09-27,21,39,304,343
76137,2019-09-27,22,49,313,362
76138,2019-09-27,23,24,232,256
76139,2019-09-28,0,26,173,199
76140,2019-09-28,1,22,108,130
76141,2019-09-28,2,13,43,56
76142,2019-09-28,3,8,31,39
76143,2019-09-28,4,1,14,15
76144,2019-09-28,5,1,28,29
76145,2019-09-28,6,13,63,76
76146,2019-09-28,7,17,184,201
76147,2019-09-28,8,47,358,405
76148,2019-09-28,9,84,624,708
76149,2019-09-28,10,118,648,766
76150,2019-09-28,11,172,758,930
76151,2019-09-28,12,184,774,958
76152,2019-09-28,13,193,738,931
76153,2019-09-28,14,178,684,862
76154,2019-09-28,15,184,768,952
76155,2019-09-28,16,207,636,843
76156,2019-09-28,17,180,680,860
76157,2019-09-28,18,126,654,780
76158,2019-09-28,19,122,517,639
76159,2019-09-28,20,64,373,437
76160,2019-09-28,21,64,302,366
76161,2019-09-28,22,42,258,300
76162,2019-09-28,23,48,228,276
76163,2019-09-29,0,26,123,149
76164,2019-09-29,1,30,117,147
76165,2019-09-29,2,30,98,128
76166,2019-09-29,3,11,41,52
76167,2019-09-29,4,5,14,19
76168,2019-09-29,5,3,22,25
76169,2019-09-29,6,6,46,52
76170,2019-09-29,7,22,133,155
76171,2019-09-29,8,44,244,288
76172,2019-09-29,9,133,434,567
76173,2019-09-29,10,131,656,787
76174,2019-09-29,11,223,677,900
76175,2019-09-29,12,172,801,973
76176,2019-09-29,13,200,756,956
76177,2019-09-29,14,176,688,864
76178,2019-09-29,15,188,661,849
76179,2019-09-29,16,185,657,842
76180,2019-09-29,17,133,686,819
76181,2019-09-29,18,126,566,692
76182,2019-09-29,19,63,474,537
76183,2019-09-29,20,38,286,324
76184,2019-09-29,21,30,210,240
76185,2019-09-29,22,24,152,176
76186,2019-09-29,23,14,73,87
76187,2019-09-30,0,11,52,63
76188,2019-09-30,1,2,20,22
76189,2019-09-30,2,5,13,18
76190,2019-09-30,3,1,7,8
76191,2019-09-30,4,2,18,20
76192,2019-09-30,5,1,116,117
76193,2019-09-30,6,5,354,359
76194,2019-09-30,7,12,848,860
76195,2019-09-30,8,31,1190,1221
76196,2019-09-30,9,6,228,234
76197,2019-09-30,10,12,121,133
76198,2019-09-30,11,2,98,100
76199,2019-09-30,12,12,179,191
76200,2019-09-30,13,30,242,272
76201,2019-09-30,14,24,318,342
76202,2019-09-30,15,50,446,496
76203,2019-09-30,16,62,733,795
76204,2019-09-30,17,68,1353,1421
76205,2019-09-30,18,50,1054,1104
76206,2019-09-30,19,43,667,710
76207,2019-09-30,20,15,401,416
76208,2019-09-30,21,20,294,314
76209,2019-09-30,22,29,128,157
76210,2019-09-30,23,6,96,102
76211,2019-10-01,0,1,30,31
76212,2019-10-01,1,2,17,19
76213,2019-10-01,2,0,9,9
76214,2019-10-01,3,0,6,6
76215,2019-10-01,4,1,29,30
76216,2019-10-01,5,3,128,131
76217,2019-10-01,6,8,389,397
76218,2019-10-01,7,15,999,1014
76219,2019-10-01,8,39,1478,1517
76220,2019-10-01,9,49,640,689
76221,2019-10-01,10,28,357,385
76222,2019-10-01,11,41,347,388
76223,2019-10-01,12,67,391,458
76224,2019-10-01,13,63,450,513
76225,2019-10-01,14,62,396,458
76226,2019-10-01,15,55,506,561
76227,2019-10-01,16,68,808,876
76228,2019-10-01,17,102,1556,1658
76229,2019-10-01,18,92,1327,1419
76230,2019-10-01,19,53,758,811
76231,2019-10-01,20,34,419,453
76232,2019-10-01,21,22,303,325
76233,2019-10-01,22,19,191,210
76234,2019-10-01,23,45,294,339
76235,2019-10-02,0,20,111,131
76236,2019-10-02,1,6,32,38
76237,2019-10-02,2,3,11,14
76238,2019-10-02,3,0,8,8
76239,2019-10-02,4,1,27,28
76240,2019-10-02,5,3,139,142
76241,2019-10-02,6,14,431,445
76242,2019-10-02,7,35,886,921
76243,2019-10-02,8,37,1466,1503
76244,2019-10-02,9,37,641,678
76245,2019-10-02,10,35,299,334
76246,2019-10-02,11,42,334,376
76247,2019-10-02,12,53,384,437
76248,2019-10-02,13,52,392,444
76249,2019-10-02,14,54,349,403
76250,2019-10-02,15,49,424,473
76251,2019-10-02,16,61,702,763
76252,2019-10-02,17,86,1436,1522
76253,2019-10-02,18,88,1190,1278
76254,2019-10-02,19,59,720,779
76255,2019-10-02,20,34,446,480
76256,2019-10-02,21,18,348,366
76257,2019-10-02,22,23,221,244
76258,2019-10-02,23,17,113,130
76259,2019-10-03,0,7,72,79
76260,2019-10-03,1,4,18,22
76261,2019-10-03,2,0,7,7
76262,2019-10-03,3,2,3,5
76263,2019-10-03,4,2,38,40
76264,2019-10-03,5,3,124,127
76265,2019-10-03,6,15,386,401
76266,2019-10-03,7,19,932,951
76267,2019-10-03,8,38,1387,1425
76268,2019-10-03,9,43,690,733
76269,2019-10-03,10,35,363,398
76270,2019-10-03,11,51,351,402
76271,2019-10-03,12,59,424,483
76272,2019-10-03,13,54,402,456
76273,2019-10-03,14,58,402,460
76274,2019-10-03,15,75,532,607
76275,2019-10-03,16,91,814,905
76276,2019-10-03,17,127,1452,1579
76277,2019-10-03,18,115,1248,1363
76278,2019-10-03,19,65,685,750
76279,2019-10-03,20,55,496,551
76280,2019-10-03,21,34,374,408
76281,2019-10-03,22,23,244,267
76282,2019-10-03,23,20,134,154
76283,2019-10-04,0,23,104,127
76284,2019-10-04,1,6,40,46
76285,2019-10-04,2,10,13,23
76286,2019-10-04,3,4,8,12
76287,2019-10-04,4,1,16,17
76288,2019-10-04,5,3,106,109
76289,2019-10-04,6,9,306,315
76290,2019-10-04,7,31,800,831
76291,2019-10-04,8,53,1392,1445
76292,2019-10-04,9,73,735,808
76293,2019-10-04,10,82,389,471
76294,2019-10-04,11,76,435,511
76295,2019-10-04,12,86,595,681
76296,2019-10-04,13,117,633,750
76297,2019-10-04,14,106,549,655
76298,2019-10-04,15,100,637,737
76299,2019-10-04,16,115,929,1044
76300,2019-10-04,17,109,1350,1459
76301,2019-10-04,18,110,1089,1199
76302,2019-10-04,19,65,649,714
76303,2019-10-04,20,54,402,456
76304,2019-10-04,21,26,307,333
76305,2019-10-04,22,32,209,241
76306,2019-10-04,23,11,184,195
76307,2019-10-05,0,11,130,141
76308,2019-10-05,1,20,74,94
76309,2019-10-05,2,8,54,62
76310,2019-10-05,3,5,17,22
76311,2019-10-05,4,0,11,11
76312,2019-10-05,5,2,21,23
76313,2019-10-05,6,10,71,81
76314,2019-10-05,7,10,163,173
76315,2019-10-05,8,42,297,339
76316,2019-10-05,9,80,559,639
76317,2019-10-05,10,123,719,842
76318,2019-10-05,11,145,803,948
76319,2019-10-05,12,173,1024,1197
76320,2019-10-05,13,158,952,1110
76321,2019-10-05,14,160,936,1096
76322,2019-10-05,15,201,816,1017
76323,2019-10-05,16,228,850,1078
76324,2019-10-05,17,219,775,994
76325,2019-10-05,18,163,629,792
76326,2019-10-05,19,57,461,518
76327,2019-10-05,20,35,321,356
76328,2019-10-05,21,38,243,281
76329,2019-10-05,22,41,244,285
76330,2019-10-05,23,27,201,228
76331,2019-10-06,0,26,145,171
76332,2019-10-06,1,27,117,144
76333,2019-10-06,2,8,60,68
76334,2019-10-06,3,9,36,45
76335,2019-10-06,4,1,17,18
76336,2019-10-06,5,3,16,19
76337,2019-10-06,6,3,37,40
76338,2019-10-06,7,16,119,135
76339,2019-10-06,8,26,263,289
76340,2019-10-06,9,46,424,470
76341,2019-10-06,10,83,591,674
76342,2019-10-06,11,127,686,813
76343,2019-10-06,12,173,766,939
76344,2019-10-06,13,162,679,841
76345,2019-10-06,14,142,618,760
76346,2019-10-06,15,161,683,844
76347,2019-10-06,16,130,660,790
76348,2019-10-06,17,143,661,804
76349,2019-10-06,18,121,674,795
76350,2019-10-06,19,59,387,446
76351,2019-10-06,20,39,292,331
76352,2019-10-06,21,19,229,248
76353,2019-10-06,22,28,142,170
76354,2019-10-06,23,21,191,212
76355,2019-10-07,0,27,95,122
76356,2019-10-07,1,4,19,23
76357,2019-10-07,2,2,9,11
76358,2019-10-07,3,3,14,17
76359,2019-10-07,4,0,20,20
76360,2019-10-07,5,2,98,100
76361,2019-10-07,6,8,337,345
76362,2019-10-07,7,15,862,877
76363,2019-10-07,8,43,1519,1562
76364,2019-10-07,9,64,604,668
76365,2019-10-07,10,61,316,377
76366,2019-10-07,11,81,330,411
76367,2019-10-07,12,94,471,565
76368,2019-10-07,13,74,411,485
76369,2019-10-07,14,85,408,493
76370,2019-10-07,15,90,581,671
76371,2019-10-07,16,98,833,931
76372,2019-10-07,17,144,1695,1839
76373,2019-10-07,18,90,1253,1343
76374,2019-10-07,19,48,716,764
76375,2019-10-07,20,26,370,396
76376,2019-10-07,21,22,230,252
76377,2019-10-07,22,21,245,266
76378,2019-10-07,23,16,127,143
76379,2019-10-08,0,12,29,41
76380,2019-10-08,1,1,8,9
76381,2019-10-08,2,1,2,3
76382,2019-10-08,3,0,3,3
76383,2019-10-08,4,4,22,26
76384,2019-10-08,5,0,118,118
76385,2019-10-08,6,8,384,392
76386,2019-10-08,7,19,931,950
76387,2019-10-08,8,35,1489,1524
76388,2019-10-08,9,26,655,681
76389,2019-10-08,10,34,268,302
76390,2019-10-08,11,54,351,405
76391,2019-10-08,12,41,401,442
76392,2019-10-08,13,42,403,445
76393,2019-10-08,14,50,370,420
76394,2019-10-08,15,72,444,516
76395,2019-10-08,16,79,819,898
76396,2019-10-08,17,84,1479,1563
76397,2019-10-08,18,71,1213,1284
76398,2019-10-08,19,32,732,764
76399,2019-10-08,20,30,458,488
76400,2019-10-08,21,6,366,372
76401,2019-10-08,22,19,199,218
76402,2019-10-08,23,12,131,143
76403,2019-10-09,0,9,35,44
76404,2019-10-09,1,5,13,18
76405,2019-10-09,2,3,9,12
76406,2019-10-09,3,1,2,3
76407,2019-10-09,4,0,16,16
76408,2019-10-09,5,2,99,101
76409,2019-10-09,6,4,337,341
76410,2019-10-09,7,12,875,887
76411,2019-10-09,8,36,1387,1423
76412,2019-10-09,9,55,671,726
76413,2019-10-09,10,44,314,358
76414,2019-10-09,11,66,333,399
76415,2019-10-09,12,51,464,515
76416,2019-10-09,13,36,470,506
76417,2019-10-09,14,71,437,508
76418,2019-10-09,15,81,503,584
76419,2019-10-09,16,88,842,930
76420,2019-10-09,17,112,1466,1578
76421,2019-10-09,18,75,1226,1301
76422,2019-10-09,19,49,739,788
76423,2019-10-09,20,42,461,503
76424,2019-10-09,21,29,324,353
76425,2019-10-09,22,28,216,244
76426,2019-10-09,23,25,105,130
76427,2019-10-10,0,4,62,66
76428,2019-10-10,1,5,37,42
76429,2019-10-10,2,8,6,14
76430,2019-10-10,3,0,4,4
76431,2019-10-10,4,1,18,19
76432,2019-10-10,5,1,124,125
76433,2019-10-10,6,9,327,336
76434,2019-10-10,7,22,820,842
76435,2019-10-10,8,36,1456,1492
76436,2019-10-10,9,50,706,756
76437,2019-10-10,10,76,377,453
76438,2019-10-10,11,63,385,448
76439,2019-10-10,12,77,455,532
76440,2019-10-10,13,78,438,516
76441,2019-10-10,14,61,458,519
76442,2019-10-10,15,103,535,638
76443,2019-10-10,16,82,790,872
76444,2019-10-10,17,103,1396,1499
76445,2019-10-10,18,87,1148,1235
76446,2019-10-10,19,66,780,846
76447,2019-10-10,20,45,518,563
76448,2019-10-10,21,33,328,361
76449,2019-10-10,22,33,236,269
76450,2019-10-10,23,7,129,136
76451,2019-10-11,0,11,73,84
76452,2019-10-11,1,5,29,34
76453,2019-10-11,2,5,12,17
76454,2019-10-11,3,2,9,11
76455,2019-10-11,4,1,14,15
76456,2019-10-11,5,3,73,76
76457,2019-10-11,6,10,246,256
76458,2019-10-11,7,15,657,672
76459,2019-10-11,8,29,1227,1256
76460,2019-10-11,9,65,703,768
76461,2019-10-11,10,66,405,471
76462,2019-10-11,11,86,449,535
76463,2019-10-11,12,104,533,637
76464,2019-10-11,13,125,521,646
76465,2019-10-11,14,136,599,735
76466,2019-10-11,15,111,667,778
76467,2019-10-11,16,133,963,1096
76468,2019-10-11,17,156,1259,1415
76469,2019-10-11,18,133,993,1126
76470,2019-10-11,19,89,675,764
76471,2019-10-11,20,53,396,449
76472,2019-10-11,21,44,363,407
76473,2019-10-11,22,38,237,275
76474,2019-10-11,23,30,221,251
76475,2019-10-12,0,28,166,194
76476,2019-10-12,1,10,87,97
76477,2019-10-12,2,18,56,74
76478,2019-10-12,3,5,26,31
76479,2019-10-12,4,1,6,7
76480,2019-10-12,5,1,22,23
76481,2019-10-12,6,6,66,72
76482,2019-10-12,7,9,145,154
76483,2019-10-12,8,38,296,334
76484,2019-10-12,9,73,509,582
76485,2019-10-12,10,137,569,706
76486,2019-10-12,11,184,719,903
76487,2019-10-12,12,227,697,924
76488,2019-10-12,13,249,747,996
76489,2019-10-12,14,255,779,1034
76490,2019-10-12,15,258,668,926
76491,2019-10-12,16,301,702,1003
76492,2019-10-12,17,219,738,957
76493,2019-10-12,18,198,607,805
76494,2019-10-12,19,117,415,532
76495,2019-10-12,20,92,293,385
76496,2019-10-12,21,94,262,356
76497,2019-10-12,22,61,218,279
76498,2019-10-12,23,63,218,281
76499,2019-10-13,0,26,145,171
76500,2019-10-13,1,20,89,109
76501,2019-10-13,2,28,81,109
76502,2019-10-13,3,10,40,50
76503,2019-10-13,4,8,15,23
76504,2019-10-13,5,3,18,21
76505,2019-10-13,6,10,68,78
76506,2019-10-13,7,16,103,119
76507,2019-10-13,8,44,244,288
76508,2019-10-13,9,89,413,502
76509,2019-10-13,10,133,545,678
76510,2019-10-13,11,231,692,923
76511,2019-10-13,12,236,689,925
76512,2019-10-13,13,177,704,881
76513,2019-10-13,14,199,663,862
76514,2019-10-13,15,141,589,730
76515,2019-10-13,16,141,492,633
76516,2019-10-13,17,147,474,621
76517,2019-10-13,18,80,468,548
76518,2019-10-13,19,86,352,438
76519,2019-10-13,20,46,250,296
76520,2019-10-13,21,45,200,245
76521,2019-10-13,22,42,173,215
76522,2019-10-13,23,19,113,132
76523,2019-10-14,0,12,59,71
76524,2019-10-14,1,4,37,41
76525,2019-10-14,2,0,27,27
76526,2019-10-14,3,1,9,10
76527,2019-10-14,4,1,20,21
76528,2019-10-14,5,3,55,58
76529,2019-10-14,6,6,141,147
76530,2019-10-14,7,13,339,352
76531,2019-10-14,8,44,682,726
76532,2019-10-14,9,60,544,604
76533,2019-10-14,10,85,434,519
76534,2019-10-14,11,152,519,671
76535,2019-10-14,12,171,621,792
76536,2019-10-14,13,132,610,742
76537,2019-10-14,14,146,609,755
76538,2019-10-14,15,167,667,834
76539,2019-10-14,16,135,732,867
76540,2019-10-14,17,156,1027,1183
76541,2019-10-14,18,104,874,978
76542,2019-10-14,19,72,618,690
76543,2019-10-14,20,57,343,400
76544,2019-10-14,21,34,277,311
76545,2019-10-14,22,23,197,220
76546,2019-10-14,23,38,213,251
76547,2019-10-15,0,12,48,60
76548,2019-10-15,1,6,19,25
76549,2019-10-15,2,2,10,12
76550,2019-10-15,3,0,4,4
76551,2019-10-15,4,0,21,21
76552,2019-10-15,5,2,127,129
76553,2019-10-15,6,6,341,347
76554,2019-10-15,7,21,846,867
76555,2019-10-15,8,32,1278,1310
76556,2019-10-15,9,30,583,613
76557,2019-10-15,10,58,330,388
76558,2019-10-15,11,67,345,412
76559,2019-10-15,12,88,425,513
76560,2019-10-15,13,84,453,537
76561,2019-10-15,14,85,382,467
76562,2019-10-15,15,75,532,607
76563,2019-10-15,16,99,804,903
76564,2019-10-15,17,124,1625,1749
76565,2019-10-15,18,100,1287,1387
76566,2019-10-15,19,54,755,809
76567,2019-10-15,20,29,453,482
76568,2019-10-15,21,31,287,318
76569,2019-10-15,22,12,216,228
76570,2019-10-15,23,46,272,318
76571,2019-10-16,0,24,127,151
76572,2019-10-16,1,12,30,42
76573,2019-10-16,2,4,4,8
76574,2019-10-16,3,1,3,4
76575,2019-10-16,4,1,23,24
76576,2019-10-16,5,2,122,124
76577,2019-10-16,6,9,331,340
76578,2019-10-16,7,16,850,866
76579,2019-10-16,8,34,1342,1376
76580,2019-10-16,9,25,585,610
76581,2019-10-16,10,22,143,165
76582,2019-10-16,11,2,49,51
76583,2019-10-16,12,1,34,35
76584,2019-10-16,13,2,34,36
76585,2019-10-16,14,2,46,48
76586,2019-10-16,15,10,188,198
76587,2019-10-16,16,15,420,435
76588,2019-10-16,17,44,1063,1107
76589,2019-10-16,18,25,896,921
76590,2019-10-16,19,7,485,492
76591,2019-10-16,20,22,306,328
76592,2019-10-16,21,14,214,228
76593,2019-10-16,22,17,141,158
76594,2019-10-16,23,10,74,84
76595,2019-10-17,0,4,49,53
76596,2019-10-17,1,1,16,17
76597,2019-10-17,2,2,12,14
76598,2019-10-17,3,0,13,13
76599,2019-10-17,4,2,26,28
76600,2019-10-17,5,3,98,101
76601,2019-10-17,6,8,296,304
76602,2019-10-17,7,15,782,797
76603,2019-10-17,8,43,1368,1411
76604,2019-10-17,9,27,651,678
76605,2019-10-17,10,44,324,368
76606,2019-10-17,11,36,314,350
76607,2019-10-17,12,33,354,387
76608,2019-10-17,13,36,365,401
76609,2019-10-17,14,67,309,376
76610,2019-10-17,15,53,408,461
76611,2019-10-17,16,55,673,728
76612,2019-10-17,17,65,1192,1257
76613,2019-10-17,18,51,1001,1052
76614,2019-10-17,19,27,573,600
76615,2019-10-17,20,16,360,376
76616,2019-10-17,21,9,275,284
76617,2019-10-17,22,13,182,195
76618,2019-10-17,23,22,141,163
76619,2019-10-18,0,3,59,62
76620,2019-10-18,1,1,23,24
76621,2019-10-18,2,2,8,10
76622,2019-10-18,3,0,4,4
76623,2019-10-18,4,1,16,17
76624,2019-10-18,5,3,70,73
76625,2019-10-18,6,6,250,256
76626,2019-10-18,7,13,638,651
76627,2019-10-18,8,40,1243,1283
76628,2019-10-18,9,53,639,692
76629,2019-10-18,10,73,336,409
76630,2019-10-18,11,77,340,417
76631,2019-10-18,12,118,442,560
76632,2019-10-18,13,111,455,566
76633,2019-10-18,14,136,496,632
76634,2019-10-18,15,127,568,695
76635,2019-10-18,16,126,808,934
76636,2019-10-18,17,122,1233,1355
76637,2019-10-18,18,75,922,997
76638,2019-10-18,19,55,579,634
76639,2019-10-18,20,36,324,360
76640,2019-10-18,21,24,262,286
76641,2019-10-18,22,33,218,251
76642,2019-10-18,23,23,184,207
76643,2019-10-19,0,18,110,128
76644,2019-10-19,1,5,81,86
76645,2019-10-19,2,5,34,39
76646,2019-10-19,3,4,18,22
76647,2019-10-19,4,1,12,13
76648,2019-10-19,5,2,30,32
76649,2019-10-19,6,3,49,52
76650,2019-10-19,7,7,138,145
76651,2019-10-19,8,32,286,318
76652,2019-10-19,9,56,449,505
76653,2019-10-19,10,94,594,688
76654,2019-10-19,11,147,679,826
76655,2019-10-19,12,227,757,984
76656,2019-10-19,13,213,720,933
76657,2019-10-19,14,215,708,923
76658,2019-10-19,15,202,745,947
76659,2019-10-19,16,192,694,886
76660,2019-10-19,17,205,643,848
76661,2019-10-19,18,122,514,636
76662,2019-10-19,19,68,344,412
76663,2019-10-19,20,44,256,300
76664,2019-10-19,21,27,226,253
76665,2019-10-19,22,41,211,252
76666,2019-10-19,23,50,167,217
76667,2019-10-20,0,29,153,182
76668,2019-10-20,1,21,85,106
76669,2019-10-20,2,11,54,65
76670,2019-10-20,3,5,42,47
76671,2019-10-20,4,1,12,13
76672,2019-10-20,5,1,11,12
76673,2019-10-20,6,0,9,9
76674,2019-10-20,7,1,22,23
76675,2019-10-20,8,3,40,43
76676,2019-10-20,9,1,51,52
76677,2019-10-20,10,1,61,62
76678,2019-10-20,11,3,58,61
76679,2019-10-20,12,3,43,46
76680,2019-10-20,13,1,43,44
76681,2019-10-20,14,3,36,39
76682,2019-10-20,15,1,36,37
76683,2019-10-20,16,0,37,37
76684,2019-10-20,17,4,55,59
76685,2019-10-20,18,1,82,83
76686,2019-10-20,19,7,120,127
76687,2019-10-20,20,8,119,127
76688,2019-10-20,21,8,93,101
76689,2019-10-20,22,15,80,95
76690,2019-10-20,23,11,54,65
76691,2019-10-21,0,12,34,46
76692,2019-10-21,1,5,22,27
76693,2019-10-21,2,2,9,11
76694,2019-10-21,3,0,6,6
76695,2019-10-21,4,0,18,18
76696,2019-10-21,5,2,92,94
76697,2019-10-21,6,0,291,291
76698,2019-10-21,7,20,698,718
76699,2019-10-21,8,28,1286,1314
76700,2019-10-21,9,21,606,627
76701,2019-10-21,10,38,269,307
76702,2019-10-21,11,60,289,349
76703,2019-10-21,12,76,370,446
76704,2019-10-21,13,94,406,500
76705,2019-10-21,14,92,381,473
76706,2019-10-21,15,111,543,654
76707,2019-10-21,16,110,879,989
76708,2019-10-21,17,133,1439,1572
76709,2019-10-21,18,73,1183,1256
76710,2019-10-21,19,32,634,666
76711,2019-10-21,20,31,403,434
76712,2019-10-21,21,14,302,316
76713,2019-10-21,22,20,164,184
76714,2019-10-21,23,6,93,99
76715,2019-10-22,0,5,59,64
76716,2019-10-22,1,2,9,11
76717,2019-10-22,2,1,10,11
76718,2019-10-22,3,0,7,7
76719,2019-10-22,4,1,26,27
76720,2019-10-22,5,1,119,120
76721,2019-10-22,6,6,350,356
76722,2019-10-22,7,20,827,847
76723,2019-10-22,8,22,1378,1400
76724,2019-10-22,9,26,615,641
76725,2019-10-22,10,26,238,264
76726,2019-10-22,11,28,304,332
76727,2019-10-22,12,20,353,373
76728,2019-10-22,13,30,330,360
76729,2019-10-22,14,18,114,132
76730,2019-10-22,15,11,95,106
76731,2019-10-22,16,5,125,130
76732,2019-10-22,17,4,317,321
76733,2019-10-22,18,8,554,562
76734,2019-10-22,19,13,474,487
76735,2019-10-22,20,10,321,331
76736,2019-10-22,21,8,226,234
76737,2019-10-22,22,10,174,184
76738,2019-10-22,23,10,83,93
76739,2019-10-23,0,13,102,115
76740,2019-10-23,1,2,10,12
76741,2019-10-23,2,1,11,12
76742,2019-10-23,3,0,2,2
76743,2019-10-23,4,0,16,16
76744,2019-10-23,5,4,111,115
76745,2019-10-23,6,8,333,341
76746,2019-10-23,7,15,823,838
76747,2019-10-23,8,24,1433,1457
76748,2019-10-23,9,37,672,709
76749,2019-10-23,10,54,307,361
76750,2019-10-23,11,56,330,386
76751,2019-10-23,12,63,459,522
76752,2019-10-23,13,76,395,471
76753,2019-10-23,14,67,403,470
76754,2019-10-23,15,90,445,535
76755,2019-10-23,16,69,760,829
76756,2019-10-23,17,93,1555,1648
76757,2019-10-23,18,79,1190,1269
76758,2019-10-23,19,48,757,805
76759,2019-10-23,20,19,451,470
76760,2019-10-23,21,19,345,364
76761,2019-10-23,22,16,211,227
76762,2019-10-23,23,7,154,161
76763,2019-10-24,0,8,129,137
76764,2019-10-24,1,3,29,32
76765,2019-10-24,2,4,12,16
76766,2019-10-24,3,1,2,3
76767,2019-10-24,4,0,16,16
76768,2019-10-24,5,2,95,97
76769,2019-10-24,6,1,299,300
76770,2019-10-24,7,14,761,775
76771,2019-10-24,8,23,1380,1403
76772,2019-10-24,9,34,713,747
76773,2019-10-24,10,53,350,403
76774,2019-10-24,11,82,381,463
76775,2019-10-24,12,74,444,518
76776,2019-10-24,13,73,479,552
76777,2019-10-24,14,86,389,475
76778,2019-10-24,15,97,552,649
76779,2019-10-24,16,59,792,851
76780,2019-10-24,17,117,1458,1575
76781,2019-10-24,18,90,1166,1256
76782,2019-10-24,19,52,641,693
76783,2019-10-24,20,43,484,527
76784,2019-10-24,21,32,339,371
76785,2019-10-24,22,24,203,227
76786,2019-10-24,23,7,123,130
76787,2019-10-25,0,5,56,61
76788,2019-10-25,1,2,26,28
76789,2019-10-25,2,4,10,14
76790,2019-10-25,3,1,9,10
76791,2019-10-25,4,2,14,16
76792,2019-10-25,5,6,93,99
76793,2019-10-25,6,5,261,266
76794,2019-10-25,7,11,637,648
76795,2019-10-25,8,26,1252,1278
76796,2019-10-25,9,47,767,814
76797,2019-10-25,10,71,377,448
76798,2019-10-25,11,66,396,462
76799,2019-10-25,12,93,545,638
76800,2019-10-25,13,70,501,571
76801,2019-10-25,14,105,505,610
76802,2019-10-25,15,171,633,804
76803,2019-10-25,16,173,932,1105
76804,2019-10-25,17,173,1331,1504
76805,2019-10-25,18,133,1029,1162
76806,2019-10-25,19,68,647,715
76807,2019-10-25,20,30,427,457
76808,2019-10-25,21,34,308,342
76809,2019-10-25,22,21,241,262
76810,2019-10-25,23,35,231,266
76811,2019-10-26,0,54,374,428
76812,2019-10-26,1,31,147,178
76813,2019-10-26,2,5,75,80
76814,2019-10-26,3,8,36,44
76815,2019-10-26,4,3,22,25
76816,2019-10-26,5,3,19,22
76817,2019-10-26,6,2,66,68
76818,2019-10-26,7,11,155,166
76819,2019-10-26,8,36,310,346
76820,2019-10-26,9,37,442,479
76821,2019-10-26,10,102,576,678
76822,2019-10-26,11,143,683,826
76823,2019-10-26,12,163,738,901
76824,2019-10-26,13,175,732,907
76825,2019-10-26,14,227,716,943
76826,2019-10-26,15,212,768,980
76827,2019-10-26,16,206,757,963
76828,2019-10-26,17,160,676,836
76829,2019-10-26,18,112,572,684
76830,2019-10-26,19,60,402,462
76831,2019-10-26,20,35,315,350
76832,2019-10-26,21,26,226,252
76833,2019-10-26,22,29,204,233
76834,2019-10-26,23,24,187,211
76835,2019-10-27,0,35,207,242
76836,2019-10-27,1,19,86,105
76837,2019-10-27,2,9,75,84
76838,2019-10-27,3,6,24,30
76839,2019-10-27,4,3,8,11
76840,2019-10-27,5,5,9,14
76841,2019-10-27,6,4,35,39
76842,2019-10-27,7,8,48,56
76843,2019-10-27,8,20,80,100
76844,2019-10-27,9,32,140,172
76845,2019-10-27,10,15,71,86
76846,2019-10-27,11,26,166,192
76847,2019-10-27,12,75,368,443
76848,2019-10-27,13,84,460,544
76849,2019-10-27,14,133,570,703
76850,2019-10-27,15,156,674,830
76851,2019-10-27,16,163,749,912
76852,2019-10-27,17,131,741,872
76853,2019-10-27,18,115,596,711
76854,2019-10-27,19,51,425,476
76855,2019-10-27,20,33,258,291
76856,2019-10-27,21,24,200,224
76857,2019-10-27,22,28,184,212
76858,2019-10-27,23,29,184,213
76859,2019-10-28,0,9,64,73
76860,2019-10-28,1,3,22,25
76861,2019-10-28,2,2,18,20
76862,2019-10-28,3,0,5,5
76863,2019-10-28,4,0,8,8
76864,2019-10-28,5,6,91,97
76865,2019-10-28,6,1,298,299
76866,2019-10-28,7,17,750,767
76867,2019-10-28,8,36,1369,1405
76868,2019-10-28,9,22,612,634
76869,2019-10-28,10,58,319,377
76870,2019-10-28,11,69,303,372
76871,2019-10-28,12,75,386,461
76872,2019-10-28,13,104,433,537
76873,2019-10-28,14,71,406,477
76874,2019-10-28,15,67,534,601
76875,2019-10-28,16,63,823,886
76876,2019-10-28,17,92,1554,1646
76877,2019-10-28,18,64,1067,1131
76878,2019-10-28,19,38,632,670
76879,2019-10-28,20,37,442,479
76880,2019-10-28,21,29,293,322
76881,2019-10-28,22,17,199,216
76882,2019-10-28,23,5,69,74
76883,2019-10-29,0,2,30,32
76884,2019-10-29,1,4,12,16
76885,2019-10-29,2,0,9,9
76886,2019-10-29,3,0,5,5
76887,2019-10-29,4,0,19,19
76888,2019-10-29,5,4,139,143
76889,2019-10-29,6,6,364,370
76890,2019-10-29,7,24,838,862
76891,2019-10-29,8,38,1412,1450
76892,2019-10-29,9,36,607,643
76893,2019-10-29,10,39,357,396
76894,2019-10-29,11,44,337,381
76895,2019-10-29,12,51,425,476
76896,2019-10-29,13,51,390,441
76897,2019-10-29,14,56,335,391
76898,2019-10-29,15,52,508,560
76899,2019-10-29,16,60,794,854
76900,2019-10-29,17,85,1397,1482
76901,2019-10-29,18,61,1097,1158
76902,2019-10-29,19,32,650,682
76903,2019-10-29,20,40,467,507
76904,2019-10-29,21,26,377,403
76905,2019-10-29,22,18,203,221
76906,2019-10-29,23,12,144,156
76907,2019-10-30,0,17,96,113
76908,2019-10-30,1,3,12,15
76909,2019-10-30,2,3,15,18
76910,2019-10-30,3,0,5,5
76911,2019-10-30,4,0,18,18
76912,2019-10-30,5,2,120,122
76913,2019-10-30,6,5,331,336
76914,2019-10-30,7,11,870,881
76915,2019-10-30,8,47,1455,1502
76916,2019-10-30,9,24,655,679
76917,2019-10-30,10,51,331,382
76918,2019-10-30,11,45,344,389
76919,2019-10-30,12,46,435,481
76920,2019-10-30,13,72,399,471
76921,2019-10-30,14,63,444,507
76922,2019-10-30,15,66,514,580
76923,2019-10-30,16,45,747,792
76924,2019-10-30,17,48,1101,1149
76925,2019-10-30,18,9,414,423
76926,2019-10-30,19,6,251,257
76927,2019-10-30,20,0,121,121
76928,2019-10-30,21,0,91,91
76929,2019-10-30,22,6,56,62
76930,2019-10-30,23,6,89,95
76931,2019-10-31,0,26,294,320
76932,2019-10-31,1,22,88,110
76933,2019-10-31,2,3,25,28
76934,2019-10-31,3,0,6,6
76935,2019-10-31,4,1,11,12
76936,2019-10-31,5,0,71,71
76937,2019-10-31,6,2,220,222
76938,2019-10-31,7,9,575,584
76939,2019-10-31,8,22,1129,1151
76940,2019-10-31,9,15,660,675
76941,2019-10-31,10,10,312,322
76942,2019-10-31,11,25,272,297
76943,2019-10-31,12,16,172,188
76944,2019-10-31,13,15,212,227
76945,2019-10-31,14,21,248,269
76946,2019-10-31,15,26,474,500
76947,2019-10-31,16,33,736,769
76948,2019-10-31,17,34,1115,1149
76949,2019-10-31,18,33,805,838
76950,2019-10-31,19,19,465,484
76951,2019-10-31,20,9,319,328
76952,2019-10-31,21,1,87,88
76953,2019-10-31,22,4,37,41
76954,2019-10-31,23,1,45,46
76955,2019-11-01,0,3,28,31
76956,2019-11-01,1,1,25,26
76957,2019-11-01,2,3,19,22
76958,2019-11-01,3,1,6,7
76959,2019-11-01,4,0,11,11
76960,2019-11-01,5,3,62,65
76961,2019-11-01,6,2,213,215
76962,2019-11-01,7,9,550,559
76963,2019-11-01,8,29,1118,1147
76964,2019-11-01,9,18,680,698
76965,2019-11-01,10,39,311,350
76966,2019-11-01,11,50,340,390
76967,2019-11-01,12,56,395,451
76968,2019-11-01,13,78,444,522
76969,2019-11-01,14,66,413,479
76970,2019-11-01,15,79,520,599
76971,2019-11-01,16,89,753,842
76972,2019-11-01,17,81,1142,1223
76973,2019-11-01,18,62,793,855
76974,2019-11-01,19,32,452,484
76975,2019-11-01,20,17,323,340
76976,2019-11-01,21,12,223,235
76977,2019-11-01,22,13,180,193
76978,2019-11-01,23,12,145,157
76979,2019-11-02,0,10,96,106
76980,2019-11-02,1,5,58,63
76981,2019-11-02,2,0,51,51
76982,2019-11-02,3,6,23,29
76983,2019-11-02,4,1,9,10
76984,2019-11-02,5,0,20,20
76985,2019-11-02,6,1,26,27
76986,2019-11-02,7,6,100,106
76987,2019-11-02,8,19,241,260
76988,2019-11-02,9,49,358,407
76989,2019-11-02,10,100,520,620
76990,2019-11-02,11,135,638,773
76991,2019-11-02,12,154,738,892
76992,2019-11-02,13,211,910,1121
76993,2019-11-02,14,192,760,952
76994,2019-11-02,15,226,908,1134
76995,2019-11-02,16,207,776,983
76996,2019-11-02,17,131,620,751
76997,2019-11-02,18,80,446,526
76998,2019-11-02,19,46,336,382
76999,2019-11-02,20,33,226,259
77000,2019-11-02,21,11,199,210
77001,2019-11-02,22,41,148,189
77002,2019-11-02,23,23,127,150
77003,2019-11-03,0,15,101,116
77004,2019-11-03,1,8,42,50
77005,2019-11-03,2,0,33,33
77006,2019-11-03,3,0,13,13
77007,2019-11-03,4,0,12,12
77008,2019-11-03,5,1,15,16
77009,2019-11-03,6,5,25,30
77010,2019-11-03,7,12,82,94
77011,2019-11-03,8,21,235,256
77012,2019-11-03,9,37,409,446
77013,2019-11-03,10,86,555,641
77014,2019-11-03,11,111,583,694
77015,2019-11-03,12,130,619,749
77016,2019-11-03,13,117,639,756
77017,2019-11-03,14,111,582,693
77018,2019-11-03,15,127,568,695
77019,2019-11-03,16,88,556,644
77020,2019-11-03,17,62,474,536
77021,2019-11-03,18,31,348,379
77022,2019-11-03,19,17,259,276
77023,2019-11-03,20,29,162,191
77024,2019-11-03,21,21,120,141
77025,2019-11-03,22,21,117,138
77026,2019-11-03,23,2,44,46
77027,2019-11-04,0,8,28,36
77028,2019-11-04,1,0,9,9
77029,2019-11-04,2,0,7,7
77030,2019-11-04,3,1,1,2
77031,2019-11-04,4,0,15,15
77032,2019-11-04,5,2,92,94
77033,2019-11-04,6,3,295,298
77034,2019-11-04,7,17,783,800
77035,2019-11-04,8,39,1172,1211
77036,2019-11-04,9,26,528,554
77037,2019-11-04,10,43,246,289
77038,2019-11-04,11,76,297,373
77039,2019-11-04,12,53,370,423
77040,2019-11-04,13,77,350,427
77041,2019-11-04,14,73,360,433
77042,2019-11-04,15,51,456,507
77043,2019-11-04,16,54,793,847
77044,2019-11-04,17,66,1194,1260
77045,2019-11-04,18,23,886,909
77046,2019-11-04,19,29,520,549
77047,2019-11-04,20,18,336,354
77048,2019-11-04,21,7,261,268
77049,2019-11-04,22,10,137,147
77050,2019-11-04,23,5,59,64
77051,2019-11-05,0,0,30,30
77052,2019-11-05,1,0,4,4
77053,2019-11-05,2,1,5,6
77054,2019-11-05,3,1,1,2
77055,2019-11-05,4,0,12,12
77056,2019-11-05,5,2,104,106
77057,2019-11-05,6,6,340,346
77058,2019-11-05,7,15,866,881
77059,2019-11-05,8,41,1385,1426
77060,2019-11-05,9,35,585,620
77061,2019-11-05,10,42,281,323
77062,2019-11-05,11,42,322,364
77063,2019-11-05,12,49,440,489
77064,2019-11-05,13,51,360,411
77065,2019-11-05,14,50,346,396
77066,2019-11-05,15,79,473,552
77067,2019-11-05,16,60,816,876
77068,2019-11-05,17,46,1226,1272
77069,2019-11-05,18,26,958,984
77070,2019-11-05,19,18,521,539
77071,2019-11-05,20,15,412,427
77072,2019-11-05,21,11,264,275
77073,2019-11-05,22,7,193,200
77074,2019-11-05,23,5,84,89
77075,2019-11-06,0,2,30,32
77076,2019-11-06,1,1,15,16
77077,2019-11-06,2,0,6,6
77078,2019-11-06,3,1,4,5
77079,2019-11-06,4,0,16,16
77080,2019-11-06,5,3,110,113
77081,2019-11-06,6,5,376,381
77082,2019-11-06,7,15,878,893
77083,2019-11-06,8,27,1346,1373
77084,2019-11-06,9,16,635,651
77085,2019-11-06,10,27,310,337
77086,2019-11-06,11,36,335,371
77087,2019-11-06,12,55,441,496
77088,2019-11-06,13,59,414,473
77089,2019-11-06,14,59,409,468
77090,2019-11-06,15,101,508,609
77091,2019-11-06,16,77,765,842
77092,2019-11-06,17,62,1172,1234
77093,2019-11-06,18,37,857,894
77094,2019-11-06,19,26,547,573
77095,2019-11-06,20,21,354,375
77096,2019-11-06,21,12,241,253
77097,2019-11-06,22,9,152,161
77098,2019-11-06,23,4,94,98
77099,2019-11-07,0,2,36,38
77100,2019-11-07,1,2,13,15
77101,2019-11-07,2,1,5,6
77102,2019-11-07,3,1,5,6
77103,2019-11-07,4,0,15,15
77104,2019-11-07,5,2,97,99
77105,2019-11-07,6,3,309,312
77106,2019-11-07,7,19,846,865
77107,2019-11-07,8,25,1352,1377
77108,2019-11-07,9,45,647,692
77109,2019-11-07,10,45,297,342
77110,2019-11-07,11,39,289,328
77111,2019-11-07,12,50,346,396
77112,2019-11-07,13,69,357,426
77113,2019-11-07,14,50,327,377
77114,2019-11-07,15,49,484,533
77115,2019-11-07,16,73,656,729
77116,2019-11-07,17,13,445,458
77117,2019-11-07,18,13,402,415
77118,2019-11-07,19,8,234,242
77119,2019-11-07,20,11,224,235
77120,2019-11-07,21,6,161,167
77121,2019-11-07,22,9,145,154
77122,2019-11-07,23,4,90,94
77123,2019-11-08,0,1,43,44
77124,2019-11-08,1,1,25,26
77125,2019-11-08,2,0,4,4
77126,2019-11-08,3,0,1,1
77127,2019-11-08,4,0,15,15
77128,2019-11-08,5,3,73,76
77129,2019-11-08,6,4,250,254
77130,2019-11-08,7,10,584,594
77131,2019-11-08,8,18,1042,1060
77132,2019-11-08,9,29,568,597
77133,2019-11-08,10,42,288,330
77134,2019-11-08,11,32,336,368
77135,2019-11-08,12,44,414,458
77136,2019-11-08,13,42,421,463
77137,2019-11-08,14,35,338,373
77138,2019-11-08,15,60,499,559
77139,2019-11-08,16,51,647,698
77140,2019-11-08,17,33,768,801
77141,2019-11-08,18,17,573,590
77142,2019-11-08,19,10,309,319
77143,2019-11-08,20,6,176,182
77144,2019-11-08,21,6,160,166
77145,2019-11-08,22,10,140,150
77146,2019-11-08,23,7,107,114
77147,2019-11-09,0,3,66,69
77148,2019-11-09,1,2,39,41
77149,2019-11-09,2,2,20,22
77150,2019-11-09,3,1,8,9
77151,2019-11-09,4,0,4,4
77152,2019-11-09,5,0,14,14
77153,2019-11-09,6,5,35,40
77154,2019-11-09,7,9,82,91
77155,2019-11-09,8,23,203,226
77156,2019-11-09,9,37,337,374
77157,2019-11-09,10,63,430,493
77158,2019-11-09,11,85,425,510
77159,2019-11-09,12,81,507,588
77160,2019-11-09,13,77,442,519
77161,2019-11-09,14,71,463,534
77162,2019-11-09,15,104,447,551
77163,2019-11-09,16,58,432,490
77164,2019-11-09,17,54,342,396
77165,2019-11-09,18,24,228,252
77166,2019-11-09,19,26,242,268
77167,2019-11-09,20,13,157,170
77168,2019-11-09,21,8,129,137
77169,2019-11-09,22,9,109,118
77170,2019-11-09,23,8,84,92
77171,2019-11-10,0,4,88,92
77172,2019-11-10,1,5,53,58
77173,2019-11-10,2,5,30,35
77174,2019-11-10,3,9,14,23
77175,2019-11-10,4,4,9,13
77176,2019-11-10,5,1,10,11
77177,2019-11-10,6,0,28,28
77178,2019-11-10,7,4,80,84
77179,2019-11-10,8,20,166,186
77180,2019-11-10,9,50,310,360
77181,2019-11-10,10,88,440,528
77182,2019-11-10,11,91,604,695
77183,2019-11-10,12,143,585,728
77184,2019-11-10,13,153,576,729
77185,2019-11-10,14,113,607,720
77186,2019-11-10,15,116,518,634
77187,2019-11-10,16,102,510,612
77188,2019-11-10,17,72,419,491
77189,2019-11-10,18,34,310,344
77190,2019-11-10,19,18,234,252
77191,2019-11-10,20,24,181,205
77192,2019-11-10,21,28,167,195
77193,2019-11-10,22,22,138,160
77194,2019-11-10,23,9,79,88
77195,2019-11-11,0,7,33,40
77196,2019-11-11,1,5,14,19
77197,2019-11-11,2,1,14,15
77198,2019-11-11,3,0,5,5
77199,2019-11-11,4,0,14,14
77200,2019-11-11,5,1,52,53
77201,2019-11-11,6,5,119,124
77202,2019-11-11,7,14,349,363
77203,2019-11-11,8,34,699,733
77204,2019-11-11,9,36,471,507
77205,2019-11-11,10,48,361,409
77206,2019-11-11,11,54,407,461
77207,2019-11-11,12,76,549,625
77208,2019-11-11,13,80,521,601
77209,2019-11-11,14,98,564,662
77210,2019-11-11,15,99,569,668
77211,2019-11-11,16,101,619,720
77212,2019-11-11,17,41,821,862
77213,2019-11-11,18,39,680,719
77214,2019-11-11,19,26,436,462
77215,2019-11-11,20,13,288,301
77216,2019-11-11,21,13,211,224
77217,2019-11-11,22,17,151,168
77218,2019-11-11,23,5,84,89
77219,2019-11-12,0,1,40,41
77220,2019-11-12,1,0,7,7
77221,2019-11-12,2,0,4,4
77222,2019-11-12,3,0,4,4
77223,2019-11-12,4,0,6,6
77224,2019-11-12,5,2,53,55
77225,2019-11-12,6,0,138,138
77226,2019-11-12,7,9,463,472
77227,2019-11-12,8,13,854,867
77228,2019-11-12,9,4,444,448
77229,2019-11-12,10,6,168,174
77230,2019-11-12,11,7,189,196
77231,2019-11-12,12,13,216,229
77232,2019-11-12,13,10,209,219
77233,2019-11-12,14,14,223,237
77234,2019-11-12,15,6,320,326
77235,2019-11-12,16,15,510,525
77236,2019-11-12,17,5,800,805
77237,2019-11-12,18,10,594,604
77238,2019-11-12,19,8,365,373
77239,2019-11-12,20,4,238,242
77240,2019-11-12,21,1,161,162
77241,2019-11-12,22,1,105,106
77242,2019-11-12,23,3,57,60
77243,2019-11-13,0,0,24,24
77244,2019-11-13,1,0,9,9
77245,2019-11-13,3,0,2,2
77246,2019-11-13,4,0,12,12
77247,2019-11-13,5,0,88,88
77248,2019-11-13,6,1,257,258
77249,2019-11-13,7,7,620,627
77250,2019-11-13,8,11,963,974
77251,2019-11-13,9,4,456,460
77252,2019-11-13,10,6,203,209
77253,2019-11-13,11,22,236,258
77254,2019-11-13,12,10,257,267
77255,2019-11-13,13,11,254,265
77256,2019-11-13,14,11,233,244
77257,2019-11-13,15,14,339,353
77258,2019-11-13,16,14,494,508
77259,2019-11-13,17,18,824,842
77260,2019-11-13,18,9,641,650
77261,2019-11-13,19,6,342,348
77262,2019-11-13,20,6,230,236
77263,2019-11-13,21,6,163,169
77264,2019-11-13,22,1,105,106
77265,2019-11-13,23,5,60,65
77266,2019-11-14,0,1,19,20
77267,2019-11-14,1,0,5,5
77268,2019-11-14,2,1,3,4
77269,2019-11-14,3,1,2,3
77270,2019-11-14,4,0,9,9
77271,2019-11-14,5,1,88,89
77272,2019-11-14,6,2,232,234
77273,2019-11-14,7,8,636,644
77274,2019-11-14,8,16,1084,1100
77275,2019-11-14,9,5,485,490
77276,2019-11-14,10,9,229,238
77277,2019-11-14,11,5,230,235
77278,2019-11-14,12,11,278,289
77279,2019-11-14,13,10,267,277
77280,2019-11-14,14,20,257,277
77281,2019-11-14,15,14,356,370
77282,2019-11-14,16,23,543,566
77283,2019-11-14,17,19,848,867
77284,2019-11-14,18,12,748,760
77285,2019-11-14,19,9,405,414
77286,2019-11-14,20,5,308,313
77287,2019-11-14,21,3,229,232
77288,2019-11-14,22,4,151,155
77289,2019-11-14,23,4,81,85
77290,2019-11-15,0,1,39,40
77291,2019-11-15,1,1,13,14
77292,2019-11-15,2,0,7,7
77293,2019-11-15,3,0,2,2
77294,2019-11-15,4,0,15,15
77295,2019-11-15,5,1,74,75
77296,2019-11-15,6,3,222,225
77297,2019-11-15,7,11,521,532
77298,2019-11-15,8,14,1031,1045
77299,2019-11-15,9,18,554,572
77300,2019-11-15,10,10,271,281
77301,2019-11-15,11,27,297,324
77302,2019-11-15,12,40,389,429
77303,2019-11-15,13,47,376,423
77304,2019-11-15,14,52,358,410
77305,2019-11-15,15,48,453,501
77306,2019-11-15,16,38,651,689
77307,2019-11-15,17,47,911,958
77308,2019-11-15,18,24,666,690
77309,2019-11-15,19,6,407,413
77310,2019-11-15,20,13,247,260
77311,2019-11-15,21,11,172,183
77312,2019-11-15,22,9,128,137
77313,2019-11-15,23,6,124,130
77314,2019-11-16,0,9,90,99
77315,2019-11-16,1,3,58,61
77316,2019-11-16,2,2,30,32
77317,2019-11-16,3,0,14,14
77318,2019-11-16,4,0,5,5
77319,2019-11-16,5,0,17,17
77320,2019-11-16,6,2,28,30
77321,2019-11-16,7,4,95,99
77322,2019-11-16,8,9,248,257
77323,2019-11-16,9,24,316,340
77324,2019-11-16,10,38,386,424
77325,2019-11-16,11,113,462,575
77326,2019-11-16,12,85,489,574
77327,2019-11-16,13,109,435,544
77328,2019-11-16,14,57,451,508
77329,2019-11-16,15,71,454,525
77330,2019-11-16,16,51,391,442
77331,2019-11-16,17,53,290,343
77332,2019-11-16,18,14,272,286
77333,2019-11-16,19,16,195,211
77334,2019-11-16,20,14,162,176
77335,2019-11-16,21,4,98,102
77336,2019-11-16,22,10,107,117
77337,2019-11-16,23,9,95,104
77338,2019-11-17,0,4,78,82
77339,2019-11-17,1,8,49,57
77340,2019-11-17,2,7,31,38
77341,2019-11-17,3,5,9,14
77342,2019-11-17,4,0,4,4
77343,2019-11-17,5,1,14,15
77344,2019-11-17,6,1,20,21
77345,2019-11-17,7,2,68,70
77346,2019-11-17,8,10,156,166
77347,2019-11-17,9,28,232,260
77348,2019-11-17,10,36,334,370
77349,2019-11-17,11,21,373,394
77350,2019-11-17,12,32,451,483
77351,2019-11-17,13,46,372,418
77352,2019-11-17,14,49,320,369
77353,2019-11-17,15,35,372,407
77354,2019-11-17,16,41,344,385
77355,2019-11-17,17,29,314,343
77356,2019-11-17,18,22,238,260
77357,2019-11-17,19,12,207,219
77358,2019-11-17,20,7,144,151
77359,2019-11-17,21,3,93,96
77360,2019-11-17,22,3,75,78
77361,2019-11-17,23,0,39,39
77362,2019-11-18,0,6,23,29
77363,2019-11-18,1,0,9,9
77364,2019-11-18,2,1,3,4
77365,2019-11-18,3,0,6,6
77366,2019-11-18,4,0,9,9
77367,2019-11-18,5,2,77,79
77368,2019-11-18,6,1,235,236
77369,2019-11-18,7,5,635,640
77370,2019-11-18,8,17,1017,1034
77371,2019-11-18,9,19,485,504
77372,2019-11-18,10,19,222,241
77373,2019-11-18,11,22,213,235
77374,2019-11-18,12,20,313,333
77375,2019-11-18,13,27,270,297
77376,2019-11-18,14,29,277,306
77377,2019-11-18,15,17,377,394
77378,2019-11-18,16,15,607,622
77379,2019-11-18,17,12,985,997
77380,2019-11-18,18,12,747,759
77381,2019-11-18,19,6,372,378
77382,2019-11-18,20,0,180,180
77383,2019-11-18,21,0,74,74
77384,2019-11-18,22,0,43,43
77385,2019-11-18,23,0,24,24
77386,2019-11-19,0,1,18,19
77387,2019-11-19,1,0,4,4
77388,2019-11-19,2,0,4,4
77389,2019-11-19,3,0,8,8
77390,2019-11-19,4,0,15,15
77391,2019-11-19,5,0,89,89
77392,2019-11-19,6,1,288,289
77393,2019-11-19,7,9,780,789
77394,2019-11-19,8,11,1206,1217
77395,2019-11-19,9,10,566,576
77396,2019-11-19,10,14,267,281
77397,2019-11-19,11,23,277,300
77398,2019-11-19,12,14,363,377
77399,2019-11-19,13,28,311,339
77400,2019-11-19,14,31,316,347
77401,2019-11-19,15,31,419,450
77402,2019-11-19,16,30,596,626
77403,2019-11-19,17,34,1046,1080
77404,2019-11-19,18,35,858,893
77405,2019-11-19,19,21,550,571
77406,2019-11-19,20,15,350,365
77407,2019-11-19,21,13,275,288
77408,2019-11-19,22,11,157,168
77409,2019-11-19,23,5,87,92
77410,2019-11-20,0,4,32,36
77411,2019-11-20,1,2,12,14
77412,2019-11-20,2,1,3,4
77413,2019-11-20,4,0,16,16
77414,2019-11-20,5,4,109,113
77415,2019-11-20,6,2,321,323
77416,2019-11-20,7,10,720,730
77417,2019-11-20,8,24,1249,1273
77418,2019-11-20,9,17,624,641
77419,2019-11-20,10,17,248,265
77420,2019-11-20,11,23,268,291
77421,2019-11-20,12,24,361,385
77422,2019-11-20,13,26,338,364
77423,2019-11-20,14,23,302,325
77424,2019-11-20,15,25,387,412
77425,2019-11-20,16,29,629,658
77426,2019-11-20,17,33,1020,1053
77427,2019-11-20,18,20,809,829
77428,2019-11-20,19,19,500,519
77429,2019-11-20,20,14,326,340
77430,2019-11-20,21,17,223,240
77431,2019-11-20,22,8,144,152
77432,2019-11-20,23,17,84,101
77433,2019-11-21,0,2,35,37
77434,2019-11-21,1,4,16,20
77435,2019-11-21,2,2,5,7
77436,2019-11-21,3,0,4,4
77437,2019-11-21,4,1,13,14
77438,2019-11-21,5,0,91,91
77439,2019-11-21,6,2,288,290
77440,2019-11-21,7,11,721,732
77441,2019-11-21,8,26,1232,1258
77442,2019-11-21,9,8,599,607
77443,2019-11-21,10,12,259,271
77444,2019-11-21,11,18,284,302
77445,2019-11-21,12,25,353,378
77446,2019-11-21,13,19,296,315
77447,2019-11-21,14,32,346,378
77448,2019-11-21,15,28,414,442
77449,2019-11-21,16,25,643,668
77450,2019-11-21,17,20,1031,1051
77451,2019-11-21,18,20,808,828
77452,2019-11-21,19,16,514,530
77453,2019-11-21,20,14,367,381
77454,2019-11-21,21,11,276,287
77455,2019-11-21,22,16,156,172
77456,2019-11-21,23,2,91,93
77457,2019-11-22,0,3,46,49
77458,2019-11-22,1,3,21,24
77459,2019-11-22,2,0,14,14
77460,2019-11-22,3,0,6,6
77461,2019-11-22,4,0,13,13
77462,2019-11-22,5,1,70,71
77463,2019-11-22,6,4,242,246
77464,2019-11-22,7,16,651,667
77465,2019-11-22,8,27,1119,1146
77466,2019-11-22,9,19,492,511
77467,2019-11-22,10,2,83,85
77468,2019-11-22,11,4,73,77
77469,2019-11-22,12,15,178,193
77470,2019-11-22,13,21,222,243
77471,2019-11-22,14,24,274,298
77472,2019-11-22,15,18,419,437
77473,2019-11-22,16,24,646,670
77474,2019-11-22,17,34,888,922
77475,2019-11-22,18,27,651,678
77476,2019-11-22,19,15,383,398
77477,2019-11-22,20,14,283,297
77478,2019-11-22,21,9,169,178
77479,2019-11-22,22,17,156,173
77480,2019-11-22,23,2,118,120
77481,2019-11-23,0,4,73,77
77482,2019-11-23,1,2,68,70
77483,2019-11-23,2,1,36,37
77484,2019-11-23,3,1,23,24
77485,2019-11-23,4,1,14,15
77486,2019-11-23,5,2,17,19
77487,2019-11-23,6,1,42,43
77488,2019-11-23,7,3,101,104
77489,2019-11-23,8,24,208,232
77490,2019-11-23,9,18,365,383
77491,2019-11-23,10,47,414,461
77492,2019-11-23,11,67,407,474
77493,2019-11-23,12,78,482,560
77494,2019-11-23,13,41,396,437
77495,2019-11-23,14,70,379,449
77496,2019-11-23,15,53,370,423
77497,2019-11-23,16,46,288,334
77498,2019-11-23,17,14,171,185
77499,2019-11-23,18,5,105,110
77500,2019-11-23,19,5,72,77
77501,2019-11-23,20,12,77,89
77502,2019-11-23,21,9,60,69
77503,2019-11-23,22,2,30,32
77504,2019-11-23,23,1,25,26
77505,2019-11-24,0,1,14,15
77506,2019-11-24,1,0,12,12
77507,2019-11-24,2,1,9,10
77508,2019-11-24,3,3,10,13
77509,2019-11-24,4,0,4,4
77510,2019-11-24,5,2,8,10
77511,2019-11-24,6,0,21,21
77512,2019-11-24,7,3,54,57
77513,2019-11-24,8,9,129,138
77514,2019-11-24,9,16,230,246
77515,2019-11-24,10,24,316,340
77516,2019-11-24,11,30,376,406
77517,2019-11-24,12,42,440,482
77518,2019-11-24,13,48,442,490
77519,2019-11-24,14,95,398,493
77520,2019-11-24,15,53,420,473
77521,2019-11-24,16,44,403,447
77522,2019-11-24,17,25,330,355
77523,2019-11-24,18,10,231,241
77524,2019-11-24,19,11,159,170
77525,2019-11-24,20,12,125,137
77526,2019-11-24,21,8,105,113
77527,2019-11-24,22,4,69,73
77528,2019-11-24,23,5,37,42
77529,2019-11-25,0,0,23,23
77530,2019-11-25,1,0,7,7
77531,2019-11-25,2,0,5,5
77532,2019-11-25,3,0,3,3
77533,2019-11-25,4,0,12,12
77534,2019-11-25,5,1,59,60
77535,2019-11-25,6,1,257,258
77536,2019-11-25,7,7,631,638
77537,2019-11-25,8,16,1040,1056
77538,2019-11-25,9,16,518,534
77539,2019-11-25,10,59,236,295
77540,2019-11-25,11,42,261,303
77541,2019-11-25,12,57,307,364
77542,2019-11-25,13,40,322,362
77543,2019-11-25,14,44,348,392
77544,2019-11-25,15,36,407,443
77545,2019-11-25,16,35,637,672
77546,2019-11-25,17,26,970,996
77547,2019-11-25,18,18,747,765
77548,2019-11-25,19,14,441,455
77549,2019-11-25,20,15,296,311
77550,2019-11-25,21,5,196,201
77551,2019-11-25,22,4,107,111
77552,2019-11-25,23,6,99,105
77553,2019-11-26,0,6,25,31
77554,2019-11-26,1,1,3,4
77555,2019-11-26,2,1,10,11
77556,2019-11-26,3,0,2,2
77557,2019-11-26,4,0,14,14
77558,2019-11-26,5,1,75,76
77559,2019-11-26,6,0,233,233
77560,2019-11-26,7,6,616,622
77561,2019-11-26,8,22,1061,1083
77562,2019-11-26,9,26,525,551
77563,2019-11-26,10,56,288,344
77564,2019-11-26,11,71,333,404
77565,2019-11-26,12,69,397,466
77566,2019-11-26,13,73,420,493
77567,2019-11-26,14,88,384,472
77568,2019-11-26,15,114,512,626
77569,2019-11-26,16,80,666,746
77570,2019-11-26,17,49,977,1026
77571,2019-11-26,18,46,678,724
77572,2019-11-26,19,24,439,463
77573,2019-11-26,20,24,271,295
77574,2019-11-26,21,15,184,199
77575,2019-11-26,22,10,132,142
77576,2019-11-26,23,7,70,77
77577,2019-11-27,0,3,31,34
77578,2019-11-27,1,2,9,11
77579,2019-11-27,2,0,7,7
77580,2019-11-27,3,0,5,5
77581,2019-11-27,4,0,14,14
77582,2019-11-27,5,3,69,72
77583,2019-11-27,6,2,145,147
77584,2019-11-27,7,1,260,261
77585,2019-11-27,8,13,556,569
77586,2019-11-27,9,24,387,411
77587,2019-11-27,10,24,278,302
77588,2019-11-27,11,40,254,294
77589,2019-11-27,12,38,373,411
77590,2019-11-27,13,47,384,431
77591,2019-11-27,14,46,494,540
77592,2019-11-27,15,64,538,602
77593,2019-11-27,16,50,511,561
77594,2019-11-27,17,26,436,462
77595,2019-11-27,18,28,313,341
77596,2019-11-27,19,12,246,258
77597,2019-11-27,20,7,161,168
77598,2019-11-27,21,17,141,158
77599,2019-11-27,22,12,87,99
77600,2019-11-27,23,3,88,91
77601,2019-11-28,0,6,35,41
77602,2019-11-28,1,7,29,36
77603,2019-11-28,2,6,28,34
77604,2019-11-28,3,1,3,4
77605,2019-11-28,4,0,6,6
77606,2019-11-28,5,1,16,17
77607,2019-11-28,6,1,30,31
77608,2019-11-28,7,6,81,87
77609,2019-11-28,8,16,138,154
77610,2019-11-28,9,20,160,180
77611,2019-11-28,10,38,147,185
77612,2019-11-28,11,31,151,182
77613,2019-11-28,12,45,161,206
77614,2019-11-28,13,33,123,156
77615,2019-11-28,14,31,141,172
77616,2019-11-28,15,35,100,135
77617,2019-11-28,16,41,103,144
77618,2019-11-28,17,18,87,105
77619,2019-11-28,18,12,54,66
77620,2019-11-28,19,7,34,41
77621,2019-11-28,20,17,41,58
77622,2019-11-28,21,8,58,66
77623,2019-11-28,22,4,44,48
77624,2019-11-28,23,5,37,42
77625,2019-11-29,0,1,14,15
77626,2019-11-29,1,1,10,11
77627,2019-11-29,2,1,6,7
77628,2019-11-29,3,0,2,2
77629,2019-11-29,4,0,7,7
77630,2019-11-29,5,0,15,15
77631,2019-11-29,6,2,55,57
77632,2019-11-29,7,7,104,111
77633,2019-11-29,8,3,134,137
77634,2019-11-29,9,19,157,176
77635,2019-11-29,10,39,206,245
77636,2019-11-29,11,67,239,306
77637,2019-11-29,12,99,303,402
77638,2019-11-29,13,78,303,381
77639,2019-11-29,14,110,320,430
77640,2019-11-29,15,89,333,422
77641,2019-11-29,16,85,353,438
77642,2019-11-29,17,68,243,311
77643,2019-11-29,18,35,199,234
77644,2019-11-29,19,26,145,171
77645,2019-11-29,20,16,123,139
77646,2019-11-29,21,9,91,100
77647,2019-11-29,22,11,84,95
77648,2019-11-29,23,6,72,78
77649,2019-11-30,0,6,37,43
77650,2019-11-30,1,4,31,35
77651,2019-11-30,2,0,21,21
77652,2019-11-30,3,1,14,15
77653,2019-11-30,4,1,10,11
77654,2019-11-30,5,1,12,13
77655,2019-11-30,6,3,23,26
77656,2019-11-30,7,8,47,55
77657,2019-11-30,8,10,125,135
77658,2019-11-30,9,32,194,226
77659,2019-11-30,10,31,227,258
77660,2019-11-30,11,33,290,323
77661,2019-11-30,12,72,294,366
77662,2019-11-30,13,62,293,355
77663,2019-11-30,14,76,285,361
77664,2019-11-30,15,71,284,355
77665,2019-11-30,16,57,257,314
77666,2019-11-30,17,41,258,299
77667,2019-11-30,18,19,178,197
77668,2019-11-30,19,7,174,181
77669,2019-11-30,20,9,124,133
77670,2019-11-30,21,10,112,122
77671,2019-11-30,22,14,93,107
77672,2019-11-30,23,8,73,81
77673,2019-12-01,0,4,42,46
77674,2019-12-01,1,3,31,34
77675,2019-12-01,2,3,28,31
77676,2019-12-01,3,2,12,14
77677,2019-12-01,4,0,7,7
77678,2019-12-01,5,0,5,5
77679,2019-12-01,6,1,13,14
77680,2019-12-01,7,0,24,24
77681,2019-12-01,8,5,76,81
77682,2019-12-01,9,3,64,67
77683,2019-12-01,10,2,65,67
77684,2019-12-01,11,1,50,51
77685,2019-12-01,12,8,81,89
77686,2019-12-01,13,1,47,48
77687,2019-12-01,14,1,51,52
77688,2019-12-01,15,3,81,84
77689,2019-12-01,16,8,131,139
77690,2019-12-01,17,7,152,159
77691,2019-12-01,18,3,158,161
77692,2019-12-01,19,2,121,123
77693,2019-12-01,20,5,80,85
77694,2019-12-01,21,9,81,90
77695,2019-12-01,22,5,54,59
77696,2019-12-01,23,5,31,36
77697,2019-12-02,0,2,15,17
77698,2019-12-02,1,0,8,8
77699,2019-12-02,2,0,3,3
77700,2019-12-02,3,0,2,2
77701,2019-12-02,4,0,10,10
77702,2019-12-02,5,2,66,68
77703,2019-12-02,6,0,233,233
77704,2019-12-02,7,5,600,605
77705,2019-12-02,8,7,1116,1123
77706,2019-12-02,9,10,440,450
77707,2019-12-02,10,7,144,151
77708,2019-12-02,11,8,101,109
77709,2019-12-02,12,5,119,124
77710,2019-12-02,13,15,142,157
77711,2019-12-02,14,4,190,194
77712,2019-12-02,15,21,273,294
77713,2019-12-02,16,3,437,440
77714,2019-12-02,17,14,772,786
77715,2019-12-02,18,7,629,636
77716,2019-12-02,19,2,309,311
77717,2019-12-02,20,5,212,217
77718,2019-12-02,21,1,177,178
77719,2019-12-02,22,4,91,95
77720,2019-12-02,23,3,42,45
77721,2019-12-03,0,2,21,23
77722,2019-12-03,1,1,7,8
77723,2019-12-03,2,0,6,6
77724,2019-12-03,3,1,1,2
77725,2019-12-03,4,0,10,10
77726,2019-12-03,5,2,102,104
77727,2019-12-03,6,1,271,272
77728,2019-12-03,7,8,669,677
77729,2019-12-03,8,16,1194,1210
77730,2019-12-03,9,10,508,518
77731,2019-12-03,10,8,258,266
77732,2019-12-03,11,12,248,260
77733,2019-12-03,12,15,302,317
77734,2019-12-03,13,13,259,272
77735,2019-12-03,14,18,251,269
77736,2019-12-03,15,19,331,350
77737,2019-12-03,16,17,548,565
77738,2019-12-03,17,20,958,978
77739,2019-12-03,18,15,749,764
77740,2019-12-03,19,10,496,506
77741,2019-12-03,20,5,302,307
77742,2019-12-03,21,1,241,242
77743,2019-12-03,22,5,121,126
77744,2019-12-03,23,4,67,71
77745,2019-12-04,0,5,23,28
77746,2019-12-04,1,1,8,9
77747,2019-12-04,2,0,3,3
77748,2019-12-04,3,1,6,7
77749,2019-12-04,4,0,17,17
77750,2019-12-04,5,1,85,86
77751,2019-12-04,6,2,261,263
77752,2019-12-04,7,5,645,650
77753,2019-12-04,8,10,1156,1166
77754,2019-12-04,9,14,575,589
77755,2019-12-04,10,9,242,251
77756,2019-12-04,11,17,242,259
77757,2019-12-04,12,14,286,300
77758,2019-12-04,13,21,275,296
77759,2019-12-04,14,15,265,280
77760,2019-12-04,15,15,389,404
77761,2019-12-04,16,8,489,497
77762,2019-12-04,17,9,838,847
77763,2019-12-04,18,8,748,756
77764,2019-12-04,19,4,461,465
77765,2019-12-04,20,6,294,300
77766,2019-12-04,21,10,227,237
77767,2019-12-04,22,6,141,147
77768,2019-12-04,23,4,64,68
77769,2019-12-05,0,4,50,54
77770,2019-12-05,1,1,10,11
77771,2019-12-05,2,2,8,10
77772,2019-12-05,3,0,2,2
77773,2019-12-05,4,1,14,15
77774,2019-12-05,5,2,80,82
77775,2019-12-05,6,10,241,251
77776,2019-12-05,7,8,673,681
77777,2019-12-05,8,9,1208,1217
77778,2019-12-05,9,10,591,601
77779,2019-12-05,10,7,217,224
77780,2019-12-05,11,9,275,284
77781,2019-12-05,12,18,315,333
77782,2019-12-05,13,22,301,323
77783,2019-12-05,14,27,300,327
77784,2019-12-05,15,17,410,427
77785,2019-12-05,16,14,559,573
77786,2019-12-05,17,23,888,911
77787,2019-12-05,18,24,771,795
77788,2019-12-05,19,17,437,454
77789,2019-12-05,20,12,308,320
77790,2019-12-05,21,2,263,265
77791,2019-12-05,22,2,160,162
77792,2019-12-05,23,3,101,104
77793,2019-12-06,0,0,50,50
77794,2019-12-06,1,1,24,25
77795,2019-12-06,2,0,5,5
77796,2019-12-06,3,1,2,3
77797,2019-12-06,4,1,11,12
77798,2019-12-06,5,1,72,73
77799,2019-12-06,6,3,201,204
77800,2019-12-06,7,7,526,533
77801,2019-12-06,8,16,1090,1106
77802,2019-12-06,9,5,644,649
77803,2019-12-06,10,20,301,321
77804,2019-12-06,11,30,302,332
77805,2019-12-06,12,38,359,397
77806,2019-12-06,13,35,361,396
77807,2019-12-06,14,26,372,398
77808,2019-12-06,15,49,417,466
77809,2019-12-06,16,38,609,647
77810,2019-12-06,17,31,871,902
77811,2019-12-06,18,21,609,630
77812,2019-12-06,19,13,376,389
77813,2019-12-06,20,16,250,266
77814,2019-12-06,21,14,190,204
77815,2019-12-06,22,13,181,194
77816,2019-12-06,23,6,127,133
77817,2019-12-07,0,10,102,112
77818,2019-12-07,1,6,80,86
77819,2019-12-07,2,2,29,31
77820,2019-12-07,3,2,27,29
77821,2019-12-07,4,0,6,6
77822,2019-12-07,5,2,18,20
77823,2019-12-07,6,1,29,30
77824,2019-12-07,7,4,81,85
77825,2019-12-07,8,18,219,237
77826,2019-12-07,9,25,324,349
77827,2019-12-07,10,44,410,454
77828,2019-12-07,11,50,463,513
77829,2019-12-07,12,68,488,556
77830,2019-12-07,13,112,433,545
77831,2019-12-07,14,63,508,571
77832,2019-12-07,15,47,461,508
77833,2019-12-07,16,41,406,447
77834,2019-12-07,17,17,335,352
77835,2019-12-07,18,13,285,298
77836,2019-12-07,19,13,229,242
77837,2019-12-07,20,16,183,199
77838,2019-12-07,21,4,146,150
77839,2019-12-07,22,6,96,102
77840,2019-12-07,23,7,112,119
77841,2019-12-08,0,13,94,107
77842,2019-12-08,1,7,48,55
77843,2019-12-08,2,3,29,32
77844,2019-12-08,3,4,19,23
77845,2019-12-08,4,2,3,5
77846,2019-12-08,5,0,14,14
77847,2019-12-08,6,2,20,22
77848,2019-12-08,7,2,97,99
77849,2019-12-08,8,3,151,154
77850,2019-12-08,9,8,214,222
77851,2019-12-08,10,34,336,370
77852,2019-12-08,11,45,437,482
77853,2019-12-08,12,49,487,536
77854,2019-12-08,13,30,431,461
77855,2019-12-08,14,65,438,503
77856,2019-12-08,15,54,440,494
77857,2019-12-08,16,29,430,459
77858,2019-12-08,17,19,331,350
77859,2019-12-08,18,15,248,263
77860,2019-12-08,19,17,214,231
77861,2019-12-08,20,9,157,166
77862,2019-12-08,21,7,139,146
77863,2019-12-08,22,2,110,112
77864,2019-12-08,23,0,54,54
77865,2019-12-09,0,0,22,22
77866,2019-12-09,1,0,8,8
77867,2019-12-09,2,0,4,4
77868,2019-12-09,3,0,1,1
77869,2019-12-09,4,0,12,12
77870,2019-12-09,5,2,65,67
77871,2019-12-09,6,0,221,221
77872,2019-12-09,7,5,563,568
77873,2019-12-09,8,15,982,997
77874,2019-12-09,9,4,383,387
77875,2019-12-09,10,3,71,74
77876,2019-12-09,11,1,42,43
77877,2019-12-09,12,1,55,56
77878,2019-12-09,13,0,61,61
77879,2019-12-09,14,0,70,70
77880,2019-12-09,15,2,76,78
77881,2019-12-09,16,3,276,279
77882,2019-12-09,17,9,633,642
77883,2019-12-09,18,7,542,549
77884,2019-12-09,19,1,289,290
77885,2019-12-09,20,2,166,168
77886,2019-12-09,21,1,131,132
77887,2019-12-09,22,3,86,89
77888,2019-12-09,23,5,59,64
77889,2019-12-10,0,1,22,23
77890,2019-12-10,1,1,17,18
77891,2019-12-10,2,1,6,7
77892,2019-12-10,3,0,7,7
77893,2019-12-10,4,1,10,11
77894,2019-12-10,5,0,94,94
77895,2019-12-10,6,2,299,301
77896,2019-12-10,7,11,696,707
77897,2019-12-10,8,19,1183,1202
77898,2019-12-10,9,20,509,529
77899,2019-12-10,10,3,129,132
77900,2019-12-10,11,9,177,186
77901,2019-12-10,12,10,242,252
77902,2019-12-10,13,8,217,225
77903,2019-12-10,14,8,160,168
77904,2019-12-10,15,8,198,206
77905,2019-12-10,16,9,355,364
77906,2019-12-10,17,14,596,610
77907,2019-12-10,18,15,489,504
77908,2019-12-10,19,3,236,239
77909,2019-12-10,20,7,189,196
77910,2019-12-10,21,0,113,113
77911,2019-12-10,22,2,97,99
77912,2019-12-10,23,4,45,49
77913,2019-12-11,0,1,17,18
77914,2019-12-11,1,0,7,7
77915,2019-12-11,2,0,2,2
77916,2019-12-11,3,0,2,2
77917,2019-12-11,4,1,9,10
77918,2019-12-11,5,2,71,73
77919,2019-12-11,6,1,241,242
77920,2019-12-11,7,5,519,524
77921,2019-12-11,8,20,927,947
77922,2019-12-11,9,5,516,521
77923,2019-12-11,10,6,222,228
77924,2019-12-11,11,12,227,239
77925,2019-12-11,12,12,253,265
77926,2019-12-11,13,21,257,278
77927,2019-12-11,14,20,238,258
77928,2019-12-11,15,10,326,336
77929,2019-12-11,16,17,532,549
77930,2019-12-11,17,22,818,840
77931,2019-12-11,18,11,722,733
77932,2019-12-11,19,7,428,435
77933,2019-12-11,20,7,239,246
77934,2019-12-11,21,4,182,186
77935,2019-12-11,22,12,146,158
77936,2019-12-11,23,2,67,69
77937,2019-12-12,0,2,36,38
77938,2019-12-12,1,2,12,14
77939,2019-12-12,2,0,8,8
77940,2019-12-12,3,0,2,2
77941,2019-12-12,4,1,10,11
77942,2019-12-12,5,1,71,72
77943,2019-12-12,6,1,236,237
77944,2019-12-12,7,6,561,567
77945,2019-12-12,8,16,1042,1058
77946,2019-12-12,9,14,498,512
77947,2019-12-12,10,9,216,225
77948,2019-12-12,11,15,227,242
77949,2019-12-12,12,23,277,300
77950,2019-12-12,13,21,277,298
77951,2019-12-12,14,15,286,301
77952,2019-12-12,15,24,326,350
77953,2019-12-12,16,27,489,516
77954,2019-12-12,17,27,822,849
77955,2019-12-12,18,16,636,652
77956,2019-12-12,19,8,353,361
77957,2019-12-12,20,3,224,227
77958,2019-12-12,21,2,203,205
77959,2019-12-12,22,3,141,144
77960,2019-12-12,23,4,119,123
77961,2019-12-13,0,3,46,49
77962,2019-12-13,1,1,19,20
77963,2019-12-13,2,3,11,14
77964,2019-12-13,3,0,1,1
77965,2019-12-13,4,0,8,8
77966,2019-12-13,5,2,62,64
77967,2019-12-13,6,1,192,193
77968,2019-12-13,7,4,485,489
77969,2019-12-13,8,6,712,718
77970,2019-12-13,9,2,290,292
77971,2019-12-13,10,2,92,94
77972,2019-12-13,11,0,100,100
77973,2019-12-13,12,3,89,92
77974,2019-12-13,13,2,149,151
77975,2019-12-13,14,2,152,154
77976,2019-12-13,15,8,226,234
77977,2019-12-13,16,8,363,371
77978,2019-12-13,17,7,500,507
77979,2019-12-13,18,6,405,411
77980,2019-12-13,19,10,229,239
77981,2019-12-13,20,2,189,191
77982,2019-12-13,21,3,111,114
77983,2019-12-13,22,0,62,62
77984,2019-12-13,23,2,54,56
77985,2019-12-14,0,1,43,44
77986,2019-12-14,1,4,44,48
77987,2019-12-14,2,3,31,34
77988,2019-12-14,3,0,8,8
77989,2019-12-14,4,3,8,11
77990,2019-12-14,5,0,19,19
77991,2019-12-14,6,1,26,27
77992,2019-12-14,7,2,77,79
77993,2019-12-14,8,4,152,156
77994,2019-12-14,9,3,181,184
77995,2019-12-14,10,7,199,206
77996,2019-12-14,11,3,157,160
77997,2019-12-14,12,6,246,252
77998,2019-12-14,13,12,264,276
77999,2019-12-14,14,17,306,323
78000,2019-12-14,15,33,369,402
78001,2019-12-14,16,28,307,335
78002,2019-12-14,17,23,287,310
78003,2019-12-14,18,14,276,290
78004,2019-12-14,19,10,198,208
78005,2019-12-14,20,6,162,168
78006,2019-12-14,21,7,148,155
78007,2019-12-14,22,8,116,124
78008,2019-12-14,23,3,118,121
78009,2019-12-15,0,6,104,110
78010,2019-12-15,1,6,75,81
78011,2019-12-15,2,1,36,37
78012,2019-12-15,3,2,19,21
78013,2019-12-15,4,0,9,9
78014,2019-12-15,5,0,12,12
78015,2019-12-15,6,0,25,25
78016,2019-12-15,7,1,51,52
78017,2019-12-15,8,5,143,148
78018,2019-12-15,9,15,230,245
78019,2019-12-15,10,31,352,383
78020,2019-12-15,11,54,423,477
78021,2019-12-15,12,51,433,484
78022,2019-12-15,13,70,523,593
78023,2019-12-15,14,62,452,514
78024,2019-12-15,15,65,419,484
78025,2019-12-15,16,47,436,483
78026,2019-12-15,17,19,311,330
78027,2019-12-15,18,11,230,241
78028,2019-12-15,19,18,181,199
78029,2019-12-15,20,17,130,147
78030,2019-12-15,21,7,108,115
78031,2019-12-15,22,6,66,72
78032,2019-12-15,23,3,55,58
78033,2019-12-16,0,1,26,27
78034,2019-12-16,1,3,12,15
78035,2019-12-16,2,0,6,6
78036,2019-12-16,3,0,2,2
78037,2019-12-16,4,1,11,12
78038,2019-12-16,5,0,60,60
78039,2019-12-16,6,0,108,108
78040,2019-12-16,7,3,149,152
78041,2019-12-16,8,4,248,252
78042,2019-12-16,9,0,150,150
78043,2019-12-16,10,7,105,112
78044,2019-12-16,11,8,144,152
78045,2019-12-16,12,11,159,170
78046,2019-12-16,13,2,166,168
78047,2019-12-16,14,3,102,105
78048,2019-12-16,15,2,99,101
78049,2019-12-16,16,1,188,189
78050,2019-12-16,17,3,364,367
78051,2019-12-16,18,5,361,366
78052,2019-12-16,19,4,260,264
78053,2019-12-16,20,1,149,150
78054,2019-12-16,21,3,131,134
78055,2019-12-16,22,2,77,79
78056,2019-12-16,23,1,43,44
78057,2019-12-17,0,0,19,19
78058,2019-12-17,1,0,3,3
78059,2019-12-17,2,0,7,7
78060,2019-12-17,3,0,1,1
78061,2019-12-17,4,0,9,9
78062,2019-12-17,5,0,84,84
78063,2019-12-17,6,0,191,191
78064,2019-12-17,7,2,512,514
78065,2019-12-17,8,9,845,854
78066,2019-12-17,9,6,449,455
78067,2019-12-17,10,3,201,204
78068,2019-12-17,11,11,167,178
78069,2019-12-17,12,24,221,245
78070,2019-12-17,13,4,191,195
78071,2019-12-17,14,6,171,177
78072,2019-12-17,15,9,249,258
78073,2019-12-17,16,8,428,436
78074,2019-12-17,17,9,586,595
78075,2019-12-17,18,9,413,422
78076,2019-12-17,19,2,313,315
78077,2019-12-17,20,5,227,232
78078,2019-12-17,21,2,170,172
78079,2019-12-17,22,3,122,125
78080,2019-12-17,23,1,57,58
78081,2019-12-18,0,2,32,34
78082,2019-12-18,1,0,12,12
78083,2019-12-18,2,1,2,3
78084,2019-12-18,3,0,7,7
78085,2019-12-18,4,0,12,12
78086,2019-12-18,5,1,86,87
78087,2019-12-18,6,0,252,252
78088,2019-12-18,7,5,525,530
78089,2019-12-18,8,10,970,980
78090,2019-12-18,9,5,513,518
78091,2019-12-18,10,16,263,279
78092,2019-12-18,11,7,236,243
78093,2019-12-18,12,12,303,315
78094,2019-12-18,13,12,267,279
78095,2019-12-18,14,11,287,298
78096,2019-12-18,15,13,334,347
78097,2019-12-18,16,15,458,473
78098,2019-12-18,17,9,703,712
78099,2019-12-18,18,6,547,553
78100,2019-12-18,19,5,323,328
78101,2019-12-18,20,0,188,188
78102,2019-12-18,21,6,149,155
78103,2019-12-18,22,2,86,88
78104,2019-12-18,23,1,38,39
78105,2019-12-19,0,0,27,27
78106,2019-12-19,1,0,11,11
78107,2019-12-19,2,0,3,3
78108,2019-12-19,3,0,3,3
78109,2019-12-19,4,0,10,10
78110,2019-12-19,5,0,64,64
78111,2019-12-19,6,1,171,172
78112,2019-12-19,7,4,390,394
78113,2019-12-19,8,11,806,817
78114,2019-12-19,9,6,404,410
78115,2019-12-19,10,8,180,188
78116,2019-12-19,11,12,174,186
78117,2019-12-19,12,8,161,169
78118,2019-12-19,13,5,168,173
78119,2019-12-19,14,12,194,206
78120,2019-12-19,15,14,290,304
78121,2019-12-19,16,12,395,407
78122,2019-12-19,17,5,606,611
78123,2019-12-19,18,11,473,484
78124,2019-12-19,19,5,280,285
78125,2019-12-19,20,4,171,175
78126,2019-12-19,21,0,132,132
78127,2019-12-19,22,1,100,101
78128,2019-12-19,23,3,71,74
78129,2019-12-20,0,1,25,26
78130,2019-12-20,1,0,21,21
78131,2019-12-20,2,0,5,5
78132,2019-12-20,3,0,4,4
78133,2019-12-20,4,0,11,11
78134,2019-12-20,5,0,57,57
78135,2019-12-20,6,1,132,133
78136,2019-12-20,7,6,345,351
78137,2019-12-20,8,6,651,657
78138,2019-12-20,9,16,398,414
78139,2019-12-20,10,23,226,249
78140,2019-12-20,11,43,246,289
78141,2019-12-20,12,26,292,318
78142,2019-12-20,13,24,307,331
78143,2019-12-20,14,22,290,312
78144,2019-12-20,15,29,404,433
78145,2019-12-20,16,15,461,476
78146,2019-12-20,17,14,564,578
78147,2019-12-20,18,20,374,394
78148,2019-12-20,19,9,222,231
78149,2019-12-20,20,3,143,146
78150,2019-12-20,21,2,101,103
78151,2019-12-20,22,2,79,81
78152,2019-12-20,23,3,70,73
78153,2019-12-21,0,0,51,51
78154,2019-12-21,1,1,33,34
78155,2019-12-21,2,1,22,23
78156,2019-12-21,3,0,9,9
78157,2019-12-21,4,0,6,6
78158,2019-12-21,5,1,11,12
78159,2019-12-21,6,2,26,28
78160,2019-12-21,7,1,38,39
78161,2019-12-21,8,9,117,126
78162,2019-12-21,9,12,189,201
78163,2019-12-21,10,15,236,251
78164,2019-12-21,11,23,272,295
78165,2019-12-21,12,32,253,285
78166,2019-12-21,13,29,244,273
78167,2019-12-21,14,30,240,270
78168,2019-12-21,15,19,295,314
78169,2019-12-21,16,22,277,299
78170,2019-12-21,17,11,204,215
78171,2019-12-21,18,12,146,158
78172,2019-12-21,19,8,118,126
78173,2019-12-21,20,2,107,109
78174,2019-12-21,21,3,66,69
78175,2019-12-21,22,3,65,68
78176,2019-12-21,23,6,64,70
78177,2019-12-22,0,3,39,42
78178,2019-12-22,1,1,26,27
78179,2019-12-22,2,0,23,23
78180,2019-12-22,3,2,8,10
78181,2019-12-22,4,1,2,3
78182,2019-12-22,5,0,7,7
78183,2019-12-22,6,0,14,14
78184,2019-12-22,7,0,27,27
78185,2019-12-22,8,4,65,69
78186,2019-12-22,9,3,145,148
78187,2019-12-22,10,14,205,219
78188,2019-12-22,11,28,240,268
78189,2019-12-22,12,34,257,291
78190,2019-12-22,13,29,282,311
78191,2019-12-22,14,45,292,337
78192,2019-12-22,15,55,293,348
78193,2019-12-22,16,40,279,319
78194,2019-12-22,17,18,193,211
78195,2019-12-22,18,7,158,165
78196,2019-12-22,19,5,121,126
78197,2019-12-22,20,4,107,111
78198,2019-12-22,21,5,59,64
78199,2019-12-22,22,5,55,60
78200,2019-12-22,23,2,40,42
78201,2019-12-23,0,3,21,24
78202,2019-12-23,1,0,4,4
78203,2019-12-23,2,0,2,2
78204,2019-12-23,3,0,1,1
78205,2019-12-23,4,0,10,10
78206,2019-12-23,5,0,28,28
78207,2019-12-23,6,1,117,118
78208,2019-12-23,7,1,201,202
78209,2019-12-23,8,12,380,392
78210,2019-12-23,9,10,307,317
78211,2019-12-23,10,12,173,185
78212,2019-12-23,11,27,210,237
78213,2019-12-23,12,28,257,285
78214,2019-12-23,13,30,260,290
78215,2019-12-23,14,26,306,332
78216,2019-12-23,15,35,354,389
78217,2019-12-23,16,30,424,454
78218,2019-12-23,17,39,430,469
78219,2019-12-23,18,20,261,281
78220,2019-12-23,19,3,159,162
78221,2019-12-23,20,19,123,142
78222,2019-12-23,21,5,79,84
78223,2019-12-23,22,11,62,73
78224,2019-12-23,23,4,41,45
78225,2019-12-24,0,0,20,20
78226,2019-12-24,1,1,11,12
78227,2019-12-24,2,3,6,9
78228,2019-12-24,4,0,4,4
78229,2019-12-24,5,1,11,12
78230,2019-12-24,6,0,43,43
78231,2019-12-24,7,1,80,81
78232,2019-12-24,8,10,157,167
78233,2019-12-24,9,9,184,193
78234,2019-12-24,10,16,207,223
78235,2019-12-24,11,27,250,277
78236,2019-12-24,12,27,229,256
78237,2019-12-24,13,65,280,345
78238,2019-12-24,14,45,234,279
78239,2019-12-24,15,49,254,303
78240,2019-12-24,16,15,177,192
78241,2019-12-24,17,23,146,169
78242,2019-12-24,18,18,102,120
78243,2019-12-24,19,6,69,75
78244,2019-12-24,20,3,54,57
78245,2019-12-24,21,1,40,41
78246,2019-12-24,22,4,22,26
78247,2019-12-24,23,2,31,33
78248,2019-12-25,0,3,19,22
78249,2019-12-25,1,2,3,5
78250,2019-12-25,2,1,6,7
78251,2019-12-25,4,0,2,2
78252,2019-12-25,5,0,4,4
78253,2019-12-25,6,1,21,22
78254,2019-12-25,7,2,37,39
78255,2019-12-25,8,1,43,44
78256,2019-12-25,9,11,66,77
78257,2019-12-25,10,18,95,113
78258,2019-12-25,11,33,123,156
78259,2019-12-25,12,68,148,216
78260,2019-12-25,13,77,132,209
78261,2019-12-25,14,77,153,230
78262,2019-12-25,15,96,178,274
78263,2019-12-25,16,79,170,249
78264,2019-12-25,17,21,61,82
78265,2019-12-25,18,24,56,80
78266,2019-12-25,19,12,49,61
78267,2019-12-25,20,5,34,39
78268,2019-12-25,21,10,24,34
78269,2019-12-25,22,8,17,25
78270,2019-12-25,23,1,14,15
78271,2019-12-26,0,3,8,11
78272,2019-12-26,1,3,4,7
78273,2019-12-26,2,0,3,3
78274,2019-12-26,3,0,1,1
78275,2019-12-26,4,0,6,6
78276,2019-12-26,5,0,14,14
78277,2019-12-26,6,0,55,55
78278,2019-12-26,7,4,114,118
78279,2019-12-26,8,4,179,183
78280,2019-12-26,9,10,207,217
78281,2019-12-26,10,29,167,196
78282,2019-12-26,11,49,197,246
78283,2019-12-26,12,62,211,273
78284,2019-12-26,13,83,212,295
78285,2019-12-26,14,109,228,337
78286,2019-12-26,15,97,279,376
78287,2019-12-26,16,92,317,409
78288,2019-12-26,17,53,280,333
78289,2019-12-26,18,33,180,213
78290,2019-12-26,19,25,140,165
78291,2019-12-26,20,17,105,122
78292,2019-12-26,21,14,72,86
78293,2019-12-26,22,6,52,58
78294,2019-12-26,23,3,45,48
78295,2019-12-27,0,4,16,20
78296,2019-12-27,1,1,8,9
78297,2019-12-27,2,0,7,7
78298,2019-12-27,3,0,2,2
78299,2019-12-27,4,0,8,8
78300,2019-12-27,5,0,27,27
78301,2019-12-27,6,0,90,90
78302,2019-12-27,7,6,154,160
78303,2019-12-27,8,15,250,265
78304,2019-12-27,9,30,224,254
78305,2019-12-27,10,41,224,265
78306,2019-12-27,11,91,234,325
78307,2019-12-27,12,91,262,353
78308,2019-12-27,13,115,248,363
78309,2019-12-27,14,98,295,393
78310,2019-12-27,15,104,346,450
78311,2019-12-27,16,100,374,474
78312,2019-12-27,17,76,385,461
78313,2019-12-27,18,47,289,336
78314,2019-12-27,19,26,201,227
78315,2019-12-27,20,31,105,136
78316,2019-12-27,21,29,101,130
78317,2019-12-27,22,23,73,96
78318,2019-12-27,23,9,54,63
78319,2019-12-28,0,8,41,49
78320,2019-12-28,1,5,25,30
78321,2019-12-28,2,9,14,23
78322,2019-12-28,3,0,7,7
78323,2019-12-28,4,0,7,7
78324,2019-12-28,5,0,8,8
78325,2019-12-28,6,2,24,26
78326,2019-12-28,7,12,48,60
78327,2019-12-28,8,16,112,128
78328,2019-12-28,9,51,211,262
78329,2019-12-28,10,100,324,424
78330,2019-12-28,11,137,389,526
78331,2019-12-28,12,187,426,613
78332,2019-12-28,13,229,409,638
78333,2019-12-28,14,209,471,680
78334,2019-12-28,15,230,520,750
78335,2019-12-28,16,186,454,640
78336,2019-12-28,17,132,346,478
78337,2019-12-28,18,68,205,273
78338,2019-12-28,19,44,173,217
78339,2019-12-28,20,30,107,137
78340,2019-12-28,21,33,101,134
78341,2019-12-28,22,26,76,102
78342,2019-12-28,23,18,51,69
78343,2019-12-29,0,4,53,57
78344,2019-12-29,1,8,39,47
78345,2019-12-29,2,5,17,22
78346,2019-12-29,3,5,9,14
78347,2019-12-29,4,2,2,4
78348,2019-12-29,5,1,9,10
78349,2019-12-29,6,1,17,18
78350,2019-12-29,7,14,46,60
78351,2019-12-29,8,28,91,119
78352,2019-12-29,9,41,175,216
78353,2019-12-29,10,32,121,153
78354,2019-12-29,11,9,67,76
78355,2019-12-29,12,4,54,58
78356,2019-12-29,13,5,53,58
78357,2019-12-29,14,6,75,81
78358,2019-12-29,15,11,58,69
78359,2019-12-29,16,6,70,76
78360,2019-12-29,17,13,39,52
78361,2019-12-29,18,4,36,40
78362,2019-12-29,19,0,50,50
78363,2019-12-29,20,0,40,40
78364,2019-12-29,21,3,21,24
78365,2019-12-29,22,2,32,34
78366,2019-12-29,23,7,24,31
78367,2019-12-30,0,3,13,16
78368,2019-12-30,1,0,3,3
78369,2019-12-30,2,0,3,3
78370,2019-12-30,4,0,10,10
78371,2019-12-30,5,0,44,44
78372,2019-12-30,6,3,115,118
78373,2019-12-30,7,13,241,254
78374,2019-12-30,8,21,430,451
78375,2019-12-30,9,37,317,354
78376,2019-12-30,10,46,182,228
78377,2019-12-30,11,3,97,100
78378,2019-12-30,12,10,105,115
78379,2019-12-30,13,59,256,315
78380,2019-12-30,14,88,308,396
78381,2019-12-30,15,110,393,503
78382,2019-12-30,16,125,528,653
78383,2019-12-30,17,74,563,637
78384,2019-12-30,18,49,405,454
78385,2019-12-30,19,25,271,296
78386,2019-12-30,20,20,173,193
78387,2019-12-30,21,23,110,133
78388,2019-12-30,22,14,81,95
78389,2019-12-30,23,1,47,48
78390,2019-12-31,0,3,23,26
78391,2019-12-31,1,1,11,12
78392,2019-12-31,2,1,5,6
78393,2019-12-31,3,0,2,2
78394,2019-12-31,4,1,6,7
78395,2019-12-31,5,4,43,47
78396,2019-12-31,6,2,106,108
78397,2019-12-31,7,5,245,250
78398,2019-12-31,8,13,459,472
78399,2019-12-31,9,25,328,353
78400,2019-12-31,10,48,233,281
78401,2019-12-31,11,61,304,365
78402,2019-12-31,12,53,346,399
78403,2019-12-31,13,62,358,420
78404,2019-12-31,14,78,452,530
78405,2019-12-31,15,84,543,627
78406,2019-12-31,16,65,502,567
78407,2019-12-31,17,41,345,386
78408,2019-12-31,18,21,253,274
78409,2019-12-31,19,27,153,180
78410,2019-12-31,20,11,124,135
78411,2019-12-31,21,10,101,111
78412,2019-12-31,22,9,71,80
78413,2019-12-31,23,24,83,107
78414,2020-01-01,0,20,86,106
78415,2020-01-01,1,6,114,120
78416,2020-01-01,2,16,86,102
78417,2020-01-01,3,3,37,40
78418,2020-01-01,4,4,11,15
78419,2020-01-01,5,1,13,14
78420,2020-01-01,6,4,23,27
78421,2020-01-01,7,1,44,45
78422,2020-01-01,8,13,62,75
78423,2020-01-01,9,24,112,136
78424,2020-01-01,10,32,170,202
78425,2020-01-01,11,55,231,286
78426,2020-01-01,12,48,264,312
78427,2020-01-01,13,90,294,384
78428,2020-01-01,14,102,310,412
78429,2020-01-01,15,131,346,477
78430,2020-01-01,16,90,316,406
78431,2020-01-01,17,63,261,324
78432,2020-01-01,18,27,176,203
78433,2020-01-01,19,18,131,149
78434,2020-01-01,20,15,90,105
78435,2020-01-01,21,9,80,89
78436,2020-01-01,22,18,67,85
78437,2020-01-01,23,2,19,21
78438,2020-01-02,0,2,17,19
78439,2020-01-02,1,0,5,5
78440,2020-01-02,2,0,2,2
78441,2020-01-02,3,0,2,2
78442,2020-01-02,4,0,10,10
78443,2020-01-02,5,1,48,49
78444,2020-01-02,6,1,161,162
78445,2020-01-02,7,4,405,409
78446,2020-01-02,8,12,721,733
78447,2020-01-02,9,12,402,414
78448,2020-01-02,10,23,207,230
78449,2020-01-02,11,42,287,329
78450,2020-01-02,12,81,308,389
78451,2020-01-02,13,69,305,374
78452,2020-01-02,14,94,332,426
78453,2020-01-02,15,66,364,430
78454,2020-01-02,16,79,588,667
78455,2020-01-02,17,39,815,854
78456,2020-01-02,18,34,580,614
78457,2020-01-02,19,15,312,327
78458,2020-01-02,20,17,176,193
78459,2020-01-02,21,17,143,160
78460,2020-01-02,22,11,95,106
78461,2020-01-02,23,3,62,65
78462,2020-01-03,0,4,20,24
78463,2020-01-03,1,2,9,11
78464,2020-01-03,2,1,1,2
78465,2020-01-03,4,0,5,5
78466,2020-01-03,5,0,25,25
78467,2020-01-03,6,2,74,76
78468,2020-01-03,7,6,309,315
78469,2020-01-03,8,10,694,704
78470,2020-01-03,9,27,380,407
78471,2020-01-03,10,29,256,285
78472,2020-01-03,11,48,290,338
78473,2020-01-03,12,36,291,327
78474,2020-01-03,13,16,228,244
78475,2020-01-03,14,15,190,205
78476,2020-01-03,15,27,270,297
78477,2020-01-03,16,26,377,403
78478,2020-01-03,17,28,460,488
78479,2020-01-03,18,19,300,319
78480,2020-01-03,19,11,210,221
78481,2020-01-03,20,8,124,132
78482,2020-01-03,21,5,103,108
78483,2020-01-03,22,2,71,73
78484,2020-01-03,23,1,38,39
78485,2020-01-04,0,0,40,40
78486,2020-01-04,1,3,20,23
78487,2020-01-04,2,3,9,12
78488,2020-01-04,3,0,7,7
78489,2020-01-04,4,0,5,5
78490,2020-01-04,5,0,17,17
78491,2020-01-04,6,1,25,26
78492,2020-01-04,7,8,82,90
78493,2020-01-04,8,8,162,170
78494,2020-01-04,9,19,221,240
78495,2020-01-04,10,30,306,336
78496,2020-01-04,11,29,402,431
78497,2020-01-04,12,55,397,452
78498,2020-01-04,13,49,415,464
78499,2020-01-04,14,65,389,454
78500,2020-01-04,15,69,330,399
78501,2020-01-04,16,16,118,134
78502,2020-01-04,17,1,81,82
78503,2020-01-04,18,1,57,58
78504,2020-01-04,19,10,128,138
78505,2020-01-04,20,7,127,134
78506,2020-01-04,21,4,79,83
78507,2020-01-04,22,6,76,82
78508,2020-01-04,23,8,94,102
78509,2020-01-05,0,1,68,69
78510,2020-01-05,1,2,36,38
78511,2020-01-05,2,2,18,20
78512,2020-01-05,3,0,10,10
78513,2020-01-05,4,0,4,4
78514,2020-01-05,5,1,11,12
78515,2020-01-05,6,0,13,13
78516,2020-01-05,7,2,48,50
78517,2020-01-05,8,6,108,114
78518,2020-01-05,9,9,181,190
78519,2020-01-05,10,20,275,295
78520,2020-01-05,11,25,311,336
78521,2020-01-05,12,19,365,384
78522,2020-01-05,13,26,366,392
78523,2020-01-05,14,20,313,333
78524,2020-01-05,15,23,327,350
78525,2020-01-05,16,26,323,349
78526,2020-01-05,17,20,235,255
78527,2020-01-05,18,8,205,213
78528,2020-01-05,19,2,147,149
78529,2020-01-05,20,11,112,123
78530,2020-01-05,21,2,79,81
78531,2020-01-05,22,2,41,43
78532,2020-01-05,23,2,37,39
78533,2020-01-06,0,0,20,20
78534,2020-01-06,1,0,7,7
78535,2020-01-06,2,0,1,1
78536,2020-01-06,3,0,3,3
78537,2020-01-06,4,0,11,11
78538,2020-01-06,5,0,73,73
78539,2020-01-06,6,0,231,231
78540,2020-01-06,7,5,595,600
78541,2020-01-06,8,6,969,975
78542,2020-01-06,9,8,413,421
78543,2020-01-06,10,18,170,188
78544,2020-01-06,11,26,185,211
78545,2020-01-06,12,33,270,303
78546,2020-01-06,13,34,237,271
78547,2020-01-06,14,44,239,283
78548,2020-01-06,15,37,359,396
78549,2020-01-06,16,29,518,547
78550,2020-01-06,17,27,971,998
78551,2020-01-06,18,23,736,759
78552,2020-01-06,19,10,441,451
78553,2020-01-06,20,2,240,242
78554,2020-01-06,21,10,178,188
78555,2020-01-06,22,3,75,78
78556,2020-01-06,23,0,53,53
78557,2020-01-07,0,0,19,19
78558,2020-01-07,1,0,6,6
78559,2020-01-07,2,2,2,4
78560,2020-01-07,3,0,2,2
78561,2020-01-07,4,1,9,10
78562,2020-01-07,5,1,93,94
78563,2020-01-07,6,0,282,282
78564,2020-01-07,7,5,645,650
78565,2020-01-07,8,6,1037,1043
78566,2020-01-07,9,7,460,467
78567,2020-01-07,10,8,176,184
78568,2020-01-07,11,9,249,258
78569,2020-01-07,12,10,432,442
78570,2020-01-07,13,8,345,353
78571,2020-01-07,14,3,108,111
78572,2020-01-07,15,2,109,111
78573,2020-01-07,16,1,118,119
78574,2020-01-07,17,1,159,160
78575,2020-01-07,18,1,248,249
78576,2020-01-07,19,2,179,181
78577,2020-01-07,20,2,129,131
78578,2020-01-07,21,1,101,102
78579,2020-01-07,22,2,65,67
78580,2020-01-07,23,2,47,49
78581,2020-01-08,0,3,19,22
78582,2020-01-08,1,0,5,5
78583,2020-01-08,2,0,1,1
78584,2020-01-08,4,1,13,14
78585,2020-01-08,5,2,67,69
78586,2020-01-08,6,1,228,229
78587,2020-01-08,7,0,511,511
78588,2020-01-08,8,9,929,938
78589,2020-01-08,9,5,408,413
78590,2020-01-08,10,5,192,197
78591,2020-01-08,11,6,184,190
78592,2020-01-08,12,13,234,247
78593,2020-01-08,13,12,219,231
78594,2020-01-08,14,15,226,241
78595,2020-01-08,15,8,319,327
78596,2020-01-08,16,11,478,489
78597,2020-01-08,17,19,875,894
78598,2020-01-08,18,8,657,665
78599,2020-01-08,19,0,366,366
78600,2020-01-08,20,2,232,234
78601,2020-01-08,21,1,184,185
78602,2020-01-08,22,3,85,88
78603,2020-01-08,23,1,45,46
78604,2020-01-09,0,0,16,16
78605,2020-01-09,1,1,9,10
78606,2020-01-09,2,0,4,4
78607,2020-01-09,4,0,8,8
78608,2020-01-09,5,2,59,61
78609,2020-01-09,6,1,245,246
78610,2020-01-09,7,2,519,521
78611,2020-01-09,8,9,980,989
78612,2020-01-09,9,5,464,469
78613,2020-01-09,10,7,181,188
78614,2020-01-09,11,7,180,187
78615,2020-01-09,12,22,251,273
78616,2020-01-09,13,11,220,231
78617,2020-01-09,14,21,207,228
78618,2020-01-09,15,13,323,336
78619,2020-01-09,16,18,444,462
78620,2020-01-09,17,8,770,778
78621,2020-01-09,18,8,652,660
78622,2020-01-09,19,3,354,357
78623,2020-01-09,20,1,238,239
78624,2020-01-09,21,0,142,142
78625,2020-01-09,22,1,105,106
78626,2020-01-09,23,2,49,51
78627,2020-01-10,0,2,18,20
78628,2020-01-10,1,2,9,11
78629,2020-01-10,2,0,5,5
78630,2020-01-10,3,1,2,3
78631,2020-01-10,4,0,9,9
78632,2020-01-10,5,1,64,65
78633,2020-01-10,6,1,202,203
78634,2020-01-10,7,3,516,519
78635,2020-01-10,8,11,912,923
78636,2020-01-10,9,8,524,532
78637,2020-01-10,10,7,252,259
78638,2020-01-10,11,29,225,254
78639,2020-01-10,12,45,292,337
78640,2020-01-10,13,39,314,353
78641,2020-01-10,14,31,271,302
78642,2020-01-10,15,22,362,384
78643,2020-01-10,16,29,540,569
78644,2020-01-10,17,19,886,905
78645,2020-01-10,18,16,652,668
78646,2020-01-10,19,21,367,388
78647,2020-01-10,20,9,249,258
78648,2020-01-10,21,13,198,211
78649,2020-01-10,22,7,139,146
78650,2020-01-10,23,3,128,131
78651,2020-01-11,0,10,91,101
78652,2020-01-11,1,4,55,59
78653,2020-01-11,2,5,38,43
78654,2020-01-11,3,2,10,12
78655,2020-01-11,4,0,7,7
78656,2020-01-11,5,1,12,13
78657,2020-01-11,6,1,40,41
78658,2020-01-11,7,5,102,107
78659,2020-01-11,8,12,231,243
78660,2020-01-11,9,17,387,404
78661,2020-01-11,10,39,457,496
78662,2020-01-11,11,81,537,618
78663,2020-01-11,12,118,671,789
78664,2020-01-11,13,126,623,749
78665,2020-01-11,14,195,717,912
78666,2020-01-11,15,165,740,905
78667,2020-01-11,16,156,688,844
78668,2020-01-11,17,76,467,543
78669,2020-01-11,18,42,359,401
78670,2020-01-11,19,36,285,321
78671,2020-01-11,20,27,214,241
78672,2020-01-11,21,27,197,224
78673,2020-01-11,22,41,159,200
78674,2020-01-11,23,23,173,196
78675,2020-01-12,0,9,103,112
78676,2020-01-12,1,3,24,27
78677,2020-01-12,2,1,21,22
78678,2020-01-12,3,0,17,17
78679,2020-01-12,4,1,7,8
78680,2020-01-12,5,0,11,11
78681,2020-01-12,6,2,33,35
78682,2020-01-12,7,6,59,65
78683,2020-01-12,8,21,172,193
78684,2020-01-12,9,41,316,357
78685,2020-01-12,10,80,509,589
78686,2020-01-12,11,62,611,673
78687,2020-01-12,12,142,703,845
78688,2020-01-12,13,156,725,881
78689,2020-01-12,14,188,817,1005
78690,2020-01-12,15,170,838,1008
78691,2020-01-12,16,131,657,788
78692,2020-01-12,17,72,492,564
78693,2020-01-12,18,44,370,414
78694,2020-01-12,19,13,250,263
78695,2020-01-12,20,17,165,182
78696,2020-01-12,21,11,121,132
78697,2020-01-12,22,12,94,106
78698,2020-01-12,23,9,41,50
78699,2020-01-13,0,4,20,24
78700,2020-01-13,1,1,8,9
78701,2020-01-13,2,1,2,3
78702,2020-01-13,3,1,2,3
78703,2020-01-13,4,1,13,14
78704,2020-01-13,5,8,81,89
78705,2020-01-13,6,5,236,241
78706,2020-01-13,7,14,665,679
78707,2020-01-13,8,8,1018,1026
78708,2020-01-13,9,9,465,474
78709,2020-01-13,10,6,259,265
78710,2020-01-13,11,26,256,282
78711,2020-01-13,12,24,301,325
78712,2020-01-13,13,27,292,319
78713,2020-01-13,14,24,286,310
78714,2020-01-13,15,16,397,413
78715,2020-01-13,16,20,601,621
78716,2020-01-13,17,17,1008,1025
78717,2020-01-13,18,10,806,816
78718,2020-01-13,19,17,480,497
78719,2020-01-13,20,17,292,309
78720,2020-01-13,21,10,223,233
78721,2020-01-13,22,7,128,135
78722,2020-01-13,23,8,73,81
78723,2020-01-14,0,2,27,29
78724,2020-01-14,1,2,7,9
78725,2020-01-14,2,0,6,6
78726,2020-01-14,3,0,1,1
78727,2020-01-14,4,0,15,15
78728,2020-01-14,5,1,87,88
78729,2020-01-14,6,2,263,265
78730,2020-01-14,7,5,410,415
78731,2020-01-14,8,13,726,739
78732,2020-01-14,9,6,443,449
78733,2020-01-14,10,4,181,185
78734,2020-01-14,11,6,144,150
78735,2020-01-14,12,8,227,235
78736,2020-01-14,13,18,240,258
78737,2020-01-14,14,7,174,181
78738,2020-01-14,15,5,285,290
78739,2020-01-14,16,11,503,514
78740,2020-01-14,17,24,856,880
78741,2020-01-14,18,14,656,670
78742,2020-01-14,19,8,467,475
78743,2020-01-14,20,3,268,271
78744,2020-01-14,21,12,203,215
78745,2020-01-14,22,6,129,135
78746,2020-01-14,23,2,82,84
78747,2020-01-15,0,7,38,45
78748,2020-01-15,1,2,12,14
78749,2020-01-15,2,0,7,7
78750,2020-01-15,3,2,4,6
78751,2020-01-15,4,1,11,12
78752,2020-01-15,5,3,101,104
78753,2020-01-15,6,3,278,281
78754,2020-01-15,7,10,666,676
78755,2020-01-15,8,17,1213,1230
78756,2020-01-15,9,12,573,585
78757,2020-01-15,10,15,270,285
78758,2020-01-15,11,37,261,298
78759,2020-01-15,12,52,366,418
78760,2020-01-15,13,47,336,383
78761,2020-01-15,14,48,365,413
78762,2020-01-15,15,59,454,513
78763,2020-01-15,16,54,618,672
78764,2020-01-15,17,48,1096,1144
78765,2020-01-15,18,26,806,832
78766,2020-01-15,19,24,507,531
78767,2020-01-15,20,15,339,354
78768,2020-01-15,21,10,240,250
78769,2020-01-15,22,6,143,149
78770,2020-01-15,23,4,75,79
78771,2020-01-16,0,7,25,32
78772,2020-01-16,1,6,9,15
78773,2020-01-16,2,1,4,5
78774,2020-01-16,3,3,3,6
78775,2020-01-16,4,1,9,10
78776,2020-01-16,5,5,79,84
78777,2020-01-16,6,4,270,274
78778,2020-01-16,7,10,695,705
78779,2020-01-16,8,13,1182,1195
78780,2020-01-16,9,18,556,574
78781,2020-01-16,10,14,235,249
78782,2020-01-16,11,24,231,255
78783,2020-01-16,12,21,322,343
78784,2020-01-16,13,25,280,305
78785,2020-01-16,14,22,275,297
78786,2020-01-16,15,18,359,377
78787,2020-01-16,16,20,488,508
78788,2020-01-16,17,13,869,882
78789,2020-01-16,18,11,609,620
78790,2020-01-16,19,2,345,347
78791,2020-01-16,20,3,230,233
78792,2020-01-16,21,4,179,183
78793,2020-01-16,22,2,118,120
78794,2020-01-16,23,4,62,66
78795,2020-01-17,0,3,23,26
78796,2020-01-17,1,0,14,14
78797,2020-01-17,2,3,7,10
78798,2020-01-17,3,0,5,5
78799,2020-01-17,4,0,8,8
78800,2020-01-17,5,1,61,62
78801,2020-01-17,6,1,195,196
78802,2020-01-17,7,3,431,434
78803,2020-01-17,8,13,840,853
78804,2020-01-17,9,7,439,446
78805,2020-01-17,10,12,227,239
78806,2020-01-17,11,29,244,273
78807,2020-01-17,12,31,290,321
78808,2020-01-17,13,23,279,302
78809,2020-01-17,14,23,273,296
78810,2020-01-17,15,38,385,423
78811,2020-01-17,16,24,474,498
78812,2020-01-17,17,13,642,655
78813,2020-01-17,18,9,470,479
78814,2020-01-17,19,4,282,286
78815,2020-01-17,20,4,191,195
78816,2020-01-17,21,4,111,115
78817,2020-01-17,22,5,73,78
78818,2020-01-17,23,4,84,88
78819,2020-01-18,0,2,58,60
78820,2020-01-18,1,2,36,38
78821,2020-01-18,2,2,27,29
78822,2020-01-18,3,0,7,7
78823,2020-01-18,4,0,7,7
78824,2020-01-18,5,0,10,10
78825,2020-01-18,6,2,33,35
78826,2020-01-18,7,0,49,49
78827,2020-01-18,8,1,115,116
78828,2020-01-18,9,8,167,175
78829,2020-01-18,10,7,245,252
78830,2020-01-18,11,17,248,265
78831,2020-01-18,12,5,151,156
78832,2020-01-18,13,18,204,222
78833,2020-01-18,14,21,151,172
78834,2020-01-18,15,5,104,109
78835,2020-01-18,16,4,54,58
78836,2020-01-18,17,3,56,59
78837,2020-01-18,18,1,79,80
78838,2020-01-18,19,6,79,85
78839,2020-01-18,20,4,89,93
78840,2020-01-18,21,2,78,80
78841,2020-01-18,22,2,58,60
78842,2020-01-18,23,6,58,64
78843,2020-01-19,0,4,48,52
78844,2020-01-19,1,2,43,45
78845,2020-01-19,2,4,34,38
78846,2020-01-19,3,5,13,18
78847,2020-01-19,4,2,3,5
78848,2020-01-19,5,0,6,6
78849,2020-01-19,6,1,21,22
78850,2020-01-19,7,6,39,45
78851,2020-01-19,8,3,133,136
78852,2020-01-19,9,9,197,206
78853,2020-01-19,10,22,256,278
78854,2020-01-19,11,49,355,404
78855,2020-01-19,12,39,359,398
78856,2020-01-19,13,61,370,431
78857,2020-01-19,14,37,295,332
78858,2020-01-19,15,40,280,320
78859,2020-01-19,16,40,305,345
78860,2020-01-19,17,23,202,225
78861,2020-01-19,18,11,197,208
78862,2020-01-19,19,14,135,149
78863,2020-01-19,20,2,99,101
78864,2020-01-19,21,2,67,69
78865,2020-01-19,22,5,64,69
78866,2020-01-19,23,1,37,38
78867,2020-01-20,0,2,31,33
78868,2020-01-20,1,1,22,23
78869,2020-01-20,2,0,6,6
78870,2020-01-20,3,0,2,2
78871,2020-01-20,4,0,1,1
78872,2020-01-20,5,0,17,17
78873,2020-01-20,6,0,60,60
78874,2020-01-20,7,4,85,89
78875,2020-01-20,8,3,172,175
78876,2020-01-20,9,6,188,194
78877,2020-01-20,10,4,176,180
78878,2020-01-20,11,15,257,272
78879,2020-01-20,12,20,266,286
78880,2020-01-20,13,14,282,296
78881,2020-01-20,14,17,289,306
78882,2020-01-20,15,17,296,313
78883,2020-01-20,16,14,274,288
78884,2020-01-20,17,16,282,298
78885,2020-01-20,18,7,232,239
78886,2020-01-20,19,1,172,173
78887,2020-01-20,20,6,118,124
78888,2020-01-20,21,2,78,80
78889,2020-01-20,22,1,50,51
78890,2020-01-20,23,0,29,29
78891,2020-01-21,0,2,13,15
78892,2020-01-21,1,1,6,7
78893,2020-01-21,2,0,6,6
78894,2020-01-21,4,0,13,13
78895,2020-01-21,5,0,73,73
78896,2020-01-21,6,0,212,212
78897,2020-01-21,7,1,488,489
78898,2020-01-21,8,3,850,853
78899,2020-01-21,9,1,423,424
78900,2020-01-21,10,2,160,162
78901,2020-01-21,11,9,137,146
78902,2020-01-21,12,6,200,206
78903,2020-01-21,13,5,200,205
78904,2020-01-21,14,19,212,231
78905,2020-01-21,15,15,275,290
78906,2020-01-21,16,3,426,429
78907,2020-01-21,17,12,772,784
78908,2020-01-21,18,5,610,615
78909,2020-01-21,19,1,321,322
78910,2020-01-21,20,1,241,242
78911,2020-01-21,21,1,152,153
78912,2020-01-21,22,3,87,90
78913,2020-01-21,23,0,37,37
78914,2020-01-22,0,0,14,14
78915,2020-01-22,1,0,4,4
78916,2020-01-22,2,0,2,2
78917,2020-01-22,3,0,3,3
78918,2020-01-22,4,0,8,8
78919,2020-01-22,5,0,86,86
78920,2020-01-22,6,0,243,243
78921,2020-01-22,7,3,536,539
78922,2020-01-22,8,9,976,985
78923,2020-01-22,9,8,462,470
78924,2020-01-22,10,3,175,178
78925,2020-01-22,11,13,178,191
78926,2020-01-22,12,14,229,243
78927,2020-01-22,13,11,253,264
78928,2020-01-22,14,17,197,214
78929,2020-01-22,15,13,338,351
78930,2020-01-22,16,12,465,477
78931,2020-01-22,17,12,899,911
78932,2020-01-22,18,8,630,638
78933,2020-01-22,19,5,376,381
78934,2020-01-22,20,4,271,275
78935,2020-01-22,21,2,176,178
78936,2020-01-22,22,1,103,104
78937,2020-01-22,23,0,60,60
78938,2020-01-23,0,0,11,11
78939,2020-01-23,1,1,6,7
78940,2020-01-23,2,2,1,3
78941,2020-01-23,3,0,2,2
78942,2020-01-23,4,0,10,10
78943,2020-01-23,5,0,68,68
78944,2020-01-23,6,1,228,229
78945,2020-01-23,7,6,530,536
78946,2020-01-23,8,6,1013,1019
78947,2020-01-23,9,19,499,518
78948,2020-01-23,10,16,223,239
78949,2020-01-23,11,12,233,245
78950,2020-01-23,12,33,258,291
78951,2020-01-23,13,19,195,214
78952,2020-01-23,14,24,228,252
78953,2020-01-23,15,30,330,360
78954,2020-01-23,16,22,476,498
78955,2020-01-23,17,20,897,917
78956,2020-01-23,18,21,671,692
78957,2020-01-23,19,19,452,471
78958,2020-01-23,20,13,286,299
78959,2020-01-23,21,7,188,195
78960,2020-01-23,22,9,128,137
78961,2020-01-23,23,4,68,72
78962,2020-01-24,0,7,26,33
78963,2020-01-24,1,0,12,12
78964,2020-01-24,2,0,1,1
78965,2020-01-24,3,1,1,2
78966,2020-01-24,4,0,10,10
78967,2020-01-24,5,0,72,72
78968,2020-01-24,6,1,216,217
78969,2020-01-24,7,3,521,524
78970,2020-01-24,8,8,986,994
78971,2020-01-24,9,17,570,587
78972,2020-01-24,10,23,285,308
78973,2020-01-24,11,25,271,296
78974,2020-01-24,12,27,343,370
78975,2020-01-24,13,26,351,377
78976,2020-01-24,14,24,277,301
78977,2020-01-24,15,51,394,445
78978,2020-01-24,16,43,568,611
78979,2020-01-24,17,36,899,935
78980,2020-01-24,18,25,652,677
78981,2020-01-24,19,8,419,427
78982,2020-01-24,20,6,239,245
78983,2020-01-24,21,7,205,212
78984,2020-01-24,22,13,136,149
78985,2020-01-24,23,6,102,108
78986,2020-01-25,0,1,45,46
78987,2020-01-25,1,1,19,20
78988,2020-01-25,2,0,6,6
78989,2020-01-25,3,0,5,5
78990,2020-01-25,4,0,2,2
78991,2020-01-25,5,0,5,5
78992,2020-01-25,6,2,14,16
78993,2020-01-25,7,0,37,37
78994,2020-01-25,8,7,123,130
78995,2020-01-25,9,5,226,231
78996,2020-01-25,10,12,299,311
78997,2020-01-25,11,24,385,409
78998,2020-01-25,12,32,443,475
78999,2020-01-25,13,44,396,440
79000,2020-01-25,14,35,374,409
79001,2020-01-25,15,62,444,506
79002,2020-01-25,16,71,410,481
79003,2020-01-25,17,34,378,412
79004,2020-01-25,18,22,295,317
79005,2020-01-25,19,24,215,239
79006,2020-01-25,20,6,189,195
79007,2020-01-25,21,10,114,124
79008,2020-01-25,22,11,105,116
79009,2020-01-25,23,6,108,114
79010,2020-01-26,0,3,79,82
79011,2020-01-26,1,3,63,66
79012,2020-01-26,2,6,36,42
79013,2020-01-26,3,1,19,20
79014,2020-01-26,4,0,5,5
79015,2020-01-26,5,0,14,14
79016,2020-01-26,6,0,24,24
79017,2020-01-26,7,0,63,63
79018,2020-01-26,8,15,123,138
79019,2020-01-26,9,26,251,277
79020,2020-01-26,10,42,404,446
79021,2020-01-26,11,34,461,495
79022,2020-01-26,12,60,483,543
79023,2020-01-26,13,70,469,539
79024,2020-01-26,14,47,404,451
79025,2020-01-26,15,34,413,447
79026,2020-01-26,16,89,391,480
79027,2020-01-26,17,42,312,354
79028,2020-01-26,18,12,266,278
79029,2020-01-26,19,8,167,175
79030,2020-01-26,20,1,115,116
79031,2020-01-26,21,1,101,102
79032,2020-01-26,22,2,51,53
79033,2020-01-26,23,1,30,31
79034,2020-01-27,0,0,14,14
79035,2020-01-27,1,0,12,12
79036,2020-01-27,2,0,3,3
79037,2020-01-27,3,0,1,1
79038,2020-01-27,4,0,6,6
79039,2020-01-27,5,1,81,82
79040,2020-01-27,6,2,229,231
79041,2020-01-27,7,4,521,525
79042,2020-01-27,8,7,1033,1040
79043,2020-01-27,9,7,490,497
79044,2020-01-27,10,21,217,238
79045,2020-01-27,11,20,236,256
79046,2020-01-27,12,18,260,278
79047,2020-01-27,13,18,276,294
79048,2020-01-27,14,12,213,225
79049,2020-01-27,15,13,332,345
79050,2020-01-27,16,8,505,513
79051,2020-01-27,17,11,910,921
79052,2020-01-27,18,9,696,705
79053,2020-01-27,19,6,396,402
79054,2020-01-27,20,4,271,275
79055,2020-01-27,21,6,171,177
79056,2020-01-27,22,9,99,108
79057,2020-01-27,23,0,44,44
79058,2020-01-28,0,1,16,17
79059,2020-01-28,1,0,5,5
79060,2020-01-28,2,0,3,3
79061,2020-01-28,3,0,3,3
79062,2020-01-28,4,0,13,13
79063,2020-01-28,5,0,86,86
79064,2020-01-28,6,1,255,256
79065,2020-01-28,7,5,662,667
79066,2020-01-28,8,11,1105,1116
79067,2020-01-28,9,14,539,553
79068,2020-01-28,10,8,226,234
79069,2020-01-28,11,9,231,240
79070,2020-01-28,12,21,281,302
79071,2020-01-28,13,16,255,271
79072,2020-01-28,14,18,237,255
79073,2020-01-28,15,9,347,356
79074,2020-01-28,16,19,495,514
79075,2020-01-28,17,18,923,941
79076,2020-01-28,18,6,675,681
79077,2020-01-28,19,7,400,407
79078,2020-01-28,20,4,253,257
79079,2020-01-28,21,2,175,177
79080,2020-01-28,22,9,130,139
79081,2020-01-28,23,9,72,81
79082,2020-01-29,0,11,27,38
79083,2020-01-29,1,0,9,9
79084,2020-01-29,2,1,1,2
79085,2020-01-29,4,0,8,8
79086,2020-01-29,5,1,83,84
79087,2020-01-29,6,2,285,287
79088,2020-01-29,7,6,659,665
79089,2020-01-29,8,9,1060,1069
79090,2020-01-29,9,6,550,556
79091,2020-01-29,10,3,212,215
79092,2020-01-29,11,7,219,226
79093,2020-01-29,12,12,275,287
79094,2020-01-29,13,18,257,275
79095,2020-01-29,14,25,274,299
79096,2020-01-29,15,20,340,360
79097,2020-01-29,16,23,531,554
79098,2020-01-29,17,19,988,1007
79099,2020-01-29,18,11,738,749
79100,2020-01-29,19,10,399,409
79101,2020-01-29,20,15,273,288
79102,2020-01-29,21,7,246,253
79103,2020-01-29,22,3,176,179
79104,2020-01-29,23,5,63,68
79105,2020-01-30,0,2,21,23
79106,2020-01-30,1,1,5,6
79107,2020-01-30,2,0,5,5
79108,2020-01-30,3,0,2,2
79109,2020-01-30,4,0,13,13
79110,2020-01-30,5,0,75,75
79111,2020-01-30,6,1,235,236
79112,2020-01-30,7,7,540,547
79113,2020-01-30,8,11,1042,1053
79114,2020-01-30,9,14,514,528
79115,2020-01-30,10,21,213,234
79116,2020-01-30,11,15,228,243
79117,2020-01-30,12,19,287,306
79118,2020-01-30,13,8,253,261
79119,2020-01-30,14,29,262,291
79120,2020-01-30,15,34,356,390
79121,2020-01-30,16,25,486,511
79122,2020-01-30,17,25,833,858
79123,2020-01-30,18,6,696,702
79124,2020-01-30,19,10,409,419
79125,2020-01-30,20,5,263,268
79126,2020-01-30,21,8,199,207
79127,2020-01-30,22,4,115,119
79128,2020-01-30,23,2,73,75
79129,2020-01-31,0,0,35,35
79130,2020-01-31,1,0,10,10
79131,2020-01-31,2,0,9,9
79132,2020-01-31,3,1,3,4
79133,2020-01-31,4,0,9,9
79134,2020-01-31,5,1,69,70
79135,2020-01-31,6,2,180,182
79136,2020-01-31,7,2,510,512
79137,2020-01-31,8,13,977,990
79138,2020-01-31,9,18,516,534
79139,2020-01-31,10,18,251,269
79140,2020-01-31,11,14,252,266
79141,2020-01-31,12,20,307,327
79142,2020-01-31,13,17,304,321
79143,2020-01-31,14,20,297,317
79144,2020-01-31,15,23,373,396
79145,2020-01-31,16,11,521,532
79146,2020-01-31,17,9,599,608
79147,2020-01-31,18,7,509,516
79148,2020-01-31,19,22,391,413
79149,2020-01-31,20,8,248,256
79150,2020-01-31,21,11,187,198
79151,2020-01-31,22,4,121,125
79152,2020-01-31,23,3,110,113
79153,2020-02-01,0,2,65,67
79154,2020-02-01,1,2,50,52
79155,2020-02-01,2,0,19,19
79156,2020-02-01,3,0,12,12
79157,2020-02-01,4,1,8,9
79158,2020-02-01,5,0,17,17
79159,2020-02-01,6,3,31,34
79160,2020-02-01,7,0,69,69
79161,2020-02-01,8,14,219,233
79162,2020-02-01,9,18,330,348
79163,2020-02-01,10,29,411,440
79164,2020-02-01,11,31,432,463
79165,2020-02-01,12,51,466,517
79166,2020-02-01,13,71,520,591
79167,2020-02-01,14,70,514,584
79168,2020-02-01,15,104,514,618
79169,2020-02-01,16,92,483,575
79170,2020-02-01,17,51,350,401
79171,2020-02-01,18,11,234,245
79172,2020-02-01,19,9,117,126
79173,2020-02-01,20,5,68,73
79174,2020-02-01,21,1,61,62
79175,2020-02-01,22,8,81,89
79176,2020-02-01,23,1,71,72
79177,2020-02-02,0,7,84,91
79178,2020-02-02,1,4,47,51
79179,2020-02-02,2,1,38,39
79180,2020-02-02,3,2,18,20
79181,2020-02-02,4,1,6,7
79182,2020-02-02,5,0,11,11
79183,2020-02-02,6,0,20,20
79184,2020-02-02,7,6,57,63
79185,2020-02-02,8,7,145,152
79186,2020-02-02,9,14,272,286
79187,2020-02-02,10,33,337,370
79188,2020-02-02,11,30,292,322
79189,2020-02-02,12,42,402,444
79190,2020-02-02,13,59,435,494
79191,2020-02-02,14,53,425,478
79192,2020-02-02,15,60,453,513
79193,2020-02-02,16,62,423,485
79194,2020-02-02,17,31,422,453
79195,2020-02-02,18,25,329,354
79196,2020-02-02,19,5,130,135
79197,2020-02-02,20,3,115,118
79198,2020-02-02,21,8,80,88
79199,2020-02-02,22,9,204,213
79200,2020-02-02,23,5,77,82
79201,2020-02-03,0,1,19,20
79202,2020-02-03,1,0,8,8
79203,2020-02-03,2,0,6,6
79204,2020-02-03,3,0,3,3
79205,2020-02-03,4,0,11,11
79206,2020-02-03,5,0,80,80
79207,2020-02-03,6,0,226,226
79208,2020-02-03,7,3,633,636
79209,2020-02-03,8,12,1137,1149
79210,2020-02-03,9,11,502,513
79211,2020-02-03,10,14,231,245
79212,2020-02-03,11,21,250,271
79213,2020-02-03,12,42,306,348
79214,2020-02-03,13,37,320,357
79215,2020-02-03,14,37,320,357
79216,2020-02-03,15,51,416,467
79217,2020-02-03,16,51,648,699
79218,2020-02-03,17,50,1124,1174
79219,2020-02-03,18,18,860,878
79220,2020-02-03,19,19,525,544
79221,2020-02-03,20,10,313,323
79222,2020-02-03,21,18,219,237
79223,2020-02-03,22,9,117,126
79224,2020-02-03,23,5,59,64
79225,2020-02-04,0,1,38,39
79226,2020-02-04,1,3,8,11
79227,2020-02-04,2,0,7,7
79228,2020-02-04,3,1,4,5
79229,2020-02-04,4,0,15,15
79230,2020-02-04,5,1,74,75
79231,2020-02-04,6,0,204,204
79232,2020-02-04,7,2,523,525
79233,2020-02-04,8,4,633,637
79234,2020-02-04,9,10,520,530
79235,2020-02-04,10,12,201,213
79236,2020-02-04,11,9,267,276
79237,2020-02-04,12,24,297,321
79238,2020-02-04,13,48,269,317
79239,2020-02-04,14,29,262,291
79240,2020-02-04,15,37,425,462
79241,2020-02-04,16,46,634,680
79242,2020-02-04,17,30,1175,1205
79243,2020-02-04,18,21,893,914
79244,2020-02-04,19,16,561,577
79245,2020-02-04,20,23,366,389
79246,2020-02-04,21,7,265,272
79247,2020-02-04,22,6,160,166
79248,2020-02-04,23,1,69,70
79249,2020-02-05,0,1,33,34
79250,2020-02-05,1,2,13,15
79251,2020-02-05,2,0,4,4
79252,2020-02-05,3,2,4,6
79253,2020-02-05,4,0,14,14
79254,2020-02-05,5,1,103,104
79255,2020-02-05,6,6,288,294
79256,2020-02-05,7,9,672,681
79257,2020-02-05,8,14,1063,1077
79258,2020-02-05,9,7,484,491
79259,2020-02-05,10,5,208,213
79260,2020-02-05,11,9,185,194
79261,2020-02-05,12,5,189,194
79262,2020-02-05,13,3,206,209
79263,2020-02-05,14,10,180,190
79264,2020-02-05,15,11,286,297
79265,2020-02-05,16,22,481,503
79266,2020-02-05,17,16,887,903
79267,2020-02-05,18,5,696,701
79268,2020-02-05,19,6,388,394
79269,2020-02-05,20,3,144,147
79270,2020-02-05,21,1,124,125
79271,2020-02-05,22,1,57,58
79272,2020-02-05,23,1,28,29
79273,2020-02-06,0,0,18,18
79274,2020-02-06,1,6,5,11
79275,2020-02-06,2,0,3,3
79276,2020-02-06,3,0,2,2
79277,2020-02-06,4,0,14,14
79278,2020-02-06,5,0,74,74
79279,2020-02-06,6,2,205,207
79280,2020-02-06,7,3,513,516
79281,2020-02-06,8,12,954,966
79282,2020-02-06,9,8,403,411
79283,2020-02-06,10,0,119,119
79284,2020-02-06,11,0,66,66
79285,2020-02-06,12,0,62,62
79286,2020-02-06,13,1,57,58
79287,2020-02-06,14,1,30,31
79288,2020-02-06,15,2,76,78
79289,2020-02-06,16,4,172,176
79290,2020-02-06,17,4,564,568
79291,2020-02-06,18,3,335,338
79292,2020-02-06,19,1,156,157
79293,2020-02-06,20,2,153,155
79294,2020-02-06,21,1,109,110
79295,2020-02-06,22,1,76,77
79296,2020-02-06,23,1,39,40
79297,2020-02-07,0,0,9,9
79298,2020-02-07,1,1,10,11
79299,2020-02-07,2,0,5,5
79300,2020-02-07,3,0,2,2
79301,2020-02-07,4,0,13,13
79302,2020-02-07,5,0,53,53
79303,2020-02-07,6,0,133,133
79304,2020-02-07,7,3,344,347
79305,2020-02-07,8,8,334,342
79306,2020-02-07,9,2,93,95
79307,2020-02-07,10,5,123,128
79308,2020-02-07,11,13,223,236
79309,2020-02-07,12,7,294,301
79310,2020-02-07,13,15,270,285
79311,2020-02-07,14,24,240,264
79312,2020-02-07,15,32,334,366
79313,2020-02-07,16,33,471,504
79314,2020-02-07,17,16,753,769
79315,2020-02-07,18,18,510,528
79316,2020-02-07,19,8,319,327
79317,2020-02-07,20,6,170,176
79318,2020-02-07,21,10,138,148
79319,2020-02-07,22,4,97,101
79320,2020-02-07,23,0,68,68
79321,2020-02-08,0,0,60,60
79322,2020-02-08,1,3,33,36
79323,2020-02-08,2,1,17,18
79324,2020-02-08,3,1,7,8
79325,2020-02-08,4,0,8,8
79326,2020-02-08,5,1,12,13
79327,2020-02-08,6,1,30,31
79328,2020-02-08,7,1,94,95
79329,2020-02-08,8,11,178,189
79330,2020-02-08,9,16,299,315
79331,2020-02-08,10,31,336,367
79332,2020-02-08,11,27,422,449
79333,2020-02-08,12,74,455,529
79334,2020-02-08,13,59,403,462
79335,2020-02-08,14,73,475,548
79336,2020-02-08,15,69,419,488
79337,2020-02-08,16,61,392,453
79338,2020-02-08,17,68,412,480
79339,2020-02-08,18,14,298,312
79340,2020-02-08,19,10,224,234
79341,2020-02-08,20,23,164,187
79342,2020-02-08,21,13,115,128
79343,2020-02-08,22,12,108,120
79344,2020-02-08,23,5,98,103
79345,2020-02-09,0,7,72,79
79346,2020-02-09,1,0,42,42
79347,2020-02-09,2,2,32,34
79348,2020-02-09,3,1,11,12
79349,2020-02-09,4,0,12,12
79350,2020-02-09,5,0,14,14
79351,2020-02-09,6,0,18,18
79352,2020-02-09,7,7,65,72
79353,2020-02-09,8,8,145,153
79354,2020-02-09,9,19,229,248
79355,2020-02-09,10,42,348,390
79356,2020-02-09,11,56,415,471
79357,2020-02-09,12,88,510,598
79358,2020-02-09,13,110,492,602
79359,2020-02-09,14,113,538,651
79360,2020-02-09,15,92,479,571
79361,2020-02-09,16,74,452,526
79362,2020-02-09,17,54,398,452
79363,2020-02-09,18,20,273,293
79364,2020-02-09,19,21,215,236
79365,2020-02-09,20,5,148,153
79366,2020-02-09,21,8,91,99
79367,2020-02-09,22,2,64,66
79368,2020-02-09,23,1,66,67
79369,2020-02-10,0,2,20,22
79370,2020-02-10,1,1,4,5
79371,2020-02-10,2,1,2,3
79372,2020-02-10,3,0,1,1
79373,2020-02-10,4,0,13,13
79374,2020-02-10,5,2,78,80
79375,2020-02-10,6,0,189,189
79376,2020-02-10,7,1,229,230
79377,2020-02-10,8,2,333,335
79378,2020-02-10,9,5,214,219
79379,2020-02-10,10,9,118,127
79380,2020-02-10,11,10,117,127
79381,2020-02-10,12,9,156,165
79382,2020-02-10,13,7,98,105
79383,2020-02-10,14,1,61,62
79384,2020-02-10,15,9,108,117
79385,2020-02-10,16,5,250,255
79386,2020-02-10,17,2,312,314
79387,2020-02-10,18,1,233,234
79388,2020-02-10,19,3,210,213
79389,2020-02-10,20,4,179,183
79390,2020-02-10,21,2,149,151
79391,2020-02-10,22,3,90,93
79392,2020-02-10,23,0,27,27
79393,2020-02-11,0,0,10,10
79394,2020-02-11,1,0,4,4
79395,2020-02-11,2,1,2,3
79396,2020-02-11,3,0,1,1
79397,2020-02-11,4,0,12,12
79398,2020-02-11,5,0,42,42
79399,2020-02-11,6,0,102,102
79400,2020-02-11,7,2,411,413
79401,2020-02-11,8,13,608,621
79402,2020-02-11,9,5,218,223
79403,2020-02-11,10,8,90,98
79404,2020-02-11,11,7,79,86
79405,2020-02-11,12,5,117,122
79406,2020-02-11,13,10,155,165
79407,2020-02-11,14,16,187,203
79408,2020-02-11,15,21,301,322
79409,2020-02-11,16,9,541,550
79410,2020-02-11,17,13,950,963
79411,2020-02-11,18,19,795,814
79412,2020-02-11,19,8,422,430
79413,2020-02-11,20,7,289,296
79414,2020-02-11,21,6,267,273
79415,2020-02-11,22,5,104,109
79416,2020-02-11,23,5,66,71
79417,2020-02-12,0,2,33,35
79418,2020-02-12,1,0,7,7
79419,2020-02-12,2,0,5,5
79420,2020-02-12,3,0,1,1
79421,2020-02-12,4,0,10,10
79422,2020-02-12,5,1,95,96
79423,2020-02-12,6,1,267,268
79424,2020-02-12,7,8,632,640
79425,2020-02-12,8,7,1120,1127
79426,2020-02-12,9,5,529,534
79427,2020-02-12,10,8,237,245
79428,2020-02-12,11,6,226,232
79429,2020-02-12,12,5,306,311
79430,2020-02-12,13,24,318,342
79431,2020-02-12,14,16,246,262
79432,2020-02-12,15,18,336,354
79433,2020-02-12,16,7,440,447
79434,2020-02-12,17,8,725,733
79435,2020-02-12,18,1,351,352
79436,2020-02-12,19,4,197,201
79437,2020-02-12,20,0,149,149
79438,2020-02-12,21,1,180,181
79439,2020-02-12,22,1,112,113
79440,2020-02-12,23,2,61,63
79441,2020-02-13,0,0,20,20
79442,2020-02-13,1,0,5,5
79443,2020-02-13,2,0,2,2
79444,2020-02-13,3,0,4,4
79445,2020-02-13,4,0,15,15
79446,2020-02-13,5,0,66,66
79447,2020-02-13,6,0,120,120
79448,2020-02-13,7,2,216,218
79449,2020-02-13,8,3,421,424
79450,2020-02-13,9,1,165,166
79451,2020-02-13,10,1,111,112
79452,2020-02-13,11,2,131,133
79453,2020-02-13,12,5,202,207
79454,2020-02-13,13,8,212,220
79455,2020-02-13,14,5,132,137
79456,2020-02-13,15,7,307,314
79457,2020-02-13,16,6,448,454
79458,2020-02-13,17,10,867,877
79459,2020-02-13,18,13,682,695
79460,2020-02-13,19,6,403,409
79461,2020-02-13,20,3,286,289
79462,2020-02-13,21,6,188,194
79463,2020-02-13,22,1,115,116
79464,2020-02-13,23,2,52,54
79465,2020-02-14,0,1,35,36
79466,2020-02-14,1,1,21,22
79467,2020-02-14,2,0,6,6
79468,2020-02-14,3,0,1,1
79469,2020-02-14,4,0,8,8
79470,2020-02-14,5,0,55,55
79471,2020-02-14,6,1,184,185
79472,2020-02-14,7,5,432,437
79473,2020-02-14,8,9,810,819
79474,2020-02-14,9,5,496,501
79475,2020-02-14,10,8,219,227
79476,2020-02-14,11,17,257,274
79477,2020-02-14,12,18,271,289
79478,2020-02-14,13,24,280,304
79479,2020-02-14,14,10,265,275
79480,2020-02-14,15,18,365,383
79481,2020-02-14,16,22,434,456
79482,2020-02-14,17,22,647,669
79483,2020-02-14,18,6,411,417
79484,2020-02-14,19,2,247,249
79485,2020-02-14,20,2,125,127
79486,2020-02-14,21,0,77,77
79487,2020-02-14,22,1,57,58
79488,2020-02-14,23,1,48,49
79489,2020-02-15,0,1,23,24
79490,2020-02-15,1,0,25,25
79491,2020-02-15,2,0,14,14
79492,2020-02-15,3,0,9,9
79493,2020-02-15,4,1,4,5
79494,2020-02-15,5,0,14,14
79495,2020-02-15,6,0,27,27
79496,2020-02-15,7,1,62,63
79497,2020-02-15,8,2,122,124
79498,2020-02-15,9,7,186,193
79499,2020-02-15,10,19,235,254
79500,2020-02-15,11,24,292,316
79501,2020-02-15,12,32,296,328
79502,2020-02-15,13,38,338,376
79503,2020-02-15,14,44,336,380
79504,2020-02-15,15,49,342,391
79505,2020-02-15,16,40,269,309
79506,2020-02-15,17,30,226,256
79507,2020-02-15,18,18,187,205
79508,2020-02-15,19,9,147,156
79509,2020-02-15,20,10,110,120
79510,2020-02-15,21,3,92,95
79511,2020-02-15,22,0,57,57
79512,2020-02-15,23,3,53,56
79513,2020-02-16,0,0,39,39
79514,2020-02-16,1,2,30,32
79515,2020-02-16,2,2,36,38
79516,2020-02-16,3,1,14,15
79517,2020-02-16,4,3,8,11
79518,2020-02-16,5,2,11,13
79519,2020-02-16,6,2,23,25
79520,2020-02-16,7,2,43,45
79521,2020-02-16,8,7,111,118
79522,2020-02-16,9,15,190,205
79523,2020-02-16,10,35,250,285
79524,2020-02-16,11,39,326,365
79525,2020-02-16,12,69,381,450
79526,2020-02-16,13,86,444,530
79527,2020-02-16,14,134,438,572
79528,2020-02-16,15,91,411,502
79529,2020-02-16,16,86,407,493
79530,2020-02-16,17,52,339,391
79531,2020-02-16,18,28,282,310
79532,2020-02-16,19,13,193,206
79533,2020-02-16,20,7,165,172
79534,2020-02-16,21,8,90,98
79535,2020-02-16,22,13,84,97
79536,2020-02-16,23,3,61,64
79537,2020-02-17,0,1,44,45
79538,2020-02-17,1,1,23,24
79539,2020-02-17,2,1,11,12
79540,2020-02-17,3,0,10,10
79541,2020-02-17,4,0,4,4
79542,2020-02-17,5,0,28,28
79543,2020-02-17,6,0,64,64
79544,2020-02-17,7,5,132,137
79545,2020-02-17,8,13,272,285
79546,2020-02-17,9,16,281,297
79547,2020-02-17,10,27,282,309
79548,2020-02-17,11,69,339,408
79549,2020-02-17,12,81,424,505
79550,2020-02-17,13,108,452,560
79551,2020-02-17,14,144,447,591
79552,2020-02-17,15,115,472,587
79553,2020-02-17,16,84,502,586
79554,2020-02-17,17,53,497,550
79555,2020-02-17,18,25,359,384
79556,2020-02-17,19,12,260,272
79557,2020-02-17,20,11,186,197
79558,2020-02-17,21,11,96,107
79559,2020-02-17,22,2,83,85
79560,2020-02-17,23,1,52,53
79561,2020-02-18,0,0,17,17
79562,2020-02-18,1,1,15,16
79563,2020-02-18,2,0,3,3
79564,2020-02-18,3,0,3,3
79565,2020-02-18,4,0,15,15
79566,2020-02-18,5,0,69,69
79567,2020-02-18,6,0,299,299
79568,2020-02-18,7,5,623,628
79569,2020-02-18,8,12,963,975
79570,2020-02-18,9,13,469,482
79571,2020-02-18,10,28,195,223
79572,2020-02-18,11,16,239,255
79573,2020-02-18,12,25,282,307
79574,2020-02-18,13,22,270,292
79575,2020-02-18,14,32,268,300
79576,2020-02-18,15,36,356,392
79577,2020-02-18,16,36,535,571
79578,2020-02-18,17,24,950,974
79579,2020-02-18,18,25,783,808
79580,2020-02-18,19,19,456,475
79581,2020-02-18,20,10,271,281
79582,2020-02-18,21,13,207,220
79583,2020-02-18,22,5,107,112
79584,2020-02-18,23,3,71,74
79585,2020-02-19,0,1,29,30
79586,2020-02-19,1,0,9,9
79587,2020-02-19,2,0,3,3
79588,2020-02-19,3,0,3,3
79589,2020-02-19,4,0,13,13
79590,2020-02-19,5,0,83,83
79591,2020-02-19,6,1,276,277
79592,2020-02-19,7,4,608,612
79593,2020-02-19,8,9,1069,1078
79594,2020-02-19,9,11,485,496
79595,2020-02-19,10,18,204,222
79596,2020-02-19,11,15,214,229
79597,2020-02-19,12,15,250,265
79598,2020-02-19,13,28,230,258
79599,2020-02-19,14,37,248,285
79600,2020-02-19,15,27,333,360
79601,2020-02-19,16,30,529,559
79602,2020-02-19,17,21,931,952
79603,2020-02-19,18,23,769,792
79604,2020-02-19,19,3,462,465
79605,2020-02-19,20,4,309,313
79606,2020-02-19,21,7,178,185
79607,2020-02-19,22,5,105,110
79608,2020-02-19,23,5,71,76
79609,2020-02-20,0,0,26,26
79610,2020-02-20,1,1,16,17
79611,2020-02-20,2,0,4,4
79612,2020-02-20,3,0,4,4
79613,2020-02-20,4,0,15,15
79614,2020-02-20,5,1,74,75
79615,2020-02-20,6,1,215,216
79616,2020-02-20,7,1,560,561
79617,2020-02-20,8,8,953,961
79618,2020-02-20,9,5,504,509
79619,2020-02-20,10,12,206,218
79620,2020-02-20,11,18,223,241
79621,2020-02-20,12,26,243,269
79622,2020-02-20,13,17,205,222
79623,2020-02-20,14,24,220,244
79624,2020-02-20,15,29,299,328
79625,2020-02-20,16,21,412,433
79626,2020-02-20,17,16,831,847
79627,2020-02-20,18,13,649,662
79628,2020-02-20,19,6,336,342
79629,2020-02-20,20,2,263,265
79630,2020-02-20,21,5,215,220
79631,2020-02-20,22,1,98,99
79632,2020-02-20,23,2,53,55
79633,2020-02-21,0,1,17,18
79634,2020-02-21,1,0,4,4
79635,2020-02-21,2,2,7,9
79636,2020-02-21,3,0,8,8
79637,2020-02-21,4,0,8,8
79638,2020-02-21,5,3,55,58
79639,2020-02-21,6,2,182,184
79640,2020-02-21,7,2,361,363
79641,2020-02-21,8,10,696,706
79642,2020-02-21,9,6,433,439
79643,2020-02-21,10,15,214,229
79644,2020-02-21,11,8,177,185
79645,2020-02-21,12,21,246,267
79646,2020-02-21,13,30,254,284
79647,2020-02-21,14,35,260,295
79648,2020-02-21,15,27,331,358
79649,2020-02-21,16,23,427,450
79650,2020-02-21,17,44,724,768
79651,2020-02-21,18,20,459,479
79652,2020-02-21,19,10,272,282
79653,2020-02-21,20,6,188,194
79654,2020-02-21,21,0,133,133
79655,2020-02-21,22,3,87,90
79656,2020-02-21,23,3,69,72
79657,2020-02-22,0,2,44,46
79658,2020-02-22,1,0,35,35
79659,2020-02-22,2,3,19,22
79660,2020-02-22,3,0,14,14
79661,2020-02-22,4,0,4,4
79662,2020-02-22,5,0,11,11
79663,2020-02-22,6,4,31,35
79664,2020-02-22,7,7,80,87
79665,2020-02-22,8,10,174,184
79666,2020-02-22,9,9,260,269
79667,2020-02-22,10,35,344,379
79668,2020-02-22,11,55,466,521
79669,2020-02-22,12,75,516,591
79670,2020-02-22,13,107,516,623
79671,2020-02-22,14,162,528,690
79672,2020-02-22,15,134,578,712
79673,2020-02-22,16,126,479,605
79674,2020-02-22,17,106,410,516
79675,2020-02-22,18,47,353,400
79676,2020-02-22,19,15,235,250
79677,2020-02-22,20,19,194,213
79678,2020-02-22,21,17,146,163
79679,2020-02-22,22,2,142,144
79680,2020-02-22,23,1,111,112
79681,2020-02-23,0,9,94,103
79682,2020-02-23,1,8,53,61
79683,2020-02-23,2,1,37,38
79684,2020-02-23,3,0,15,15
79685,2020-02-23,4,0,6,6
79686,2020-02-23,5,1,15,16
79687,2020-02-23,6,0,27,27
79688,2020-02-23,7,5,43,48
79689,2020-02-23,8,20,149,169
79690,2020-02-23,9,39,279,318
79691,2020-02-23,10,70,386,456
79692,2020-02-23,11,65,422,487
79693,2020-02-23,12,122,577,699
79694,2020-02-23,13,130,610,740
79695,2020-02-23,14,152,620,772
79696,2020-02-23,15,164,699,863
79697,2020-02-23,16,121,577,698
79698,2020-02-23,17,86,503,589
79699,2020-02-23,18,32,341,373
79700,2020-02-23,19,16,201,217
79701,2020-02-23,20,16,125,141
79702,2020-02-23,21,4,104,108
79703,2020-02-23,22,10,69,79
79704,2020-02-23,23,4,26,30
79705,2020-02-24,0,2,18,20
79706,2020-02-24,1,0,10,10
79707,2020-02-24,2,0,1,1
79708,2020-02-24,3,0,1,1
79709,2020-02-24,4,0,10,10
79710,2020-02-24,5,0,80,80
79711,2020-02-24,6,3,226,229
79712,2020-02-24,7,8,579,587
79713,2020-02-24,8,23,988,1011
79714,2020-02-24,9,18,405,423
79715,2020-02-24,10,26,234,260
79716,2020-02-24,11,34,234,268
79717,2020-02-24,12,37,291,328
79718,2020-02-24,13,48,261,309
79719,2020-02-24,14,36,282,318
79720,2020-02-24,15,35,337,372
79721,2020-02-24,16,30,510,540
79722,2020-02-24,17,33,990,1023
79723,2020-02-24,18,10,789,799
79724,2020-02-24,19,26,424,450
79725,2020-02-24,20,15,307,322
79726,2020-02-24,21,8,192,200
79727,2020-02-24,22,15,121,136
79728,2020-02-24,23,7,51,58
79729,2020-02-25,0,2,31,33
79730,2020-02-25,1,0,5,5
79731,2020-02-25,2,0,4,4
79732,2020-02-25,3,0,2,2
79733,2020-02-25,4,0,16,16
79734,2020-02-25,5,1,75,76
79735,2020-02-25,6,0,127,127
79736,2020-02-25,7,2,201,203
79737,2020-02-25,8,2,392,394
79738,2020-02-25,9,1,163,164
79739,2020-02-25,10,1,84,85
79740,2020-02-25,11,11,157,168
79741,2020-02-25,12,7,227,234
79742,2020-02-25,13,16,206,222
79743,2020-02-25,14,19,226,245
79744,2020-02-25,15,32,340,372
79745,2020-02-25,16,23,494,517
79746,2020-02-25,17,36,966,1002
79747,2020-02-25,18,30,686,716
79748,2020-02-25,19,15,444,459
79749,2020-02-25,20,13,313,326
79750,2020-02-25,21,4,183,187
79751,2020-02-25,22,5,133,138
79752,2020-02-25,23,5,64,69
79753,2020-02-26,0,2,22,24
79754,2020-02-26,1,2,7,9
79755,2020-02-26,2,2,2,4
79756,2020-02-26,3,0,3,3
79757,2020-02-26,4,0,11,11
79758,2020-02-26,5,0,106,106
79759,2020-02-26,6,3,288,291
79760,2020-02-26,7,6,634,640
79761,2020-02-26,8,15,1123,1138
79762,2020-02-26,9,9,520,529
79763,2020-02-26,10,15,241,256
79764,2020-02-26,11,25,238,263
79765,2020-02-26,12,20,275,295
79766,2020-02-26,13,19,286,305
79767,2020-02-26,14,20,217,237
79768,2020-02-26,15,46,329,375
79769,2020-02-26,16,21,456,477
79770,2020-02-26,17,24,903,927
79771,2020-02-26,18,12,597,609
79772,2020-02-26,19,9,340,349
79773,2020-02-26,20,2,220,222
79774,2020-02-26,21,2,181,183
79775,2020-02-26,22,2,90,92
79776,2020-02-26,23,1,33,34
79777,2020-02-27,0,0,7,7
79778,2020-02-27,1,0,4,4
79779,2020-02-27,2,0,6,6
79780,2020-02-27,3,0,1,1
79781,2020-02-27,4,1,7,8
79782,2020-02-27,5,0,82,82
79783,2020-02-27,6,0,196,196
79784,2020-02-27,7,6,569,575
79785,2020-02-27,8,12,969,981
79786,2020-02-27,9,8,458,466
79787,2020-02-27,10,10,191,201
79788,2020-02-27,11,15,196,211
79789,2020-02-27,12,5,247,252
79790,2020-02-27,13,7,203,210
79791,2020-02-27,14,8,191,199
79792,2020-02-27,15,15,305,320
79793,2020-02-27,16,12,418,430
79794,2020-02-27,17,14,749,763
79795,2020-02-27,18,16,594,610
79796,2020-02-27,19,7,348,355
79797,2020-02-27,20,3,209,212
79798,2020-02-27,21,1,159,160
79799,2020-02-27,22,4,107,111
79800,2020-02-27,23,3,52,55
79801,2020-02-28,0,3,25,28
79802,2020-02-28,1,5,21,26
79803,2020-02-28,2,0,10,10
79804,2020-02-28,3,1,2,3
79805,2020-02-28,4,0,9,9
79806,2020-02-28,5,0,78,78
79807,2020-02-28,6,4,172,176
79808,2020-02-28,7,4,471,475
79809,2020-02-28,8,21,862,883
79810,2020-02-28,9,11,451,462
79811,2020-02-28,10,8,215,223
79812,2020-02-28,11,24,276,300
79813,2020-02-28,12,16,333,349
79814,2020-02-28,13,38,281,319
79815,2020-02-28,14,36,278,314
79816,2020-02-28,15,43,394,437
79817,2020-02-28,16,43,489,532
79818,2020-02-28,17,19,783,802
79819,2020-02-28,18,20,533,553
79820,2020-02-28,19,8,335,343
79821,2020-02-28,20,7,195,202
79822,2020-02-28,21,6,127,133
79823,2020-02-28,22,3,86,89
79824,2020-02-28,23,2,64,66
79825,2020-02-29,0,2,64,66
79826,2020-02-29,1,2,42,44
79827,2020-02-29,2,2,16,18
79828,2020-02-29,3,0,6,6
79829,2020-02-29,4,2,3,5
79830,2020-02-29,5,0,14,14
79831,2020-02-29,6,0,28,28
79832,2020-02-29,7,3,70,73
79833,2020-02-29,8,5,173,178
79834,2020-02-29,9,11,249,260
79835,2020-02-29,10,9,318,327
79836,2020-02-29,11,28,311,339
79837,2020-02-29,12,27,329,356
79838,2020-02-29,13,23,280,303
79839,2020-02-29,14,42,276,318
79840,2020-02-29,15,39,312,351
79841,2020-02-29,16,24,254,278
79842,2020-02-29,17,40,227,267
79843,2020-02-29,18,18,235,253
79844,2020-02-29,19,4,187,191
79845,2020-02-29,20,6,115,121
79846,2020-02-29,21,6,81,87
79847,2020-02-29,22,7,96,103
79848,2020-02-29,23,6,62,68
79849,2020-03-01,0,2,46,48
79850,2020-03-01,1,1,30,31
79851,2020-03-01,2,3,28,31
79852,2020-03-01,3,0,11,11
79853,2020-03-01,4,0,3,3
79854,2020-03-01,5,0,9,9
79855,2020-03-01,6,0,22,22
79856,2020-03-01,7,5,45,50
79857,2020-03-01,8,10,131,141
79858,2020-03-01,9,18,185,203
79859,2020-03-01,10,44,262,306
79860,2020-03-01,11,50,360,410
79861,2020-03-01,12,71,406,477
79862,2020-03-01,13,86,450,536
79863,2020-03-01,14,112,481,593
79864,2020-03-01,15,93,469,562
79865,2020-03-01,16,99,459,558
79866,2020-03-01,17,60,406,466
79867,2020-03-01,18,28,289,317
79868,2020-03-01,19,10,186,196
79869,2020-03-01,20,6,130,136
79870,2020-03-01,21,6,106,112
79871,2020-03-01,22,5,62,67
79872,2020-03-01,23,7,30,37
79873,2020-03-02,0,2,10,12
79874,2020-03-02,1,0,4,4
79875,2020-03-02,2,0,1,1
79876,2020-03-02,3,0,3,3
79877,2020-03-02,4,4,14,18
79878,2020-03-02,5,0,71,71
79879,2020-03-02,6,2,243,245
79880,2020-03-02,7,6,642,648
79881,2020-03-02,8,17,1049,1066
79882,2020-03-02,9,22,457,479
79883,2020-03-02,10,33,237,270
79884,2020-03-02,11,31,248,279
79885,2020-03-02,12,33,303,336
79886,2020-03-02,13,46,319,365
79887,2020-03-02,14,58,286,344
79888,2020-03-02,15,46,401,447
79889,2020-03-02,16,59,566,625
79890,2020-03-02,17,31,843,874
79891,2020-03-02,18,22,770,792
79892,2020-03-02,19,12,376,388
79893,2020-03-02,20,7,183,190
79894,2020-03-02,21,4,123,127
79895,2020-03-02,22,2,35,37
79896,2020-03-02,23,2,43,45
79897,2020-03-03,0,0,23,23
79898,2020-03-03,1,0,5,5
79899,2020-03-03,2,0,2,2
79900,2020-03-03,3,0,2,2
79901,2020-03-03,4,0,17,17
79902,2020-03-03,5,1,81,82
79903,2020-03-03,6,3,284,287
79904,2020-03-03,7,10,699,709
79905,2020-03-03,8,28,1202,1230
79906,2020-03-03,9,29,479,508
79907,2020-03-03,10,19,219,238
79908,2020-03-03,11,14,143,157
79909,2020-03-03,12,6,134,140
79910,2020-03-03,13,14,170,184
79911,2020-03-03,14,18,224,242
79912,2020-03-03,15,42,389,431
79913,2020-03-03,16,53,532,585
79914,2020-03-03,17,53,1133,1186
79915,2020-03-03,18,26,774,800
79916,2020-03-03,19,9,267,276
79917,2020-03-03,20,8,254,262
79918,2020-03-03,21,3,119,122
79919,2020-03-03,22,9,100,109
79920,2020-03-03,23,5,49,54
79921,2020-03-04,0,0,24,24
79922,2020-03-04,1,3,3,6
79923,2020-03-04,2,0,2,2
79924,2020-03-04,3,2,3,5
79925,2020-03-04,4,0,10,10
79926,2020-03-04,5,0,98,98
79927,2020-03-04,6,2,302,304
79928,2020-03-04,7,11,717,728
79929,2020-03-04,8,22,1138,1160
79930,2020-03-04,9,17,529,546
79931,2020-03-04,10,35,243,278
79932,2020-03-04,11,40,248,288
79933,2020-03-04,12,50,319,369
79934,2020-03-04,13,49,298,347
79935,2020-03-04,14,57,321,378
79936,2020-03-04,15,50,422,472
79937,2020-03-04,16,62,629,691
79938,2020-03-04,17,42,1132,1174
79939,2020-03-04,18,27,869,896
79940,2020-03-04,19,18,473,491
79941,2020-03-04,20,23,345,368
79942,2020-03-04,21,14,236,250
79943,2020-03-04,22,20,165,185
79944,2020-03-04,23,4,53,57
79945,2020-03-05,0,2,26,28
79946,2020-03-05,1,0,10,10
79947,2020-03-05,2,1,3,4
79948,2020-03-05,3,0,1,1
79949,2020-03-05,4,0,8,8
79950,2020-03-05,5,0,83,83
79951,2020-03-05,6,12,294,306
79952,2020-03-05,7,8,661,669
79953,2020-03-05,8,13,1157,1170
79954,2020-03-05,9,21,522,543
79955,2020-03-05,10,17,215,232
79956,2020-03-05,11,27,214,241
79957,2020-03-05,12,44,290,334
79958,2020-03-05,13,51,289,340
79959,2020-03-05,14,38,304,342
79960,2020-03-05,15,33,375,408
79961,2020-03-05,16,43,548,591
79962,2020-03-05,17,64,1012,1076
79963,2020-03-05,18,36,746,782
79964,2020-03-05,19,17,429,446
79965,2020-03-05,20,20,295,315
79966,2020-03-05,21,6,222,228
79967,2020-03-05,22,7,134,141
79968,2020-03-05,23,4,74,78
79969,2020-03-06,0,4,35,39
79970,2020-03-06,1,0,10,10
79971,2020-03-06,2,1,4,5
79972,2020-03-06,3,0,2,2
79973,2020-03-06,4,0,10,10
79974,2020-03-06,5,0,76,76
79975,2020-03-06,6,5,219,224
79976,2020-03-06,7,9,498,507
79977,2020-03-06,8,17,898,915
79978,2020-03-06,9,7,454,461
79979,2020-03-06,10,20,192,212
79980,2020-03-06,11,19,227,246
79981,2020-03-06,12,33,260,293
79982,2020-03-06,13,45,303,348
79983,2020-03-06,14,26,305,331
79984,2020-03-06,15,33,382,415
79985,2020-03-06,16,27,483,510
79986,2020-03-06,17,30,810,840
79987,2020-03-06,18,21,566,587
79988,2020-03-06,19,8,338,346
79989,2020-03-06,20,5,197,202
79990,2020-03-06,21,10,165,175
79991,2020-03-06,22,1,99,100
79992,2020-03-06,23,3,75,78
79993,2020-03-07,0,3,63,66
79994,2020-03-07,1,2,31,33
79995,2020-03-07,2,1,32,33
79996,2020-03-07,3,4,22,26
79997,2020-03-07,4,1,4,5
79998,2020-03-07,5,0,11,11
79999,2020-03-07,6,1,36,37
80000,2020-03-07,7,4,93,97
80001,2020-03-07,8,16,193,209
80002,2020-03-07,9,28,278,306
80003,2020-03-07,10,34,363,397
80004,2020-03-07,11,70,380,450
80005,2020-03-07,12,102,424,526
80006,2020-03-07,13,117,446,563
80007,2020-03-07,14,142,494,636
80008,2020-03-07,15,128,469,597
80009,2020-03-07,16,126,406,532
80010,2020-03-07,17,98,410,508
80011,2020-03-07,18,60,318,378
80012,2020-03-07,19,37,237,274
80013,2020-03-07,20,17,170,187
80014,2020-03-07,21,17,110,127
80015,2020-03-07,22,9,101,110
80016,2020-03-07,23,7,77,84
80017,2020-03-08,0,4,62,66
80018,2020-03-08,1,1,37,38
80019,2020-03-08,3,9,45,54
80020,2020-03-08,4,3,22,25
80021,2020-03-08,5,0,7,7
80022,2020-03-08,6,1,21,22
80023,2020-03-08,7,2,49,51
80024,2020-03-08,8,8,133,141
80025,2020-03-08,9,24,216,240
80026,2020-03-08,10,52,309,361
80027,2020-03-08,11,60,419,479
80028,2020-03-08,12,135,603,738
80029,2020-03-08,13,146,599,745
80030,2020-03-08,14,170,627,797
80031,2020-03-08,15,183,650,833
80032,2020-03-08,16,141,615,756
80033,2020-03-08,17,141,548,689
80034,2020-03-08,18,93,507,600
80035,2020-03-08,19,63,299,362
80036,2020-03-08,20,22,165,187
80037,2020-03-08,21,12,154,166
80038,2020-03-08,22,13,86,99
80039,2020-03-08,23,3,53,56
80040,2020-03-09,0,1,21,22
80041,2020-03-09,1,1,13,14
80042,2020-03-09,2,1,4,5
80043,2020-03-09,3,0,3,3
80044,2020-03-09,4,0,9,9
80045,2020-03-09,5,0,74,74
80046,2020-03-09,6,2,231,233
80047,2020-03-09,7,4,520,524
80048,2020-03-09,8,23,1014,1037
80049,2020-03-09,9,17,518,535
80050,2020-03-09,10,27,247,274
80051,2020-03-09,11,65,254,319
80052,2020-03-09,12,65,369,434
80053,2020-03-09,13,82,370,452
80054,2020-03-09,14,82,386,468
80055,2020-03-09,15,104,513,617
80056,2020-03-09,16,101,686,787
80057,2020-03-09,17,140,1240,1380
80058,2020-03-09,18,99,1067,1166
80059,2020-03-09,19,72,580,652
80060,2020-03-09,20,24,321,345
80061,2020-03-09,21,22,201,223
80062,2020-03-09,22,21,131,152
80063,2020-03-09,23,7,71,78
80064,2020-03-10,0,4,23,27
80065,2020-03-10,1,6,13,19
80066,2020-03-10,2,0,5,5
80067,2020-03-10,3,1,3,4
80068,2020-03-10,4,1,13,14
80069,2020-03-10,5,1,96,97
80070,2020-03-10,6,4,270,274
80071,2020-03-10,7,3,673,676
80072,2020-03-10,8,15,879,894
80073,2020-03-10,9,7,487,494
80074,2020-03-10,10,29,210,239
80075,2020-03-10,11,36,244,280
80076,2020-03-10,12,20,276,296
80077,2020-03-10,13,19,292,311
80078,2020-03-10,14,56,282,338
80079,2020-03-10,15,57,416,473
80080,2020-03-10,16,51,608,659
80081,2020-03-10,17,80,1146,1226
80082,2020-03-10,18,66,1003,1069
80083,2020-03-10,19,35,522,557
80084,2020-03-10,20,25,313,338
80085,2020-03-10,21,20,217,237
80086,2020-03-10,22,10,86,96
80087,2020-03-10,23,10,64,74
80088,2020-03-11,0,3,21,24
80089,2020-03-11,1,0,7,7
80090,2020-03-11,2,1,5,6
80091,2020-03-11,3,1,1,2
80092,2020-03-11,4,0,12,12
80093,2020-03-11,5,2,82,84
80094,2020-03-11,6,1,268,269
80095,2020-03-11,7,9,613,622
80096,2020-03-11,8,24,1128,1152
80097,2020-03-11,9,43,565,608
80098,2020-03-11,10,48,251,299
80099,2020-03-11,11,29,258,287
80100,2020-03-11,12,37,303,340
80101,2020-03-11,13,24,314,338
80102,2020-03-11,14,39,279,318
80103,2020-03-11,15,36,376,412
80104,2020-03-11,16,58,532,590
80105,2020-03-11,17,54,1036,1090
80106,2020-03-11,18,44,806,850
80107,2020-03-11,19,14,488,502
80108,2020-03-11,20,16,291,307
80109,2020-03-11,21,3,177,180
80110,2020-03-11,22,8,118,126
80111,2020-03-11,23,6,73,79
80112,2020-03-12,0,1,25,26
80113,2020-03-12,1,0,6,6
80114,2020-03-12,2,1,4,5
80115,2020-03-12,3,0,3,3
80116,2020-03-12,4,0,12,12
80117,2020-03-12,5,0,66,66
80118,2020-03-12,6,4,229,233
80119,2020-03-12,7,8,541,549
80120,2020-03-12,8,13,986,999
80121,2020-03-12,9,10,509,519
80122,2020-03-12,10,26,261,287
80123,2020-03-12,11,27,279,306
80124,2020-03-12,12,37,293,330
80125,2020-03-12,13,66,290,356
80126,2020-03-12,14,49,308,357
80127,2020-03-12,15,66,414,480
80128,2020-03-12,16,55,530,585
80129,2020-03-12,17,68,902,970
80130,2020-03-12,18,45,732,777
80131,2020-03-12,19,25,396,421
80132,2020-03-12,20,12,258,270
80133,2020-03-12,21,17,162,179
80134,2020-03-12,22,23,107,130
80135,2020-03-12,23,5,59,64
80136,2020-03-13,0,5,32,37
80137,2020-03-13,1,3,15,18
80138,2020-03-13,2,2,1,3
80139,2020-03-13,3,0,2,2
80140,2020-03-13,4,0,3,3
80141,2020-03-13,5,1,44,45
80142,2020-03-13,6,2,150,152
80143,2020-03-13,7,10,320,330
80144,2020-03-13,8,11,626,637
80145,2020-03-13,9,14,366,380
80146,2020-03-13,10,43,231,274
80147,2020-03-13,11,54,332,386
80148,2020-03-13,12,58,319,377
80149,2020-03-13,13,65,342,407
80150,2020-03-13,14,84,360,444
80151,2020-03-13,15,118,418,536
80152,2020-03-13,16,79,521,600
80153,2020-03-13,17,95,781,876
80154,2020-03-13,18,54,594,648
80155,2020-03-13,19,41,396,437
80156,2020-03-13,20,37,199,236
80157,2020-03-13,21,20,142,162
80158,2020-03-13,22,19,102,121
80159,2020-03-13,23,5,95,100
80160,2020-03-14,0,6,63,69
80161,2020-03-14,1,1,35,36
80162,2020-03-14,2,2,20,22
80163,2020-03-14,3,1,8,9
80164,2020-03-14,4,0,6,6
80165,2020-03-14,5,1,9,10
80166,2020-03-14,6,2,27,29
80167,2020-03-14,7,3,69,72
80168,2020-03-14,8,8,137,145
80169,2020-03-14,9,23,236,259
80170,2020-03-14,10,34,280,314
80171,2020-03-14,11,96,406,502
80172,2020-03-14,12,146,496,642
80173,2020-03-14,13,169,538,707
80174,2020-03-14,14,151,599,750
80175,2020-03-14,15,151,533,684
80176,2020-03-14,16,104,479,583
80177,2020-03-14,17,102,369,471
80178,2020-03-14,18,47,287,334
80179,2020-03-14,19,32,198,230
80180,2020-03-14,20,8,76,84
80181,2020-03-14,21,5,38,43
80182,2020-03-14,22,1,24,25
80183,2020-03-14,23,0,17,17
80184,2020-03-15,0,0,23,23
80185,2020-03-15,1,0,10,10
80186,2020-03-15,2,0,6,6
80187,2020-03-15,3,1,4,5
80188,2020-03-15,4,0,4,4
80189,2020-03-15,5,0,6,6
80190,2020-03-15,6,1,18,19
80191,2020-03-15,7,0,28,28
80192,2020-03-15,8,0,65,65
80193,2020-03-15,9,5,68,73
80194,2020-03-15,10,14,126,140
80195,2020-03-15,11,24,185,209
80196,2020-03-15,12,31,254,285
80197,2020-03-15,13,49,301,350
80198,2020-03-15,14,69,337,406
80199,2020-03-15,15,59,319,378
80200,2020-03-15,16,62,299,361
80201,2020-03-15,17,51,259,310
80202,2020-03-15,18,34,230,264
80203,2020-03-15,19,17,155,172
80204,2020-03-15,20,4,83,87
80205,2020-03-15,21,3,61,64
80206,2020-03-15,22,3,47,50
80207,2020-03-15,23,2,21,23
80208,2020-03-16,0,2,29,31
80209,2020-03-16,1,2,14,16
80210,2020-03-16,2,1,6,7
80211,2020-03-16,3,0,2,2
80212,2020-03-16,4,0,4,4
80213,2020-03-16,5,1,32,33
80214,2020-03-16,6,3,111,114
80215,2020-03-16,7,9,208,217
80216,2020-03-16,8,2,359,361
80217,2020-03-16,9,14,196,210
80218,2020-03-16,10,16,134,150
80219,2020-03-16,11,27,180,207
80220,2020-03-16,12,34,215,249
80221,2020-03-16,13,31,207,238
80222,2020-03-16,14,20,207,227
80223,2020-03-16,15,32,242,274
80224,2020-03-16,16,28,329,357
80225,2020-03-16,17,20,397,417
80226,2020-03-16,18,21,335,356
80227,2020-03-16,19,8,211,219
80228,2020-03-16,20,8,107,115
80229,2020-03-16,21,9,64,73
80230,2020-03-16,22,0,42,42
80231,2020-03-16,23,1,20,21
80232,2020-03-17,0,0,6,6
80233,2020-03-17,1,0,11,11
80234,2020-03-17,2,1,4,5
80235,2020-03-17,3,1,2,3
80236,2020-03-17,4,0,10,10
80237,2020-03-17,5,0,27,27
80238,2020-03-17,6,2,70,72
80239,2020-03-17,7,1,148,149
80240,2020-03-17,8,5,174,179
80241,2020-03-17,9,9,143,152
80242,2020-03-17,10,9,125,134
80243,2020-03-17,11,20,145,165
80244,2020-03-17,12,30,193,223
80245,2020-03-17,13,44,204,248
80246,2020-03-17,14,45,255,300
80247,2020-03-17,15,44,270,314
80248,2020-03-17,16,64,318,382
80249,2020-03-17,17,60,438,498
80250,2020-03-17,18,63,403,466
80251,2020-03-17,19,32,272,304
80252,2020-03-17,20,6,126,132
80253,2020-03-17,21,5,57,62
80254,2020-03-17,22,1,39,40
80255,2020-03-17,23,2,24,26
80256,2020-03-18,0,0,26,26
80257,2020-03-18,1,3,10,13
80258,2020-03-18,2,1,2,3
80259,2020-03-18,3,0,2,2
80260,2020-03-18,4,0,2,2
80261,2020-03-18,5,1,24,25
80262,2020-03-18,6,1,63,64
80263,2020-03-18,7,4,176,180
80264,2020-03-18,8,8,210,218
80265,2020-03-18,9,7,154,161
80266,2020-03-18,10,18,145,163
80267,2020-03-18,11,30,160,190
80268,2020-03-18,12,18,230,248
80269,2020-03-18,13,50,232,282
80270,2020-03-18,14,28,205,233
80271,2020-03-18,15,45,250,295
80272,2020-03-18,16,45,324,369
80273,2020-03-18,17,55,416,471
80274,2020-03-18,18,59,378,437
80275,2020-03-18,19,14,257,271
80276,2020-03-18,20,2,73,75
80277,2020-03-18,21,3,41,44
80278,2020-03-18,22,0,32,32
80279,2020-03-18,23,1,14,15
80280,2020-03-19,0,0,7,7
80281,2020-03-19,1,0,6,6
80282,2020-03-19,2,0,4,4
80283,2020-03-19,3,1,0,1
80284,2020-03-19,4,0,2,2
80285,2020-03-19,5,0,10,10
80286,2020-03-19,6,0,47,47
80287,2020-03-19,7,4,129,133
80288,2020-03-19,8,4,159,163
80289,2020-03-19,9,7,117,124
80290,2020-03-19,10,11,121,132
80291,2020-03-19,11,20,114,134
80292,2020-03-19,12,29,210,239
80293,2020-03-19,13,25,251,276
80294,2020-03-19,14,48,243,291
80295,2020-03-19,15,65,291,356
80296,2020-03-19,16,83,409,492
80297,2020-03-19,17,118,627,745
80298,2020-03-19,18,133,626,759
80299,2020-03-19,19,37,335,372
80300,2020-03-19,20,26,114,140
80301,2020-03-19,21,1,47,48
80302,2020-03-19,22,8,48,56
80303,2020-03-19,23,1,20,21
80304,2020-03-20,0,2,15,17
80305,2020-03-20,1,1,4,5
80306,2020-03-20,2,0,4,4
80307,2020-03-20,3,0,2,2
80308,2020-03-20,4,1,11,12
80309,2020-03-20,5,0,23,23
80310,2020-03-20,6,5,81,86
80311,2020-03-20,7,16,179,195
80312,2020-03-20,8,11,224,235
80313,2020-03-20,9,18,153,171
80314,2020-03-20,10,20,158,178
80315,2020-03-20,11,29,206,235
80316,2020-03-20,12,36,174,210
80317,2020-03-20,13,28,144,172
80318,2020-03-20,14,31,224,255
80319,2020-03-20,15,77,301,378
80320,2020-03-20,16,81,404,485
80321,2020-03-20,17,119,578,697
80322,2020-03-20,18,95,495,590
80323,2020-03-20,19,51,337,388
80324,2020-03-20,20,33,177,210
80325,2020-03-20,21,25,85,110
80326,2020-03-20,22,23,61,84
80327,2020-03-20,23,17,48,65
80328,2020-03-21,0,5,32,37
80329,2020-03-21,1,6,18,24
80330,2020-03-21,2,2,10,12
80331,2020-03-21,3,0,3,3
80332,2020-03-21,5,0,11,11
80333,2020-03-21,6,4,38,42
80334,2020-03-21,7,6,58,64
80335,2020-03-21,8,5,102,107
80336,2020-03-21,9,18,165,183
80337,2020-03-21,10,27,233,260
80338,2020-03-21,11,57,380,437
80339,2020-03-21,12,98,421,519
80340,2020-03-21,13,112,527,639
80341,2020-03-21,14,147,520,667
80342,2020-03-21,15,103,473,576
80343,2020-03-21,16,89,342,431
80344,2020-03-21,17,77,352,429
80345,2020-03-21,18,56,275,331
80346,2020-03-21,19,30,179,209
80347,2020-03-21,20,15,86,101
80348,2020-03-21,21,4,44,48
80349,2020-03-21,22,12,34,46
80350,2020-03-21,23,4,29,33
80351,2020-03-22,0,1,11,12
80352,2020-03-22,1,0,6,6
80353,2020-03-22,2,0,3,3
80354,2020-03-22,3,0,1,1
80355,2020-03-22,4,2,2,4
80356,2020-03-22,5,1,10,11
80357,2020-03-22,6,2,42,44
80358,2020-03-22,7,6,56,62
80359,2020-03-22,8,12,99,111
80360,2020-03-22,9,12,145,157
80361,2020-03-22,10,26,181,207
80362,2020-03-22,11,53,247,300
80363,2020-03-22,12,90,319,409
80364,2020-03-22,13,85,414,499
80365,2020-03-22,14,122,526,648
80366,2020-03-22,15,118,501,619
80367,2020-03-22,16,84,439,523
80368,2020-03-22,17,82,265,347
80369,2020-03-22,18,43,173,216
80370,2020-03-22,19,13,91,104
80371,2020-03-22,20,1,59,60
80372,2020-03-22,21,2,35,37
80373,2020-03-22,22,3,23,26
80374,2020-03-22,23,1,16,17
80375,2020-03-23,0,0,2,2
80376,2020-03-23,1,0,1,1
80377,2020-03-23,2,0,1,1
80378,2020-03-23,4,0,2,2
80379,2020-03-23,5,0,13,13
80380,2020-03-23,6,0,24,24
80381,2020-03-23,7,3,46,49
80382,2020-03-23,8,0,30,30
80383,2020-03-23,9,0,17,17
80384,2020-03-23,10,1,21,22
80385,2020-03-23,11,0,39,39
80386,2020-03-23,12,3,56,59
80387,2020-03-23,13,4,59,63
80388,2020-03-23,14,4,65,69
80389,2020-03-23,15,4,63,67
80390,2020-03-23,16,3,87,90
80391,2020-03-23,17,8,126,134
80392,2020-03-23,18,13,141,154
80393,2020-03-23,19,6,96,102
80394,2020-03-23,20,4,50,54
80395,2020-03-23,21,3,28,31
80396,2020-03-23,22,4,19,23
80397,2020-03-23,23,3,10,13
80398,2020-03-24,0,0,8,8
80399,2020-03-24,2,0,1,1
80400,2020-03-24,4,1,2,3
80401,2020-03-24,5,2,27,29
80402,2020-03-24,6,1,64,65
80403,2020-03-24,7,6,108,114
80404,2020-03-24,8,7,100,107
80405,2020-03-24,9,3,83,86
80406,2020-03-24,10,0,83,83
80407,2020-03-24,11,5,94,99
80408,2020-03-24,12,8,130,138
80409,2020-03-24,13,17,162,179
80410,2020-03-24,14,18,162,180
80411,2020-03-24,15,39,195,234
80412,2020-03-24,16,48,220,268
80413,2020-03-24,17,50,336,386
80414,2020-03-24,18,36,299,335
80415,2020-03-24,19,10,182,192
80416,2020-03-24,20,5,82,87
80417,2020-03-24,21,3,49,52
80418,2020-03-24,22,0,17,17
80419,2020-03-24,23,2,14,16
80420,2020-03-25,0,1,8,9
80421,2020-03-25,1,0,3,3
80422,2020-03-25,2,0,1,1
80423,2020-03-25,4,0,3,3
80424,2020-03-25,5,0,16,16
80425,2020-03-25,6,0,24,24
80426,2020-03-25,7,0,37,37
80427,2020-03-25,8,1,52,53
80428,2020-03-25,9,1,38,39
80429,2020-03-25,10,2,34,36
80430,2020-03-25,11,1,19,20
80431,2020-03-25,12,0,27,27
80432,2020-03-25,13,0,30,30
80433,2020-03-25,14,8,68,76
80434,2020-03-25,15,5,67,72
80435,2020-03-25,16,1,68,69
80436,2020-03-25,17,6,83,89
80437,2020-03-25,18,7,112,119
80438,2020-03-25,19,3,81,84
80439,2020-03-25,20,4,61,65
80440,2020-03-25,21,2,30,32
80441,2020-03-25,22,1,20,21
80442,2020-03-25,23,0,15,15
80443,2020-03-26,0,0,6,6
80444,2020-03-26,1,1,2,3
80445,2020-03-26,2,0,2,2
80446,2020-03-26,4,0,1,1
80447,2020-03-26,5,0,26,26
80448,2020-03-26,6,0,49,49
80449,2020-03-26,7,8,89,97
80450,2020-03-26,8,6,91,97
80451,2020-03-26,9,8,75,83
80452,2020-03-26,10,10,75,85
80453,2020-03-26,11,7,86,93
80454,2020-03-26,12,10,132,142
80455,2020-03-26,13,19,132,151
80456,2020-03-26,14,31,183,214
80457,2020-03-26,15,34,219,253
80458,2020-03-26,16,44,267,311
80459,2020-03-26,17,51,351,402
80460,2020-03-26,18,41,342,383
80461,2020-03-26,19,27,211,238
80462,2020-03-26,20,12,81,93
80463,2020-03-26,21,4,40,44
80464,2020-03-26,22,2,23,25
80465,2020-03-26,23,0,16,16
80466,2020-03-27,0,0,2,2
80467,2020-03-27,1,0,5,5
80468,2020-03-27,2,0,4,4
80469,2020-03-27,3,0,1,1
80470,2020-03-27,4,0,3,3
80471,2020-03-27,5,0,14,14
80472,2020-03-27,6,0,46,46
80473,2020-03-27,7,4,78,82
80474,2020-03-27,8,7,101,108
80475,2020-03-27,9,7,79,86
80476,2020-03-27,10,10,86,96
80477,2020-03-27,11,16,123,139
80478,2020-03-27,12,20,162,182
80479,2020-03-27,13,30,214,244
80480,2020-03-27,14,38,235,273
80481,2020-03-27,15,27,214,241
80482,2020-03-27,16,45,296,341
80483,2020-03-27,17,66,329,395
80484,2020-03-27,18,76,340,416
80485,2020-03-27,19,34,215,249
80486,2020-03-27,20,13,125,138
80487,2020-03-27,21,5,48,53
80488,2020-03-27,22,0,41,41
80489,2020-03-27,23,4,29,33
80490,2020-03-28,0,0,13,13
80491,2020-03-28,1,0,11,11
80492,2020-03-28,2,0,5,5
80493,2020-03-28,3,0,1,1
80494,2020-03-28,4,0,2,2
80495,2020-03-28,5,0,3,3
80496,2020-03-28,6,0,3,3
80497,2020-03-28,7,1,26,27
80498,2020-03-28,8,1,16,17
80499,2020-03-28,9,7,51,58
80500,2020-03-28,10,10,85,95
80501,2020-03-28,11,6,112,118
80502,2020-03-28,12,25,154,179
80503,2020-03-28,13,36,192,228
80504,2020-03-28,14,36,215,251
80505,2020-03-28,15,43,244,287
80506,2020-03-28,16,31,247,278
80507,2020-03-28,17,28,229,257
80508,2020-03-28,18,13,153,166
80509,2020-03-28,19,10,129,139
80510,2020-03-28,20,4,59,63
80511,2020-03-28,21,2,35,37
80512,2020-03-28,22,0,34,34
80513,2020-03-28,23,2,19,21
80514,2020-03-29,0,2,13,15
80515,2020-03-29,1,1,7,8
80516,2020-03-29,2,1,5,6
80517,2020-03-29,3,0,5,5
80518,2020-03-29,4,0,4,4
80519,2020-03-29,5,0,5,5
80520,2020-03-29,6,1,9,10
80521,2020-03-29,7,6,35,41
80522,2020-03-29,8,1,53,54
80523,2020-03-29,9,7,106,113
80524,2020-03-29,10,9,151,160
80525,2020-03-29,11,31,163,194
80526,2020-03-29,12,30,222,252
80527,2020-03-29,13,45,262,307
80528,2020-03-29,14,56,338,394
80529,2020-03-29,15,107,415,522
80530,2020-03-29,16,128,509,637
80531,2020-03-29,17,123,469,592
80532,2020-03-29,18,78,317,395
80533,2020-03-29,19,44,219,263
80534,2020-03-29,20,11,78,89
80535,2020-03-29,21,12,39,51
80536,2020-03-29,22,2,26,28
80537,2020-03-29,23,3,22,25
80538,2020-03-30,0,3,4,7
80539,2020-03-30,1,1,5,6
80540,2020-03-30,2,2,3,5
80541,2020-03-30,3,0,1,1
80542,2020-03-30,4,0,6,6
80543,2020-03-30,5,0,14,14
80544,2020-03-30,6,1,40,41
80545,2020-03-30,7,1,83,84
80546,2020-03-30,8,5,108,113
80547,2020-03-30,9,3,75,78
80548,2020-03-30,10,5,70,75
80549,2020-03-30,11,25,108,133
80550,2020-03-30,12,20,158,178
80551,2020-03-30,13,20,176,196
80552,2020-03-30,14,22,191,213
80553,2020-03-30,15,28,234,262
80554,2020-03-30,16,37,250,287
80555,2020-03-30,17,49,347,396
80556,2020-03-30,18,44,346,390
80557,2020-03-30,19,18,220,238
80558,2020-03-30,20,9,87,96
80559,2020-03-30,21,2,40,42
80560,2020-03-30,22,3,26,29
80561,2020-03-30,23,0,11,11
80562,2020-03-31,0,0,3,3
80563,2020-03-31,1,0,3,3
80564,2020-03-31,4,0,4,4
80565,2020-03-31,5,0,11,11
80566,2020-03-31,6,0,36,36
80567,2020-03-31,7,7,93,100
80568,2020-03-31,8,3,93,96
80569,2020-03-31,9,5,70,75
80570,2020-03-31,10,4,60,64
80571,2020-03-31,11,5,91,96
80572,2020-03-31,12,9,103,112
80573,2020-03-31,13,7,109,116
80574,2020-03-31,14,8,119,127
80575,2020-03-31,15,16,105,121
80576,2020-03-31,16,7,142,149
80577,2020-03-31,17,12,147,159
80578,2020-03-31,18,11,113,124
80579,2020-03-31,19,2,49,51
80580,2020-03-31,20,4,21,25
80581,2020-03-31,21,1,8,9
80582,2020-03-31,22,0,8,8
80583,2020-03-31,23,0,9,9
80584,2020-04-01,0,0,1,1
80585,2020-04-01,1,0,2,2
80586,2020-04-01,2,1,0,1
80587,2020-04-01,3,0,2,2
80588,2020-04-01,4,2,3,5
80589,2020-04-01,5,0,9,9
80590,2020-04-01,6,5,32,37
80591,2020-04-01,7,10,66,76
80592,2020-04-01,8,9,91,100
80593,2020-04-01,9,10,56,66
80594,2020-04-01,10,9,47,56
80595,2020-04-01,11,14,47,61
80596,2020-04-01,12,25,81,106
80597,2020-04-01,13,44,75,119
80598,2020-04-01,14,24,66,90
80599,2020-04-01,15,37,88,125
80600,2020-04-01,16,37,127,164
80601,2020-04-01,17,66,174,240
80602,2020-04-01,18,75,161,236
80603,2020-04-01,19,21,136,157
80604,2020-04-01,20,13,44,57
80605,2020-04-01,21,3,27,30
80606,2020-04-01,22,3,12,15
80607,2020-04-01,23,2,8,10
80608,2020-04-02,0,0,4,4
80609,2020-04-02,1,1,0,1
80610,2020-04-02,2,1,1,2
80611,2020-04-02,3,0,1,1
80612,2020-04-02,4,2,3,5
80613,2020-04-02,5,0,15,15
80614,2020-04-02,6,4,29,33
80615,2020-04-02,7,22,66,88
80616,2020-04-02,8,13,82,95
80617,2020-04-02,9,8,57,65
80618,2020-04-02,10,12,51,63
80619,2020-04-02,11,10,75,85
80620,2020-04-02,12,35,85,120
80621,2020-04-02,13,35,111,146
80622,2020-04-02,14,29,81,110
80623,2020-04-02,15,43,101,144
80624,2020-04-02,16,62,161,223
80625,2020-04-02,17,92,195,287
80626,2020-04-02,18,89,206,295
80627,2020-04-02,19,31,122,153
80628,2020-04-02,20,17,59,76
80629,2020-04-02,21,7,30,37
80630,2020-04-02,22,5,24,29
80631,2020-04-02,23,2,6,8
80632,2020-04-03,0,4,1,5
80633,2020-04-03,1,1,1,2
80634,2020-04-03,2,0,2,2
80635,2020-04-03,4,1,3,4
80636,2020-04-03,5,0,5,5
80637,2020-04-03,6,2,34,36
80638,2020-04-03,7,23,80,103
80639,2020-04-03,8,12,87,99
80640,2020-04-03,9,9,68,77
80641,2020-04-03,10,13,62,75
80642,2020-04-03,11,30,63,93
80643,2020-04-03,12,30,116,146
80644,2020-04-03,13,30,98,128
80645,2020-04-03,14,48,108,156
80646,2020-04-03,15,68,136,204
80647,2020-04-03,16,84,174,258
80648,2020-04-03,17,101,229,330
80649,2020-04-03,18,112,243,355
80650,2020-04-03,19,55,174,229
80651,2020-04-03,20,33,65,98
80652,2020-04-03,21,11,39,50
80653,2020-04-03,22,8,14,22
80654,2020-04-03,23,4,12,16
80655,2020-04-04,0,4,5,9
80656,2020-04-04,1,1,6,7
80657,2020-04-04,2,3,1,4
80658,2020-04-04,3,0,3,3
80659,2020-04-04,4,1,1,2
80660,2020-04-04,5,2,5,7
80661,2020-04-04,6,0,23,23
80662,2020-04-04,7,15,39,54
80663,2020-04-04,8,13,50,63
80664,2020-04-04,9,26,83,109
80665,2020-04-04,10,48,113,161
80666,2020-04-04,11,71,142,213
80667,2020-04-04,12,110,153,263
80668,2020-04-04,13,148,175,323
80669,2020-04-04,14,164,191,355
80670,2020-04-04,15,163,221,384
80671,2020-04-04,16,168,210,378
80672,2020-04-04,17,93,171,264
80673,2020-04-04,18,71,158,229
80674,2020-04-04,19,33,117,150
80675,2020-04-04,20,22,36,58
80676,2020-04-04,21,18,29,47
80677,2020-04-04,22,11,18,29
80678,2020-04-04,23,10,14,24
80679,2020-04-05,0,4,9,13
80680,2020-04-05,1,5,6,11
80681,2020-04-05,2,2,2,4
80682,2020-04-05,3,1,1,2
80683,2020-04-05,4,1,2,3
80684,2020-04-05,5,4,4,8
80685,2020-04-05,6,4,16,20
80686,2020-04-05,7,10,42,52
80687,2020-04-05,8,16,62,78
80688,2020-04-05,9,35,74,109
80689,2020-04-05,10,41,120,161
80690,2020-04-05,11,118,164,282
80691,2020-04-05,12,179,210,389
80692,2020-04-05,13,240,278,518
80693,2020-04-05,14,246,269,515
80694,2020-04-05,15,330,288,618
80695,2020-04-05,16,249,295,544
80696,2020-04-05,17,204,262,466
80697,2020-04-05,18,140,202,342
80698,2020-04-05,19,60,124,184
80699,2020-04-05,20,19,49,68
80700,2020-04-05,21,9,16,25
80701,2020-04-05,22,8,19,27
80702,2020-04-05,23,4,9,13
80703,2020-04-06,0,9,7,16
80704,2020-04-06,1,5,0,5
80705,2020-04-06,2,3,0,3
80706,2020-04-06,4,4,4,8
80707,2020-04-06,5,1,8,9
80708,2020-04-06,6,12,45,57
80709,2020-04-06,7,11,65,76
80710,2020-04-06,8,23,83,106
80711,2020-04-06,9,18,57,75
80712,2020-04-06,10,15,73,88
80713,2020-04-06,11,30,79,109
80714,2020-04-06,12,46,111,157
80715,2020-04-06,13,72,116,188
80716,2020-04-06,14,77,130,207
80717,2020-04-06,15,97,126,223
80718,2020-04-06,16,109,203,312
80719,2020-04-06,17,149,286,435
80720,2020-04-06,18,141,236,377
80721,2020-04-06,19,90,134,224
80722,2020-04-06,20,24,77,101
80723,2020-04-06,21,13,36,49
80724,2020-04-06,22,2,25,27
80725,2020-04-06,23,4,14,18
80726,2020-04-07,0,1,9,10
80727,2020-04-07,1,0,1,1
80728,2020-04-07,2,0,2,2
80729,2020-04-07,4,3,1,4
80730,2020-04-07,5,1,10,11
80731,2020-04-07,6,5,31,36
80732,2020-04-07,7,19,67,86
80733,2020-04-07,8,26,83,109
80734,2020-04-07,9,16,70,86
80735,2020-04-07,10,21,77,98
80736,2020-04-07,11,40,81,121
80737,2020-04-07,12,42,120,162
80738,2020-04-07,13,52,112,164
80739,2020-04-07,14,52,112,164
80740,2020-04-07,15,15,53,68
80741,2020-04-07,16,16,56,72
80742,2020-04-07,17,71,124,195
80743,2020-04-07,18,79,150,229
80744,2020-04-07,19,55,156,211
80745,2020-04-07,20,20,52,72
80746,2020-04-07,21,9,28,37
80747,2020-04-07,22,7,21,28
80748,2020-04-07,23,5,9,14
80749,2020-04-08,0,2,3,5
80750,2020-04-08,1,0,1,1
80751,2020-04-08,2,3,0,3
80752,2020-04-08,3,0,1,1
80753,2020-04-08,4,3,0,3
80754,2020-04-08,5,1,6,7
80755,2020-04-08,6,6,25,31
80756,2020-04-08,7,6,40,46
80757,2020-04-08,8,15,80,95
80758,2020-04-08,9,20,62,82
80759,2020-04-08,10,28,67,95
80760,2020-04-08,11,43,94,137
80761,2020-04-08,12,54,108,162
80762,2020-04-08,13,70,121,191
80763,2020-04-08,14,86,130,216
80764,2020-04-08,15,113,161,274
80765,2020-04-08,16,134,182,316
80766,2020-04-08,17,188,307,495
80767,2020-04-08,18,212,287,499
80768,2020-04-08,19,134,199,333
80769,2020-04-08,20,43,72,115
80770,2020-04-08,21,20,30,50
80771,2020-04-08,22,8,19,27
80772,2020-04-08,23,7,12,19
80773,2020-04-09,0,5,0,5
80774,2020-04-09,1,1,1,2
80775,2020-04-09,2,1,1,2
80776,2020-04-09,3,1,0,1
80777,2020-04-09,4,2,3,5
80778,2020-04-09,5,3,10,13
80779,2020-04-09,6,2,19,21
80780,2020-04-09,7,11,54,65
80781,2020-04-09,8,17,78,95
80782,2020-04-09,9,24,65,89
80783,2020-04-09,10,28,68,96
80784,2020-04-09,11,35,97,132
80785,2020-04-09,12,25,76,101
80786,2020-04-09,13,36,94,130
80787,2020-04-09,14,53,94,147
80788,2020-04-09,15,40,88,128
80789,2020-04-09,16,58,128,186
80790,2020-04-09,17,57,157,214
80791,2020-04-09,18,72,144,216
80792,2020-04-09,19,41,112,153
80793,2020-04-09,20,18,37,55
80794,2020-04-09,21,9,21,30
80795,2020-04-09,22,3,7,10
80796,2020-04-09,23,4,6,10
80797,2020-04-10,0,4,3,7
80798,2020-04-10,4,1,1,2
80799,2020-04-10,5,2,9,11
80800,2020-04-10,6,7,37,44
80801,2020-04-10,7,20,65,85
80802,2020-04-10,8,17,75,92
80803,2020-04-10,9,15,42,57
80804,2020-04-10,10,9,59,68
80805,2020-04-10,11,11,54,65
80806,2020-04-10,12,29,71,100
80807,2020-04-10,13,27,77,104
80808,2020-04-10,14,36,74,110
80809,2020-04-10,15,50,70,120
80810,2020-04-10,16,36,98,134
80811,2020-04-10,17,50,138,188
80812,2020-04-10,18,40,110,150
80813,2020-04-10,19,46,82,128
80814,2020-04-10,20,16,36,52
80815,2020-04-10,21,10,25,35
80816,2020-04-10,22,14,21,35
80817,2020-04-10,23,2,14,16
80818,2020-04-11,0,3,2,5
80819,2020-04-11,1,1,4,5
80820,2020-04-11,2,0,3,3
80821,2020-04-11,3,3,0,3
80822,2020-04-11,4,1,1,2
80823,2020-04-11,5,0,5,5
80824,2020-04-11,6,1,18,19
80825,2020-04-11,7,9,29,38
80826,2020-04-11,8,13,48,61
80827,2020-04-11,9,32,77,109
80828,2020-04-11,10,49,110,159
80829,2020-04-11,11,96,121,217
80830,2020-04-11,12,153,156,309
80831,2020-04-11,13,181,199,380
80832,2020-04-11,14,217,237,454
80833,2020-04-11,15,253,246,499
80834,2020-04-11,16,249,269,518
80835,2020-04-11,17,188,269,457
80836,2020-04-11,18,150,211,361
80837,2020-04-11,19,87,151,238
80838,2020-04-11,20,39,66,105
80839,2020-04-11,21,23,48,71
80840,2020-04-11,22,16,28,44
80841,2020-04-11,23,9,14,23
80842,2020-04-12,0,6,8,14
80843,2020-04-12,2,2,0,2
80844,2020-04-12,4,2,1,3
80845,2020-04-12,5,2,8,10
80846,2020-04-12,6,7,19,26
80847,2020-04-12,7,13,48,61
80848,2020-04-12,8,15,53,68
80849,2020-04-12,9,30,85,115
80850,2020-04-12,10,54,96,150
80851,2020-04-12,11,73,135,208
80852,2020-04-12,12,104,155,259
80853,2020-04-12,13,138,179,317
80854,2020-04-12,14,187,229,416
80855,2020-04-12,15,222,258,480
80856,2020-04-12,16,173,272,445
80857,2020-04-12,17,128,179,307
80858,2020-04-12,18,72,96,168
80859,2020-04-12,19,45,71,116
80860,2020-04-12,20,8,27,35
80861,2020-04-12,21,10,15,25
80862,2020-04-12,22,9,11,20
80863,2020-04-12,23,5,3,8
80864,2020-04-13,0,0,1,1
80865,2020-04-13,1,0,1,1
80866,2020-04-13,4,1,1,2
80867,2020-04-13,5,1,3,4
80868,2020-04-13,6,3,9,12
80869,2020-04-13,7,2,9,11
80870,2020-04-13,8,3,20,23
80871,2020-04-13,9,4,26,30
80872,2020-04-13,10,9,39,48
80873,2020-04-13,11,7,39,46
80874,2020-04-13,12,10,39,49
80875,2020-04-13,13,11,48,59
80876,2020-04-13,14,28,70,98
80877,2020-04-13,15,37,40,77
80878,2020-04-13,16,55,128,183
80879,2020-04-13,17,107,193,300
80880,2020-04-13,18,118,245,363
80881,2020-04-13,19,84,160,244
80882,2020-04-13,20,28,62,90
80883,2020-04-13,21,17,44,61
80884,2020-04-13,22,10,14,24
80885,2020-04-13,23,4,7,11
80886,2020-04-14,0,2,1,3
80887,2020-04-14,1,2,0,2
80888,2020-04-14,2,3,1,4
80889,2020-04-14,4,1,4,5
80890,2020-04-14,5,5,9,14
80891,2020-04-14,6,7,41,48
80892,2020-04-14,7,13,70,83
80893,2020-04-14,8,19,71,90
80894,2020-04-14,9,17,54,71
80895,2020-04-14,10,19,53,72
80896,2020-04-14,11,27,73,100
80897,2020-04-14,12,38,115,153
80898,2020-04-14,13,46,113,159
80899,2020-04-14,14,44,94,138
80900,2020-04-14,15,50,100,150
80901,2020-04-14,16,77,130,207
80902,2020-04-14,17,117,173,290
80903,2020-04-14,18,93,182,275
80904,2020-04-14,19,43,84,127
80905,2020-04-14,20,16,38,54
80906,2020-04-14,21,6,23,29
80907,2020-04-14,22,3,8,11
80908,2020-04-14,23,0,3,3
80909,2020-04-15,0,1,0,1
80910,2020-04-15,1,0,1,1
80911,2020-04-15,2,0,1,1
80912,2020-04-15,3,2,0,2
80913,2020-04-15,4,1,0,1
80914,2020-04-15,5,0,4,4
80915,2020-04-15,6,4,22,26
80916,2020-04-15,7,11,52,63
80917,2020-04-15,8,13,85,98
80918,2020-04-15,9,18,49,67
80919,2020-04-15,10,19,39,58
80920,2020-04-15,11,20,69,89
80921,2020-04-15,12,32,96,128
80922,2020-04-15,13,38,105,143
80923,2020-04-15,14,43,92,135
80924,2020-04-15,15,59,124,183
80925,2020-04-15,16,87,143,230
80926,2020-04-15,17,86,199,285
80927,2020-04-15,18,100,245,345
80928,2020-04-15,19,87,156,243
80929,2020-04-15,20,27,63,90
80930,2020-04-15,21,7,47,54
80931,2020-04-15,22,7,13,20
80932,2020-04-15,23,6,11,17
80933,2020-04-16,0,2,7,9
80934,2020-04-16,2,0,2,2
80935,2020-04-16,4,1,4,5
80936,2020-04-16,5,1,10,11
80937,2020-04-16,6,6,45,51
80938,2020-04-16,7,7,63,70
80939,2020-04-16,8,18,71,89
80940,2020-04-16,9,12,48,60
80941,2020-04-16,10,21,57,78
80942,2020-04-16,11,21,77,98
80943,2020-04-16,12,36,91,127
80944,2020-04-16,13,37,100,137
80945,2020-04-16,14,55,80,135
80946,2020-04-16,15,51,103,154
80947,2020-04-16,16,49,126,175
80948,2020-04-16,17,91,151,242
80949,2020-04-16,18,95,190,285
80950,2020-04-16,19,63,125,188
80951,2020-04-16,20,20,51,71
80952,2020-04-16,21,12,31,43
80953,2020-04-16,22,10,16,26
80954,2020-04-16,23,6,19,25
80955,2020-04-17,0,0,3,3
80956,2020-04-17,1,0,1,1
80957,2020-04-17,2,1,1,2
80958,2020-04-17,3,1,0,1
80959,2020-04-17,4,3,2,5
80960,2020-04-17,5,4,3,7
80961,2020-04-17,6,6,31,37
80962,2020-04-17,7,8,42,50
80963,2020-04-17,8,18,74,92
80964,2020-04-17,9,19,49,68
80965,2020-04-17,10,21,51,72
80966,2020-04-17,11,21,67,88
80967,2020-04-17,12,25,103,128
80968,2020-04-17,13,50,117,167
80969,2020-04-17,14,43,100,143
80970,2020-04-17,15,56,113,169
80971,2020-04-17,16,65,147,212
80972,2020-04-17,17,86,182,268
80973,2020-04-17,18,100,162,262
80974,2020-04-17,19,59,137,196
80975,2020-04-17,20,32,68,100
80976,2020-04-17,21,19,29,48
80977,2020-04-17,22,5,20,25
80978,2020-04-17,23,9,23,32
80979,2020-04-18,0,4,12,16
80980,2020-04-18,1,5,4,9
80981,2020-04-18,2,2,2,4
80982,2020-04-18,3,0,3,3
80983,2020-04-18,4,4,1,5
80984,2020-04-18,5,3,2,5
80985,2020-04-18,6,1,6,7
80986,2020-04-18,7,1,19,20
80987,2020-04-18,8,7,23,30
80988,2020-04-18,9,6,27,33
80989,2020-04-18,10,15,34,49
80990,2020-04-18,11,35,82,117
80991,2020-04-18,12,58,103,161
80992,2020-04-18,13,77,138,215
80993,2020-04-18,14,129,173,302
80994,2020-04-18,15,160,190,350
80995,2020-04-18,16,146,210,356
80996,2020-04-18,17,126,186,312
80997,2020-04-18,18,96,152,248
80998,2020-04-18,19,61,143,204
80999,2020-04-18,20,30,69,99
81000,2020-04-18,21,22,19,41
81001,2020-04-18,22,11,18,29
81002,2020-04-18,23,15,8,23
81003,2020-04-19,0,1,10,11
81004,2020-04-19,1,1,6,7
81005,2020-04-19,2,2,8,10
81006,2020-04-19,3,1,0,1
81007,2020-04-19,4,2,6,8
81008,2020-04-19,5,2,9,11
81009,2020-04-19,6,11,11,22
81010,2020-04-19,7,9,23,32
81011,2020-04-19,8,18,56,74
81012,2020-04-19,9,35,78,113
81013,2020-04-19,10,65,108,173
81014,2020-04-19,11,127,167,294
81015,2020-04-19,12,249,247,496
81016,2020-04-19,13,294,319,613
81017,2020-04-19,14,292,278,570
81018,2020-04-19,15,358,292,650
81019,2020-04-19,16,248,243,491
81020,2020-04-19,17,208,222,430
81021,2020-04-19,18,134,155,289
81022,2020-04-19,19,84,104,188
81023,2020-04-19,20,50,45,95
81024,2020-04-19,21,24,25,49
81025,2020-04-19,22,16,18,34
81026,2020-04-19,23,13,17,30
81027,2020-04-20,0,0,6,6
81028,2020-04-20,1,3,1,4
81029,2020-04-20,2,1,0,1
81030,2020-04-20,3,1,0,1
81031,2020-04-20,4,2,2,4
81032,2020-04-20,5,7,8,15
81033,2020-04-20,6,8,37,45
81034,2020-04-20,7,11,64,75
81035,2020-04-20,8,25,81,106
81036,2020-04-20,9,26,54,80
81037,2020-04-20,10,15,59,74
81038,2020-04-20,11,26,57,83
81039,2020-04-20,12,44,79,123
81040,2020-04-20,13,42,95,137
81041,2020-04-20,14,43,75,118
81042,2020-04-20,15,68,104,172
81043,2020-04-20,16,84,120,204
81044,2020-04-20,17,118,176,294
81045,2020-04-20,18,131,225,356
81046,2020-04-20,19,87,138,225
81047,2020-04-20,20,34,69,103
81048,2020-04-20,21,18,32,50
81049,2020-04-20,22,9,21,30
81050,2020-04-20,23,7,12,19
81051,2020-04-21,0,1,3,4
81052,2020-04-21,1,2,1,3
81053,2020-04-21,2,2,0,2
81054,2020-04-21,3,1,0,1
81055,2020-04-21,4,4,4,8
81056,2020-04-21,5,2,5,7
81057,2020-04-21,6,10,36,46
81058,2020-04-21,7,18,66,84
81059,2020-04-21,8,21,83,104
81060,2020-04-21,9,18,71,89
81061,2020-04-21,10,18,53,71
81062,2020-04-21,11,21,80,101
81063,2020-04-21,12,38,91,129
81064,2020-04-21,13,24,69,93
81065,2020-04-21,14,28,40,68
81066,2020-04-21,15,30,63,93
81067,2020-04-21,16,51,91,142
81068,2020-04-21,17,120,134,254
81069,2020-04-21,18,99,164,263
81070,2020-04-21,19,64,124,188
81071,2020-04-21,20,24,63,87
81072,2020-04-21,21,6,25,31
81073,2020-04-21,22,12,12,24
81074,2020-04-21,23,5,12,17
81075,2020-04-22,0,3,2,5
81076,2020-04-22,1,1,0,1
81077,2020-04-22,2,0,1,1
81078,2020-04-22,4,2,4,6
81079,2020-04-22,5,3,10,13
81080,2020-04-22,6,7,34,41
81081,2020-04-22,7,17,55,72
81082,2020-04-22,8,18,75,93
81083,2020-04-22,9,26,50,76
81084,2020-04-22,10,30,49,79
81085,2020-04-22,11,31,80,111
81086,2020-04-22,12,52,106,158
81087,2020-04-22,13,56,110,166
81088,2020-04-22,14,71,116,187
81089,2020-04-22,15,77,113,190
81090,2020-04-22,16,91,144,235
81091,2020-04-22,17,162,242,404
81092,2020-04-22,18,157,230,387
81093,2020-04-22,19,96,169,265
81094,2020-04-22,20,38,85,123
81095,2020-04-22,21,22,42,64
81096,2020-04-22,22,10,15,25
81097,2020-04-22,23,5,12,17
81098,2020-04-23,0,7,1,8
81099,2020-04-23,1,4,2,6
81100,2020-04-23,2,1,0,1
81101,2020-04-23,3,1,0,1
81102,2020-04-23,4,1,4,5
81103,2020-04-23,5,4,10,14
81104,2020-04-23,6,10,44,54
81105,2020-04-23,7,19,74,93
81106,2020-04-23,8,32,97,129
81107,2020-04-23,9,25,44,69
81108,2020-04-23,10,27,64,91
81109,2020-04-23,11,42,82,124
81110,2020-04-23,12,41,103,144
81111,2020-04-23,13,45,110,155
81112,2020-04-23,14,26,66,92
81113,2020-04-23,15,10,41,51
81114,2020-04-23,16,21,37,58
81115,2020-04-23,17,16,39,55
81116,2020-04-23,18,18,35,53
81117,2020-04-23,19,7,21,28
81118,2020-04-23,20,4,14,18
81119,2020-04-23,21,3,8,11
81120,2020-04-23,22,2,5,7
81121,2020-04-23,23,4,4,8
81122,2020-04-24,0,6,1,7
81123,2020-04-24,1,2,0,2
81124,2020-04-24,3,6,1,7
81125,2020-04-24,4,1,2,3
81126,2020-04-24,5,0,1,1
81127,2020-04-24,6,3,11,14
81128,2020-04-24,7,3,22,25
81129,2020-04-24,8,10,31,41
81130,2020-04-24,9,10,40,50
81131,2020-04-24,10,12,37,49
81132,2020-04-24,11,17,59,76
81133,2020-04-24,12,30,75,105
81134,2020-04-24,13,29,82,111
81135,2020-04-24,14,35,67,102
81136,2020-04-24,15,46,87,133
81137,2020-04-24,16,47,141,188
81138,2020-04-24,17,87,183,270
81139,2020-04-24,18,92,176,268
81140,2020-04-24,19,50,117,167
81141,2020-04-24,20,39,73,112
81142,2020-04-24,21,18,22,40
81143,2020-04-24,22,12,23,35
81144,2020-04-24,23,7,24,31
81145,2020-04-25,0,13,14,27
81146,2020-04-25,1,2,8,10
81147,2020-04-25,2,3,3,6
81148,2020-04-25,3,1,1,2
81149,2020-04-25,4,1,1,2
81150,2020-04-25,5,3,2,5
81151,2020-04-25,6,2,13,15
81152,2020-04-25,7,22,30,52
81153,2020-04-25,8,25,51,76
81154,2020-04-25,9,38,90,128
81155,2020-04-25,10,74,138,212
81156,2020-04-25,11,102,163,265
81157,2020-04-25,12,186,233,419
81158,2020-04-25,13,323,291,614
81159,2020-04-25,14,326,360,686
81160,2020-04-25,15,322,331,653
81161,2020-04-25,16,292,275,567
81162,2020-04-25,17,205,217,422
81163,2020-04-25,18,113,162,275
81164,2020-04-25,19,71,99,170
81165,2020-04-25,20,18,40,58
81166,2020-04-25,21,13,17,30
81167,2020-04-25,22,7,12,19
81168,2020-04-25,23,8,5,13
81169,2020-04-26,0,3,6,9
81170,2020-04-26,1,3,3,6
81171,2020-04-26,2,2,9,11
81172,2020-04-26,3,1,3,4
81173,2020-04-26,4,4,3,7
81174,2020-04-26,5,1,3,4
81175,2020-04-26,6,1,10,11
81176,2020-04-26,7,12,18,30
81177,2020-04-26,8,3,17,20
81178,2020-04-26,9,7,33,40
81179,2020-04-26,10,29,58,87
81180,2020-04-26,11,21,73,94
81181,2020-04-26,12,31,78,109
81182,2020-04-26,13,61,133,194
81183,2020-04-26,14,90,152,242
81184,2020-04-26,15,94,151,245
81185,2020-04-26,16,85,127,212
81186,2020-04-26,17,66,102,168
81187,2020-04-26,18,60,98,158
81188,2020-04-26,19,21,48,69
81189,2020-04-26,20,8,29,37
81190,2020-04-26,21,9,23,32
81191,2020-04-26,22,8,19,27
81192,2020-04-26,23,5,20,25
81193,2020-04-27,0,5,5,10
81194,2020-04-27,4,1,1,2
81195,2020-04-27,5,4,5,9
81196,2020-04-27,6,10,22,32
81197,2020-04-27,7,11,60,71
81198,2020-04-27,8,7,71,78
81199,2020-04-27,9,19,48,67
81200,2020-04-27,10,19,46,65
81201,2020-04-27,11,25,59,84
81202,2020-04-27,12,34,90,124
81203,2020-04-27,13,36,77,113
81204,2020-04-27,14,36,83,119
81205,2020-04-27,15,42,86,128
81206,2020-04-27,16,60,112,172
81207,2020-04-27,17,69,161,230
81208,2020-04-27,18,98,197,295
81209,2020-04-27,19,78,173,251
81210,2020-04-27,20,35,66,101
81211,2020-04-27,21,18,36,54
81212,2020-04-27,22,14,19,33
81213,2020-04-27,23,5,7,12
81214,2020-04-28,0,8,3,11
81215,2020-04-28,1,1,2,3
81216,2020-04-28,2,5,2,7
81217,2020-04-28,4,4,1,5
81218,2020-04-28,5,3,11,14
81219,2020-04-28,6,6,44,50
81220,2020-04-28,7,22,61,83
81221,2020-04-28,8,26,93,119
81222,2020-04-28,9,24,60,84
81223,2020-04-28,10,24,58,82
81224,2020-04-28,11,41,102,143
81225,2020-04-28,12,45,109,154
81226,2020-04-28,13,26,68,94
81227,2020-04-28,14,20,56,76
81228,2020-04-28,15,26,66,92
81229,2020-04-28,16,35,91,126
81230,2020-04-28,17,50,115,165
81231,2020-04-28,18,49,103,152
81232,2020-04-28,19,30,68,98
81233,2020-04-28,20,14,44,58
81234,2020-04-28,21,11,22,33
81235,2020-04-28,22,15,10,25
81236,2020-04-28,23,6,11,17
81237,2020-04-29,0,2,3,5
81238,2020-04-29,1,4,2,6
81239,2020-04-29,2,2,0,2
81240,2020-04-29,3,2,1,3
81241,2020-04-29,4,2,1,3
81242,2020-04-29,5,2,11,13
81243,2020-04-29,6,13,37,50
81244,2020-04-29,7,16,72,88
81245,2020-04-29,8,28,85,113
81246,2020-04-29,9,34,70,104
81247,2020-04-29,10,19,71,90
81248,2020-04-29,11,69,82,151
81249,2020-04-29,12,69,145,214
81250,2020-04-29,13,101,134,235
81251,2020-04-29,14,88,153,241
81252,2020-04-29,15,125,128,253
81253,2020-04-29,16,147,222,369
81254,2020-04-29,17,245,338,583
81255,2020-04-29,18,247,327,574
81256,2020-04-29,19,144,214,358
81257,2020-04-29,20,55,100,155
81258,2020-04-29,21,23,42,65
81259,2020-04-29,22,19,29,48
81260,2020-04-29,23,6,29,35
81261,2020-04-30,0,10,10,20
81262,2020-04-30,1,4,1,5
81263,2020-04-30,2,0,2,2
81264,2020-04-30,4,4,3,7
81265,2020-04-30,5,4,22,26
81266,2020-04-30,6,3,44,47
81267,2020-04-30,7,18,76,94
81268,2020-04-30,8,27,61,88
81269,2020-04-30,9,3,25,28
81270,2020-04-30,10,6,15,21
81271,2020-04-30,11,2,10,12
81272,2020-04-30,12,6,8,14
81273,2020-04-30,13,4,14,18
81274,2020-04-30,14,5,11,16
81275,2020-04-30,15,4,13,17
81276,2020-04-30,16,9,25,34
81277,2020-04-30,17,17,23,40
81278,2020-04-30,18,16,61,77
81279,2020-04-30,19,20,51,71
81280,2020-04-30,20,20,52,72
81281,2020-04-30,21,22,22,44
81282,2020-04-30,22,5,6,11
81283,2020-04-30,23,5,12,17
81284,2020-05-01,0,2,7,9
81285,2020-05-01,2,4,0,4
81286,2020-05-01,3,0,1,1
81287,2020-05-01,4,3,1,4
81288,2020-05-01,5,5,5,10
81289,2020-05-01,6,6,28,34
81290,2020-05-01,7,14,64,78
81291,2020-05-01,8,14,56,70
81292,2020-05-01,9,7,25,32
81293,2020-05-01,10,18,46,64
81294,2020-05-01,11,30,84,114
81295,2020-05-01,12,56,125,181
81296,2020-05-01,13,72,148,220
81297,2020-05-01,14,95,143,238
81298,2020-05-01,15,112,161,273
81299,2020-05-01,16,113,205,318
81300,2020-05-01,17,140,239,379
81301,2020-05-01,18,143,213,356
81302,2020-05-01,19,116,176,292
81303,2020-05-01,20,46,87,133
81304,2020-05-01,21,28,48,76
81305,2020-05-01,22,21,31,52
81306,2020-05-01,23,6,24,30
81307,2020-05-02,0,6,15,21
81308,2020-05-02,1,5,10,15
81309,2020-05-02,2,7,2,9
81310,2020-05-02,3,3,3,6
81311,2020-05-02,4,1,3,4
81312,2020-05-02,5,7,10,17
81313,2020-05-02,6,10,23,33
81314,2020-05-02,7,26,41,67
81315,2020-05-02,8,24,74,98
81316,2020-05-02,9,74,109,183
81317,2020-05-02,10,183,175,358
81318,2020-05-02,11,415,352,767
81319,2020-05-02,12,418,422,840
81320,2020-05-02,13,577,372,949
81321,2020-05-02,14,662,423,1085
81322,2020-05-02,15,645,464,1109
81323,2020-05-02,16,625,403,1028
81324,2020-05-02,17,598,325,923
81325,2020-05-02,18,367,282,649
81326,2020-05-02,19,230,201,431
81327,2020-05-02,20,116,93,209
81328,2020-05-02,21,56,43,99
81329,2020-05-02,22,33,32,65
81330,2020-05-02,23,31,31,62
81331,2020-05-03,0,10,11,21
81332,2020-05-03,1,10,3,13
81333,2020-05-03,2,8,5,13
81334,2020-05-03,3,5,1,6
81335,2020-05-03,4,3,3,6
81336,2020-05-03,5,2,6,8
81337,2020-05-03,6,14,19,33
81338,2020-05-03,7,16,53,69
81339,2020-05-03,8,37,50,87
81340,2020-05-03,9,68,93,161
81341,2020-05-03,10,47,85,132
81342,2020-05-03,11,40,47,87
81343,2020-05-03,12,58,109,167
81344,2020-05-03,13,105,132,237
81345,2020-05-03,14,167,188,355
81346,2020-05-03,15,290,259,549
81347,2020-05-03,16,270,262,532
81348,2020-05-03,17,200,237,437
81349,2020-05-03,18,164,211,375
81350,2020-05-03,19,104,100,204
81351,2020-05-03,20,49,61,110
81352,2020-05-03,21,18,23,41
81353,2020-05-03,22,7,3,10
81354,2020-05-03,23,4,5,9
81355,2020-05-04,1,0,1,1
81356,2020-05-04,2,1,1,2
81357,2020-05-04,3,3,1,4
81358,2020-05-04,4,1,1,2
81359,2020-05-04,5,10,12,22
81360,2020-05-04,6,10,45,55
81361,2020-05-04,7,25,69,94
81362,2020-05-04,8,27,80,107
81363,2020-05-04,9,30,57,87
81364,2020-05-04,10,36,74,110
81365,2020-05-04,11,49,107,156
81366,2020-05-04,12,90,145,235
81367,2020-05-04,13,86,110,196
81368,2020-05-04,14,139,128,267
81369,2020-05-04,15,172,142,314
81370,2020-05-04,16,190,172,362
81371,2020-05-04,17,267,242,509
81372,2020-05-04,18,223,292,515
81373,2020-05-04,19,175,202,377
81374,2020-05-04,20,71,92,163
81375,2020-05-04,21,31,31,62
81376,2020-05-04,22,32,22,54
81377,2020-05-04,23,8,16,24
81378,2020-05-05,0,5,6,11
81379,2020-05-05,1,2,0,2
81380,2020-05-05,2,2,0,2
81381,2020-05-05,3,2,1,3
81382,2020-05-05,4,1,5,6
81383,2020-05-05,5,9,15,24
81384,2020-05-05,6,7,46,53
81385,2020-05-05,7,30,94,124
81386,2020-05-05,8,22,89,111
81387,2020-05-05,9,21,83,104
81388,2020-05-05,10,32,66,98
81389,2020-05-05,11,38,74,112
81390,2020-05-05,12,67,97,164
81391,2020-05-05,13,60,105,165
81392,2020-05-05,14,60,90,150
81393,2020-05-05,15,89,98,187
81394,2020-05-05,16,76,128,204
81395,2020-05-05,17,107,187,294
81396,2020-05-05,18,101,201,302
81397,2020-05-05,19,70,115,185
81398,2020-05-05,20,13,29,42
81399,2020-05-05,21,5,8,13
81400,2020-05-05,22,3,5,8
81401,2020-05-05,23,3,7,10
81402,2020-05-06,0,4,4,8
81403,2020-05-06,1,4,4,8
81404,2020-05-06,3,3,0,3
81405,2020-05-06,4,3,3,6
81406,2020-05-06,5,7,13,20
81407,2020-05-06,6,6,25,31
81408,2020-05-06,7,10,34,44
81409,2020-05-06,8,4,37,41
81410,2020-05-06,9,9,20,29
81411,2020-05-06,10,11,30,41
81412,2020-05-06,11,11,43,54
81413,2020-05-06,12,17,31,48
81414,2020-05-06,13,17,33,50
81415,2020-05-06,14,14,42,56
81416,2020-05-06,15,25,53,78
81417,2020-05-06,16,46,93,139
81418,2020-05-06,17,63,127,190
81419,2020-05-06,18,83,148,231
81420,2020-05-06,19,53,112,165
81421,2020-05-06,20,22,56,78
81422,2020-05-06,21,9,22,31
81423,2020-05-06,22,8,16,24
81424,2020-05-06,23,2,8,10
81425,2020-05-07,0,1,1,2
81426,2020-05-07,1,1,0,1
81427,2020-05-07,2,0,1,1
81428,2020-05-07,3,2,0,2
81429,2020-05-07,4,3,5,8
81430,2020-05-07,5,7,14,21
81431,2020-05-07,6,9,39,48
81432,2020-05-07,7,21,89,110
81433,2020-05-07,8,38,100,138
81434,2020-05-07,9,30,76,106
81435,2020-05-07,10,41,66,107
81436,2020-05-07,11,48,89,137
81437,2020-05-07,12,95,118,213
81438,2020-05-07,13,107,117,224
81439,2020-05-07,14,113,132,245
81440,2020-05-07,15,166,135,301
81441,2020-05-07,16,191,192,383
81442,2020-05-07,17,248,331,579
81443,2020-05-07,18,255,305,560
81444,2020-05-07,19,136,252,388
81445,2020-05-07,20,76,111,187
81446,2020-05-07,21,29,59,88
81447,2020-05-07,22,14,36,50
81448,2020-05-07,23,13,22,35
81449,2020-05-08,0,5,5,10
81450,2020-05-08,1,0,3,3
81451,2020-05-08,2,6,0,6
81452,2020-05-08,3,4,0,4
81453,2020-05-08,4,6,3,9
81454,2020-05-08,5,8,16,24
81455,2020-05-08,6,7,36,43
81456,2020-05-08,7,24,70,94
81457,2020-05-08,8,29,94,123
81458,2020-05-08,9,29,76,105
81459,2020-05-08,10,50,109,159
81460,2020-05-08,11,48,108,156
81461,2020-05-08,12,53,144,197
81462,2020-05-08,13,59,122,181
81463,2020-05-08,14,55,64,119
81464,2020-05-08,15,40,61,101
81465,2020-05-08,16,31,50,81
81466,2020-05-08,17,35,70,105
81467,2020-05-08,18,29,68,97
81468,2020-05-08,19,23,68,91
81469,2020-05-08,20,9,48,57
81470,2020-05-08,21,7,14,21
81471,2020-05-08,22,3,10,13
81472,2020-05-08,23,8,11,19
81473,2020-05-09,0,12,12,24
81474,2020-05-09,1,2,4,6
81475,2020-05-09,2,1,5,6
81476,2020-05-09,3,2,1,3
81477,2020-05-09,4,3,2,5
81478,2020-05-09,5,4,9,13
81479,2020-05-09,6,8,18,26
81480,2020-05-09,7,11,32,43
81481,2020-05-09,8,31,48,79
81482,2020-05-09,9,37,48,85
81483,2020-05-09,10,47,111,158
81484,2020-05-09,11,65,115,180
81485,2020-05-09,12,113,158,271
81486,2020-05-09,13,144,122,266
81487,2020-05-09,14,159,164,323
81488,2020-05-09,15,172,164,336
81489,2020-05-09,16,141,116,257
81490,2020-05-09,17,122,147,269
81491,2020-05-09,18,79,127,206
81492,2020-05-09,19,75,96,171
81493,2020-05-09,20,40,35,75
81494,2020-05-09,21,16,30,46
81495,2020-05-09,22,21,17,38
81496,2020-05-09,23,7,19,26
81497,2020-05-10,0,10,6,16
81498,2020-05-10,1,5,2,7
81499,2020-05-10,2,3,3,6
81500,2020-05-10,3,3,1,4
81501,2020-05-10,4,1,5,6
81502,2020-05-10,5,1,6,7
81503,2020-05-10,6,7,17,24
81504,2020-05-10,7,9,38,47
81505,2020-05-10,8,29,56,85
81506,2020-05-10,9,41,100,141
81507,2020-05-10,10,78,123,201
81508,2020-05-10,11,187,146,333
81509,2020-05-10,12,272,235,507
81510,2020-05-10,13,358,270,628
81511,2020-05-10,14,403,381,784
81512,2020-05-10,15,368,356,724
81513,2020-05-10,16,351,325,676
81514,2020-05-10,17,324,271,595
81515,2020-05-10,18,226,220,446
81516,2020-05-10,19,154,124,278
81517,2020-05-10,20,72,82,154
81518,2020-05-10,21,51,31,82
81519,2020-05-10,22,16,28,44
81520,2020-05-10,23,13,19,32
81521,2020-05-11,0,2,4,6
81522,2020-05-11,1,5,2,7
81523,2020-05-11,2,3,2,5
81524,2020-05-11,3,3,2,5
81525,2020-05-11,4,2,0,2
81526,2020-05-11,5,5,6,11
81527,2020-05-11,6,9,28,37
81528,2020-05-11,7,20,69,89
81529,2020-05-11,8,31,87,118
81530,2020-05-11,9,34,77,111
81531,2020-05-11,10,35,59,94
81532,2020-05-11,11,44,65,109
81533,2020-05-11,12,55,108,163
81534,2020-05-11,13,48,93,141
81535,2020-05-11,14,64,73,137
81536,2020-05-11,15,85,93,178
81537,2020-05-11,16,102,114,216
81538,2020-05-11,17,101,151,252
81539,2020-05-11,18,115,157,272
81540,2020-05-11,19,49,112,161
81541,2020-05-11,20,16,42,58
81542,2020-05-11,21,15,20,35
81543,2020-05-11,22,18,16,34
81544,2020-05-11,23,13,5,18
81545,2020-05-12,0,2,3,5
81546,2020-05-12,1,5,1,6
81547,2020-05-12,2,2,0,2
81548,2020-05-12,3,5,0,5
81549,2020-05-12,4,1,4,5
81550,2020-05-12,5,7,17,24
81551,2020-05-12,6,6,49,55
81552,2020-05-12,7,20,81,101
81553,2020-05-12,8,20,88,108
81554,2020-05-12,9,14,77,91
81555,2020-05-12,10,30,63,93
81556,2020-05-12,11,41,75,116
81557,2020-05-12,12,48,120,168
81558,2020-05-12,13,54,122,176
81559,2020-05-12,14,90,126,216
81560,2020-05-12,15,94,125,219
81561,2020-05-12,16,124,155,279
81562,2020-05-12,17,149,239,388
81563,2020-05-12,18,164,220,384
81564,2020-05-12,19,130,165,295
81565,2020-05-12,20,81,94,175
81566,2020-05-12,21,29,32,61
81567,2020-05-12,22,17,11,28
81568,2020-05-12,23,8,20,28
81569,2020-05-13,0,4,5,9
81570,2020-05-13,1,2,2,4
81571,2020-05-13,2,0,1,1
81572,2020-05-13,3,4,3,7
81573,2020-05-13,4,6,2,8
81574,2020-05-13,5,8,19,27
81575,2020-05-13,6,8,42,50
81576,2020-05-13,7,15,58,73
81577,2020-05-13,8,28,108,136
81578,2020-05-13,9,40,84,124
81579,2020-05-13,10,39,76,115
81580,2020-05-13,11,63,96,159
81581,2020-05-13,12,80,133,213
81582,2020-05-13,13,108,122,230
81583,2020-05-13,14,146,157,303
81584,2020-05-13,15,168,157,325
81585,2020-05-13,16,202,197,399
81586,2020-05-13,17,297,291,588
81587,2020-05-13,18,254,327,581
81588,2020-05-13,19,193,228,421
81589,2020-05-13,20,77,129,206
81590,2020-05-13,21,43,45,88
81591,2020-05-13,22,25,20,45
81592,2020-05-13,23,14,18,32
81593,2020-05-14,0,3,10,13
81594,2020-05-14,1,3,4,7
81595,2020-05-14,2,2,3,5
81596,2020-05-14,3,1,1,2
81597,2020-05-14,4,1,4,5
81598,2020-05-14,5,8,19,27
81599,2020-05-14,6,17,46,63
81600,2020-05-14,7,23,71,94
81601,2020-05-14,8,28,100,128
81602,2020-05-14,9,37,74,111
81603,2020-05-14,10,49,69,118
81604,2020-05-14,11,65,95,160
81605,2020-05-14,12,79,127,206
81606,2020-05-14,13,92,153,245
81607,2020-05-14,14,116,111,227
81608,2020-05-14,15,92,106,198
81609,2020-05-14,16,147,166,313
81610,2020-05-14,17,219,253,472
81611,2020-05-14,18,214,288,502
81612,2020-05-14,19,172,224,396
81613,2020-05-14,20,76,101,177
81614,2020-05-14,21,34,45,79
81615,2020-05-14,22,20,16,36
81616,2020-05-14,23,9,17,26
81617,2020-05-15,0,6,7,13
81618,2020-05-15,1,6,6,12
81619,2020-05-15,2,3,7,10
81620,2020-05-15,3,2,0,2
81621,2020-05-15,4,4,2,6
81622,2020-05-15,5,7,17,24
81623,2020-05-15,6,20,55,75
81624,2020-05-15,7,32,80,112
81625,2020-05-15,8,44,116,160
81626,2020-05-15,9,44,99,143
81627,2020-05-15,10,75,96,171
81628,2020-05-15,11,90,138,228
81629,2020-05-15,12,136,151,287
81630,2020-05-15,13,188,156,344
81631,2020-05-15,14,226,177,403
81632,2020-05-15,15,256,206,462
81633,2020-05-15,16,310,260,570
81634,2020-05-15,17,414,315,729
81635,2020-05-15,18,385,295,680
81636,2020-05-15,19,291,281,572
81637,2020-05-15,20,230,181,411
81638,2020-05-15,21,109,81,190
81639,2020-05-15,22,69,45,114
81640,2020-05-15,23,67,33,100
81641,2020-05-16,0,30,21,51
81642,2020-05-16,1,17,14,31
81643,2020-05-16,2,16,13,29
81644,2020-05-16,3,11,5,16
81645,2020-05-16,4,3,3,6
81646,2020-05-16,5,5,12,17
81647,2020-05-16,6,21,38,59
81648,2020-05-16,7,26,54,80
81649,2020-05-16,8,75,96,171
81650,2020-05-16,9,137,141,278
81651,2020-05-16,10,220,194,414
81652,2020-05-16,11,289,242,531
81653,2020-05-16,12,389,302,691
81654,2020-05-16,13,545,292,837
81655,2020-05-16,14,612,324,936
81656,2020-05-16,15,610,371,981
81657,2020-05-16,16,597,348,945
81658,2020-05-16,17,479,331,810
81659,2020-05-16,18,417,315,732
81660,2020-05-16,19,315,246,561
81661,2020-05-16,20,183,180,363
81662,2020-05-16,21,124,97,221
81663,2020-05-16,22,92,43,135
81664,2020-05-16,23,88,33,121
81665,2020-05-17,0,49,19,68
81666,2020-05-17,1,25,12,37
81667,2020-05-17,2,2,8,10
81668,2020-05-17,3,4,8,12
81669,2020-05-17,4,5,5,10
81670,2020-05-17,5,7,7,14
81671,2020-05-17,6,15,19,34
81672,2020-05-17,7,20,41,61
81673,2020-05-17,8,36,98,134
81674,2020-05-17,9,81,125,206
81675,2020-05-17,10,150,125,275
81676,2020-05-17,11,175,133,308
81677,2020-05-17,12,252,219,471
81678,2020-05-17,13,274,252,526
81679,2020-05-17,14,382,247,629
81680,2020-05-17,15,328,294,622
81681,2020-05-17,16,316,275,591
81682,2020-05-17,17,261,242,503
81683,2020-05-17,18,269,197,466
81684,2020-05-17,19,197,131,328
81685,2020-05-17,20,89,74,163
81686,2020-05-17,21,50,37,87
81687,2020-05-17,22,30,27,57
81688,2020-05-17,23,26,19,45
81689,2020-05-18,0,7,9,16
81690,2020-05-18,1,9,2,11
81691,2020-05-18,2,1,1,2
81692,2020-05-18,3,3,0,3
81693,2020-05-18,4,5,4,9
81694,2020-05-18,5,2,19,21
81695,2020-05-18,6,10,43,53
81696,2020-05-18,7,23,68,91
81697,2020-05-18,8,24,102,126
81698,2020-05-18,9,43,78,121
81699,2020-05-18,10,26,74,100
81700,2020-05-18,11,36,76,112
81701,2020-05-18,12,58,97,155
81702,2020-05-18,13,86,94,180
81703,2020-05-18,14,78,112,190
81704,2020-05-18,15,89,119,208
81705,2020-05-18,16,96,132,228
81706,2020-05-18,17,176,177,353
81707,2020-05-18,18,152,212,364
81708,2020-05-18,19,118,150,268
81709,2020-05-18,20,61,82,143
81710,2020-05-18,21,45,45,90
81711,2020-05-18,22,21,28,49
81712,2020-05-18,23,22,26,48
81713,2020-05-19,0,9,4,13
81714,2020-05-19,1,4,4,8
81715,2020-05-19,2,3,1,4
81716,2020-05-19,3,2,6,8
81717,2020-05-19,4,1,2,3
81718,2020-05-19,5,6,16,22
81719,2020-05-19,6,9,47,56
81720,2020-05-19,7,28,96,124
81721,2020-05-19,8,33,104,137
81722,2020-05-19,9,31,67,98
81723,2020-05-19,10,35,80,115
81724,2020-05-19,11,59,109,168
81725,2020-05-19,12,96,134,230
81726,2020-05-19,13,119,111,230
81727,2020-05-19,14,106,136,242
81728,2020-05-19,15,127,136,263
81729,2020-05-19,16,116,158,274
81730,2020-05-19,17,157,207,364
81731,2020-05-19,18,140,209,349
81732,2020-05-19,19,103,109,212
81733,2020-05-19,20,61,66,127
81734,2020-05-19,21,47,34,81
81735,2020-05-19,22,23,19,42
81736,2020-05-19,23,14,17,31
81737,2020-05-20,0,5,8,13
81738,2020-05-20,1,1,0,1
81739,2020-05-20,3,4,0,4
81740,2020-05-20,4,1,1,2
81741,2020-05-20,5,8,18,26
81742,2020-05-20,6,16,49,65
81743,2020-05-20,7,33,85,118
81744,2020-05-20,8,33,93,126
81745,2020-05-20,9,40,70,110
81746,2020-05-20,10,47,65,112
81747,2020-05-20,11,46,97,143
81748,2020-05-20,12,62,85,147
81749,2020-05-20,13,76,102,178
81750,2020-05-20,14,91,121,212
81751,2020-05-20,15,118,118,236
81752,2020-05-20,16,144,179,323
81753,2020-05-20,17,164,202,366
81754,2020-05-20,18,245,269,514
81755,2020-05-20,19,163,206,369
81756,2020-05-20,20,75,116,191
81757,2020-05-20,21,29,42,71
81758,2020-05-20,22,17,34,51
81759,2020-05-20,23,18,20,38
81760,2020-05-21,0,8,11,19
81761,2020-05-21,1,4,3,7
81762,2020-05-21,2,7,0,7
81763,2020-05-21,4,2,2,4
81764,2020-05-21,5,5,12,17
81765,2020-05-21,6,15,37,52
81766,2020-05-21,7,29,89,118
81767,2020-05-21,8,42,98,140
81768,2020-05-21,9,40,64,104
81769,2020-05-21,10,51,69,120
81770,2020-05-21,11,68,82,150
81771,2020-05-21,12,85,106,191
81772,2020-05-21,13,103,110,213
81773,2020-05-21,14,117,125,242
81774,2020-05-21,15,113,134,247
81775,2020-05-21,16,146,183,329
81776,2020-05-21,17,261,255,516
81777,2020-05-21,18,223,276,499
81778,2020-05-21,19,165,181,346
81779,2020-05-21,20,74,102,176
81780,2020-05-21,21,54,68,122
81781,2020-05-21,22,32,42,74
81782,2020-05-21,23,15,21,36
81783,2020-05-22,0,5,12,17
81784,2020-05-22,1,2,10,12
81785,2020-05-22,2,14,3,17
81786,2020-05-22,3,2,2,4
81787,2020-05-22,4,3,5,8
81788,2020-05-22,5,4,6,10
81789,2020-05-22,6,5,31,36
81790,2020-05-22,7,11,24,35
81791,2020-05-22,8,8,28,36
81792,2020-05-22,9,6,24,30
81793,2020-05-22,10,20,43,63
81794,2020-05-22,11,21,65,86
81795,2020-05-22,12,34,43,77
81796,2020-05-22,13,24,43,67
81797,2020-05-22,14,47,63,110
81798,2020-05-22,15,112,150,262
81799,2020-05-22,16,171,232,403
81800,2020-05-22,17,212,287,499
81801,2020-05-22,18,236,254,490
81802,2020-05-22,19,167,174,341
81803,2020-05-22,20,95,115,210
81804,2020-05-22,21,65,59,124
81805,2020-05-22,22,32,34,66
81806,2020-05-22,23,29,26,55
81807,2020-05-23,0,25,21,46
81808,2020-05-23,1,5,7,12
81809,2020-05-23,2,2,4,6
81810,2020-05-23,3,4,3,7
81811,2020-05-23,4,5,1,6
81812,2020-05-23,5,3,9,12
81813,2020-05-23,6,6,24,30
81814,2020-05-23,7,21,38,59
81815,2020-05-23,8,46,73,119
81816,2020-05-23,9,100,129,229
81817,2020-05-23,10,199,193,392
81818,2020-05-23,11,339,263,602
81819,2020-05-23,12,495,323,818
81820,2020-05-23,13,529,366,895
81821,2020-05-23,14,627,340,967
81822,2020-05-23,15,664,332,996
81823,2020-05-23,16,519,344,863
81824,2020-05-23,17,534,312,846
81825,2020-05-23,18,486,287,773
81826,2020-05-23,19,381,234,615
81827,2020-05-23,20,217,174,391
81828,2020-05-23,21,105,89,194
81829,2020-05-23,22,120,59,179
81830,2020-05-23,23,61,51,112
81831,2020-05-24,0,33,27,60
81832,2020-05-24,1,34,18,52
81833,2020-05-24,2,14,7,21
81834,2020-05-24,3,5,2,7
81835,2020-05-24,4,1,3,4
81836,2020-05-24,5,8,12,20
81837,2020-05-24,6,11,31,42
81838,2020-05-24,7,23,35,58
81839,2020-05-24,8,42,63,105
81840,2020-05-24,9,82,113,195
81841,2020-05-24,10,136,149,285
81842,2020-05-24,11,190,192,382
81843,2020-05-24,12,291,185,476
81844,2020-05-24,13,337,252,589
81845,2020-05-24,14,438,266,704
81846,2020-05-24,15,425,291,716
81847,2020-05-24,16,424,281,705
81848,2020-05-24,17,362,254,616
81849,2020-05-24,18,287,191,478
81850,2020-05-24,19,210,149,359
81851,2020-05-24,20,94,102,196
81852,2020-05-24,21,63,64,127
81853,2020-05-24,22,45,34,79
81854,2020-05-24,23,35,26,61
81855,2020-05-25,0,20,19,39
81856,2020-05-25,1,14,7,21
81857,2020-05-25,2,7,5,12
81858,2020-05-25,3,20,3,23
81859,2020-05-25,4,3,4,7
81860,2020-05-25,5,10,9,19
81861,2020-05-25,6,25,21,46
81862,2020-05-25,7,45,30,75
81863,2020-05-25,8,41,74,115
81864,2020-05-25,9,101,103,204
81865,2020-05-25,10,166,153,319
81866,2020-05-25,11,315,215,530
81867,2020-05-25,12,404,293,697
81868,2020-05-25,13,545,341,886
81869,2020-05-25,14,573,340,913
81870,2020-05-25,15,626,348,974
81871,2020-05-25,16,618,363,981
81872,2020-05-25,17,538,345,883
81873,2020-05-25,18,509,287,796
81874,2020-05-25,19,356,214,570
81875,2020-05-25,20,221,169,390
81876,2020-05-25,21,125,70,195
81877,2020-05-25,22,65,34,99
81878,2020-05-25,23,32,27,59
81879,2020-05-26,0,29,8,37
81880,2020-05-26,1,18,4,22
81881,2020-05-26,2,5,3,8
81882,2020-05-26,3,2,1,3
81883,2020-05-26,4,4,5,9
81884,2020-05-26,5,14,18,32
81885,2020-05-26,6,20,53,73
81886,2020-05-26,7,40,80,120
81887,2020-05-26,8,51,114,165
81888,2020-05-26,9,51,98,149
81889,2020-05-26,10,63,93,156
81890,2020-05-26,11,81,122,203
81891,2020-05-26,12,126,137,263
81892,2020-05-26,13,135,150,285
81893,2020-05-26,14,163,180,343
81894,2020-05-26,15,170,158,328
81895,2020-05-26,16,220,168,388
81896,2020-05-26,17,323,269,592
81897,2020-05-26,18,325,306,631
81898,2020-05-26,19,275,225,500
81899,2020-05-26,20,162,182,344
81900,2020-05-26,21,80,65,145
81901,2020-05-26,22,53,29,82
81902,2020-05-26,23,28,20,48
81903,2020-05-27,0,24,7,31
81904,2020-05-27,1,4,2,6
81905,2020-05-27,2,7,1,8
81906,2020-05-27,3,3,1,4
81907,2020-05-27,4,5,5,10
81908,2020-05-27,5,9,26,35
81909,2020-05-27,6,24,58,82
81910,2020-05-27,7,27,106,133
81911,2020-05-27,8,44,131,175
81912,2020-05-27,9,60,121,181
81913,2020-05-27,10,63,92,155
81914,2020-05-27,11,92,110,202
81915,2020-05-27,12,94,144,238
81916,2020-05-27,13,132,142,274
81917,2020-05-27,14,163,134,297
81918,2020-05-27,15,146,149,295
81919,2020-05-27,16,166,163,329
81920,2020-05-27,17,255,313,568
81921,2020-05-27,18,328,303,631
81922,2020-05-27,19,264,269,533
81923,2020-05-27,20,151,190,341
81924,2020-05-27,21,75,71,146
81925,2020-05-27,22,44,30,74
81926,2020-05-27,23,31,22,53
81927,2020-05-28,0,13,6,19
81928,2020-05-28,1,8,5,13
81929,2020-05-28,2,6,3,9
81930,2020-05-28,3,1,2,3
81931,2020-05-28,4,3,6,9
81932,2020-05-28,5,10,23,33
81933,2020-05-28,6,20,47,67
81934,2020-05-28,7,36,73,109
81935,2020-05-28,8,40,86,126
81936,2020-05-28,9,20,56,76
81937,2020-05-28,10,27,45,72
81938,2020-05-28,11,45,64,109
81939,2020-05-28,12,56,101,157
81940,2020-05-28,13,49,108,157
81941,2020-05-28,14,68,92,160
81942,2020-05-28,15,73,88,161
81943,2020-05-28,16,131,162,293
81944,2020-05-28,17,162,233,395
81945,2020-05-28,18,261,248,509
81946,2020-05-28,19,197,209,406
81947,2020-05-28,20,154,133,287
81948,2020-05-28,21,95,82,177
81949,2020-05-28,22,38,33,71
81950,2020-05-28,23,34,19,53
81951,2020-05-29,0,18,8,26
81952,2020-05-29,1,7,4,11
81953,2020-05-29,2,12,4,16
81954,2020-05-29,3,6,1,7
81955,2020-05-29,4,3,2,5
81956,2020-05-29,5,11,15,26
81957,2020-05-29,6,26,79,105
81958,2020-05-29,7,40,83,123
81959,2020-05-29,8,49,112,161
81960,2020-05-29,9,61,121,182
81961,2020-05-29,10,72,105,177
81962,2020-05-29,11,80,109,189
81963,2020-05-29,12,134,164,298
81964,2020-05-29,13,161,154,315
81965,2020-05-29,14,177,162,339
81966,2020-05-29,15,178,185,363
81967,2020-05-29,16,208,222,430
81968,2020-05-29,17,310,263,573
81969,2020-05-29,18,289,274,563
81970,2020-05-29,19,324,295,619
81971,2020-05-29,20,234,186,420
81972,2020-05-29,21,172,115,287
81973,2020-05-29,22,147,86,233
81974,2020-05-29,23,84,63,147
81975,2020-05-30,0,51,27,78
81976,2020-05-30,1,31,16,47
81977,2020-05-30,2,26,12,38
81978,2020-05-30,3,8,10,18
81979,2020-05-30,4,6,1,7
81980,2020-05-30,5,5,9,14
81981,2020-05-30,6,22,35,57
81982,2020-05-30,7,47,61,108
81983,2020-05-30,8,72,103,175
81984,2020-05-30,9,173,171,344
81985,2020-05-30,10,202,217,419
81986,2020-05-30,11,342,227,569
81987,2020-05-30,12,410,306,716
81988,2020-05-30,13,564,355,919
81989,2020-05-30,14,613,361,974
81990,2020-05-30,15,597,355,952
81991,2020-05-30,16,614,396,1010
81992,2020-05-30,17,530,343,873
81993,2020-05-30,18,524,375,899
81994,2020-05-30,19,561,314,875
81995,2020-05-30,20,409,224,633
81996,2020-05-30,21,271,160,431
81997,2020-05-30,22,203,106,309
81998,2020-05-30,23,200,71,271
81999,2020-05-31,0,168,61,229
82000,2020-05-31,1,74,24,98
82001,2020-05-31,2,35,12,47
82002,2020-05-31,3,4,5,9
82003,2020-05-31,4,7,7,14
82004,2020-05-31,5,11,6,17
82005,2020-05-31,6,7,20,27
82006,2020-05-31,7,49,54,103
82007,2020-05-31,8,67,94,161
82008,2020-05-31,9,130,161,291
82009,2020-05-31,10,253,215,468
82010,2020-05-31,11,372,312,684
82011,2020-05-31,12,453,359,812
82012,2020-05-31,13,621,369,990
82013,2020-05-31,14,730,427,1157
82014,2020-05-31,15,742,445,1187
82015,2020-05-31,16,427,239,666
82016,2020-05-31,17,156,52,208
82017,2020-05-31,18,111,41,152
82018,2020-05-31,19,108,35,143
82019,2020-05-31,20,82,24,106
82020,2020-05-31,21,28,6,34
82021,2020-05-31,22,5,0,5
82022,2020-05-31,23,2,2,4
82023,2020-06-01,0,6,3,9
82024,2020-06-01,1,5,0,5
82025,2020-06-01,2,1,0,1
82026,2020-06-01,4,0,1,1
82027,2020-06-01,5,1,2,3
82028,2020-06-01,6,28,61,89
82029,2020-06-01,7,60,87,147
82030,2020-06-01,8,63,152,215
82031,2020-06-01,9,77,120,197
82032,2020-06-01,10,75,109,184
82033,2020-06-01,11,100,134,234
82034,2020-06-01,12,152,171,323
82035,2020-06-01,13,174,195,369
82036,2020-06-01,14,181,198,379
82037,2020-06-01,15,247,205,452
82038,2020-06-01,16,303,274,577
82039,2020-06-01,17,443,417,860
82040,2020-06-01,18,409,349,758
82041,2020-06-01,19,71,33,104
82042,2020-06-01,20,34,17,51
82043,2020-06-01,21,34,8,42
82044,2020-06-01,22,6,3,9
82045,2020-06-01,23,4,0,4
82046,2020-06-02,0,2,0,2
82047,2020-06-02,2,0,1,1
82048,2020-06-02,3,0,1,1
82049,2020-06-02,4,1,0,1
82050,2020-06-02,5,2,2,4
82051,2020-06-02,6,34,70,104
82052,2020-06-02,7,57,109,166
82053,2020-06-02,8,72,118,190
82054,2020-06-02,9,80,104,184
82055,2020-06-02,10,75,112,187
82056,2020-06-02,11,96,142,238
82057,2020-06-02,12,134,157,291
82058,2020-06-02,13,150,170,320
82059,2020-06-02,14,192,192,384
82060,2020-06-02,15,302,189,491
82061,2020-06-02,16,415,299,714
82062,2020-06-02,17,507,400,907
82063,2020-06-02,18,554,390,944
82064,2020-06-02,19,77,46,123
82065,2020-06-02,20,43,25,68
82066,2020-06-02,21,33,10,43
82067,2020-06-02,22,9,1,10
82068,2020-06-02,23,11,1,12
82069,2020-06-03,0,4,0,4
82070,2020-06-03,1,4,1,5
82071,2020-06-03,2,3,0,3
82072,2020-06-03,4,1,0,1
82073,2020-06-03,5,4,2,6
82074,2020-06-03,6,33,57,90
82075,2020-06-03,7,63,103,166
82076,2020-06-03,8,91,142,233
82077,2020-06-03,9,98,106,204
82078,2020-06-03,10,126,103,229
82079,2020-06-03,11,118,119,237
82080,2020-06-03,12,166,175,341
82081,2020-06-03,13,169,150,319
82082,2020-06-03,14,202,162,364
82083,2020-06-03,15,219,165,384
82084,2020-06-03,16,314,232,546
82085,2020-06-03,17,395,353,748
82086,2020-06-03,18,465,314,779
82087,2020-06-03,19,417,293,710
82088,2020-06-03,20,363,203,566
82089,2020-06-03,21,254,136,390
82090,2020-06-03,22,142,43,185
82091,2020-06-03,23,2,3,5
82092,2020-06-04,0,2,1,3
82093,2020-06-04,1,1,0,1
82094,2020-06-04,5,6,1,7
82095,2020-06-04,6,35,58,93
82096,2020-06-04,7,57,101,158
82097,2020-06-04,8,65,153,218
82098,2020-06-04,9,77,117,194
82099,2020-06-04,10,100,105,205
82100,2020-06-04,11,135,131,266
82101,2020-06-04,12,155,157,312
82102,2020-06-04,13,143,122,265
82103,2020-06-04,14,180,115,295
82104,2020-06-04,15,200,175,375
82105,2020-06-04,16,242,210,452
82106,2020-06-04,17,366,298,664
82107,2020-06-04,18,380,327,707
82108,2020-06-04,19,335,264,599
82109,2020-06-04,20,82,39,121
82110,2020-06-04,21,54,35,89
82111,2020-06-04,22,62,39,101
82112,2020-06-04,23,22,18,40
82113,2020-06-05,0,4,8,12
82114,2020-06-05,1,2,0,2
82115,2020-06-05,2,6,3,9
82116,2020-06-05,3,5,1,6
82117,2020-06-05,4,6,2,8
82118,2020-06-05,5,14,8,22
82119,2020-06-05,6,34,55,89
82120,2020-06-05,7,60,114,174
82121,2020-06-05,8,71,134,205
82122,2020-06-05,9,96,111,207
82123,2020-06-05,10,117,149,266
82124,2020-06-05,11,144,149,293
82125,2020-06-05,12,182,201,383
82126,2020-06-05,13,215,173,388
82127,2020-06-05,14,234,172,406
82128,2020-06-05,15,232,227,459
82129,2020-06-05,16,296,286,582
82130,2020-06-05,17,335,355,690
82131,2020-06-05,18,145,149,294
82132,2020-06-05,19,49,36,85
82133,2020-06-05,20,45,44,89
82134,2020-06-05,21,94,63,157
82135,2020-06-05,22,69,42,111
82136,2020-06-05,23,69,38,107
82137,2020-06-06,0,25,27,52
82138,2020-06-06,1,20,11,31
82139,2020-06-06,2,16,8,24
82140,2020-06-06,3,7,5,12
82141,2020-06-06,4,8,4,12
82142,2020-06-06,5,14,20,34
82143,2020-06-06,6,28,47,75
82144,2020-06-06,7,53,82,135
82145,2020-06-06,8,133,154,287
82146,2020-06-06,9,218,213,431
82147,2020-06-06,10,363,255,618
82148,2020-06-06,11,519,386,905
82149,2020-06-06,12,607,429,1036
82150,2020-06-06,13,993,502,1495
82151,2020-06-06,14,978,478,1456
82152,2020-06-06,15,1005,409,1414
82153,2020-06-06,16,1244,501,1745
82154,2020-06-06,17,1061,416,1477
82155,2020-06-06,18,849,321,1170
82156,2020-06-06,19,713,286,999
82157,2020-06-06,20,568,191,759
82158,2020-06-06,21,412,170,582
82159,2020-06-06,22,325,113,438
82160,2020-06-06,23,235,57,292
82161,2020-06-07,0,118,42,160
82162,2020-06-07,1,68,27,95
82163,2020-06-07,2,17,7,24
82164,2020-06-07,3,16,7,23
82165,2020-06-07,4,8,6,14
82166,2020-06-07,5,11,11,22
82167,2020-06-07,6,29,26,55
82168,2020-06-07,7,55,50,105
82169,2020-06-07,8,91,113,204
82170,2020-06-07,9,147,168,315
82171,2020-06-07,10,277,214,491
82172,2020-06-07,11,376,276,652
82173,2020-06-07,12,459,309,768
82174,2020-06-07,13,549,346,895
82175,2020-06-07,14,639,365,1004
82176,2020-06-07,15,608,317,925
82177,2020-06-07,16,647,330,977
82178,2020-06-07,17,626,337,963
82179,2020-06-07,18,578,316,894
82180,2020-06-07,19,554,223,777
82181,2020-06-07,20,403,198,601
82182,2020-06-07,21,215,120,335
82183,2020-06-07,22,142,77,219
82184,2020-06-07,23,85,32,117
82185,2020-06-08,0,51,20,71
82186,2020-06-08,1,22,3,25
82187,2020-06-08,2,3,1,4
82188,2020-06-08,3,3,1,4
82189,2020-06-08,4,6,6,12
82190,2020-06-08,5,23,23,46
82191,2020-06-08,6,34,66,100
82192,2020-06-08,7,73,107,180
82193,2020-06-08,8,84,166,250
82194,2020-06-08,9,103,116,219
82195,2020-06-08,10,133,97,230
82196,2020-06-08,11,169,134,303
82197,2020-06-08,12,262,171,433
82198,2020-06-08,13,287,170,457
82199,2020-06-08,14,251,170,421
82200,2020-06-08,15,288,166,454
82201,2020-06-08,16,280,237,517
82202,2020-06-08,17,456,353,809
82203,2020-06-08,18,496,363,859
82204,2020-06-08,19,431,279,710
82205,2020-06-08,20,274,185,459
82206,2020-06-08,21,139,99,238
82207,2020-06-08,22,73,43,116
82208,2020-06-08,23,68,30,98
82209,2020-06-09,0,27,12,39
82210,2020-06-09,1,9,6,15
82211,2020-06-09,2,7,1,8
82212,2020-06-09,3,4,8,12
82213,2020-06-09,4,5,9,14
82214,2020-06-09,5,25,27,52
82215,2020-06-09,6,42,52,94
82216,2020-06-09,7,89,151,240
82217,2020-06-09,8,100,187,287
82218,2020-06-09,9,131,118,249
82219,2020-06-09,10,149,134,283
82220,2020-06-09,11,161,137,298
82221,2020-06-09,12,295,162,457
82222,2020-06-09,13,269,149,418
82223,2020-06-09,14,288,153,441
82224,2020-06-09,15,236,163,399
82225,2020-06-09,16,244,227,471
82226,2020-06-09,17,385,279,664
82227,2020-06-09,18,429,322,751
82228,2020-06-09,19,380,255,635
82229,2020-06-09,20,263,182,445
82230,2020-06-09,21,152,93,245
82231,2020-06-09,22,96,62,158
82232,2020-06-09,23,56,25,81
82233,2020-06-10,0,25,12,37
82234,2020-06-10,1,12,5,17
82235,2020-06-10,2,10,2,12
82236,2020-06-10,3,4,3,7
82237,2020-06-10,4,8,3,11
82238,2020-06-10,5,18,32,50
82239,2020-06-10,6,43,67,110
82240,2020-06-10,7,69,119,188
82241,2020-06-10,8,93,180,273
82242,2020-06-10,9,105,133,238
82243,2020-06-10,10,131,119,250
82244,2020-06-10,11,111,134,245
82245,2020-06-10,12,125,184,309
82246,2020-06-10,13,150,161,311
82247,2020-06-10,14,153,135,288
82248,2020-06-10,15,159,124,283
82249,2020-06-10,16,200,210,410
82250,2020-06-10,17,256,288,544
82251,2020-06-10,18,343,343,686
82252,2020-06-10,19,293,261,554
82253,2020-06-10,20,115,136,251
82254,2020-06-10,21,98,92,190
82255,2020-06-10,22,50,45,95
82256,2020-06-10,23,25,26,51
82257,2020-06-11,0,6,6,12
82258,2020-06-11,1,4,8,12
82259,2020-06-11,2,8,2,10
82260,2020-06-11,3,2,1,3
82261,2020-06-11,4,3,4,7
82262,2020-06-11,5,7,17,24
82263,2020-06-11,6,28,72,100
82264,2020-06-11,7,52,130,182
82265,2020-06-11,8,68,156,224
82266,2020-06-11,9,72,119,191
82267,2020-06-11,10,39,52,91
82268,2020-06-11,11,34,50,84
82269,2020-06-11,12,62,54,116
82270,2020-06-11,13,82,83,165
82271,2020-06-11,14,95,140,235
82272,2020-06-11,15,138,117,255
82273,2020-06-11,16,170,213,383
82274,2020-06-11,17,246,319,565
82275,2020-06-11,18,344,306,650
82276,2020-06-11,19,285,252,537
82277,2020-06-11,20,217,162,379
82278,2020-06-11,21,118,114,232
82279,2020-06-11,22,79,83,162
82280,2020-06-11,23,48,32,80
82281,2020-06-12,0,34,26,60
82282,2020-06-12,1,5,4,9
82283,2020-06-12,2,7,4,11
82284,2020-06-12,3,6,3,9
82285,2020-06-12,4,6,5,11
82286,2020-06-12,5,13,16,29
82287,2020-06-12,6,36,76,112
82288,2020-06-12,7,73,105,178
82289,2020-06-12,8,98,181,279
82290,2020-06-12,9,101,139,240
82291,2020-06-12,10,110,167,277
82292,2020-06-12,11,158,178,336
82293,2020-06-12,12,192,182,374
82294,2020-06-12,13,241,241,482
82295,2020-06-12,14,246,204,450
82296,2020-06-12,15,272,227,499
82297,2020-06-12,16,301,302,603
82298,2020-06-12,17,365,380,745
82299,2020-06-12,18,400,351,751
82300,2020-06-12,19,372,305,677
82301,2020-06-12,20,258,187,445
82302,2020-06-12,21,229,167,396
82303,2020-06-12,22,151,94,245
82304,2020-06-12,23,126,80,206
82305,2020-06-13,0,87,46,133
82306,2020-06-13,1,77,27,104
82307,2020-06-13,2,34,14,48
82308,2020-06-13,3,15,13,28
82309,2020-06-13,4,9,6,15
82310,2020-06-13,5,14,12,26
82311,2020-06-13,6,28,46,74
82312,2020-06-13,7,71,68,139
82313,2020-06-13,8,116,123,239
82314,2020-06-13,9,177,187,364
82315,2020-06-13,10,303,268,571
82316,2020-06-13,11,459,342,801
82317,2020-06-13,12,514,388,902
82318,2020-06-13,13,648,345,993
82319,2020-06-13,14,783,427,1210
82320,2020-06-13,15,718,395,1113
82321,2020-06-13,16,706,373,1079
82322,2020-06-13,17,647,348,995
82323,2020-06-13,18,645,342,987
82324,2020-06-13,19,497,296,793
82325,2020-06-13,20,365,231,596
82326,2020-06-13,21,279,123,402
82327,2020-06-13,22,169,97,266
82328,2020-06-13,23,132,84,216
82329,2020-06-14,0,116,43,159
82330,2020-06-14,1,51,23,74
82331,2020-06-14,2,53,18,71
82332,2020-06-14,3,11,4,15
82333,2020-06-14,4,4,6,10
82334,2020-06-14,5,10,9,19
82335,2020-06-14,6,30,30,60
82336,2020-06-14,7,48,47,95
82337,2020-06-14,8,82,100,182
82338,2020-06-14,9,179,136,315
82339,2020-06-14,10,294,194,488
82340,2020-06-14,11,440,280,720
82341,2020-06-14,12,494,334,828
82342,2020-06-14,13,572,390,962
82343,2020-06-14,14,619,409,1028
82344,2020-06-14,15,648,385,1033
82345,2020-06-14,16,601,365,966
82346,2020-06-14,17,565,328,893
82347,2020-06-14,18,498,297,795
82348,2020-06-14,19,403,236,639
82349,2020-06-14,20,291,165,456
82350,2020-06-14,21,170,105,275
82351,2020-06-14,22,101,56,157
82352,2020-06-14,23,69,25,94
82353,2020-06-15,0,25,9,34
82354,2020-06-15,1,15,3,18
82355,2020-06-15,2,6,2,8
82356,2020-06-15,3,6,3,9
82357,2020-06-15,4,5,6,11
82358,2020-06-15,5,17,29,46
82359,2020-06-15,6,35,71,106
82360,2020-06-15,7,51,123,174
82361,2020-06-15,8,79,169,248
82362,2020-06-15,9,91,121,212
82363,2020-06-15,10,75,122,197
82364,2020-06-15,11,116,136,252
82365,2020-06-15,12,195,146,341
82366,2020-06-15,13,178,171,349
82367,2020-06-15,14,225,166,391
82368,2020-06-15,15,231,192,423
82369,2020-06-15,16,221,240,461
82370,2020-06-15,17,356,322,678
82371,2020-06-15,18,373,323,696
82372,2020-06-15,19,322,286,608
82373,2020-06-15,20,229,178,407
82374,2020-06-15,21,92,107,199
82375,2020-06-15,22,73,48,121
82376,2020-06-15,23,32,21,53
82377,2020-06-16,0,13,6,19
82378,2020-06-16,1,11,11,22
82379,2020-06-16,2,6,4,10
82380,2020-06-16,3,6,2,8
82381,2020-06-16,4,4,5,9
82382,2020-06-16,5,26,18,44
82383,2020-06-16,6,34,67,101
82384,2020-06-16,7,68,138,206
82385,2020-06-16,8,89,173,262
82386,2020-06-16,9,68,138,206
82387,2020-06-16,10,109,130,239
82388,2020-06-16,11,121,136,257
82389,2020-06-16,12,130,182,312
82390,2020-06-16,13,172,179,351
82391,2020-06-16,14,167,187,354
82392,2020-06-16,15,229,192,421
82393,2020-06-16,16,229,244,473
82394,2020-06-16,17,279,356,635
82395,2020-06-16,18,388,389,777
82396,2020-06-16,19,316,309,625
82397,2020-06-16,20,215,184,399
82398,2020-06-16,21,154,117,271
82399,2020-06-16,22,90,47,137
82400,2020-06-16,23,41,24,65
82401,2020-06-17,0,23,12,35
82402,2020-06-17,1,3,8,11
82403,2020-06-17,2,6,7,13
82404,2020-06-17,3,2,0,2
82405,2020-06-17,4,3,8,11
82406,2020-06-17,5,17,21,38
82407,2020-06-17,6,24,54,78
82408,2020-06-17,7,70,118,188
82409,2020-06-17,8,76,180,256
82410,2020-06-17,9,78,144,222
82411,2020-06-17,10,77,117,194
82412,2020-06-17,11,92,136,228
82413,2020-06-17,12,108,174,282
82414,2020-06-17,13,108,169,277
82415,2020-06-17,14,139,90,229
82416,2020-06-17,15,104,132,236
82417,2020-06-17,16,51,86,137
82418,2020-06-17,17,35,46,81
82419,2020-06-17,18,23,53,76
82420,2020-06-17,19,43,74,117
82421,2020-06-17,20,32,32,64
82422,2020-06-17,21,45,25,70
82423,2020-06-17,22,19,19,38
82424,2020-06-17,23,9,19,28
82425,2020-06-18,0,8,5,13
82426,2020-06-18,1,0,6,6
82427,2020-06-18,2,3,0,3
82428,2020-06-18,3,2,1,3
82429,2020-06-18,4,8,3,11
82430,2020-06-18,5,20,15,35
82431,2020-06-18,6,19,50,69
82432,2020-06-18,7,45,110,155
82433,2020-06-18,8,69,166,235
82434,2020-06-18,9,48,84,132
82435,2020-06-18,10,82,103,185
82436,2020-06-18,11,102,133,235
82437,2020-06-18,12,127,154,281
82438,2020-06-18,13,168,167,335
82439,2020-06-18,14,150,147,297
82440,2020-06-18,15,173,184,357
82441,2020-06-18,16,218,277,495
82442,2020-06-18,17,288,384,672
82443,2020-06-18,18,341,399,740
82444,2020-06-18,19,330,304,634
82445,2020-06-18,20,235,222,457
82446,2020-06-18,21,130,126,256
82447,2020-06-18,22,107,80,187
82448,2020-06-18,23,61,48,109
82449,2020-06-19,0,45,14,59
82450,2020-06-19,1,26,10,36
82451,2020-06-19,2,5,2,7
82452,2020-06-19,3,1,3,4
82453,2020-06-19,4,4,1,5
82454,2020-06-19,5,16,30,46
82455,2020-06-19,6,29,57,86
82456,2020-06-19,7,66,115,181
82457,2020-06-19,8,90,182,272
82458,2020-06-19,9,83,183,266
82459,2020-06-19,10,104,182,286
82460,2020-06-19,11,181,222,403
82461,2020-06-19,12,225,243,468
82462,2020-06-19,13,293,244,537
82463,2020-06-19,14,316,294,610
82464,2020-06-19,15,275,246,521
82465,2020-06-19,16,182,119,301
82466,2020-06-19,17,319,245,564
82467,2020-06-19,18,423,304,727
82468,2020-06-19,19,381,268,649
82469,2020-06-19,20,312,209,521
82470,2020-06-19,21,220,110,330
82471,2020-06-19,22,148,67,215
82472,2020-06-19,23,97,66,163
82473,2020-06-20,0,75,50,125
82474,2020-06-20,1,39,28,67
82475,2020-06-20,2,33,11,44
82476,2020-06-20,3,5,9,14
82477,2020-06-20,4,8,5,13
82478,2020-06-20,5,5,10,15
82479,2020-06-20,6,23,53,76
82480,2020-06-20,7,49,78,127
82481,2020-06-20,8,104,122,226
82482,2020-06-20,9,178,184,362
82483,2020-06-20,10,276,266,542
82484,2020-06-20,11,260,226,486
82485,2020-06-20,12,135,159,294
82486,2020-06-20,13,173,123,296
82487,2020-06-20,14,185,129,314
82488,2020-06-20,15,124,94,218
82489,2020-06-20,16,134,105,239
82490,2020-06-20,17,262,177,439
82491,2020-06-20,18,320,265,585
82492,2020-06-20,19,292,304,596
82493,2020-06-20,20,226,191,417
82494,2020-06-20,21,188,136,324
82495,2020-06-20,22,183,101,284
82496,2020-06-20,23,125,77,202
82497,2020-06-21,0,88,53,141
82498,2020-06-21,1,67,24,91
82499,2020-06-21,2,49,14,63
82500,2020-06-21,3,8,8,16
82501,2020-06-21,4,9,4,13
82502,2020-06-21,5,9,7,16
82503,2020-06-21,6,16,21,37
82504,2020-06-21,7,50,40,90
82505,2020-06-21,8,82,95,177
82506,2020-06-21,9,173,172,345
82507,2020-06-21,10,254,227,481
82508,2020-06-21,11,304,307,611
82509,2020-06-21,12,346,326,672
82510,2020-06-21,13,462,321,783
82511,2020-06-21,14,471,318,789
82512,2020-06-21,15,475,305,780
82513,2020-06-21,16,503,297,800
82514,2020-06-21,17,419,312,731
82515,2020-06-21,18,424,284,708
82516,2020-06-21,19,353,229,582
82517,2020-06-21,20,266,202,468
82518,2020-06-21,21,181,116,297
82519,2020-06-21,22,144,76,220
82520,2020-06-21,23,76,50,126
82521,2020-06-22,0,32,16,48
82522,2020-06-22,1,30,9,39
82523,2020-06-22,2,8,9,17
82524,2020-06-22,3,11,4,15
82525,2020-06-22,4,9,9,18
82526,2020-06-22,5,27,27,54
82527,2020-06-22,6,40,85,125
82528,2020-06-22,7,67,131,198
82529,2020-06-22,8,110,201,311
82530,2020-06-22,9,103,149,252
82531,2020-06-22,10,95,129,224
82532,2020-06-22,11,100,125,225
82533,2020-06-22,12,154,190,344
82534,2020-06-22,13,132,163,295
82535,2020-06-22,14,150,141,291
82536,2020-06-22,15,164,181,345
82537,2020-06-22,16,198,201,399
82538,2020-06-22,17,181,249,430
82539,2020-06-22,18,196,252,448
82540,2020-06-22,19,131,170,301
82541,2020-06-22,20,96,125,221
82542,2020-06-22,21,97,81,178
82543,2020-06-22,22,49,56,105
82544,2020-06-22,23,35,40,75
82545,2020-06-23,0,28,13,41
82546,2020-06-23,1,18,5,23
82547,2020-06-23,2,5,8,13
82548,2020-06-23,3,2,5,7
82549,2020-06-23,4,5,6,11
82550,2020-06-23,5,24,33,57
82551,2020-06-23,6,51,91,142
82552,2020-06-23,7,86,168,254
82553,2020-06-23,8,113,205,318
82554,2020-06-23,9,94,150,244
82555,2020-06-23,10,110,155,265
82556,2020-06-23,11,125,173,298
82557,2020-06-23,12,136,188,324
82558,2020-06-23,13,160,164,324
82559,2020-06-23,14,149,135,284
82560,2020-06-23,15,171,171,342
82561,2020-06-23,16,179,211,390
82562,2020-06-23,17,256,351,607
82563,2020-06-23,18,316,352,668
82564,2020-06-23,19,277,308,585
82565,2020-06-23,20,252,199,451
82566,2020-06-23,21,121,103,224
82567,2020-06-23,22,121,79,200
82568,2020-06-23,23,72,46,118
82569,2020-06-24,0,16,20,36
82570,2020-06-24,1,14,5,19
82571,2020-06-24,2,17,4,21
82572,2020-06-24,3,4,4,8
82573,2020-06-24,4,10,3,13
82574,2020-06-24,5,25,27,52
82575,2020-06-24,6,56,93,149
82576,2020-06-24,7,91,173,264
82577,2020-06-24,8,114,223,337
82578,2020-06-24,9,124,169,293
82579,2020-06-24,10,95,154,249
82580,2020-06-24,11,141,175,316
82581,2020-06-24,12,160,191,351
82582,2020-06-24,13,163,186,349
82583,2020-06-24,14,173,179,352
82584,2020-06-24,15,213,185,398
82585,2020-06-24,16,216,268,484
82586,2020-06-24,17,393,388,781
82587,2020-06-24,18,423,412,835
82588,2020-06-24,19,444,377,821
82589,2020-06-24,20,285,262,547
82590,2020-06-24,21,209,157,366
82591,2020-06-24,22,137,106,243
82592,2020-06-24,23,75,42,117
82593,2020-06-25,0,31,23,54
82594,2020-06-25,1,16,6,22
82595,2020-06-25,2,3,5,8
82596,2020-06-25,3,2,3,5
82597,2020-06-25,4,5,3,8
82598,2020-06-25,5,23,30,53
82599,2020-06-25,6,35,94,129
82600,2020-06-25,7,81,140,221
82601,2020-06-25,8,114,234,348
82602,2020-06-25,9,126,134,260
82603,2020-06-25,10,92,145,237
82604,2020-06-25,11,126,171,297
82605,2020-06-25,12,158,177,335
82606,2020-06-25,13,168,189,357
82607,2020-06-25,14,159,166,325
82608,2020-06-25,15,174,161,335
82609,2020-06-25,16,200,197,397
82610,2020-06-25,17,292,324,616
82611,2020-06-25,18,319,367,686
82612,2020-06-25,19,254,236,490
82613,2020-06-25,20,198,184,382
82614,2020-06-25,21,110,110,220
82615,2020-06-25,22,104,65,169
82616,2020-06-25,23,74,45,119
82617,2020-06-26,0,25,11,36
82618,2020-06-26,1,28,7,35
82619,2020-06-26,2,10,11,21
82620,2020-06-26,3,1,5,6
82621,2020-06-26,4,12,7,19
82622,2020-06-26,5,18,25,43
82623,2020-06-26,6,48,92,140
82624,2020-06-26,7,91,155,246
82625,2020-06-26,8,107,236,343
82626,2020-06-26,9,126,181,307
82627,2020-06-26,10,120,166,286
82628,2020-06-26,11,187,186,373
82629,2020-06-26,12,204,223,427
82630,2020-06-26,13,202,220,422
82631,2020-06-26,14,251,239,490
82632,2020-06-26,15,257,243,500
82633,2020-06-26,16,284,301,585
82634,2020-06-26,17,369,388,757
82635,2020-06-26,18,462,381,843
82636,2020-06-26,19,386,345,731
82637,2020-06-26,20,358,215,573
82638,2020-06-26,21,211,150,361
82639,2020-06-26,22,213,92,305
82640,2020-06-26,23,177,70,247
82641,2020-06-27,0,104,41,145
82642,2020-06-27,1,66,31,97
82643,2020-06-27,2,26,10,36
82644,2020-06-27,3,11,11,22
82645,2020-06-27,4,6,5,11
82646,2020-06-27,5,25,13,38
82647,2020-06-27,6,40,39,79
82648,2020-06-27,7,71,70,141
82649,2020-06-27,8,120,145,265
82650,2020-06-27,9,216,207,423
82651,2020-06-27,10,326,280,606
82652,2020-06-27,11,353,281,634
82653,2020-06-27,12,472,320,792
82654,2020-06-27,13,499,303,802
82655,2020-06-27,14,474,319,793
82656,2020-06-27,15,502,320,822
82657,2020-06-27,16,474,275,749
82658,2020-06-27,17,281,215,496
82659,2020-06-27,18,297,192,489
82660,2020-06-27,19,252,190,442
82661,2020-06-27,20,237,159,396
82662,2020-06-27,21,176,128,304
82663,2020-06-27,22,171,82,253
82664,2020-06-27,23,133,88,221
82665,2020-06-28,0,119,37,156
82666,2020-06-28,1,55,27,82
82667,2020-06-28,2,32,23,55
82668,2020-06-28,3,11,6,17
82669,2020-06-28,4,9,5,14
82670,2020-06-28,5,13,14,27
82671,2020-06-28,6,28,38,66
82672,2020-06-28,7,61,51,112
82673,2020-06-28,8,119,128,247
82674,2020-06-28,9,190,206,396
82675,2020-06-28,10,283,220,503
82676,2020-06-28,11,330,256,586
82677,2020-06-28,12,376,284,660
82678,2020-06-28,13,398,315,713
82679,2020-06-28,14,393,296,689
82680,2020-06-28,15,435,268,703
82681,2020-06-28,16,400,287,687
82682,2020-06-28,17,413,278,691
82683,2020-06-28,18,363,264,627
82684,2020-06-28,19,299,231,530
82685,2020-06-28,20,298,165,463
82686,2020-06-28,21,153,134,287
82687,2020-06-28,22,109,71,180
82688,2020-06-28,23,61,36,97
82689,2020-06-29,0,36,17,53
82690,2020-06-29,1,7,16,23
82691,2020-06-29,2,18,6,24
82692,2020-06-29,3,3,3,6
82693,2020-06-29,4,9,5,14
82694,2020-06-29,5,23,27,50
82695,2020-06-29,6,40,100,140
82696,2020-06-29,7,81,169,250
82697,2020-06-29,8,133,213,346
82698,2020-06-29,9,112,163,275
82699,2020-06-29,10,97,126,223
82700,2020-06-29,11,134,157,291
82701,2020-06-29,12,171,159,330
82702,2020-06-29,13,144,175,319
82703,2020-06-29,14,153,158,311
82704,2020-06-29,15,165,181,346
82705,2020-06-29,16,205,227,432
82706,2020-06-29,17,315,315,630
82707,2020-06-29,18,337,380,717
82708,2020-06-29,19,362,260,622
82709,2020-06-29,20,218,230,448
82710,2020-06-29,21,143,122,265
82711,2020-06-29,22,93,55,148
82712,2020-06-29,23,58,45,103
82713,2020-06-30,0,32,8,40
82714,2020-06-30,1,4,5,9
82715,2020-06-30,2,7,7,14
82716,2020-06-30,3,3,4,7
82717,2020-06-30,4,6,7,13
82718,2020-06-30,5,21,34,55
82719,2020-06-30,6,28,117,145
82720,2020-06-30,7,84,177,261
82721,2020-06-30,8,122,208,330
82722,2020-06-30,9,112,152,264
82723,2020-06-30,10,125,126,251
82724,2020-06-30,11,141,186,327
82725,2020-06-30,12,153,165,318
82726,2020-06-30,13,179,171,350
82727,2020-06-30,14,196,167,363
82728,2020-06-30,15,226,189,415
82729,2020-06-30,16,219,227,446
82730,2020-06-30,17,320,317,637
82731,2020-06-30,18,354,340,694
82732,2020-06-30,19,334,312,646
82733,2020-06-30,20,281,230,511
82734,2020-06-30,21,154,142,296
82735,2020-06-30,22,93,74,167
82736,2020-06-30,23,59,48,107
82737,2020-07-01,0,28,27,55
82738,2020-07-01,1,15,13,28
82739,2020-07-01,2,11,5,16
82740,2020-07-01,3,6,4,10
82741,2020-07-01,4,15,4,19
82742,2020-07-01,5,19,26,45
82743,2020-07-01,6,44,88,132
82744,2020-07-01,7,76,174,250
82745,2020-07-01,8,109,194,303
82746,2020-07-01,9,110,160,270
82747,2020-07-01,10,100,153,253
82748,2020-07-01,11,128,180,308
82749,2020-07-01,12,156,171,327
82750,2020-07-01,13,139,202,341
82751,2020-07-01,14,158,194,352
82752,2020-07-01,15,206,164,370
82753,2020-07-01,16,200,259,459
82754,2020-07-01,17,288,325,613
82755,2020-07-01,18,336,294,630
82756,2020-07-01,19,354,262,616
82757,2020-07-01,20,228,158,386
82758,2020-07-01,21,162,140,302
82759,2020-07-01,22,113,86,199
82760,2020-07-01,23,57,47,104
82761,2020-07-02,0,43,20,63
82762,2020-07-02,1,12,9,21
82763,2020-07-02,2,9,7,16
82764,2020-07-02,3,0,7,7
82765,2020-07-02,4,7,10,17
82766,2020-07-02,5,22,33,55
82767,2020-07-02,6,41,92,133
82768,2020-07-02,7,84,171,255
82769,2020-07-02,8,121,185,306
82770,2020-07-02,9,122,186,308
82771,2020-07-02,10,138,164,302
82772,2020-07-02,11,150,195,345
82773,2020-07-02,12,211,213,424
82774,2020-07-02,13,188,208,396
82775,2020-07-02,14,237,207,444
82776,2020-07-02,15,280,213,493
82777,2020-07-02,16,263,289,552
82778,2020-07-02,17,324,351,675
82779,2020-07-02,18,352,344,696
82780,2020-07-02,19,322,315,637
82781,2020-07-02,20,283,271,554
82782,2020-07-02,21,172,134,306
82783,2020-07-02,22,158,127,285
82784,2020-07-02,23,97,66,163
82785,2020-07-03,0,62,34,96
82786,2020-07-03,1,37,21,58
82787,2020-07-03,2,19,13,32
82788,2020-07-03,3,10,6,16
82789,2020-07-03,4,13,4,17
82790,2020-07-03,5,17,16,33
82791,2020-07-03,6,35,66,101
82792,2020-07-03,7,68,100,168
82793,2020-07-03,8,131,172,303
82794,2020-07-03,9,200,202,402
82795,2020-07-03,10,303,232,535
82796,2020-07-03,11,346,243,589
82797,2020-07-03,12,373,251,624
82798,2020-07-03,13,360,253,613
82799,2020-07-03,14,391,241,632
82800,2020-07-03,15,375,248,623
82801,2020-07-03,16,336,230,566
82802,2020-07-03,17,314,231,545
82803,2020-07-03,18,316,197,513
82804,2020-07-03,19,368,254,622
82805,2020-07-03,20,308,221,529
82806,2020-07-03,21,239,129,368
82807,2020-07-03,22,204,85,289
82808,2020-07-03,23,132,85,217
82809,2020-07-04,0,103,53,156
82810,2020-07-04,1,49,22,71
82811,2020-07-04,2,23,18,41
82812,2020-07-04,3,15,10,25
82813,2020-07-04,4,11,6,17
82814,2020-07-04,5,20,9,29
82815,2020-07-04,6,36,39,75
82816,2020-07-04,7,61,85,146
82817,2020-07-04,8,124,122,246
82818,2020-07-04,9,253,161,414
82819,2020-07-04,10,379,221,600
82820,2020-07-04,11,470,235,705
82821,2020-07-04,12,524,229,753
82822,2020-07-04,13,509,237,746
82823,2020-07-04,14,574,241,815
82824,2020-07-04,15,477,277,754
82825,2020-07-04,16,447,247,694
82826,2020-07-04,17,533,237,770
82827,2020-07-04,18,607,261,868
82828,2020-07-04,19,483,232,715
82829,2020-07-04,20,594,274,868
82830,2020-07-04,21,507,208,715
82831,2020-07-04,22,476,172,648
82832,2020-07-04,23,288,111,399
82833,2020-07-05,0,230,77,307
82834,2020-07-05,1,87,32,119
82835,2020-07-05,2,45,19,64
82836,2020-07-05,3,29,6,35
82837,2020-07-05,4,19,6,25
82838,2020-07-05,5,8,7,15
82839,2020-07-05,6,36,34,70
82840,2020-07-05,7,53,62,115
82841,2020-07-05,8,103,103,206
82842,2020-07-05,9,184,165,349
82843,2020-07-05,10,278,170,448
82844,2020-07-05,11,280,215,495
82845,2020-07-05,12,319,217,536
82846,2020-07-05,13,327,189,516
82847,2020-07-05,14,327,190,517
82848,2020-07-05,15,341,182,523
82849,2020-07-05,16,273,236,509
82850,2020-07-05,17,249,176,425
82851,2020-07-05,18,223,167,390
82852,2020-07-05,19,277,182,459
82853,2020-07-05,20,227,155,382
82854,2020-07-05,21,145,92,237
82855,2020-07-05,22,94,69,163
82856,2020-07-05,23,65,28,93
82857,2020-07-06,0,32,16,48
82858,2020-07-06,1,11,10,21
82859,2020-07-06,2,10,5,15
82860,2020-07-06,3,5,3,8
82861,2020-07-06,4,8,5,13
82862,2020-07-06,5,20,31,51
82863,2020-07-06,6,38,94,132
82864,2020-07-06,7,92,170,262
82865,2020-07-06,8,114,212,326
82866,2020-07-06,9,134,162,296
82867,2020-07-06,10,121,145,266
82868,2020-07-06,11,188,161,349
82869,2020-07-06,12,161,192,353
82870,2020-07-06,13,170,175,345
82871,2020-07-06,14,166,147,313
82872,2020-07-06,15,177,141,318
82873,2020-07-06,16,195,220,415
82874,2020-07-06,17,242,259,501
82875,2020-07-06,18,120,154,274
82876,2020-07-06,19,51,60,111
82877,2020-07-06,20,108,109,217
82878,2020-07-06,21,101,96,197
82879,2020-07-06,22,53,41,94
82880,2020-07-06,23,30,27,57
82881,2020-07-07,0,8,5,13
82882,2020-07-07,1,8,1,9
82883,2020-07-07,2,2,1,3
82884,2020-07-07,3,1,2,3
82885,2020-07-07,4,10,4,14
82886,2020-07-07,5,22,35,57
82887,2020-07-07,6,36,101,137
82888,2020-07-07,7,83,163,246
82889,2020-07-07,8,108,223,331
82890,2020-07-07,9,104,158,262
82891,2020-07-07,10,97,156,253
82892,2020-07-07,11,159,147,306
82893,2020-07-07,12,160,176,336
82894,2020-07-07,13,158,163,321
82895,2020-07-07,14,147,179,326
82896,2020-07-07,15,142,181,323
82897,2020-07-07,16,186,222,408
82898,2020-07-07,17,244,315,559
82899,2020-07-07,18,257,295,552
82900,2020-07-07,19,245,233,478
82901,2020-07-07,20,194,178,372
82902,2020-07-07,21,113,118,231
82903,2020-07-07,22,68,64,132
82904,2020-07-07,23,48,43,91
82905,2020-07-08,0,14,12,26
82906,2020-07-08,1,19,9,28
82907,2020-07-08,2,6,4,10
82908,2020-07-08,3,4,1,5
82909,2020-07-08,4,11,5,16
82910,2020-07-08,5,24,39,63
82911,2020-07-08,6,45,108,153
82912,2020-07-08,7,113,208,321
82913,2020-07-08,8,128,226,354
82914,2020-07-08,9,103,150,253
82915,2020-07-08,10,128,141,269
82916,2020-07-08,11,140,148,288
82917,2020-07-08,12,180,188,368
82918,2020-07-08,13,173,151,324
82919,2020-07-08,14,180,147,327
82920,2020-07-08,15,185,148,333
82921,2020-07-08,16,207,196,403
82922,2020-07-08,17,291,359,650
82923,2020-07-08,18,359,369,728
82924,2020-07-08,19,335,314,649
82925,2020-07-08,20,310,252,562
82926,2020-07-08,21,185,136,321
82927,2020-07-08,22,100,60,160
82928,2020-07-08,23,65,43,108
82929,2020-07-09,0,25,11,36
82930,2020-07-09,1,6,3,9
82931,2020-07-09,2,6,3,9
82932,2020-07-09,3,3,0,3
82933,2020-07-09,4,9,3,12
82934,2020-07-09,5,32,33,65
82935,2020-07-09,6,37,110,147
82936,2020-07-09,7,103,196,299
82937,2020-07-09,8,121,212,333
82938,2020-07-09,9,135,165,300
82939,2020-07-09,10,120,133,253
82940,2020-07-09,11,131,147,278
82941,2020-07-09,12,139,187,326
82942,2020-07-09,13,175,169,344
82943,2020-07-09,14,164,192,356
82944,2020-07-09,15,193,189,382
82945,2020-07-09,16,198,227,425
82946,2020-07-09,17,264,354,618
82947,2020-07-09,18,352,386,738
82948,2020-07-09,19,295,323,618
82949,2020-07-09,20,240,264,504
82950,2020-07-09,21,159,171,330
82951,2020-07-09,22,105,78,183
82952,2020-07-09,23,56,70,126
82953,2020-07-10,0,40,17,57
82954,2020-07-10,1,19,9,28
82955,2020-07-10,2,13,2,15
82956,2020-07-10,3,7,2,9
82957,2020-07-10,4,9,1,10
82958,2020-07-10,5,30,36,66
82959,2020-07-10,6,46,80,126
82960,2020-07-10,7,78,166,244
82961,2020-07-10,8,93,218,311
82962,2020-07-10,9,128,181,309
82963,2020-07-10,10,141,136,277
82964,2020-07-10,11,159,171,330
82965,2020-07-10,12,150,187,337
82966,2020-07-10,13,212,200,412
82967,2020-07-10,14,233,222,455
82968,2020-07-10,15,266,208,474
82969,2020-07-10,16,290,274,564
82970,2020-07-10,17,329,377,706
82971,2020-07-10,18,404,356,760
82972,2020-07-10,19,327,320,647
82973,2020-07-10,20,274,239,513
82974,2020-07-10,21,186,151,337
82975,2020-07-10,22,182,120,302
82976,2020-07-10,23,179,74,253
82977,2020-07-11,0,123,53,176
82978,2020-07-11,1,45,26,71
82979,2020-07-11,2,17,13,30
82980,2020-07-11,3,15,4,19
82981,2020-07-11,4,14,3,17
82982,2020-07-11,5,16,13,29
82983,2020-07-11,6,36,59,95
82984,2020-07-11,7,79,94,173
82985,2020-07-11,8,129,176,305
82986,2020-07-11,9,198,244,442
82987,2020-07-11,10,275,279,554
82988,2020-07-11,11,381,299,680
82989,2020-07-11,12,407,324,731
82990,2020-07-11,13,462,280,742
82991,2020-07-11,14,515,353,868
82992,2020-07-11,15,411,291,702
82993,2020-07-11,16,398,293,691
82994,2020-07-11,17,479,303,782
82995,2020-07-11,18,408,322,730
82996,2020-07-11,19,448,301,749
82997,2020-07-11,20,387,237,624
82998,2020-07-11,21,207,149,356
82999,2020-07-11,22,239,124,363
83000,2020-07-11,23,159,83,242
83001,2020-07-12,0,91,47,138
83002,2020-07-12,1,74,19,93
83003,2020-07-12,2,41,12,53
83004,2020-07-12,3,15,11,26
83005,2020-07-12,4,13,5,18
83006,2020-07-12,5,12,7,19
83007,2020-07-12,6,30,38,68
83008,2020-07-12,7,92,89,181
83009,2020-07-12,8,127,167,294
83010,2020-07-12,9,199,234,433
83011,2020-07-12,10,297,257,554
83012,2020-07-12,11,397,289,686
83013,2020-07-12,12,376,300,676
83014,2020-07-12,13,385,294,679
83015,2020-07-12,14,381,304,685
83016,2020-07-12,15,442,254,696
83017,2020-07-12,16,431,276,707
83018,2020-07-12,17,377,306,683
83019,2020-07-12,18,366,265,631
83020,2020-07-12,19,270,178,448
83021,2020-07-12,20,191,171,362
83022,2020-07-12,21,140,104,244
83023,2020-07-12,22,107,63,170
83024,2020-07-12,23,53,37,90
83025,2020-07-13,0,33,12,45
83026,2020-07-13,1,26,2,28
83027,2020-07-13,2,6,1,7
83028,2020-07-13,3,8,2,10
83029,2020-07-13,4,11,5,16
83030,2020-07-13,5,31,33,64
83031,2020-07-13,6,49,108,157
83032,2020-07-13,7,75,189,264
83033,2020-07-13,8,117,243,360
83034,2020-07-13,9,100,149,249
83035,2020-07-13,10,138,146,284
83036,2020-07-13,11,174,171,345
83037,2020-07-13,12,174,173,347
83038,2020-07-13,13,182,167,349
83039,2020-07-13,14,162,165,327
83040,2020-07-13,15,182,156,338
83041,2020-07-13,16,249,220,469
83042,2020-07-13,17,312,341,653
83043,2020-07-13,18,321,382,703
83044,2020-07-13,19,348,338,686
83045,2020-07-13,20,248,248,496
83046,2020-07-13,21,128,142,270
83047,2020-07-13,22,58,57,115
83048,2020-07-13,23,47,28,75
83049,2020-07-14,0,20,8,28
83050,2020-07-14,1,6,3,9
83051,2020-07-14,2,4,2,6
83052,2020-07-14,3,4,1,5
83053,2020-07-14,4,8,3,11
83054,2020-07-14,5,21,33,54
83055,2020-07-14,6,48,136,184
83056,2020-07-14,7,94,216,310
83057,2020-07-14,8,101,253,354
83058,2020-07-14,9,127,169,296
83059,2020-07-14,10,110,164,274
83060,2020-07-14,11,141,201,342
83061,2020-07-14,12,187,237,424
83062,2020-07-14,13,130,186,316
83063,2020-07-14,14,168,186,354
83064,2020-07-14,15,202,216,418
83065,2020-07-14,16,187,243,430
83066,2020-07-14,17,310,353,663
83067,2020-07-14,18,330,395,725
83068,2020-07-14,19,369,318,687
83069,2020-07-14,20,290,292,582
83070,2020-07-14,21,150,162,312
83071,2020-07-14,22,96,99,195
83072,2020-07-14,23,67,56,123
83073,2020-07-15,0,22,9,31
83074,2020-07-15,1,14,9,23
83075,2020-07-15,2,7,2,9
83076,2020-07-15,3,3,3,6
83077,2020-07-15,4,8,5,13
83078,2020-07-15,5,31,27,58
83079,2020-07-15,6,58,96,154
83080,2020-07-15,7,90,256,346
83081,2020-07-15,8,145,258,403
83082,2020-07-15,9,117,159,276
83083,2020-07-15,10,104,147,251
83084,2020-07-15,11,193,179,372
83085,2020-07-15,12,184,198,382
83086,2020-07-15,13,181,181,362
83087,2020-07-15,14,166,170,336
83088,2020-07-15,15,173,163,336
83089,2020-07-15,16,211,268,479
83090,2020-07-15,17,317,397,714
83091,2020-07-15,18,367,363,730
83092,2020-07-15,19,367,310,677
83093,2020-07-15,20,316,276,592
83094,2020-07-15,21,171,151,322
83095,2020-07-15,22,100,100,200
83096,2020-07-15,23,63,55,118
83097,2020-07-16,0,38,16,54
83098,2020-07-16,1,13,5,18
83099,2020-07-16,2,2,4,6
83100,2020-07-16,3,4,8,12
83101,2020-07-16,4,2,7,9
83102,2020-07-16,5,36,45,81
83103,2020-07-16,6,45,112,157
83104,2020-07-16,7,81,226,307
83105,2020-07-16,8,125,259,384
83106,2020-07-16,9,123,162,285
83107,2020-07-16,10,104,141,245
83108,2020-07-16,11,155,165,320
83109,2020-07-16,12,174,200,374
83110,2020-07-16,13,176,196,372
83111,2020-07-16,14,189,199,388
83112,2020-07-16,15,187,226,413
83113,2020-07-16,16,246,276,522
83114,2020-07-16,17,372,382,754
83115,2020-07-16,18,325,413,738
83116,2020-07-16,19,392,361,753
83117,2020-07-16,20,266,271,537
83118,2020-07-16,21,151,170,321
83119,2020-07-16,22,116,100,216
83120,2020-07-16,23,92,55,147
83121,2020-07-17,0,26,32,58
83122,2020-07-17,1,33,15,48
83123,2020-07-17,2,13,12,25
83124,2020-07-17,3,13,2,15
83125,2020-07-17,4,12,7,19
83126,2020-07-17,5,27,26,53
83127,2020-07-17,6,49,88,137
83128,2020-07-17,7,114,190,304
83129,2020-07-17,8,134,260,394
83130,2020-07-17,9,112,176,288
83131,2020-07-17,10,137,171,308
83132,2020-07-17,11,177,212,389
83133,2020-07-17,12,193,233,426
83134,2020-07-17,13,219,234,453
83135,2020-07-17,14,222,226,448
83136,2020-07-17,15,245,209,454
83137,2020-07-17,16,272,262,534
83138,2020-07-17,17,299,369,668
83139,2020-07-17,18,386,328,714
83140,2020-07-17,19,415,367,782
83141,2020-07-17,20,269,250,519
83142,2020-07-17,21,209,156,365
83143,2020-07-17,22,173,97,270
83144,2020-07-17,23,132,77,209
83145,2020-07-18,0,127,57,184
83146,2020-07-18,1,53,23,76
83147,2020-07-18,2,22,19,41
83148,2020-07-18,3,22,13,35
83149,2020-07-18,4,17,6,23
83150,2020-07-18,5,21,10,31
83151,2020-07-18,6,58,53,111
83152,2020-07-18,7,91,125,216
83153,2020-07-18,8,162,189,351
83154,2020-07-18,9,244,259,503
83155,2020-07-18,10,316,280,596
83156,2020-07-18,11,371,317,688
83157,2020-07-18,12,420,316,736
83158,2020-07-18,13,421,294,715
83159,2020-07-18,14,456,297,753
83160,2020-07-18,15,404,220,624
83161,2020-07-18,16,364,237,601
83162,2020-07-18,17,320,269,589
83163,2020-07-18,18,377,233,610
83164,2020-07-18,19,449,262,711
83165,2020-07-18,20,397,215,612
83166,2020-07-18,21,279,143,422
83167,2020-07-18,22,223,131,354
83168,2020-07-18,23,227,91,318
83169,2020-07-19,0,135,72,207
83170,2020-07-19,1,63,31,94
83171,2020-07-19,2,50,18,68
83172,2020-07-19,3,29,10,39
83173,2020-07-19,4,11,7,18
83174,2020-07-19,5,21,18,39
83175,2020-07-19,6,51,57,108
83176,2020-07-19,7,100,93,193
83177,2020-07-19,8,117,183,300
83178,2020-07-19,9,186,178,364
83179,2020-07-19,10,301,216,517
83180,2020-07-19,11,330,269,599
83181,2020-07-19,12,319,237,556
83182,2020-07-19,13,380,238,618
83183,2020-07-19,14,341,214,555
83184,2020-07-19,15,344,220,564
83185,2020-07-19,16,318,197,515
83186,2020-07-19,17,275,206,481
83187,2020-07-19,18,276,215,491
83188,2020-07-19,19,313,232,545
83189,2020-07-19,20,240,181,421
83190,2020-07-19,21,188,141,329
83191,2020-07-19,22,128,87,215
83192,2020-07-19,23,60,26,86
83193,2020-07-20,0,37,20,57
83194,2020-07-20,1,20,4,24
83195,2020-07-20,2,8,5,13
83196,2020-07-20,3,8,1,9
83197,2020-07-20,4,8,6,14
83198,2020-07-20,5,42,34,76
83199,2020-07-20,6,61,103,164
83200,2020-07-20,7,88,215,303
83201,2020-07-20,8,100,247,347
83202,2020-07-20,9,110,176,286
83203,2020-07-20,10,105,156,261
83204,2020-07-20,11,141,160,301
83205,2020-07-20,12,143,170,313
83206,2020-07-20,13,147,165,312
83207,2020-07-20,14,136,158,294
83208,2020-07-20,15,163,144,307
83209,2020-07-20,16,159,187,346
83210,2020-07-20,17,199,293,492
83211,2020-07-20,18,200,234,434
83212,2020-07-20,19,183,245,428
83213,2020-07-20,20,155,175,330
83214,2020-07-20,21,88,74,162
83215,2020-07-20,22,75,43,118
83216,2020-07-20,23,43,31,74
83217,2020-07-21,0,18,14,32
83218,2020-07-21,1,10,5,15
83219,2020-07-21,2,10,1,11
83220,2020-07-21,3,10,0,10
83221,2020-07-21,4,8,3,11
83222,2020-07-21,5,44,32,76
83223,2020-07-21,6,64,109,173
83224,2020-07-21,7,101,201,302
83225,2020-07-21,8,129,247,376
83226,2020-07-21,9,134,181,315
83227,2020-07-21,10,139,149,288
83228,2020-07-21,11,117,151,268
83229,2020-07-21,12,160,202,362
83230,2020-07-21,13,160,181,341
83231,2020-07-21,14,125,158,283
83232,2020-07-21,15,151,156,307
83233,2020-07-21,16,201,225,426
83234,2020-07-21,17,247,331,578
83235,2020-07-21,18,310,361,671
83236,2020-07-21,19,246,293,539
83237,2020-07-21,20,96,129,225
83238,2020-07-21,21,61,71,132
83239,2020-07-21,22,41,57,98
83240,2020-07-21,23,33,29,62
83241,2020-07-22,0,19,13,32
83242,2020-07-22,1,15,6,21
83243,2020-07-22,2,5,2,7
83244,2020-07-22,3,7,1,8
83245,2020-07-22,4,12,4,16
83246,2020-07-22,5,39,41,80
83247,2020-07-22,6,74,101,175
83248,2020-07-22,7,139,232,371
83249,2020-07-22,8,154,260,414
83250,2020-07-22,9,119,197,316
83251,2020-07-22,10,134,119,253
83252,2020-07-22,11,149,154,303
83253,2020-07-22,12,155,209,364
83254,2020-07-22,13,154,185,339
83255,2020-07-22,14,142,158,300
83256,2020-07-22,15,182,209,391
83257,2020-07-22,16,26,50,76
83258,2020-07-22,17,52,51,103
83259,2020-07-22,18,49,74,123
83260,2020-07-22,19,67,113,180
83261,2020-07-22,20,81,131,212
83262,2020-07-22,21,72,91,163
83263,2020-07-22,22,74,65,139
83264,2020-07-22,23,40,45,85
83265,2020-07-23,0,27,17,44
83266,2020-07-23,1,11,12,23
83267,2020-07-23,2,9,5,14
83268,2020-07-23,3,6,1,7
83269,2020-07-23,4,10,2,12
83270,2020-07-23,5,31,39,70
83271,2020-07-23,6,64,124,188
83272,2020-07-23,7,111,209,320
83273,2020-07-23,8,137,268,405
83274,2020-07-23,9,132,199,331
83275,2020-07-23,10,130,191,321
83276,2020-07-23,11,135,167,302
83277,2020-07-23,12,182,198,380
83278,2020-07-23,13,162,187,349
83279,2020-07-23,14,187,177,364
83280,2020-07-23,15,195,193,388
83281,2020-07-23,16,186,227,413
83282,2020-07-23,17,257,390,647
83283,2020-07-23,18,356,401,757
83284,2020-07-23,19,292,309,601
83285,2020-07-23,20,149,159,308
83286,2020-07-23,21,28,42,70
83287,2020-07-23,22,47,55,102
83288,2020-07-23,23,35,36,71
83289,2020-07-24,0,39,15,54
83290,2020-07-24,1,15,9,24
83291,2020-07-24,2,10,2,12
83292,2020-07-24,3,8,2,10
83293,2020-07-24,4,11,5,16
83294,2020-07-24,5,20,14,34
83295,2020-07-24,6,15,32,47
83296,2020-07-24,7,35,82,117
83297,2020-07-24,8,80,182,262
83298,2020-07-24,9,111,141,252
83299,2020-07-24,10,143,182,325
83300,2020-07-24,11,144,191,335
83301,2020-07-24,12,198,194,392
83302,2020-07-24,13,199,206,405
83303,2020-07-24,14,242,240,482
83304,2020-07-24,15,242,212,454
83305,2020-07-24,16,264,301,565
83306,2020-07-24,17,345,362,707
83307,2020-07-24,18,339,401,740
83308,2020-07-24,19,314,295,609
83309,2020-07-24,20,241,226,467
83310,2020-07-24,21,166,139,305
83311,2020-07-24,22,147,98,245
83312,2020-07-24,23,164,81,245
83313,2020-07-25,0,91,76,167
83314,2020-07-25,1,60,25,85
83315,2020-07-25,2,31,8,39
83316,2020-07-25,3,34,11,45
83317,2020-07-25,4,10,4,14
83318,2020-07-25,5,11,8,19
83319,2020-07-25,6,60,58,118
83320,2020-07-25,7,86,119,205
83321,2020-07-25,8,169,193,362
83322,2020-07-25,9,290,274,564
83323,2020-07-25,10,349,336,685
83324,2020-07-25,11,499,321,820
83325,2020-07-25,12,540,336,876
83326,2020-07-25,13,476,342,818
83327,2020-07-25,14,462,280,742
83328,2020-07-25,15,502,290,792
83329,2020-07-25,16,437,325,762
83330,2020-07-25,17,472,293,765
83331,2020-07-25,18,466,294,760
83332,2020-07-25,19,483,281,764
83333,2020-07-25,20,369,210,579
83334,2020-07-25,21,304,159,463
83335,2020-07-25,22,214,106,320
83336,2020-07-25,23,199,106,305
83337,2020-07-26,0,133,85,218
83338,2020-07-26,1,77,24,101
83339,2020-07-26,2,61,16,77
83340,2020-07-26,3,28,5,33
83341,2020-07-26,4,16,6,22
83342,2020-07-26,5,24,11,35
83343,2020-07-26,6,30,35,65
83344,2020-07-26,7,89,92,181
83345,2020-07-26,8,128,166,294
83346,2020-07-26,9,221,208,429
83347,2020-07-26,10,298,243,541
83348,2020-07-26,11,320,276,596
83349,2020-07-26,12,340,298,638
83350,2020-07-26,13,354,279,633
83351,2020-07-26,14,337,240,577
83352,2020-07-26,15,364,246,610
83353,2020-07-26,16,361,251,612
83354,2020-07-26,17,307,287,594
83355,2020-07-26,18,346,241,587
83356,2020-07-26,19,334,220,554
83357,2020-07-26,20,326,205,531
83358,2020-07-26,21,214,125,339
83359,2020-07-26,22,150,83,233
83360,2020-07-26,23,80,64,144
83361,2020-07-27,0,33,27,60
83362,2020-07-27,1,22,13,35
83363,2020-07-27,2,6,4,10
83364,2020-07-27,3,6,0,6
83365,2020-07-27,4,14,9,23
83366,2020-07-27,5,26,38,64
83367,2020-07-27,6,63,100,163
83368,2020-07-27,7,82,201,283
83369,2020-07-27,8,132,264,396
83370,2020-07-27,9,127,160,287
83371,2020-07-27,10,127,145,272
83372,2020-07-27,11,130,168,298
83373,2020-07-27,12,164,189,353
83374,2020-07-27,13,173,173,346
83375,2020-07-27,14,164,151,315
83376,2020-07-27,15,169,170,339
83377,2020-07-27,16,179,230,409
83378,2020-07-27,17,298,309,607
83379,2020-07-27,18,354,392,746
83380,2020-07-27,19,338,349,687
83381,2020-07-27,20,295,267,562
83382,2020-07-27,21,177,153,330
83383,2020-07-27,22,93,81,174
83384,2020-07-27,23,59,34,93
83385,2020-07-28,0,33,26,59
83386,2020-07-28,1,8,7,15
83387,2020-07-28,2,13,3,16
83388,2020-07-28,3,7,1,8
83389,2020-07-28,4,12,4,16
83390,2020-07-28,5,31,51,82
83391,2020-07-28,6,65,130,195
83392,2020-07-28,7,134,243,377
83393,2020-07-28,8,150,302,452
83394,2020-07-28,9,152,194,346
83395,2020-07-28,10,112,165,277
83396,2020-07-28,11,151,172,323
83397,2020-07-28,12,166,172,338
83398,2020-07-28,13,137,175,312
83399,2020-07-28,14,168,191,359
83400,2020-07-28,15,194,153,347
83401,2020-07-28,16,227,222,449
83402,2020-07-28,17,291,338,629
83403,2020-07-28,18,357,392,749
83404,2020-07-28,19,302,328,630
83405,2020-07-28,20,219,267,486
83406,2020-07-28,21,157,140,297
83407,2020-07-28,22,84,75,159
83408,2020-07-28,23,73,37,110
83409,2020-07-29,0,44,16,60
83410,2020-07-29,1,12,5,17
83411,2020-07-29,2,10,2,12
83412,2020-07-29,3,4,2,6
83413,2020-07-29,4,9,5,14
83414,2020-07-29,5,26,42,68
83415,2020-07-29,6,71,107,178
83416,2020-07-29,7,137,209,346
83417,2020-07-29,8,162,258,420
83418,2020-07-29,9,134,171,305
83419,2020-07-29,10,137,168,305
83420,2020-07-29,11,173,189,362
83421,2020-07-29,12,184,182,366
83422,2020-07-29,13,187,160,347
83423,2020-07-29,14,180,168,348
83424,2020-07-29,15,188,188,376
83425,2020-07-29,16,217,254,471
83426,2020-07-29,17,291,348,639
83427,2020-07-29,18,392,414,806
83428,2020-07-29,19,390,389,779
83429,2020-07-29,20,301,274,575
83430,2020-07-29,21,203,173,376
83431,2020-07-29,22,137,97,234
83432,2020-07-29,23,90,48,138
83433,2020-07-30,0,33,17,50
83434,2020-07-30,1,16,7,23
83435,2020-07-30,2,13,2,15
83436,2020-07-30,3,6,2,8
83437,2020-07-30,4,12,10,22
83438,2020-07-30,5,25,39,64
83439,2020-07-30,6,47,105,152
83440,2020-07-30,7,106,238,344
83441,2020-07-30,8,141,276,417
83442,2020-07-30,9,127,157,284
83443,2020-07-30,10,135,178,313
83444,2020-07-30,11,142,184,326
83445,2020-07-30,12,159,202,361
83446,2020-07-30,13,162,196,358
83447,2020-07-30,14,190,165,355
83448,2020-07-30,15,210,183,393
83449,2020-07-30,16,231,266,497
83450,2020-07-30,17,307,388,695
83451,2020-07-30,18,352,410,762
83452,2020-07-30,19,205,242,447
83453,2020-07-30,20,47,66,113
83454,2020-07-30,21,74,69,143
83455,2020-07-30,22,73,56,129
83456,2020-07-30,23,73,46,119
83457,2020-07-31,0,33,10,43
83458,2020-07-31,1,12,7,19
83459,2020-07-31,2,5,3,8
83460,2020-07-31,3,10,1,11
83461,2020-07-31,4,13,3,16
83462,2020-07-31,5,20,24,44
83463,2020-07-31,6,40,88,128
83464,2020-07-31,7,69,129,198
83465,2020-07-31,8,59,125,184
83466,2020-07-31,9,41,76,117
83467,2020-07-31,10,77,109,186
83468,2020-07-31,11,90,112,202
83469,2020-07-31,12,107,139,246
83470,2020-07-31,13,137,138,275
83471,2020-07-31,14,129,141,270
83472,2020-07-31,15,221,212,433
83473,2020-07-31,16,272,310,582
83474,2020-07-31,17,308,371,679
83475,2020-07-31,18,321,365,686
83476,2020-07-31,19,310,306,616
83477,2020-07-31,20,260,221,481
83478,2020-07-31,21,170,121,291
83479,2020-07-31,22,147,105,252
83480,2020-07-31,23,145,72,217
83481,2020-08-01,0,99,46,145
83482,2020-08-01,1,83,29,112
83483,2020-08-01,2,31,19,50
83484,2020-08-01,3,17,10,27
83485,2020-08-01,4,18,3,21
83486,2020-08-01,5,14,16,30
83487,2020-08-01,6,36,56,92
83488,2020-08-01,7,84,123,207
83489,2020-08-01,8,161,167,328
83490,2020-08-01,9,239,263,502
83491,2020-08-01,10,376,295,671
83492,2020-08-01,11,458,353,811
83493,2020-08-01,12,426,357,783
83494,2020-08-01,13,483,299,782
83495,2020-08-01,14,474,337,811
83496,2020-08-01,15,545,316,861
83497,2020-08-01,16,489,332,821
83498,2020-08-01,17,480,338,818
83499,2020-08-01,18,539,332,871
83500,2020-08-01,19,436,255,691
83501,2020-08-01,20,350,233,583
83502,2020-08-01,21,259,125,384
83503,2020-08-01,22,231,114,345
83504,2020-08-01,23,168,80,248
83505,2020-08-02,0,133,54,187
83506,2020-08-02,1,78,26,104
83507,2020-08-02,2,49,12,61
83508,2020-08-02,3,19,5,24
83509,2020-08-02,4,9,3,12
83510,2020-08-02,5,13,9,22
83511,2020-08-02,6,44,40,84
83512,2020-08-02,7,74,93,167
83513,2020-08-02,8,101,157,258
83514,2020-08-02,9,244,243,487
83515,2020-08-02,10,262,287,549
83516,2020-08-02,11,382,288,670
83517,2020-08-02,12,383,366,749
83518,2020-08-02,13,437,329,766
83519,2020-08-02,14,452,287,739
83520,2020-08-02,15,493,256,749
83521,2020-08-02,16,445,275,720
83522,2020-08-02,17,370,287,657
83523,2020-08-02,18,327,247,574
83524,2020-08-02,19,388,265,653
83525,2020-08-02,20,294,196,490
83526,2020-08-02,21,196,128,324
83527,2020-08-02,22,158,88,246
83528,2020-08-02,23,85,40,125
83529,2020-08-03,0,45,13,58
83530,2020-08-03,1,20,7,27
83531,2020-08-03,2,12,1,13
83532,2020-08-03,3,8,2,10
83533,2020-08-03,4,14,7,21
83534,2020-08-03,5,36,33,69
83535,2020-08-03,6,48,98,146
83536,2020-08-03,7,97,190,287
83537,2020-08-03,8,137,280,417
83538,2020-08-03,9,117,211,328
83539,2020-08-03,10,142,185,327
83540,2020-08-03,11,169,221,390
83541,2020-08-03,12,213,194,407
83542,2020-08-03,13,270,211,481
83543,2020-08-03,14,198,203,401
83544,2020-08-03,15,146,185,331
83545,2020-08-03,16,126,157,283
83546,2020-08-03,17,39,55,94
83547,2020-08-03,18,81,110,191
83548,2020-08-03,19,45,55,100
83549,2020-08-03,20,74,90,164
83550,2020-08-03,21,46,56,102
83551,2020-08-03,22,41,39,80
83552,2020-08-03,23,35,22,57
83553,2020-08-04,0,14,12,26
83554,2020-08-04,1,4,5,9
83555,2020-08-04,2,5,4,9
83556,2020-08-04,3,2,0,2
83557,2020-08-04,4,6,2,8
83558,2020-08-04,5,10,6,16
83559,2020-08-04,6,11,16,27
83560,2020-08-04,7,9,27,36
83561,2020-08-04,8,11,17,28
83562,2020-08-04,9,4,16,20
83563,2020-08-04,10,28,32,60
83564,2020-08-04,11,76,87,163
83565,2020-08-04,12,130,172,302
83566,2020-08-04,13,195,171,366
83567,2020-08-04,14,202,169,371
83568,2020-08-04,15,243,179,422
83569,2020-08-04,16,247,265,512
83570,2020-08-04,17,371,385,756
83571,2020-08-04,18,439,390,829
83572,2020-08-04,19,386,380,766
83573,2020-08-04,20,218,277,495
83574,2020-08-04,21,140,117,257
83575,2020-08-04,22,66,69,135
83576,2020-08-04,23,76,38,114
83577,2020-08-05,0,39,15,54
83578,2020-08-05,1,10,3,13
83579,2020-08-05,2,10,2,12
83580,2020-08-05,3,8,3,11
83581,2020-08-05,4,12,8,20
83582,2020-08-05,5,24,37,61
83583,2020-08-05,6,60,115,175
83584,2020-08-05,7,135,222,357
83585,2020-08-05,8,140,300,440
83586,2020-08-05,9,130,196,326
83587,2020-08-05,10,140,196,336
83588,2020-08-05,11,161,192,353
83589,2020-08-05,12,177,226,403
83590,2020-08-05,13,220,202,422
83591,2020-08-05,14,197,216,413
83592,2020-08-05,15,233,212,445
83593,2020-08-05,16,275,304,579
83594,2020-08-05,17,419,421,840
83595,2020-08-05,18,437,494,931
83596,2020-08-05,19,474,405,879
83597,2020-08-05,20,371,296,667
83598,2020-08-05,21,193,147,340
83599,2020-08-05,22,158,97,255
83600,2020-08-05,23,82,58,140
83601,2020-08-06,0,19,14,33
83602,2020-08-06,1,20,6,26
83603,2020-08-06,2,15,4,19
83604,2020-08-06,3,6,5,11
83605,2020-08-06,4,5,5,10
83606,2020-08-06,5,7,12,19
83607,2020-08-06,6,33,65,98
83608,2020-08-06,7,76,170,246
83609,2020-08-06,8,80,218,298
83610,2020-08-06,9,110,145,255
83611,2020-08-06,10,129,148,277
83612,2020-08-06,11,145,165,310
83613,2020-08-06,12,165,186,351
83614,2020-08-06,13,210,201,411
83615,2020-08-06,14,223,191,414
83616,2020-08-06,15,203,189,392
83617,2020-08-06,16,206,213,419
83618,2020-08-06,17,266,281,547
83619,2020-08-06,18,270,375,645
83620,2020-08-06,19,226,308,534
83621,2020-08-06,20,156,156,312
83622,2020-08-06,21,98,110,208
83623,2020-08-06,22,83,49,132
83624,2020-08-06,23,71,39,110
83625,2020-08-07,0,49,15,64
83626,2020-08-07,1,22,8,30
83627,2020-08-07,2,7,4,11
83628,2020-08-07,3,5,2,7
83629,2020-08-07,4,18,8,26
83630,2020-08-07,5,26,30,56
83631,2020-08-07,6,53,95,148
83632,2020-08-07,7,84,183,267
83633,2020-08-07,8,114,228,342
83634,2020-08-07,9,126,169,295
83635,2020-08-07,10,147,171,318
83636,2020-08-07,11,178,221,399
83637,2020-08-07,12,191,233,424
83638,2020-08-07,13,232,228,460
83639,2020-08-07,14,242,231,473
83640,2020-08-07,15,317,235,552
83641,2020-08-07,16,289,295,584
83642,2020-08-07,17,390,385,775
83643,2020-08-07,18,419,449,868
83644,2020-08-07,19,379,379,758
83645,2020-08-07,20,293,254,547
83646,2020-08-07,21,143,106,249
83647,2020-08-07,22,133,82,215
83648,2020-08-07,23,116,64,180
83649,2020-08-08,0,104,54,158
83650,2020-08-08,1,67,19,86
83651,2020-08-08,2,40,12,52
83652,2020-08-08,3,17,7,24
83653,2020-08-08,4,13,2,15
83654,2020-08-08,5,19,12,31
83655,2020-08-08,6,64,51,115
83656,2020-08-08,7,86,115,201
83657,2020-08-08,8,153,230,383
83658,2020-08-08,9,274,255,529
83659,2020-08-08,10,390,331,721
83660,2020-08-08,11,471,342,813
83661,2020-08-08,12,489,362,851
83662,2020-08-08,13,553,356,909
83663,2020-08-08,14,586,356,942
83664,2020-08-08,15,570,377,947
83665,2020-08-08,16,629,345,974
83666,2020-08-08,17,562,343,905
83667,2020-08-08,18,520,339,859
83668,2020-08-08,19,432,353,785
83669,2020-08-08,20,410,255,665
83670,2020-08-08,21,280,142,422
83671,2020-08-08,22,196,116,312
83672,2020-08-08,23,217,102,319
83673,2020-08-09,0,123,65,188
83674,2020-08-09,1,62,38,100
83675,2020-08-09,2,38,16,54
83676,2020-08-09,3,22,7,29
83677,2020-08-09,4,14,5,19
83678,2020-08-09,5,19,8,27
83679,2020-08-09,6,49,41,90
83680,2020-08-09,7,96,85,181
83681,2020-08-09,8,118,146,264
83682,2020-08-09,9,236,237,473
83683,2020-08-09,10,328,286,614
83684,2020-08-09,11,354,351,705
83685,2020-08-09,12,497,337,834
83686,2020-08-09,13,550,301,851
83687,2020-08-09,14,246,186,432
83688,2020-08-09,15,412,256,668
83689,2020-08-09,16,384,327,711
83690,2020-08-09,17,354,324,678
83691,2020-08-09,18,446,339,785
83692,2020-08-09,19,378,279,657
83693,2020-08-09,20,270,221,491
83694,2020-08-09,21,170,133,303
83695,2020-08-09,22,162,72,234
83696,2020-08-09,23,91,48,139
83697,2020-08-10,0,43,15,58
83698,2020-08-10,1,21,6,27
83699,2020-08-10,2,14,4,18
83700,2020-08-10,3,9,3,12
83701,2020-08-10,4,19,7,26
83702,2020-08-10,5,30,37,67
83703,2020-08-10,6,51,108,159
83704,2020-08-10,7,99,189,288
83705,2020-08-10,8,116,234,350
83706,2020-08-10,9,123,155,278
83707,2020-08-10,10,122,148,270
83708,2020-08-10,11,149,149,298
83709,2020-08-10,12,170,197,367
83710,2020-08-10,13,158,178,336
83711,2020-08-10,14,165,184,349
83712,2020-08-10,15,218,184,402
83713,2020-08-10,16,216,249,465
83714,2020-08-10,17,275,291,566
83715,2020-08-10,18,339,376,715
83716,2020-08-10,19,388,314,702
83717,2020-08-10,20,202,237,439
83718,2020-08-10,21,128,116,244
83719,2020-08-10,22,119,78,197
83720,2020-08-10,23,56,33,89
83721,2020-08-11,0,20,16,36
83722,2020-08-11,1,14,10,24
83723,2020-08-11,2,3,4,7
83724,2020-08-11,3,7,2,9
83725,2020-08-11,4,10,6,16
83726,2020-08-11,5,25,40,65
83727,2020-08-11,6,65,118,183
83728,2020-08-11,7,108,216,324
83729,2020-08-11,8,141,260,401
83730,2020-08-11,9,114,169,283
83731,2020-08-11,10,109,162,271
83732,2020-08-11,11,166,162,328
83733,2020-08-11,12,175,207,382
83734,2020-08-11,13,150,202,352
83735,2020-08-11,14,176,190,366
83736,2020-08-11,15,176,224,400
83737,2020-08-11,16,239,269,508
83738,2020-08-11,17,342,406,748
83739,2020-08-11,18,350,421,771
83740,2020-08-11,19,393,411,804
83741,2020-08-11,20,237,255,492
83742,2020-08-11,21,156,140,296
83743,2020-08-11,22,107,89,196
83744,2020-08-11,23,89,34,123
83745,2020-08-12,0,38,20,58
83746,2020-08-12,1,21,9,30
83747,2020-08-12,2,12,11,23
83748,2020-08-12,3,5,6,11
83749,2020-08-12,4,11,4,15
83750,2020-08-12,5,10,9,19
83751,2020-08-12,6,14,31,45
83752,2020-08-12,7,36,106,142
83753,2020-08-12,8,80,171,251
83754,2020-08-12,9,117,167,284
83755,2020-08-12,10,132,163,295
83756,2020-08-12,11,155,200,355
83757,2020-08-12,12,169,232,401
83758,2020-08-12,13,162,208,370
83759,2020-08-12,14,184,180,364
83760,2020-08-12,15,215,196,411
83761,2020-08-12,16,196,257,453
83762,2020-08-12,17,241,313,554
83763,2020-08-12,18,270,347,617
83764,2020-08-12,19,261,309,570
83765,2020-08-12,20,181,192,373
83766,2020-08-12,21,113,115,228
83767,2020-08-12,22,88,80,168
83768,2020-08-12,23,72,49,121
83769,2020-08-13,0,44,17,61
83770,2020-08-13,1,26,11,37
83771,2020-08-13,2,15,4,19
83772,2020-08-13,3,11,6,17
83773,2020-08-13,4,11,2,13
83774,2020-08-13,5,28,35,63
83775,2020-08-13,6,43,93,136
83776,2020-08-13,7,22,65,87
83777,2020-08-13,8,27,84,111
83778,2020-08-13,9,15,29,44
83779,2020-08-13,10,6,24,30
83780,2020-08-13,11,31,53,84
83781,2020-08-13,12,93,131,224
83782,2020-08-13,13,171,177,348
83783,2020-08-13,14,139,186,325
83784,2020-08-13,15,196,192,388
83785,2020-08-13,16,219,274,493
83786,2020-08-13,17,286,392,678
83787,2020-08-13,18,340,471,811
83788,2020-08-13,19,327,361,688
83789,2020-08-13,20,209,248,457
83790,2020-08-13,21,160,124,284
83791,2020-08-13,22,97,100,197
83792,2020-08-13,23,95,67,162
83793,2020-08-14,0,43,21,64
83794,2020-08-14,1,36,11,47
83795,2020-08-14,2,14,7,21
83796,2020-08-14,3,9,1,10
83797,2020-08-14,4,16,4,20
83798,2020-08-14,5,18,32,50
83799,2020-08-14,6,39,92,131
83800,2020-08-14,7,102,163,265
83801,2020-08-14,8,127,266,393
83802,2020-08-14,9,117,178,295
83803,2020-08-14,10,148,141,289
83804,2020-08-14,11,191,213,404
83805,2020-08-14,12,222,252,474
83806,2020-08-14,13,256,236,492
83807,2020-08-14,14,247,245,492
83808,2020-08-14,15,262,258,520
83809,2020-08-14,16,256,288,544
83810,2020-08-14,17,347,390,737
83811,2020-08-14,18,351,431,782
83812,2020-08-14,19,376,438,814
83813,2020-08-14,20,232,228,460
83814,2020-08-14,21,194,157,351
83815,2020-08-14,22,197,112,309
83816,2020-08-14,23,184,73,257
83817,2020-08-15,0,135,89,224
83818,2020-08-15,1,81,45,126
83819,2020-08-15,2,44,14,58
83820,2020-08-15,3,28,9,37
83821,2020-08-15,4,9,5,14
83822,2020-08-15,5,7,10,17
83823,2020-08-15,6,34,43,77
83824,2020-08-15,7,60,86,146
83825,2020-08-15,8,120,173,293
83826,2020-08-15,9,193,240,433
83827,2020-08-15,10,326,322,648
83828,2020-08-15,11,415,385,800
83829,2020-08-15,12,438,391,829
83830,2020-08-15,13,509,333,842
83831,2020-08-15,14,498,366,864
83832,2020-08-15,15,479,321,800
83833,2020-08-15,16,391,307,698
83834,2020-08-15,17,277,249,526
83835,2020-08-15,18,291,266,557
83836,2020-08-15,19,183,164,347
83837,2020-08-15,20,123,122,245
83838,2020-08-15,21,135,103,238
83839,2020-08-15,22,107,81,188
83840,2020-08-15,23,107,66,173
83841,2020-08-16,0,45,51,96
83842,2020-08-16,1,20,8,28
83843,2020-08-16,2,6,8,14
83844,2020-08-16,3,3,1,4
83845,2020-08-16,4,1,4,5
83846,2020-08-16,5,7,2,9
83847,2020-08-16,6,12,7,19
83848,2020-08-16,7,36,39,75
83849,2020-08-16,8,45,81,126
83850,2020-08-16,9,80,109,189
83851,2020-08-16,10,164,185,349
83852,2020-08-16,11,135,170,305
83853,2020-08-16,12,162,205,367
83854,2020-08-16,13,265,233,498
83855,2020-08-16,14,364,300,664
83856,2020-08-16,15,430,347,777
83857,2020-08-16,16,379,335,714
83858,2020-08-16,17,391,346,737
83859,2020-08-16,18,359,297,656
83860,2020-08-16,19,332,270,602
83861,2020-08-16,20,218,181,399
83862,2020-08-16,21,135,121,256
83863,2020-08-16,22,91,69,160
83864,2020-08-16,23,55,30,85
83865,2020-08-17,0,35,21,56
83866,2020-08-17,1,25,11,36
83867,2020-08-17,2,13,8,21
83868,2020-08-17,3,2,6,8
83869,2020-08-17,4,8,7,15
83870,2020-08-17,5,15,35,50
83871,2020-08-17,6,48,79,127
83872,2020-08-17,7,100,196,296
83873,2020-08-17,8,128,242,370
83874,2020-08-17,9,112,183,295
83875,2020-08-17,10,123,187,310
83876,2020-08-17,11,169,197,366
83877,2020-08-17,12,198,247,445
83878,2020-08-17,13,202,234,436
83879,2020-08-17,14,203,203,406
83880,2020-08-17,15,233,240,473
83881,2020-08-17,16,188,201,389
83882,2020-08-17,17,249,280,529
83883,2020-08-17,18,219,301,520
83884,2020-08-17,19,185,255,440
83885,2020-08-17,20,162,178,340
83886,2020-08-17,21,90,81,171
83887,2020-08-17,22,86,47,133
83888,2020-08-17,23,55,41,96
83889,2020-08-18,0,30,19,49
83890,2020-08-18,1,26,6,32
83891,2020-08-18,2,13,6,19
83892,2020-08-18,3,9,8,17
83893,2020-08-18,4,7,11,18
83894,2020-08-18,5,20,37,57
83895,2020-08-18,6,58,125,183
83896,2020-08-18,7,91,241,332
83897,2020-08-18,8,121,267,388
83898,2020-08-18,9,117,169,286
83899,2020-08-18,10,155,190,345
83900,2020-08-18,11,145,201,346
83901,2020-08-18,12,193,224,417
83902,2020-08-18,13,257,204,461
83903,2020-08-18,14,215,197,412
83904,2020-08-18,15,264,226,490
83905,2020-08-18,16,299,291,590
83906,2020-08-18,17,384,461,845
83907,2020-08-18,18,410,500,910
83908,2020-08-18,19,415,410,825
83909,2020-08-18,20,255,331,586
83910,2020-08-18,21,138,131,269
83911,2020-08-18,22,102,89,191
83912,2020-08-18,23,64,53,117
83913,2020-08-19,0,46,18,64
83914,2020-08-19,1,26,14,40
83915,2020-08-19,2,22,3,25
83916,2020-08-19,3,8,1,9
83917,2020-08-19,4,9,6,15
83918,2020-08-19,5,8,15,23
83919,2020-08-19,6,25,65,90
83920,2020-08-19,7,27,75,102
83921,2020-08-19,8,51,140,191
83922,2020-08-19,9,75,131,206
83923,2020-08-19,10,84,123,207
83924,2020-08-19,11,119,162,281
83925,2020-08-19,12,168,196,364
83926,2020-08-19,13,198,207,405
83927,2020-08-19,14,223,208,431
83928,2020-08-19,15,201,255,456
83929,2020-08-19,16,246,277,523
83930,2020-08-19,17,347,458,805
83931,2020-08-19,18,391,499,890
83932,2020-08-19,19,391,452,843
83933,2020-08-19,20,243,309,552
83934,2020-08-19,21,147,145,292
83935,2020-08-19,22,106,92,198
83936,2020-08-19,23,70,53,123
83937,2020-08-20,0,43,20,63
83938,2020-08-20,1,22,10,32
83939,2020-08-20,2,10,3,13
83940,2020-08-20,3,7,5,12
83941,2020-08-20,4,9,13,22
83942,2020-08-20,5,26,37,63
83943,2020-08-20,6,53,117,170
83944,2020-08-20,7,96,233,329
83945,2020-08-20,8,140,312,452
83946,2020-08-20,9,116,200,316
83947,2020-08-20,10,131,180,311
83948,2020-08-20,11,168,223,391
83949,2020-08-20,12,204,244,448
83950,2020-08-20,13,214,229,443
83951,2020-08-20,14,264,228,492
83952,2020-08-20,15,259,258,517
83953,2020-08-20,16,302,295,597
83954,2020-08-20,17,348,450,798
83955,2020-08-20,18,416,486,902
83956,2020-08-20,19,349,401,750
83957,2020-08-20,20,230,273,503
83958,2020-08-20,21,154,168,322
83959,2020-08-20,22,126,122,248
83960,2020-08-20,23,83,58,141
83961,2020-08-21,0,34,28,62
83962,2020-08-21,1,23,13,36
83963,2020-08-21,2,13,7,20
83964,2020-08-21,3,12,3,15
83965,2020-08-21,4,10,11,21
83966,2020-08-21,5,17,26,43
83967,2020-08-21,6,55,90,145
83968,2020-08-21,7,95,194,289
83969,2020-08-21,8,98,245,343
83970,2020-08-21,9,146,189,335
83971,2020-08-21,10,145,172,317
83972,2020-08-21,11,194,259,453
83973,2020-08-21,12,214,252,466
83974,2020-08-21,13,213,264,477
83975,2020-08-21,14,258,266,524
83976,2020-08-21,15,300,254,554
83977,2020-08-21,16,345,395,740
83978,2020-08-21,17,406,483,889
83979,2020-08-21,18,454,470,924
83980,2020-08-21,19,384,377,761
83981,2020-08-21,20,265,264,529
83982,2020-08-21,21,161,150,311
83983,2020-08-21,22,150,101,251
83984,2020-08-21,23,131,93,224
83985,2020-08-22,0,102,78,180
83986,2020-08-22,1,52,49,101
83987,2020-08-22,2,19,13,32
83988,2020-08-22,3,10,6,16
83989,2020-08-22,4,10,4,14
83990,2020-08-22,5,13,10,23
83991,2020-08-22,6,32,36,68
83992,2020-08-22,7,93,83,176
83993,2020-08-22,8,93,136,229
83994,2020-08-22,9,194,197,391
83995,2020-08-22,10,293,302,595
83996,2020-08-22,11,440,361,801
83997,2020-08-22,12,459,400,859
83998,2020-08-22,13,546,434,980
83999,2020-08-22,14,542,413,955
84000,2020-08-22,15,494,374,868
84001,2020-08-22,16,492,326,818
84002,2020-08-22,17,481,334,815
84003,2020-08-22,18,430,378,808
84004,2020-08-22,19,398,347,745
84005,2020-08-22,20,260,227,487
84006,2020-08-22,21,214,143,357
84007,2020-08-22,22,169,107,276
84008,2020-08-22,23,174,94,268
84009,2020-08-23,0,156,82,238
84010,2020-08-23,1,73,28,101
84011,2020-08-23,2,38,12,50
84012,2020-08-23,3,22,6,28
84013,2020-08-23,4,13,7,20
84014,2020-08-23,5,12,9,21
84015,2020-08-23,6,30,41,71
84016,2020-08-23,7,62,71,133
84017,2020-08-23,8,102,134,236
84018,2020-08-23,9,221,257,478
84019,2020-08-23,10,339,317,656
84020,2020-08-23,11,484,388,872
84021,2020-08-23,12,506,403,909
84022,2020-08-23,13,503,365,868
84023,2020-08-23,14,523,371,894
84024,2020-08-23,15,424,310,734
84025,2020-08-23,16,405,311,716
84026,2020-08-23,17,401,339,740
84027,2020-08-23,18,384,348,732
84028,2020-08-23,19,345,261,606
84029,2020-08-23,20,197,204,401
84030,2020-08-23,21,101,101,202
84031,2020-08-23,22,117,85,202
84032,2020-08-23,23,74,33,107
84033,2020-08-24,0,50,22,72
84034,2020-08-24,1,11,16,27
84035,2020-08-24,2,11,8,19
84036,2020-08-24,3,8,5,13
84037,2020-08-24,4,10,9,19
84038,2020-08-24,5,16,27,43
84039,2020-08-24,6,47,88,135
84040,2020-08-24,7,82,219,301
84041,2020-08-24,8,121,260,381
84042,2020-08-24,9,112,185,297
84043,2020-08-24,10,107,148,255
84044,2020-08-24,11,149,187,336
84045,2020-08-24,12,156,237,393
84046,2020-08-24,13,128,157,285
84047,2020-08-24,14,103,159,262
84048,2020-08-24,15,149,207,356
84049,2020-08-24,16,195,283,478
84050,2020-08-24,17,286,371,657
84051,2020-08-24,18,294,445,739
84052,2020-08-24,19,317,388,705
84053,2020-08-24,20,162,252,414
84054,2020-08-24,21,124,128,252
84055,2020-08-24,22,72,82,154
84056,2020-08-24,23,60,41,101
84057,2020-08-25,0,34,24,58
84058,2020-08-25,1,12,12,24
84059,2020-08-25,2,8,8,16
84060,2020-08-25,3,1,2,3
84061,2020-08-25,4,16,5,21
84062,2020-08-25,5,19,36,55
84063,2020-08-25,6,51,135,186
84064,2020-08-25,7,104,228,332
84065,2020-08-25,8,140,279,419
84066,2020-08-25,9,115,199,314
84067,2020-08-25,10,116,145,261
84068,2020-08-25,11,176,229,405
84069,2020-08-25,12,162,254,416
84070,2020-08-25,13,161,187,348
84071,2020-08-25,14,167,198,365
84072,2020-08-25,15,194,243,437
84073,2020-08-25,16,220,304,524
84074,2020-08-25,17,293,455,748
84075,2020-08-25,18,307,457,764
84076,2020-08-25,19,174,242,416
84077,2020-08-25,20,112,147,259
84078,2020-08-25,21,99,100,199
84079,2020-08-25,22,96,65,161
84080,2020-08-25,23,49,49,98
84081,2020-08-26,0,24,17,41
84082,2020-08-26,1,22,11,33
84083,2020-08-26,2,7,5,12
84084,2020-08-26,3,5,6,11
84085,2020-08-26,4,8,9,17
84086,2020-08-26,5,16,33,49
84087,2020-08-26,6,41,126,167
84088,2020-08-26,7,103,213,316
84089,2020-08-26,8,130,300,430
84090,2020-08-26,9,110,194,304
84091,2020-08-26,10,118,197,315
84092,2020-08-26,11,157,259,416
84093,2020-08-26,12,230,257,487
84094,2020-08-26,13,212,217,429
84095,2020-08-26,14,235,201,436
84096,2020-08-26,15,221,231,452
84097,2020-08-26,16,278,303,581
84098,2020-08-26,17,366,477,843
84099,2020-08-26,18,430,528,958
84100,2020-08-26,19,382,466,848
84101,2020-08-26,20,248,311,559
84102,2020-08-26,21,157,170,327
84103,2020-08-26,22,129,110,239
84104,2020-08-26,23,74,69,143
84105,2020-08-27,0,49,26,75
84106,2020-08-27,1,17,12,29
84107,2020-08-27,2,6,5,11
84108,2020-08-27,3,5,1,6
84109,2020-08-27,4,9,5,14
84110,2020-08-27,5,26,38,64
84111,2020-08-27,6,55,123,178
84112,2020-08-27,7,117,248,365
84113,2020-08-27,8,144,272,416
84114,2020-08-27,9,139,206,345
84115,2020-08-27,10,132,208,340
84116,2020-08-27,11,156,178,334
84117,2020-08-27,12,202,253,455
84118,2020-08-27,13,215,240,455
84119,2020-08-27,14,237,201,438
84120,2020-08-27,15,254,229,483
84121,2020-08-27,16,293,306,599
84122,2020-08-27,17,372,427,799
84123,2020-08-27,18,433,489,922
84124,2020-08-27,19,389,364,753
84125,2020-08-27,20,289,267,556
84126,2020-08-27,21,213,193,406
84127,2020-08-27,22,197,130,327
84128,2020-08-27,23,196,117,313
84129,2020-08-28,0,121,54,175
84130,2020-08-28,1,33,24,57
84131,2020-08-28,2,28,18,46
84132,2020-08-28,3,10,6,16
84133,2020-08-28,4,13,8,21
84134,2020-08-28,5,24,30,54
84135,2020-08-28,6,71,114,185
84136,2020-08-28,7,150,214,364
84137,2020-08-28,8,201,265,466
84138,2020-08-28,9,271,254,525
84139,2020-08-28,10,413,259,672
84140,2020-08-28,11,434,339,773
84141,2020-08-28,12,552,296,848
84142,2020-08-28,13,628,333,961
84143,2020-08-28,14,759,370,1129
84144,2020-08-28,15,857,423,1280
84145,2020-08-28,16,721,425,1146
84146,2020-08-28,17,565,439,1004
84147,2020-08-28,18,138,140,278
84148,2020-08-28,19,101,100,201
84149,2020-08-28,20,102,79,181
84150,2020-08-28,21,44,34,78
84151,2020-08-28,22,37,32,69
84152,2020-08-28,23,74,29,103
84153,2020-08-29,0,45,31,76
84154,2020-08-29,1,13,8,21
84155,2020-08-29,2,8,11,19
84156,2020-08-29,3,13,8,21
84157,2020-08-29,4,10,6,16
84158,2020-08-29,5,16,10,26
84159,2020-08-29,6,27,33,60
84160,2020-08-29,7,48,68,116
84161,2020-08-29,8,48,87,135
84162,2020-08-29,9,34,64,98
84163,2020-08-29,10,69,106,175
84164,2020-08-29,11,150,176,326
84165,2020-08-29,12,234,215,449
84166,2020-08-29,13,270,243,513
84167,2020-08-29,14,316,233,549
84168,2020-08-29,15,439,284,723
84169,2020-08-29,16,504,379,883
84170,2020-08-29,17,496,363,859
84171,2020-08-29,18,565,417,982
84172,2020-08-29,19,492,357,849
84173,2020-08-29,20,367,221,588
84174,2020-08-29,21,254,157,411
84175,2020-08-29,22,214,114,328
84176,2020-08-29,23,201,137,338
84177,2020-08-30,0,167,102,269
84178,2020-08-30,1,103,40,143
84179,2020-08-30,2,70,21,91
84180,2020-08-30,3,30,17,47
84181,2020-08-30,4,13,2,15
84182,2020-08-30,5,17,8,25
84183,2020-08-30,6,44,32,76
84184,2020-08-30,7,67,100,167
84185,2020-08-30,8,100,181,281
84186,2020-08-30,9,308,287,595
84187,2020-08-30,10,419,358,777
84188,2020-08-30,11,528,424,952
84189,2020-08-30,12,643,503,1146
84190,2020-08-30,13,646,451,1097
84191,2020-08-30,14,668,458,1126
84192,2020-08-30,15,620,445,1065
84193,2020-08-30,16,604,421,1025
84194,2020-08-30,17,514,425,939
84195,2020-08-30,18,440,412,852
84196,2020-08-30,19,423,343,766
84197,2020-08-30,20,207,194,401
84198,2020-08-30,21,170,121,291
84199,2020-08-30,22,138,85,223
84200,2020-08-30,23,69,37,106
84201,2020-08-31,0,41,32,73
84202,2020-08-31,1,26,13,39
84203,2020-08-31,2,6,11,17
84204,2020-08-31,3,3,3,6
84205,2020-08-31,4,10,8,18
84206,2020-08-31,5,13,32,45
84207,2020-08-31,6,61,92,153
84208,2020-08-31,7,90,228,318
84209,2020-08-31,8,117,284,401
84210,2020-08-31,9,113,204,317
84211,2020-08-31,10,129,157,286
84212,2020-08-31,11,129,176,305
84213,2020-08-31,12,146,194,340
84214,2020-08-31,13,92,102,194
84215,2020-08-31,14,67,97,164
84216,2020-08-31,15,84,102,186
84217,2020-08-31,16,80,107,187
84218,2020-08-31,17,59,111,170
84219,2020-08-31,18,51,125,176
84220,2020-08-31,19,101,163,264
84221,2020-08-31,20,78,102,180
84222,2020-08-31,21,55,59,114
84223,2020-08-31,22,40,28,68
84224,2020-08-31,23,31,21,52
84225,2020-09-01,0,25,8,33
84226,2020-09-01,1,20,7,27
84227,2020-09-01,2,16,1,17
84228,2020-09-01,3,7,1,8
84229,2020-09-01,4,12,7,19
84230,2020-09-01,5,9,26,35
84231,2020-09-01,6,42,95,137
84232,2020-09-01,7,94,216,310
84233,2020-09-01,8,120,263,383
84234,2020-09-01,9,115,193,308
84235,2020-09-01,10,109,136,245
84236,2020-09-01,11,122,197,319
84237,2020-09-01,12,167,229,396
84238,2020-09-01,13,170,210,380
84239,2020-09-01,14,209,211,420
84240,2020-09-01,15,197,247,444
84241,2020-09-01,16,218,336,554
84242,2020-09-01,17,364,491,855
84243,2020-09-01,18,350,467,817
84244,2020-09-01,19,272,389,661
84245,2020-09-01,20,163,215,378
84246,2020-09-01,21,116,136,252
84247,2020-09-01,22,88,73,161
84248,2020-09-01,23,37,29,66
84249,2020-09-02,0,36,17,53
84250,2020-09-02,1,13,11,24
84251,2020-09-02,2,7,7,14
84252,2020-09-02,3,7,3,10
84253,2020-09-02,4,11,7,18
84254,2020-09-02,5,13,28,41
84255,2020-09-02,6,38,117,155
84256,2020-09-02,7,90,217,307
84257,2020-09-02,8,105,288,393
84258,2020-09-02,9,90,192,282
84259,2020-09-02,10,121,172,293
84260,2020-09-02,11,130,216,346
84261,2020-09-02,12,197,232,429
84262,2020-09-02,13,189,232,421
84263,2020-09-02,14,179,216,395
84264,2020-09-02,15,189,271,460
84265,2020-09-02,16,257,350,607
84266,2020-09-02,17,264,456,720
84267,2020-09-02,18,305,412,717
84268,2020-09-02,19,204,325,529
84269,2020-09-02,20,119,170,289
84270,2020-09-02,21,90,134,224
84271,2020-09-02,22,104,86,190
84272,2020-09-02,23,80,54,134
84273,2020-09-03,0,23,23,46
84274,2020-09-03,1,22,12,34
84275,2020-09-03,2,4,8,12
84276,2020-09-03,3,14,8,22
84277,2020-09-03,4,9,5,14
84278,2020-09-03,5,12,37,49
84279,2020-09-03,6,51,118,169
84280,2020-09-03,7,94,236,330
84281,2020-09-03,8,124,288,412
84282,2020-09-03,9,112,211,323
84283,2020-09-03,10,109,181,290
84284,2020-09-03,11,139,196,335
84285,2020-09-03,12,165,249,414
84286,2020-09-03,13,157,245,402
84287,2020-09-03,14,192,229,421
84288,2020-09-03,15,189,248,437
84289,2020-09-03,16,220,322,542
84290,2020-09-03,17,171,312,483
84291,2020-09-03,18,82,162,244
84292,2020-09-03,19,43,95,138
84293,2020-09-03,20,46,85,131
84294,2020-09-03,21,60,76,136
84295,2020-09-03,22,57,69,126
84296,2020-09-03,23,36,25,61
84297,2020-09-04,0,25,21,46
84298,2020-09-04,1,3,11,14
84299,2020-09-04,2,3,3,6
84300,2020-09-04,3,8,2,10
84301,2020-09-04,4,13,13,26
84302,2020-09-04,5,16,32,48
84303,2020-09-04,6,39,91,130
84304,2020-09-04,7,76,211,287
84305,2020-09-04,8,135,254,389
84306,2020-09-04,9,160,208,368
84307,2020-09-04,10,147,216,363
84308,2020-09-04,11,222,247,469
84309,2020-09-04,12,276,276,552
84310,2020-09-04,13,265,313,578
84311,2020-09-04,14,287,316,603
84312,2020-09-04,15,325,356,681
84313,2020-09-04,16,294,374,668
84314,2020-09-04,17,356,441,797
84315,2020-09-04,18,409,437,846
84316,2020-09-04,19,289,403,692
84317,2020-09-04,20,212,221,433
84318,2020-09-04,21,146,148,294
84319,2020-09-04,22,163,123,286
84320,2020-09-04,23,143,103,246
84321,2020-09-05,0,120,65,185
84322,2020-09-05,1,60,49,109
84323,2020-09-05,2,40,12,52
84324,2020-09-05,3,15,11,26
84325,2020-09-05,4,18,8,26
84326,2020-09-05,5,11,6,17
84327,2020-09-05,6,36,49,85
84328,2020-09-05,7,70,117,187
84329,2020-09-05,8,140,174,314
84330,2020-09-05,9,204,251,455
84331,2020-09-05,10,414,339,753
84332,2020-09-05,11,505,364,869
84333,2020-09-05,12,624,425,1049
84334,2020-09-05,13,700,393,1093
84335,2020-09-05,14,797,426,1223
84336,2020-09-05,15,671,367,1038
84337,2020-09-05,16,692,385,1077
84338,2020-09-05,17,648,384,1032
84339,2020-09-05,18,580,359,939
84340,2020-09-05,19,516,351,867
84341,2020-09-05,20,289,232,521
84342,2020-09-05,21,237,155,392
84343,2020-09-05,22,209,107,316
84344,2020-09-05,23,187,90,277
84345,2020-09-06,0,149,68,217
84346,2020-09-06,1,67,42,109
84347,2020-09-06,2,64,23,87
84348,2020-09-06,3,18,6,24
84349,2020-09-06,4,15,3,18
84350,2020-09-06,5,13,6,19
84351,2020-09-06,6,35,39,74
84352,2020-09-06,7,65,80,145
84353,2020-09-06,8,117,142,259
84354,2020-09-06,9,244,268,512
84355,2020-09-06,10,375,299,674
84356,2020-09-06,11,551,382,933
84357,2020-09-06,12,590,393,983
84358,2020-09-06,13,650,380,1030
84359,2020-09-06,14,741,388,1129
84360,2020-09-06,15,699,418,1117
84361,2020-09-06,16,617,366,983
84362,2020-09-06,17,624,360,984
84363,2020-09-06,18,531,368,899
84364,2020-09-06,19,442,307,749
84365,2020-09-06,20,294,183,477
84366,2020-09-06,21,226,136,362
84367,2020-09-06,22,212,120,332
84368,2020-09-06,23,147,81,228
84369,2020-09-07,0,88,28,116
84370,2020-09-07,1,48,21,69
84371,2020-09-07,2,34,18,52
84372,2020-09-07,3,13,2,15
84373,2020-09-07,4,13,5,18
84374,2020-09-07,5,18,17,35
84375,2020-09-07,6,36,48,84
84376,2020-09-07,7,71,84,155
84377,2020-09-07,8,104,133,237
84378,2020-09-07,9,217,235,452
84379,2020-09-07,10,340,327,667
84380,2020-09-07,11,468,361,829
84381,2020-09-07,12,555,373,928
84382,2020-09-07,13,549,394,943
84383,2020-09-07,14,590,392,982
84384,2020-09-07,15,585,411,996
84385,2020-09-07,16,540,398,938
84386,2020-09-07,17,464,377,841
84387,2020-09-07,18,470,363,833
84388,2020-09-07,19,351,282,633
84389,2020-09-07,20,169,140,309
84390,2020-09-07,21,111,105,216
84391,2020-09-07,22,88,69,157
84392,2020-09-07,23,43,40,83
84393,2020-09-08,0,28,12,40
84394,2020-09-08,1,17,7,24
84395,2020-09-08,2,5,8,13
84396,2020-09-08,3,4,2,6
84397,2020-09-08,4,8,6,14
84398,2020-09-08,5,18,35,53
84399,2020-09-08,6,50,109,159
84400,2020-09-08,7,87,235,322
84401,2020-09-08,8,114,286,400
84402,2020-09-08,9,121,195,316
84403,2020-09-08,10,127,157,284
84404,2020-09-08,11,142,195,337
84405,2020-09-08,12,189,209,398
84406,2020-09-08,13,157,240,397
84407,2020-09-08,14,156,181,337
84408,2020-09-08,15,197,233,430
84409,2020-09-08,16,227,287,514
84410,2020-09-08,17,320,461,781
84411,2020-09-08,18,343,446,789
84412,2020-09-08,19,296,358,654
84413,2020-09-08,20,163,213,376
84414,2020-09-08,21,86,118,204
84415,2020-09-08,22,77,53,130
84416,2020-09-08,23,54,20,74
84417,2020-09-09,0,26,10,36
84418,2020-09-09,1,18,12,30
84419,2020-09-09,2,5,6,11
84420,2020-09-09,3,3,5,8
84421,2020-09-09,4,9,6,15
84422,2020-09-09,5,22,35,57
84423,2020-09-09,6,48,120,168
84424,2020-09-09,7,80,229,309
84425,2020-09-09,8,116,304,420
84426,2020-09-09,9,97,230,327
84427,2020-09-09,10,93,148,241
84428,2020-09-09,11,116,188,304
84429,2020-09-09,12,104,161,265
84430,2020-09-09,13,90,121,211
84431,2020-09-09,14,123,158,281
84432,2020-09-09,15,123,171,294
84433,2020-09-09,16,156,216,372
84434,2020-09-09,17,168,326,494
84435,2020-09-09,18,130,237,367
84436,2020-09-09,19,103,178,281
84437,2020-09-09,20,60,95,155
84438,2020-09-09,21,26,37,63
84439,2020-09-09,22,27,40,67
84440,2020-09-09,23,35,23,58
84441,2020-09-10,0,17,16,33
84442,2020-09-10,1,11,15,26
84443,2020-09-10,2,4,2,6
84444,2020-09-10,3,1,3,4
84445,2020-09-10,4,10,9,19
84446,2020-09-10,5,13,33,46
84447,2020-09-10,6,38,101,139
84448,2020-09-10,7,57,158,215
84449,2020-09-10,8,99,246,345
84450,2020-09-10,9,66,145,211
84451,2020-09-10,10,60,110,170
84452,2020-09-10,11,35,60,95
84453,2020-09-10,12,54,76,130
84454,2020-09-10,13,18,37,55
84455,2020-09-10,14,21,25,46
84456,2020-09-10,15,53,93,146
84457,2020-09-10,16,76,156,232
84458,2020-09-10,17,144,315,459
84459,2020-09-10,18,198,314,512
84460,2020-09-10,19,188,279,467
84461,2020-09-10,20,96,169,265
84462,2020-09-10,21,92,79,171
84463,2020-09-10,22,93,72,165
84464,2020-09-10,23,55,68,123
84465,2020-09-11,0,43,36,79
84466,2020-09-11,1,16,15,31
84467,2020-09-11,2,14,7,21
84468,2020-09-11,3,6,1,7
84469,2020-09-11,4,13,10,23
84470,2020-09-11,5,23,23,46
84471,2020-09-11,6,44,107,151
84472,2020-09-11,7,85,211,296
84473,2020-09-11,8,109,277,386
84474,2020-09-11,9,118,217,335
84475,2020-09-11,10,124,193,317
84476,2020-09-11,11,186,204,390
84477,2020-09-11,12,209,290,499
84478,2020-09-11,13,226,296,522
84479,2020-09-11,14,240,292,532
84480,2020-09-11,15,229,283,512
84481,2020-09-11,16,300,331,631
84482,2020-09-11,17,372,527,899
84483,2020-09-11,18,378,489,867
84484,2020-09-11,19,285,416,701
84485,2020-09-11,20,234,255,489
84486,2020-09-11,21,163,169,332
84487,2020-09-11,22,148,128,276
84488,2020-09-11,23,120,119,239
84489,2020-09-12,0,89,80,169
84490,2020-09-12,1,54,33,87
84491,2020-09-12,2,31,15,46
84492,2020-09-12,3,16,6,22
84493,2020-09-12,4,9,11,20
84494,2020-09-12,5,10,9,19
84495,2020-09-12,6,35,40,75
84496,2020-09-12,7,41,46,87
84497,2020-09-12,8,64,86,150
84498,2020-09-12,9,121,177,298
84499,2020-09-12,10,219,285,504
84500,2020-09-12,11,322,360,682
84501,2020-09-12,12,483,403,886
84502,2020-09-12,13,458,386,844
84503,2020-09-12,14,544,401,945
84504,2020-09-12,15,539,452,991
84505,2020-09-12,16,544,409,953
84506,2020-09-12,17,462,423,885
84507,2020-09-12,18,515,420,935
84508,2020-09-12,19,361,359,720
84509,2020-09-12,20,266,230,496
84510,2020-09-12,21,167,150,317
84511,2020-09-12,22,150,116,266
84512,2020-09-12,23,163,108,271
84513,2020-09-13,0,108,66,174
84514,2020-09-13,1,84,37,121
84515,2020-09-13,2,41,17,58
84516,2020-09-13,3,10,2,12
84517,2020-09-13,4,11,7,18
84518,2020-09-13,5,9,15,24
84519,2020-09-13,6,30,28,58
84520,2020-09-13,7,67,79,146
84521,2020-09-13,8,121,189,310
84522,2020-09-13,9,186,260,446
84523,2020-09-13,10,337,347,684
84524,2020-09-13,11,426,389,815
84525,2020-09-13,12,521,466,987
84526,2020-09-13,13,551,414,965
84527,2020-09-13,14,601,394,995
84528,2020-09-13,15,514,405,919
84529,2020-09-13,16,545,444,989
84530,2020-09-13,17,480,409,889
84531,2020-09-13,18,465,375,840
84532,2020-09-13,19,327,291,618
84533,2020-09-13,20,182,184,366
84534,2020-09-13,21,136,97,233
84535,2020-09-13,22,105,78,183
84536,2020-09-13,23,37,40,77
84537,2020-09-14,0,25,10,35
84538,2020-09-14,1,21,9,30
84539,2020-09-14,2,16,3,19
84540,2020-09-14,3,2,3,5
84541,2020-09-14,4,12,12,24
84542,2020-09-14,5,17,33,50
84543,2020-09-14,6,45,110,155
84544,2020-09-14,7,80,236,316
84545,2020-09-14,8,109,292,401
84546,2020-09-14,9,106,167,273
84547,2020-09-14,10,109,164,273
84548,2020-09-14,11,110,173,283
84549,2020-09-14,12,168,245,413
84550,2020-09-14,13,172,210,382
84551,2020-09-14,14,214,219,433
84552,2020-09-14,15,217,244,461
84553,2020-09-14,16,265,370,635
84554,2020-09-14,17,308,510,818
84555,2020-09-14,18,335,568,903
84556,2020-09-14,19,257,378,635
84557,2020-09-14,20,142,187,329
84558,2020-09-14,21,116,122,238
84559,2020-09-14,22,98,70,168
84560,2020-09-14,23,59,46,105
84561,2020-09-15,0,29,15,44
84562,2020-09-15,1,21,8,29
84563,2020-09-15,2,5,6,11
84564,2020-09-15,3,4,8,12
84565,2020-09-15,4,11,10,21
84566,2020-09-15,5,15,36,51
84567,2020-09-15,6,62,108,170
84568,2020-09-15,7,79,235,314
84569,2020-09-15,8,109,302,411
84570,2020-09-15,9,103,215,318
84571,2020-09-15,10,98,176,274
84572,2020-09-15,11,134,198,332
84573,2020-09-15,12,135,246,381
84574,2020-09-15,13,161,222,383
84575,2020-09-15,14,175,192,367
84576,2020-09-15,15,239,273,512
84577,2020-09-15,16,266,348,614
84578,2020-09-15,17,351,550,901
84579,2020-09-15,18,376,581,957
84580,2020-09-15,19,266,408,674
84581,2020-09-15,20,141,185,326
84582,2020-09-15,21,115,144,259
84583,2020-09-15,22,58,79,137
84584,2020-09-15,23,35,37,72
84585,2020-09-16,0,16,25,41
84586,2020-09-16,1,7,19,26
84587,2020-09-16,2,11,7,18
84588,2020-09-16,3,5,1,6
84589,2020-09-16,4,7,6,13
84590,2020-09-16,5,14,38,52
84591,2020-09-16,6,31,109,140
84592,2020-09-16,7,66,236,302
84593,2020-09-16,8,117,263,380
84594,2020-09-16,9,86,205,291
84595,2020-09-16,10,110,177,287
84596,2020-09-16,11,145,218,363
84597,2020-09-16,12,174,244,418
84598,2020-09-16,13,171,228,399
84599,2020-09-16,14,177,231,408
84600,2020-09-16,15,236,251,487
84601,2020-09-16,16,306,347,653
84602,2020-09-16,17,401,506,907
84603,2020-09-16,18,461,539,1000
84604,2020-09-16,19,287,339,626
84605,2020-09-16,20,141,193,334
84606,2020-09-16,21,106,112,218
84607,2020-09-16,22,95,97,192
84608,2020-09-16,23,51,59,110
84609,2020-09-17,0,22,22,44
84610,2020-09-17,1,11,10,21
84611,2020-09-17,2,6,8,14
84612,2020-09-17,3,5,6,11
84613,2020-09-17,4,8,9,17
84614,2020-09-17,5,24,40,64
84615,2020-09-17,6,43,121,164
84616,2020-09-17,7,81,218,299
84617,2020-09-17,8,110,303,413
84618,2020-09-17,9,118,215,333
84619,2020-09-17,10,110,181,291
84620,2020-09-17,11,134,223,357
84621,2020-09-17,12,146,231,377
84622,2020-09-17,13,198,238,436
84623,2020-09-17,14,216,212,428
84624,2020-09-17,15,210,265,475
84625,2020-09-17,16,144,196,340
84626,2020-09-17,17,96,179,275
84627,2020-09-17,18,72,157,229
84628,2020-09-17,19,47,103,150
84629,2020-09-17,20,31,44,75
84630,2020-09-17,21,16,36,52
84631,2020-09-17,22,23,34,57
84632,2020-09-17,23,22,21,43
84633,2020-09-18,0,12,25,37
84634,2020-09-18,1,8,8,16
84635,2020-09-18,2,10,10,20
84636,2020-09-18,3,9,3,12
84637,2020-09-18,4,7,4,11
84638,2020-09-18,5,19,36,55
84639,2020-09-18,6,39,95,134
84640,2020-09-18,7,76,184,260
84641,2020-09-18,8,112,270,382
84642,2020-09-18,9,116,203,319
84643,2020-09-18,10,146,199,345
84644,2020-09-18,11,199,217,416
84645,2020-09-18,12,198,298,496
84646,2020-09-18,13,244,272,516
84647,2020-09-18,14,283,302,585
84648,2020-09-18,15,296,373,669
84649,2020-09-18,16,332,421,753
84650,2020-09-18,17,447,559,1006
84651,2020-09-18,18,433,558,991
84652,2020-09-18,19,328,439,767
84653,2020-09-18,20,231,258,489
84654,2020-09-18,21,219,179,398
84655,2020-09-18,22,213,197,410
84656,2020-09-18,23,178,149,327
84657,2020-09-19,0,126,95,221
84658,2020-09-19,1,59,43,102
84659,2020-09-19,2,24,22,46
84660,2020-09-19,3,12,9,21
84661,2020-09-19,4,12,2,14
84662,2020-09-19,5,5,6,11
84663,2020-09-19,6,33,44,77
84664,2020-09-19,7,71,111,182
84665,2020-09-19,8,125,184,309
84666,2020-09-19,9,211,265,476
84667,2020-09-19,10,330,294,624
84668,2020-09-19,11,470,406,876
84669,2020-09-19,12,601,440,1041
84670,2020-09-19,13,630,470,1100
84671,2020-09-19,14,672,478,1150
84672,2020-09-19,15,693,422,1115
84673,2020-09-19,16,664,489,1153
84674,2020-09-19,17,661,504,1165
84675,2020-09-19,18,527,397,924
84676,2020-09-19,19,445,385,830
84677,2020-09-19,20,269,202,471
84678,2020-09-19,21,187,159,346
84679,2020-09-19,22,175,134,309
84680,2020-09-19,23,98,91,189
84681,2020-09-20,0,72,60,132
84682,2020-09-20,1,35,40,75
84683,2020-09-20,2,16,15,31
84684,2020-09-20,3,5,8,13
84685,2020-09-20,4,8,7,15
84686,2020-09-20,5,3,7,10
84687,2020-09-20,6,21,31,52
84688,2020-09-20,7,30,72,102
84689,2020-09-20,8,61,128,189
84690,2020-09-20,9,168,222,390
84691,2020-09-20,10,230,285,515
84692,2020-09-20,11,351,404,755
84693,2020-09-20,12,536,436,972
84694,2020-09-20,13,633,444,1077
84695,2020-09-20,14,633,428,1061
84696,2020-09-20,15,592,452,1044
84697,2020-09-20,16,638,455,1093
84698,2020-09-20,17,618,450,1068
84699,2020-09-20,18,505,331,836
84700,2020-09-20,19,279,249,528
84701,2020-09-20,20,134,131,265
84702,2020-09-20,21,98,91,189
84703,2020-09-20,22,74,71,145
84704,2020-09-20,23,52,35,87
84705,2020-09-21,0,26,11,37
84706,2020-09-21,1,12,10,22
84707,2020-09-21,2,7,7,14
84708,2020-09-21,3,5,3,8
84709,2020-09-21,4,13,8,21
84710,2020-09-21,5,21,30,51
84711,2020-09-21,6,34,89,123
84712,2020-09-21,7,73,198,271
84713,2020-09-21,8,124,271,395
84714,2020-09-21,9,97,189,286
84715,2020-09-21,10,95,163,258
84716,2020-09-21,11,115,191,306
84717,2020-09-21,12,179,246,425
84718,2020-09-21,13,160,218,378
84719,2020-09-21,14,179,221,400
84720,2020-09-21,15,222,228,450
84721,2020-09-21,16,269,375,644
84722,2020-09-21,17,337,532,869
84723,2020-09-21,18,380,533,913
84724,2020-09-21,19,219,335,554
84725,2020-09-21,20,126,174,300
84726,2020-09-21,21,70,95,165
84727,2020-09-21,22,68,56,124
84728,2020-09-21,23,29,41,70
84729,2020-09-22,0,21,15,36
84730,2020-09-22,1,12,5,17
84731,2020-09-22,2,5,2,7
84732,2020-09-22,3,5,4,9
84733,2020-09-22,4,9,3,12
84734,2020-09-22,5,18,37,55
84735,2020-09-22,6,35,89,124
84736,2020-09-22,7,81,220,301
84737,2020-09-22,8,109,290,399
84738,2020-09-22,9,83,191,274
84739,2020-09-22,10,102,161,263
84740,2020-09-22,11,112,180,292
84741,2020-09-22,12,174,285,459
84742,2020-09-22,13,181,225,406
84743,2020-09-22,14,190,232,422
84744,2020-09-22,15,222,285,507
84745,2020-09-22,16,262,360,622
84746,2020-09-22,17,376,573,949
84747,2020-09-22,18,435,572,1007
84748,2020-09-22,19,245,373,618
84749,2020-09-22,20,118,175,293
84750,2020-09-22,21,105,104,209
84751,2020-09-22,22,63,62,125
84752,2020-09-22,23,51,44,95
84753,2020-09-23,0,27,19,46
84754,2020-09-23,1,6,5,11
84755,2020-09-23,2,7,3,10
84756,2020-09-23,3,4,5,9
84757,2020-09-23,4,9,11,20
84758,2020-09-23,5,14,36,50
84759,2020-09-23,6,35,110,145
84760,2020-09-23,7,80,224,304
84761,2020-09-23,8,136,324,460
84762,2020-09-23,9,121,219,340
84763,2020-09-23,10,126,211,337
84764,2020-09-23,11,165,229,394
84765,2020-09-23,12,180,276,456
84766,2020-09-23,13,261,237,498
84767,2020-09-23,14,213,264,477
84768,2020-09-23,15,296,300,596
84769,2020-09-23,16,272,384,656
84770,2020-09-23,17,444,566,1010
84771,2020-09-23,18,474,624,1098
84772,2020-09-23,19,334,438,772
84773,2020-09-23,20,221,240,461
84774,2020-09-23,21,138,182,320
84775,2020-09-23,22,105,108,213
84776,2020-09-23,23,61,38,99
84777,2020-09-24,0,27,20,47
84778,2020-09-24,1,14,8,22
84779,2020-09-24,2,10,4,14
84780,2020-09-24,3,7,5,12
84781,2020-09-24,4,9,6,15
84782,2020-09-24,5,15,31,46
84783,2020-09-24,6,42,105,147
84784,2020-09-24,7,91,245,336
84785,2020-09-24,8,117,311,428
84786,2020-09-24,9,104,240,344
84787,2020-09-24,10,122,184,306
84788,2020-09-24,11,167,205,372
84789,2020-09-24,12,190,309,499
84790,2020-09-24,13,196,230,426
84791,2020-09-24,14,231,213,444
84792,2020-09-24,15,244,291,535
84793,2020-09-24,16,270,314,584
84794,2020-09-24,17,349,526,875
84795,2020-09-24,18,379,491,870
84796,2020-09-24,19,288,387,675
84797,2020-09-24,20,184,231,415
84798,2020-09-24,21,130,156,286
84799,2020-09-24,22,112,96,208
84800,2020-09-24,23,83,54,137
84801,2020-09-25,0,48,25,73
84802,2020-09-25,1,24,14,38
84803,2020-09-25,2,14,6,20
84804,2020-09-25,3,5,7,12
84805,2020-09-25,4,13,8,21
84806,2020-09-25,5,19,35,54
84807,2020-09-25,6,38,108,146
84808,2020-09-25,7,84,201,285
84809,2020-09-25,8,106,293,399
84810,2020-09-25,9,138,208,346
84811,2020-09-25,10,172,206,378
84812,2020-09-25,11,242,299,541
84813,2020-09-25,12,243,247,490
84814,2020-09-25,13,244,268,512
84815,2020-09-25,14,248,243,491
84816,2020-09-25,15,315,296,611
84817,2020-09-25,16,154,236,390
84818,2020-09-25,17,195,229,424
84819,2020-09-25,18,178,274,452
84820,2020-09-25,19,123,184,307
84821,2020-09-25,20,113,113,226
84822,2020-09-25,21,81,100,181
84823,2020-09-25,22,79,91,170
84824,2020-09-25,23,36,34,70
84825,2020-09-26,0,23,19,42
84826,2020-09-26,1,9,17,26
84827,2020-09-26,2,5,9,14
84828,2020-09-26,3,6,3,9
84829,2020-09-26,4,9,2,11
84830,2020-09-26,5,10,6,16
84831,2020-09-26,6,26,31,57
84832,2020-09-26,7,44,65,109
84833,2020-09-26,8,98,142,240
84834,2020-09-26,9,191,238,429
84835,2020-09-26,10,276,239,515
84836,2020-09-26,11,411,339,750
84837,2020-09-26,12,407,396,803
84838,2020-09-26,13,457,397,854
84839,2020-09-26,14,532,419,951
84840,2020-09-26,15,572,422,994
84841,2020-09-26,16,564,411,975
84842,2020-09-26,17,519,387,906
84843,2020-09-26,18,475,324,799
84844,2020-09-26,19,292,318,610
84845,2020-09-26,20,223,194,417
84846,2020-09-26,21,89,94,183
84847,2020-09-26,22,97,98,195
84848,2020-09-26,23,111,83,194
84849,2020-09-27,0,98,76,174
84850,2020-09-27,1,61,34,95
84851,2020-09-27,2,18,19,37
84852,2020-09-27,3,15,13,28
84853,2020-09-27,4,8,15,23
84854,2020-09-27,5,10,4,14
84855,2020-09-27,6,27,19,46
84856,2020-09-27,7,59,65,124
84857,2020-09-27,8,88,121,209
84858,2020-09-27,9,192,244,436
84859,2020-09-27,10,309,330,639
84860,2020-09-27,11,439,370,809
84861,2020-09-27,12,508,410,918
84862,2020-09-27,13,500,425,925
84863,2020-09-27,14,479,367,846
84864,2020-09-27,15,505,385,890
84865,2020-09-27,16,445,390,835
84866,2020-09-27,17,428,381,809
84867,2020-09-27,18,340,357,697
84868,2020-09-27,19,235,227,462
84869,2020-09-27,20,169,148,317
84870,2020-09-27,21,90,112,202
84871,2020-09-27,22,95,77,172
84872,2020-09-27,23,55,39,94
84873,2020-09-28,0,29,19,48
84874,2020-09-28,1,13,11,24
84875,2020-09-28,2,5,3,8
84876,2020-09-28,3,10,4,14
84877,2020-09-28,4,12,5,17
84878,2020-09-28,5,20,32,52
84879,2020-09-28,6,34,87,121
84880,2020-09-28,7,89,195,284
84881,2020-09-28,8,107,283,390
84882,2020-09-28,9,109,195,304
84883,2020-09-28,10,133,175,308
84884,2020-09-28,11,149,204,353
84885,2020-09-28,12,190,229,419
84886,2020-09-28,13,192,265,457
84887,2020-09-28,14,192,239,431
84888,2020-09-28,15,215,254,469
84889,2020-09-28,16,264,332,596
84890,2020-09-28,17,371,505,876
84891,2020-09-28,18,298,450,748
84892,2020-09-28,19,206,334,540
84893,2020-09-28,20,141,201,342
84894,2020-09-28,21,74,106,180
84895,2020-09-28,22,62,75,137
84896,2020-09-28,23,39,34,73
84897,2020-09-29,0,29,13,42
84898,2020-09-29,1,7,13,20
84899,2020-09-29,2,11,5,16
84900,2020-09-29,3,2,4,6
84901,2020-09-29,4,7,7,14
84902,2020-09-29,5,24,31,55
84903,2020-09-29,6,38,100,138
84904,2020-09-29,7,88,223,311
84905,2020-09-29,8,126,308,434
84906,2020-09-29,9,101,206,307
84907,2020-09-29,10,112,187,299
84908,2020-09-29,11,137,195,332
84909,2020-09-29,12,157,273,430
84910,2020-09-29,13,153,235,388
84911,2020-09-29,14,182,260,442
84912,2020-09-29,15,155,268,423
84913,2020-09-29,16,180,296,476
84914,2020-09-29,17,185,429,614
84915,2020-09-29,18,222,387,609
84916,2020-09-29,19,135,223,358
84917,2020-09-29,20,83,144,227
84918,2020-09-29,21,36,48,84
84919,2020-09-29,22,28,29,57
84920,2020-09-29,23,32,26,58
84921,2020-09-30,0,18,9,27
84922,2020-09-30,1,4,8,12
84923,2020-09-30,2,3,4,7
84924,2020-09-30,3,0,6,6
84925,2020-09-30,4,10,4,14
84926,2020-09-30,5,13,26,39
84927,2020-09-30,6,39,85,124
84928,2020-09-30,7,89,209,298
84929,2020-09-30,8,95,294,389
84930,2020-09-30,9,87,216,303
84931,2020-09-30,10,116,185,301
84932,2020-09-30,11,132,231,363
84933,2020-09-30,12,154,296,450
84934,2020-09-30,13,195,258,453
84935,2020-09-30,14,165,242,407
84936,2020-09-30,15,222,306,528
84937,2020-09-30,16,227,325,552
84938,2020-09-30,17,336,556,892
84939,2020-09-30,18,347,596,943
84940,2020-09-30,19,222,376,598
84941,2020-09-30,20,139,215,354
84942,2020-09-30,21,82,109,191
84943,2020-09-30,22,75,103,178
84944,2020-09-30,23,57,54,111
84945,2020-10-01,0,16,12,28
84946,2020-10-01,1,12,6,18
84947,2020-10-01,2,10,4,14
84948,2020-10-01,3,5,9,14
84949,2020-10-01,4,8,11,19
84950,2020-10-01,5,12,38,50
84951,2020-10-01,6,33,100,133
84952,2020-10-01,7,90,248,338
84953,2020-10-01,8,137,344,481
84954,2020-10-01,9,111,212,323
84955,2020-10-01,10,113,215,328
84956,2020-10-01,11,91,240,331
84957,2020-10-01,12,149,269,418
84958,2020-10-01,13,158,298,456
84959,2020-10-01,14,152,249,401
84960,2020-10-01,15,216,303,519
84961,2020-10-01,16,248,397,645
84962,2020-10-01,17,270,538,808
84963,2020-10-01,18,171,356,527
84964,2020-10-01,19,152,248,400
84965,2020-10-01,20,101,183,284
84966,2020-10-01,21,61,104,165
84967,2020-10-01,22,43,59,102
84968,2020-10-01,23,26,41,67
84969,2020-10-02,0,31,27,58
84970,2020-10-02,1,6,6,12
84971,2020-10-02,2,3,3,6
84972,2020-10-02,3,3,6,9
84973,2020-10-02,4,10,1,11
84974,2020-10-02,5,8,14,22
84975,2020-10-02,6,30,66,96
84976,2020-10-02,7,43,160,203
84977,2020-10-02,8,84,246,330
84978,2020-10-02,9,99,223,322
84979,2020-10-02,10,115,185,300
84980,2020-10-02,11,159,276,435
84981,2020-10-02,12,216,291,507
84982,2020-10-02,13,247,283,530
84983,2020-10-02,14,276,334,610
84984,2020-10-02,15,323,348,671
84985,2020-10-02,16,360,431,791
84986,2020-10-02,17,384,575,959
84987,2020-10-02,18,393,538,931
84988,2020-10-02,19,259,375,634
84989,2020-10-02,20,160,198,358
84990,2020-10-02,21,123,170,293
84991,2020-10-02,22,120,106,226
84992,2020-10-02,23,106,82,188
84993,2020-10-03,0,80,64,144
84994,2020-10-03,1,44,33,77
84995,2020-10-03,2,38,22,60
84996,2020-10-03,3,17,10,27
84997,2020-10-03,4,12,6,18
84998,2020-10-03,5,13,11,24
84999,2020-10-03,6,31,28,59
85000,2020-10-03,7,67,87,154
85001,2020-10-03,8,122,167,289
85002,2020-10-03,9,222,245,467
85003,2020-10-03,10,313,307,620
85004,2020-10-03,11,477,399,876
85005,2020-10-03,12,612,462,1074
85006,2020-10-03,13,704,437,1141
85007,2020-10-03,14,694,446,1140
85008,2020-10-03,15,705,465,1170
85009,2020-10-03,16,705,401,1106
85010,2020-10-03,17,612,437,1049
85011,2020-10-03,18,503,444,947
85012,2020-10-03,19,263,293,556
85013,2020-10-03,20,199,167,366
85014,2020-10-03,21,130,137,267
85015,2020-10-03,22,155,117,272
85016,2020-10-03,23,110,96,206
85017,2020-10-04,0,97,71,168
85018,2020-10-04,1,49,24,73
85019,2020-10-04,2,15,13,28
85020,2020-10-04,3,5,10,15
85021,2020-10-04,4,10,4,14
85022,2020-10-04,5,3,6,9
85023,2020-10-04,6,23,29,52
85024,2020-10-04,7,50,82,132
85025,2020-10-04,8,79,124,203
85026,2020-10-04,9,140,181,321
85027,2020-10-04,10,269,270,539
85028,2020-10-04,11,394,348,742
85029,2020-10-04,12,430,441,871
85030,2020-10-04,13,540,456,996
85031,2020-10-04,14,423,314,737
85032,2020-10-04,15,396,296,692
85033,2020-10-04,16,468,390,858
85034,2020-10-04,17,412,419,831
85035,2020-10-04,18,322,323,645
85036,2020-10-04,19,183,245,428
85037,2020-10-04,20,126,150,276
85038,2020-10-04,21,112,83,195
85039,2020-10-04,22,81,56,137
85040,2020-10-04,23,42,22,64
85041,2020-10-05,0,19,10,29
85042,2020-10-05,1,12,5,17
85043,2020-10-05,2,8,4,12
85044,2020-10-05,3,1,7,8
85045,2020-10-05,4,11,6,17
85046,2020-10-05,5,13,28,41
85047,2020-10-05,6,39,97,136
85048,2020-10-05,7,71,197,268
85049,2020-10-05,8,92,262,354
85050,2020-10-05,9,112,187,299
85051,2020-10-05,10,122,149,271
85052,2020-10-05,11,154,184,338
85053,2020-10-05,12,182,279,461
85054,2020-10-05,13,171,226,397
85055,2020-10-05,14,183,221,404
85056,2020-10-05,15,220,265,485
85057,2020-10-05,16,218,350,568
85058,2020-10-05,17,273,474,747
85059,2020-10-05,18,286,453,739
85060,2020-10-05,19,163,321,484
85061,2020-10-05,20,98,152,250
85062,2020-10-05,21,56,86,142
85063,2020-10-05,22,61,61,122
85064,2020-10-05,23,22,42,64
85065,2020-10-06,0,29,9,38
85066,2020-10-06,1,9,2,11
85067,2020-10-06,2,8,7,15
85068,2020-10-06,3,5,4,9
85069,2020-10-06,4,6,6,12
85070,2020-10-06,5,20,32,52
85071,2020-10-06,6,32,78,110
85072,2020-10-06,7,67,217,284
85073,2020-10-06,8,108,301,409
85074,2020-10-06,9,98,222,320
85075,2020-10-06,10,117,180,297
85076,2020-10-06,11,152,190,342
85077,2020-10-06,12,181,253,434
85078,2020-10-06,13,158,260,418
85079,2020-10-06,14,175,233,408
85080,2020-10-06,15,218,282,500
85081,2020-10-06,16,243,332,575
85082,2020-10-06,17,361,548,909
85083,2020-10-06,18,314,546,860
85084,2020-10-06,19,205,315,520
85085,2020-10-06,20,145,195,340
85086,2020-10-06,21,107,124,231
85087,2020-10-06,22,72,80,152
85088,2020-10-06,23,52,35,87
85089,2020-10-07,0,23,25,48
85090,2020-10-07,1,14,9,23
85091,2020-10-07,2,9,4,13
85092,2020-10-07,3,7,3,10
85093,2020-10-07,4,8,7,15
85094,2020-10-07,5,17,27,44
85095,2020-10-07,6,34,108,142
85096,2020-10-07,7,73,216,289
85097,2020-10-07,8,120,313,433
85098,2020-10-07,9,92,222,314
85099,2020-10-07,10,95,203,298
85100,2020-10-07,11,134,260,394
85101,2020-10-07,12,175,304,479
85102,2020-10-07,13,187,270,457
85103,2020-10-07,14,196,257,453
85104,2020-10-07,15,215,287,502
85105,2020-10-07,16,285,403,688
85106,2020-10-07,17,362,645,1007
85107,2020-10-07,18,373,565,938
85108,2020-10-07,19,250,355,605
85109,2020-10-07,20,157,222,379
85110,2020-10-07,21,124,131,255
85111,2020-10-07,22,93,100,193
85112,2020-10-07,23,79,69,148
85113,2020-10-08,0,46,32,78
85114,2020-10-08,1,22,16,38
85115,2020-10-08,2,7,8,15
85116,2020-10-08,3,8,3,11
85117,2020-10-08,4,10,4,14
85118,2020-10-08,5,15,32,47
85119,2020-10-08,6,36,104,140
85120,2020-10-08,7,77,235,312
85121,2020-10-08,8,99,282,381
85122,2020-10-08,9,97,208,305
85123,2020-10-08,10,95,181,276
85124,2020-10-08,11,116,211,327
85125,2020-10-08,12,167,275,442
85126,2020-10-08,13,166,276,442
85127,2020-10-08,14,175,256,431
85128,2020-10-08,15,218,298,516
85129,2020-10-08,16,259,373,632
85130,2020-10-08,17,330,555,885
85131,2020-10-08,18,359,557,916
85132,2020-10-08,19,221,313,534
85133,2020-10-08,20,137,208,345
85134,2020-10-08,21,110,136,246
85135,2020-10-08,22,94,97,191
85136,2020-10-08,23,62,51,113
85137,2020-10-09,0,22,18,40
85138,2020-10-09,1,15,11,26
85139,2020-10-09,2,9,12,21
85140,2020-10-09,3,7,8,15
85141,2020-10-09,4,8,10,18
85142,2020-10-09,5,16,24,40
85143,2020-10-09,6,35,92,127
85144,2020-10-09,7,80,203,283
85145,2020-10-09,8,92,288,380
85146,2020-10-09,9,99,244,343
85147,2020-10-09,10,161,180,341
85148,2020-10-09,11,203,255,458
85149,2020-10-09,12,282,326,608
85150,2020-10-09,13,262,306,568
85151,2020-10-09,14,274,317,591
85152,2020-10-09,15,378,342,720
85153,2020-10-09,16,397,429,826
85154,2020-10-09,17,472,536,1008
85155,2020-10-09,18,427,491,918
85156,2020-10-09,19,215,347,562
85157,2020-10-09,20,160,228,388
85158,2020-10-09,21,117,131,248
85159,2020-10-09,22,132,121,253
85160,2020-10-09,23,97,100,197
85161,2020-10-10,0,94,62,156
85162,2020-10-10,1,43,26,69
85163,2020-10-10,2,17,14,31
85164,2020-10-10,3,12,11,23
85165,2020-10-10,4,14,9,23
85166,2020-10-10,5,8,7,15
85167,2020-10-10,6,25,24,49
85168,2020-10-10,7,68,92,160
85169,2020-10-10,8,121,143,264
85170,2020-10-10,9,228,275,503
85171,2020-10-10,10,386,304,690
85172,2020-10-10,11,457,377,834
85173,2020-10-10,12,619,431,1050
85174,2020-10-10,13,595,414,1009
85175,2020-10-10,14,659,431,1090
85176,2020-10-10,15,739,452,1191
85177,2020-10-10,16,673,397,1070
85178,2020-10-10,17,511,392,903
85179,2020-10-10,18,440,323,763
85180,2020-10-10,19,277,239,516
85181,2020-10-10,20,239,173,412
85182,2020-10-10,21,160,136,296
85183,2020-10-10,22,170,105,275
85184,2020-10-10,23,120,99,219
85185,2020-10-11,0,122,87,209
85186,2020-10-11,1,72,45,117
85187,2020-10-11,2,36,21,57
85188,2020-10-11,3,17,14,31
85189,2020-10-11,4,19,10,29
85190,2020-10-11,5,14,13,27
85191,2020-10-11,6,25,19,44
85192,2020-10-11,7,51,52,103
85193,2020-10-11,8,85,139,224
85194,2020-10-11,9,210,204,414
85195,2020-10-11,10,317,286,603
85196,2020-10-11,11,313,368,681
85197,2020-10-11,12,346,338,684
85198,2020-10-11,13,270,275,545
85199,2020-10-11,14,150,133,283
85200,2020-10-11,15,107,115,222
85201,2020-10-11,16,119,97,216
85202,2020-10-11,17,92,127,219
85203,2020-10-11,18,80,94,174
85204,2020-10-11,19,37,46,83
85205,2020-10-11,20,25,27,52
85206,2020-10-11,21,24,20,44
85207,2020-10-11,22,16,24,40
85208,2020-10-11,23,28,21,49
85209,2020-10-12,0,9,12,21
85210,2020-10-12,1,4,4,8
85211,2020-10-12,2,3,5,8
85212,2020-10-12,3,1,1,2
85213,2020-10-12,4,7,2,9
85214,2020-10-12,5,5,3,8
85215,2020-10-12,6,8,20,28
85216,2020-10-12,7,22,56,78
85217,2020-10-12,8,31,118,149
85218,2020-10-12,9,37,104,141
85219,2020-10-12,10,68,124,192
85220,2020-10-12,11,105,153,258
85221,2020-10-12,12,86,182,268
85222,2020-10-12,13,127,207,334
85223,2020-10-12,14,93,140,233
85224,2020-10-12,15,69,112,181
85225,2020-10-12,16,62,143,205
85226,2020-10-12,17,59,152,211
85227,2020-10-12,18,65,162,227
85228,2020-10-12,19,71,152,223
85229,2020-10-12,20,52,93,145
85230,2020-10-12,21,30,63,93
85231,2020-10-12,22,25,45,70
85232,2020-10-12,23,20,20,40
85233,2020-10-13,0,19,11,30
85234,2020-10-13,1,7,9,16
85235,2020-10-13,2,7,3,10
85236,2020-10-13,3,2,6,8
85237,2020-10-13,4,8,6,14
85238,2020-10-13,5,19,33,52
85239,2020-10-13,6,28,92,120
85240,2020-10-13,7,51,169,220
85241,2020-10-13,8,67,279,346
85242,2020-10-13,9,70,187,257
85243,2020-10-13,10,80,180,260
85244,2020-10-13,11,117,209,326
85245,2020-10-13,12,130,235,365
85246,2020-10-13,13,179,244,423
85247,2020-10-13,14,194,215,409
85248,2020-10-13,15,226,257,483
85249,2020-10-13,16,248,345,593
85250,2020-10-13,17,314,535,849
85251,2020-10-13,18,316,526,842
85252,2020-10-13,19,179,317,496
85253,2020-10-13,20,70,192,262
85254,2020-10-13,21,72,131,203
85255,2020-10-13,22,62,73,135
85256,2020-10-13,23,35,41,76
85257,2020-10-14,0,23,19,42
85258,2020-10-14,1,10,11,21
85259,2020-10-14,2,8,3,11
85260,2020-10-14,3,5,6,11
85261,2020-10-14,4,9,10,19
85262,2020-10-14,5,8,38,46
85263,2020-10-14,6,35,92,127
85264,2020-10-14,7,57,211,268
85265,2020-10-14,8,92,268,360
85266,2020-10-14,9,90,235,325
85267,2020-10-14,10,98,191,289
85268,2020-10-14,11,160,237,397
85269,2020-10-14,12,211,278,489
85270,2020-10-14,13,171,257,428
85271,2020-10-14,14,231,278,509
85272,2020-10-14,15,217,293,510
85273,2020-10-14,16,251,380,631
85274,2020-10-14,17,350,595,945
85275,2020-10-14,18,313,560,873
85276,2020-10-14,19,191,338,529
85277,2020-10-14,20,118,160,278
85278,2020-10-14,21,86,140,226
85279,2020-10-14,22,91,95,186
85280,2020-10-14,23,35,46,81
85281,2020-10-15,0,26,23,49
85282,2020-10-15,1,14,6,20
85283,2020-10-15,2,12,4,16
85284,2020-10-15,3,7,8,15
85285,2020-10-15,4,8,5,13
85286,2020-10-15,5,18,35,53
85287,2020-10-15,6,45,105,150
85288,2020-10-15,7,64,215,279
85289,2020-10-15,8,103,324,427
85290,2020-10-15,9,103,270,373
85291,2020-10-15,10,104,207,311
85292,2020-10-15,11,143,216,359
85293,2020-10-15,12,161,258,419
85294,2020-10-15,13,188,283,471
85295,2020-10-15,14,185,258,443
85296,2020-10-15,15,216,290,506
85297,2020-10-15,16,271,400,671
85298,2020-10-15,17,366,548,914
85299,2020-10-15,18,352,561,913
85300,2020-10-15,19,204,352,556
85301,2020-10-15,20,133,212,345
85302,2020-10-15,21,151,149,300
85303,2020-10-15,22,121,82,203
85304,2020-10-15,23,57,46,103
85305,2020-10-16,0,28,34,62
85306,2020-10-16,1,26,18,44
85307,2020-10-16,2,9,8,17
85308,2020-10-16,3,5,7,12
85309,2020-10-16,4,9,9,18
85310,2020-10-16,5,15,26,41
85311,2020-10-16,6,33,86,119
85312,2020-10-16,7,25,77,102
85313,2020-10-16,8,37,92,129
85314,2020-10-16,9,55,145,200
85315,2020-10-16,10,61,122,183
85316,2020-10-16,11,94,138,232
85317,2020-10-16,12,103,156,259
85318,2020-10-16,13,120,191,311
85319,2020-10-16,14,147,196,343
85320,2020-10-16,15,189,211,400
85321,2020-10-16,16,150,167,317
85322,2020-10-16,17,341,369,710
85323,2020-10-16,18,229,387,616
85324,2020-10-16,19,118,215,333
85325,2020-10-16,20,118,166,284
85326,2020-10-16,21,78,122,200
85327,2020-10-16,22,76,85,161
85328,2020-10-16,23,57,62,119
85329,2020-10-17,0,75,70,145
85330,2020-10-17,1,35,25,60
85331,2020-10-17,2,14,11,25
85332,2020-10-17,3,8,10,18
85333,2020-10-17,4,4,4,8
85334,2020-10-17,5,6,11,17
85335,2020-10-17,6,19,27,46
85336,2020-10-17,7,41,70,111
85337,2020-10-17,8,82,137,219
85338,2020-10-17,9,172,211,383
85339,2020-10-17,10,332,348,680
85340,2020-10-17,11,455,424,879
85341,2020-10-17,12,539,446,985
85342,2020-10-17,13,522,431,953
85343,2020-10-17,14,676,467,1143
85344,2020-10-17,15,738,451,1189
85345,2020-10-17,16,639,450,1089
85346,2020-10-17,17,514,448,962
85347,2020-10-17,18,415,339,754
85348,2020-10-17,19,220,262,482
85349,2020-10-17,20,164,176,340
85350,2020-10-17,21,122,104,226
85351,2020-10-17,22,103,71,174
85352,2020-10-17,23,114,98,212
85353,2020-10-18,0,78,71,149
85354,2020-10-18,1,34,26,60
85355,2020-10-18,2,15,9,24
85356,2020-10-18,3,12,11,23
85357,2020-10-18,4,6,5,11
85358,2020-10-18,5,17,14,31
85359,2020-10-18,6,19,20,39
85360,2020-10-18,7,55,66,121
85361,2020-10-18,8,67,117,184
85362,2020-10-18,9,173,235,408
85363,2020-10-18,10,261,297,558
85364,2020-10-18,11,383,330,713
85365,2020-10-18,12,454,449,903
85366,2020-10-18,13,457,433,890
85367,2020-10-18,14,531,411,942
85368,2020-10-18,15,472,376,848
85369,2020-10-18,16,531,411,942
85370,2020-10-18,17,340,371,711
85371,2020-10-18,18,270,284,554
85372,2020-10-18,19,140,193,333
85373,2020-10-18,20,96,112,208
85374,2020-10-18,21,86,82,168
85375,2020-10-18,22,68,57,125
85376,2020-10-18,23,45,28,73
85377,2020-10-19,0,38,16,54
85378,2020-10-19,1,16,5,21
85379,2020-10-19,2,12,8,20
85380,2020-10-19,3,1,8,9
85381,2020-10-19,4,9,6,15
85382,2020-10-19,5,11,27,38
85383,2020-10-19,6,23,111,134
85384,2020-10-19,7,64,205,269
85385,2020-10-19,8,99,290,389
85386,2020-10-19,9,83,204,287
85387,2020-10-19,10,102,168,270
85388,2020-10-19,11,160,196,356
85389,2020-10-19,12,156,231,387
85390,2020-10-19,13,157,219,376
85391,2020-10-19,14,245,223,468
85392,2020-10-19,15,222,244,466
85393,2020-10-19,16,261,344,605
85394,2020-10-19,17,280,492,772
85395,2020-10-19,18,258,466,724
85396,2020-10-19,19,148,248,396
85397,2020-10-19,20,89,151,240
85398,2020-10-19,21,64,94,158
85399,2020-10-19,22,59,63,122
85400,2020-10-19,23,38,33,71
85401,2020-10-20,0,19,13,32
85402,2020-10-20,1,14,8,22
85403,2020-10-20,2,4,4,8
85404,2020-10-20,3,1,3,4
85405,2020-10-20,4,2,7,9
85406,2020-10-20,5,15,34,49
85407,2020-10-20,6,28,100,128
85408,2020-10-20,7,66,202,268
85409,2020-10-20,8,115,295,410
85410,2020-10-20,9,90,222,312
85411,2020-10-20,10,88,185,273
85412,2020-10-20,11,106,185,291
85413,2020-10-20,12,153,245,398
85414,2020-10-20,13,181,248,429
85415,2020-10-20,14,197,250,447
85416,2020-10-20,15,212,291,503
85417,2020-10-20,16,265,362,627
85418,2020-10-20,17,351,560,911
85419,2020-10-20,18,342,563,905
85420,2020-10-20,19,182,284,466
85421,2020-10-20,20,101,185,286
85422,2020-10-20,21,80,113,193
85423,2020-10-20,22,71,81,152
85424,2020-10-20,23,37,37,74
85425,2020-10-21,0,19,12,31
85426,2020-10-21,1,10,11,21
85427,2020-10-21,2,8,6,14
85428,2020-10-21,3,5,5,10
85429,2020-10-21,4,10,8,18
85430,2020-10-21,5,12,42,54
85431,2020-10-21,6,27,103,130
85432,2020-10-21,7,56,210,266
85433,2020-10-21,8,88,227,315
85434,2020-10-21,9,87,204,291
85435,2020-10-21,10,93,161,254
85436,2020-10-21,11,128,191,319
85437,2020-10-21,12,127,245,372
85438,2020-10-21,13,174,211,385
85439,2020-10-21,14,170,241,411
85440,2020-10-21,15,183,260,443
85441,2020-10-21,16,229,373,602
85442,2020-10-21,17,355,607,962
85443,2020-10-21,18,291,537,828
85444,2020-10-21,19,171,343,514
85445,2020-10-21,20,137,221,358
85446,2020-10-21,21,104,122,226
85447,2020-10-21,22,81,76,157
85448,2020-10-21,23,52,38,90
85449,2020-10-22,0,18,19,37
85450,2020-10-22,1,16,8,24
85451,2020-10-22,2,9,9,18
85452,2020-10-22,3,2,1,3
85453,2020-10-22,4,8,9,17
85454,2020-10-22,5,15,34,49
85455,2020-10-22,6,37,96,133
85456,2020-10-22,7,51,214,265
85457,2020-10-22,8,98,282,380
85458,2020-10-22,9,96,224,320
85459,2020-10-22,10,75,173,248
85460,2020-10-22,11,135,171,306
85461,2020-10-22,12,160,233,393
85462,2020-10-22,13,199,250,449
85463,2020-10-22,14,175,263,438
85464,2020-10-22,15,207,289,496
85465,2020-10-22,16,263,376,639
85466,2020-10-22,17,326,581,907
85467,2020-10-22,18,340,545,885
85468,2020-10-22,19,189,324,513
85469,2020-10-22,20,144,203,347
85470,2020-10-22,21,100,121,221
85471,2020-10-22,22,87,100,187
85472,2020-10-22,23,84,82,166
85473,2020-10-23,0,52,37,89
85474,2020-10-23,1,12,10,22
85475,2020-10-23,2,8,7,15
85476,2020-10-23,3,1,2,3
85477,2020-10-23,4,10,6,16
85478,2020-10-23,5,15,24,39
85479,2020-10-23,6,21,91,112
85480,2020-10-23,7,62,184,246
85481,2020-10-23,8,84,258,342
85482,2020-10-23,9,107,251,358
85483,2020-10-23,10,151,216,367
85484,2020-10-23,11,182,268,450
85485,2020-10-23,12,224,297,521
85486,2020-10-23,13,230,304,534
85487,2020-10-23,14,251,245,496
85488,2020-10-23,15,303,361,664
85489,2020-10-23,16,381,414,795
85490,2020-10-23,17,362,579,941
85491,2020-10-23,18,394,524,918
85492,2020-10-23,19,221,368,589
85493,2020-10-23,20,168,233,401
85494,2020-10-23,21,136,152,288
85495,2020-10-23,22,163,108,271
85496,2020-10-23,23,134,108,242
85497,2020-10-24,0,93,77,170
85498,2020-10-24,1,42,37,79
85499,2020-10-24,2,29,18,47
85500,2020-10-24,3,11,14,25
85501,2020-10-24,4,10,9,19
85502,2020-10-24,5,11,13,24
85503,2020-10-24,6,30,35,65
85504,2020-10-24,7,56,102,158
85505,2020-10-24,8,91,178,269
85506,2020-10-24,9,208,277,485
85507,2020-10-24,10,332,357,689
85508,2020-10-24,11,502,366,868
85509,2020-10-24,12,576,438,1014
85510,2020-10-24,13,643,439,1082
85511,2020-10-24,14,660,408,1068
85512,2020-10-24,15,715,485,1200
85513,2020-10-24,16,688,471,1159
85514,2020-10-24,17,532,421,953
85515,2020-10-24,18,369,326,695
85516,2020-10-24,19,210,255,465
85517,2020-10-24,20,193,172,365
85518,2020-10-24,21,165,126,291
85519,2020-10-24,22,140,99,239
85520,2020-10-24,23,110,84,194
85521,2020-10-25,0,78,61,139
85522,2020-10-25,1,34,27,61
85523,2020-10-25,2,24,17,41
85524,2020-10-25,3,16,8,24
85525,2020-10-25,4,5,2,7
85526,2020-10-25,5,3,4,7
85527,2020-10-25,6,5,13,18
85528,2020-10-25,7,10,16,26
85529,2020-10-25,8,17,31,48
85530,2020-10-25,9,39,64,103
85531,2020-10-25,10,53,67,120
85532,2020-10-25,11,42,87,129
85533,2020-10-25,12,85,119,204
85534,2020-10-25,13,105,148,253
85535,2020-10-25,14,107,130,237
85536,2020-10-25,15,117,159,276
85537,2020-10-25,16,133,188,321
85538,2020-10-25,17,104,171,275
85539,2020-10-25,18,78,160,238
85540,2020-10-25,19,47,99,146
85541,2020-10-25,20,63,57,120
85542,2020-10-25,21,43,47,90
85543,2020-10-25,22,39,28,67
85544,2020-10-25,23,41,20,61
85545,2020-10-26,0,9,5,14
85546,2020-10-26,1,5,5,10
85547,2020-10-26,2,3,3,6
85548,2020-10-26,3,1,2,3
85549,2020-10-26,4,10,8,18
85550,2020-10-26,5,11,27,38
85551,2020-10-26,6,19,88,107
85552,2020-10-26,7,46,173,219
85553,2020-10-26,8,70,262,332
85554,2020-10-26,9,81,186,267
85555,2020-10-26,10,82,141,223
85556,2020-10-26,11,123,169,292
85557,2020-10-26,12,137,188,325
85558,2020-10-26,13,127,204,331
85559,2020-10-26,14,177,228,405
85560,2020-10-26,15,166,224,390
85561,2020-10-26,16,192,299,491
85562,2020-10-26,17,265,502,767
85563,2020-10-26,18,249,383,632
85564,2020-10-26,19,144,233,377
85565,2020-10-26,20,79,127,206
85566,2020-10-26,21,46,84,130
85567,2020-10-26,22,45,66,111
85568,2020-10-26,23,27,32,59
85569,2020-10-27,0,17,17,34
85570,2020-10-27,1,14,6,20
85571,2020-10-27,2,4,6,10
85572,2020-10-27,3,1,5,6
85573,2020-10-27,4,6,8,14
85574,2020-10-27,5,14,28,42
85575,2020-10-27,6,35,111,146
85576,2020-10-27,7,58,207,265
85577,2020-10-27,8,99,291,390
85578,2020-10-27,9,86,223,309
85579,2020-10-27,10,88,139,227
85580,2020-10-27,11,108,172,280
85581,2020-10-27,12,134,235,369
85582,2020-10-27,13,130,235,365
85583,2020-10-27,14,154,223,377
85584,2020-10-27,15,175,270,445
85585,2020-10-27,16,272,363,635
85586,2020-10-27,17,287,518,805
85587,2020-10-27,18,193,438,631
85588,2020-10-27,19,157,271,428
85589,2020-10-27,20,71,179,250
85590,2020-10-27,21,69,125,194
85591,2020-10-27,22,84,62,146
85592,2020-10-27,23,37,39,76
85593,2020-10-28,0,26,27,53
85594,2020-10-28,1,10,7,17
85595,2020-10-28,2,4,3,7
85596,2020-10-28,3,1,2,3
85597,2020-10-28,4,9,10,19
85598,2020-10-28,5,9,30,39
85599,2020-10-28,6,40,106,146
85600,2020-10-28,7,64,220,284
85601,2020-10-28,8,93,291,384
85602,2020-10-28,9,76,223,299
85603,2020-10-28,10,74,160,234
85604,2020-10-28,11,112,201,313
85605,2020-10-28,12,151,285,436
85606,2020-10-28,13,130,263,393
85607,2020-10-28,14,174,270,444
85608,2020-10-28,15,231,286,517
85609,2020-10-28,16,233,386,619
85610,2020-10-28,17,314,600,914
85611,2020-10-28,18,242,491,733
85612,2020-10-28,19,149,350,499
85613,2020-10-28,20,91,196,287
85614,2020-10-28,21,96,148,244
85615,2020-10-28,22,75,117,192
85616,2020-10-28,23,60,46,106
85617,2020-10-29,0,35,35,70
85618,2020-10-29,1,10,11,21
85619,2020-10-29,2,4,6,10
85620,2020-10-29,3,0,2,2
85621,2020-10-29,4,3,6,9
85622,2020-10-29,5,4,8,12
85623,2020-10-29,6,8,16,24
85624,2020-10-29,7,6,51,57
85625,2020-10-29,8,23,95,118
85626,2020-10-29,9,9,40,49
85627,2020-10-29,10,13,27,40
85628,2020-10-29,11,8,20,28
85629,2020-10-29,12,20,41,61
85630,2020-10-29,13,11,36,47
85631,2020-10-29,14,15,31,46
85632,2020-10-29,15,40,62,102
85633,2020-10-29,16,69,133,202
85634,2020-10-29,17,74,256,330
85635,2020-10-29,18,113,254,367
85636,2020-10-29,19,64,190,254
85637,2020-10-29,20,53,112,165
85638,2020-10-29,21,29,40,69
85639,2020-10-29,22,28,39,67
85640,2020-10-29,23,23,20,43
85641,2020-10-30,0,10,23,33
85642,2020-10-30,1,11,8,19
85643,2020-10-30,2,0,2,2
85644,2020-10-30,3,0,1,1
85645,2020-10-30,4,10,3,13
85646,2020-10-30,5,9,20,29
85647,2020-10-30,6,21,67,88
85648,2020-10-30,7,41,145,186
85649,2020-10-30,8,60,244,304
85650,2020-10-30,9,71,187,258
85651,2020-10-30,10,67,185,252
85652,2020-10-30,11,110,210,320
85653,2020-10-30,12,147,294,441
85654,2020-10-30,13,146,248,394
85655,2020-10-30,14,162,252,414
85656,2020-10-30,15,219,312,531
85657,2020-10-30,16,233,386,619
85658,2020-10-30,17,279,464,743
85659,2020-10-30,18,222,418,640
85660,2020-10-30,19,154,270,424
85661,2020-10-30,20,101,184,285
85662,2020-10-30,21,70,122,192
85663,2020-10-30,22,68,86,154
85664,2020-10-30,23,65,73,138
85665,2020-10-31,0,46,48,94
85666,2020-10-31,1,24,31,55
85667,2020-10-31,2,14,25,39
85668,2020-10-31,3,9,14,23
85669,2020-10-31,4,7,7,14
85670,2020-10-31,5,5,10,15
85671,2020-10-31,6,10,22,32
85672,2020-10-31,7,42,79,121
85673,2020-10-31,8,65,115,180
85674,2020-10-31,9,124,203,327
85675,2020-10-31,10,199,273,472
85676,2020-10-31,11,259,321,580
85677,2020-10-31,12,288,347,635
85678,2020-10-31,13,342,369,711
85679,2020-10-31,14,355,338,693
85680,2020-10-31,15,306,367,673
85681,2020-10-31,16,304,327,631
85682,2020-10-31,17,190,295,485
85683,2020-10-31,18,216,243,459
85684,2020-10-31,19,134,181,315
85685,2020-10-31,20,100,122,222
85686,2020-10-31,21,54,108,162
85687,2020-10-31,22,89,77,166
85688,2020-10-31,23,83,64,147
85689,2020-11-01,0,67,86,153
85690,2020-11-01,1,76,69,145
85691,2020-11-01,2,6,18,24
85692,2020-11-01,3,9,9,18
85693,2020-11-01,4,8,6,14
85694,2020-11-01,5,11,8,19
85695,2020-11-01,6,16,26,42
85696,2020-11-01,7,41,74,115
85697,2020-11-01,8,59,119,178
85698,2020-11-01,9,25,64,89
85699,2020-11-01,10,13,24,37
85700,2020-11-01,11,14,30,44
85701,2020-11-01,12,51,92,143
85702,2020-11-01,13,107,149,256
85703,2020-11-01,14,134,207,341
85704,2020-11-01,15,158,260,418
85705,2020-11-01,16,201,286,487
85706,2020-11-01,17,144,241,385
85707,2020-11-01,18,91,188,279
85708,2020-11-01,19,54,124,178
85709,2020-11-01,20,53,66,119
85710,2020-11-01,21,34,53,87
85711,2020-11-01,22,26,36,62
85712,2020-11-01,23,20,22,42
85713,2020-11-02,0,7,7,14
85714,2020-11-02,1,4,7,11
85715,2020-11-02,2,0,6,6
85716,2020-11-02,3,2,0,2
85717,2020-11-02,4,6,7,13
85718,2020-11-02,5,13,29,42
85719,2020-11-02,6,25,87,112
85720,2020-11-02,7,43,199,242
85721,2020-11-02,8,66,231,297
85722,2020-11-02,9,47,136,183
85723,2020-11-02,10,47,119,166
85724,2020-11-02,11,63,166,229
85725,2020-11-02,12,81,174,255
85726,2020-11-02,13,111,214,325
85727,2020-11-02,14,126,199,325
85728,2020-11-02,15,132,205,337
85729,2020-11-02,16,141,268,409
85730,2020-11-02,17,119,321,440
85731,2020-11-02,18,103,279,382
85732,2020-11-02,19,60,205,265
85733,2020-11-02,20,53,119,172
85734,2020-11-02,21,47,77,124
85735,2020-11-02,22,37,35,72
85736,2020-11-02,23,18,29,47
85737,2020-11-03,0,13,3,16
85738,2020-11-03,1,5,6,11
85739,2020-11-03,2,1,4,5
85740,2020-11-03,3,5,3,8
85741,2020-11-03,4,5,9,14
85742,2020-11-03,5,15,46,61
85743,2020-11-03,6,39,126,165
85744,2020-11-03,7,56,185,241
85745,2020-11-03,8,84,256,340
85746,2020-11-03,9,76,203,279
85747,2020-11-03,10,117,188,305
85748,2020-11-03,11,173,223,396
85749,2020-11-03,12,193,264,457
85750,2020-11-03,13,235,274,509
85751,2020-11-03,14,250,292,542
85752,2020-11-03,15,249,308,557
85753,2020-11-03,16,281,386,667
85754,2020-11-03,17,250,445,695
85755,2020-11-03,18,167,320,487
85756,2020-11-03,19,153,238,391
85757,2020-11-03,20,93,148,241
85758,2020-11-03,21,62,77,139
85759,2020-11-03,22,69,66,135
85760,2020-11-03,23,71,95,166
85761,2020-11-04,0,72,65,137
85762,2020-11-04,1,62,45,107
85763,2020-11-04,2,17,21,38
85764,2020-11-04,3,15,11,26
85765,2020-11-04,4,11,6,17
85766,2020-11-04,5,13,24,37
85767,2020-11-04,6,19,68,87
85768,2020-11-04,7,38,140,178
85769,2020-11-04,8,42,178,220
85770,2020-11-04,9,63,157,220
85771,2020-11-04,10,73,153,226
85772,2020-11-04,11,99,157,256
85773,2020-11-04,12,95,192,287
85774,2020-11-04,13,154,200,354
85775,2020-11-04,14,193,210,403
85776,2020-11-04,15,193,247,440
85777,2020-11-04,16,244,358,602
85778,2020-11-04,17,211,396,607
85779,2020-11-04,18,176,305,481
85780,2020-11-04,19,97,176,273
85781,2020-11-04,20,81,129,210
85782,2020-11-04,21,66,91,157
85783,2020-11-04,22,50,58,108
85784,2020-11-04,23,39,33,72
85785,2020-11-05,0,15,12,27
85786,2020-11-05,1,5,17,22
85787,2020-11-05,2,10,10,20
85788,2020-11-05,3,2,3,5
85789,2020-11-05,4,4,9,13
85790,2020-11-05,5,6,30,36
85791,2020-11-05,6,29,96,125
85792,2020-11-05,7,56,214,270
85793,2020-11-05,8,75,251,326
85794,2020-11-05,9,94,176,270
85795,2020-11-05,10,104,174,278
85796,2020-11-05,11,110,192,302
85797,2020-11-05,12,127,235,362
85798,2020-11-05,13,164,212,376
85799,2020-11-05,14,202,233,435
85800,2020-11-05,15,212,291,503
85801,2020-11-05,16,228,348,576
85802,2020-11-05,17,244,432,676
85803,2020-11-05,18,157,322,479
85804,2020-11-05,19,129,230,359
85805,2020-11-05,20,80,124,204
85806,2020-11-05,21,95,100,195
85807,2020-11-05,22,82,92,174
85808,2020-11-05,23,61,53,114
85809,2020-11-06,0,33,21,54
85810,2020-11-06,1,13,9,22
85811,2020-11-06,2,6,6,12
85812,2020-11-06,3,6,4,10
85813,2020-11-06,4,9,8,17
85814,2020-11-06,5,17,25,42
85815,2020-11-06,6,36,91,127
85816,2020-11-06,7,49,176,225
85817,2020-11-06,8,87,234,321
85818,2020-11-06,9,107,185,292
85819,2020-11-06,10,103,191,294
85820,2020-11-06,11,153,214,367
85821,2020-11-06,12,212,261,473
85822,2020-11-06,13,233,260,493
85823,2020-11-06,14,269,298,567
85824,2020-11-06,15,357,382,739
85825,2020-11-06,16,351,469,820
85826,2020-11-06,17,276,493,769
85827,2020-11-06,18,245,341,586
85828,2020-11-06,19,176,277,453
85829,2020-11-06,20,144,192,336
85830,2020-11-06,21,166,142,308
85831,2020-11-06,22,107,131,238
85832,2020-11-06,23,93,107,200
85833,2020-11-07,0,73,68,141
85834,2020-11-07,1,37,40,77
85835,2020-11-07,2,22,20,42
85836,2020-11-07,3,8,13,21
85837,2020-11-07,4,14,7,21
85838,2020-11-07,5,6,10,16
85839,2020-11-07,6,24,33,57
85840,2020-11-07,7,45,81,126
85841,2020-11-07,8,63,83,146
85842,2020-11-07,9,200,329,529
85843,2020-11-07,10,339,367,706
85844,2020-11-07,11,504,465,969
85845,2020-11-07,12,814,658,1472
85846,2020-11-07,13,860,643,1503
85847,2020-11-07,14,881,588,1469
85848,2020-11-07,15,1008,550,1558
85849,2020-11-07,16,954,614,1568
85850,2020-11-07,17,751,466,1217
85851,2020-11-07,18,495,318,813
85852,2020-11-07,19,352,238,590
85853,2020-11-07,20,282,157,439
85854,2020-11-07,21,255,163,418
85855,2020-11-07,22,207,144,351
85856,2020-11-07,23,233,151,384
85857,2020-11-08,0,177,83,260
85858,2020-11-08,1,73,35,108
85859,2020-11-08,2,21,24,45
85860,2020-11-08,3,9,7,16
85861,2020-11-08,4,4,7,11
85862,2020-11-08,5,10,13,23
85863,2020-11-08,6,14,22,36
85864,2020-11-08,7,43,78,121
85865,2020-11-08,8,78,141,219
85866,2020-11-08,9,183,217,400
85867,2020-11-08,10,269,289,558
85868,2020-11-08,11,383,389,772
85869,2020-11-08,12,436,392,828
85870,2020-11-08,13,640,489,1129
85871,2020-11-08,14,648,544,1192
85872,2020-11-08,15,592,518,1110
85873,2020-11-08,16,613,536,1149
85874,2020-11-08,17,367,375,742
85875,2020-11-08,18,210,190,400
85876,2020-11-08,19,144,149,293
85877,2020-11-08,20,95,117,212
85878,2020-11-08,21,61,69,130
85879,2020-11-08,22,49,48,97
85880,2020-11-08,23,29,35,64
85881,2020-11-09,0,24,22,46
85882,2020-11-09,1,5,5,10
85883,2020-11-09,2,1,9,10
85884,2020-11-09,3,3,2,5
85885,2020-11-09,4,15,11,26
85886,2020-11-09,5,11,29,40
85887,2020-11-09,6,26,95,121
85888,2020-11-09,7,63,185,248
85889,2020-11-09,8,85,281,366
85890,2020-11-09,9,107,184,291
85891,2020-11-09,10,96,169,265
85892,2020-11-09,11,154,214,368
85893,2020-11-09,12,165,216,381
85894,2020-11-09,13,200,207,407
85895,2020-11-09,14,187,217,404
85896,2020-11-09,15,211,278,489
85897,2020-11-09,16,214,426,640
85898,2020-11-09,17,246,497,743
85899,2020-11-09,18,182,344,526
85900,2020-11-09,19,124,228,352
85901,2020-11-09,20,96,121,217
85902,2020-11-09,21,49,94,143
85903,2020-11-09,22,37,60,97
85904,2020-11-09,23,30,33,63
85905,2020-11-10,0,22,8,30
85906,2020-11-10,1,11,6,17
85907,2020-11-10,2,2,3,5
85908,2020-11-10,3,4,3,7
85909,2020-11-10,4,11,10,21
85910,2020-11-10,5,16,35,51
85911,2020-11-10,6,37,118,155
85912,2020-11-10,7,58,238,296
85913,2020-11-10,8,109,317,426
85914,2020-11-10,9,116,216,332
85915,2020-11-10,10,113,180,293
85916,2020-11-10,11,151,195,346
85917,2020-11-10,12,181,226,407
85918,2020-11-10,13,182,273,455
85919,2020-11-10,14,200,261,461
85920,2020-11-10,15,237,305,542
85921,2020-11-10,16,314,437,751
85922,2020-11-10,17,277,516,793
85923,2020-11-10,18,203,347,550
85924,2020-11-10,19,150,268,418
85925,2020-11-10,20,98,179,277
85926,2020-11-10,21,76,131,207
85927,2020-11-10,22,82,88,170
85928,2020-11-10,23,53,50,103
85929,2020-11-11,0,30,25,55
85930,2020-11-11,1,19,9,28
85931,2020-11-11,2,0,4,4
85932,2020-11-11,3,5,6,11
85933,2020-11-11,4,7,11,18
85934,2020-11-11,5,10,19,29
85935,2020-11-11,6,18,73,91
85936,2020-11-11,7,36,139,175
85937,2020-11-11,8,19,105,124
85938,2020-11-11,9,13,71,84
85939,2020-11-11,10,19,57,76
85940,2020-11-11,11,21,69,90
85941,2020-11-11,12,27,65,92
85942,2020-11-11,13,31,52,83
85943,2020-11-11,14,29,88,117
85944,2020-11-11,15,41,93,134
85945,2020-11-11,16,64,107,171
85946,2020-11-11,17,35,107,142
85947,2020-11-11,18,33,118,151
85948,2020-11-11,19,37,122,159
85949,2020-11-11,20,40,93,133
85950,2020-11-11,21,22,29,51
85951,2020-11-11,22,8,15,23
85952,2020-11-11,23,4,3,7
85953,2020-11-12,0,5,9,14
85954,2020-11-12,1,3,5,8
85955,2020-11-12,2,4,1,5
85956,2020-11-12,3,3,2,5
85957,2020-11-12,4,3,6,9
85958,2020-11-12,5,6,9,15
85959,2020-11-12,6,18,43,61
85960,2020-11-12,7,19,85,104
85961,2020-11-12,8,19,112,131
85962,2020-11-12,9,15,57,72
85963,2020-11-12,10,16,50,66
85964,2020-11-12,11,26,59,85
85965,2020-11-12,12,62,117,179
85966,2020-11-12,13,64,152,216
85967,2020-11-12,14,102,174,276
85968,2020-11-12,15,106,189,295
85969,2020-11-12,16,114,265,379
85970,2020-11-12,17,121,310,431
85971,2020-11-12,18,105,287,392
85972,2020-11-12,19,80,186,266
85973,2020-11-12,20,58,107,165
85974,2020-11-12,21,66,83,149
85975,2020-11-12,22,44,55,99
85976,2020-11-12,23,58,35,93
85977,2020-11-13,0,21,21,42
85978,2020-11-13,1,9,18,27
85979,2020-11-13,2,2,8,10
85980,2020-11-13,3,1,1,2
85981,2020-11-13,4,7,8,15
85982,2020-11-13,5,9,29,38
85983,2020-11-13,6,21,93,114
85984,2020-11-13,7,62,203,265
85985,2020-11-13,8,88,255,343
85986,2020-11-13,9,90,208,298
85987,2020-11-13,10,102,189,291
85988,2020-11-13,11,143,248,391
85989,2020-11-13,12,171,248,419
85990,2020-11-13,13,219,293,512
85991,2020-11-13,14,224,264,488
85992,2020-11-13,15,264,373,637
85993,2020-11-13,16,315,427,742
85994,2020-11-13,17,258,423,681
85995,2020-11-13,18,185,367,552
85996,2020-11-13,19,133,263,396
85997,2020-11-13,20,96,147,243
85998,2020-11-13,21,107,93,200
85999,2020-11-13,22,75,96,171
86000,2020-11-13,23,88,88,176
86001,2020-11-14,0,56,65,121
86002,2020-11-14,1,16,31,47
86003,2020-11-14,2,17,9,26
86004,2020-11-14,3,16,9,25
86005,2020-11-14,4,10,8,18
86006,2020-11-14,5,9,9,18
86007,2020-11-14,6,14,31,45
86008,2020-11-14,7,39,86,125
86009,2020-11-14,8,122,146,268
86010,2020-11-14,9,171,224,395
86011,2020-11-14,10,302,300,602
86012,2020-11-14,11,374,372,746
86013,2020-11-14,12,457,445,902
86014,2020-11-14,13,534,455,989
86015,2020-11-14,14,636,505,1141
86016,2020-11-14,15,632,446,1078
86017,2020-11-14,16,495,448,943
86018,2020-11-14,17,300,315,615
86019,2020-11-14,18,193,248,441
86020,2020-11-14,19,118,165,283
86021,2020-11-14,20,108,114,222
86022,2020-11-14,21,79,100,179
86023,2020-11-14,22,90,79,169
86024,2020-11-14,23,66,64,130
86025,2020-11-15,0,51,56,107
86026,2020-11-15,1,30,28,58
86027,2020-11-15,2,14,14,28
86028,2020-11-15,3,7,11,18
86029,2020-11-15,4,10,10,20
86030,2020-11-15,5,9,14,23
86031,2020-11-15,6,14,26,40
86032,2020-11-15,7,38,64,102
86033,2020-11-15,8,60,121,181
86034,2020-11-15,9,125,178,303
86035,2020-11-15,10,214,261,475
86036,2020-11-15,11,267,316,583
86037,2020-11-15,12,281,344,625
86038,2020-11-15,13,301,312,613
86039,2020-11-15,14,217,306,523
86040,2020-11-15,15,270,301,571
86041,2020-11-15,16,205,298,503
86042,2020-11-15,17,133,203,336
86043,2020-11-15,18,154,149,303
86044,2020-11-15,19,38,67,105
86045,2020-11-15,20,34,44,78
86046,2020-11-15,21,39,53,92
86047,2020-11-15,22,31,43,74
86048,2020-11-15,23,31,29,60
86049,2020-11-16,0,19,17,36
86050,2020-11-16,1,9,5,14
86051,2020-11-16,2,4,4,8
86052,2020-11-16,3,5,2,7
86053,2020-11-16,4,7,7,14
86054,2020-11-16,5,14,30,44
86055,2020-11-16,6,23,88,111
86056,2020-11-16,7,56,185,241
86057,2020-11-16,8,73,239,312
86058,2020-11-16,9,76,186,262
86059,2020-11-16,10,82,200,282
86060,2020-11-16,11,113,193,306
86061,2020-11-16,12,165,229,394
86062,2020-11-16,13,119,216,335
86063,2020-11-16,14,180,189,369
86064,2020-11-16,15,174,231,405
86065,2020-11-16,16,203,337,540
86066,2020-11-16,17,142,386,528
86067,2020-11-16,18,113,298,411
86068,2020-11-16,19,96,188,284
86069,2020-11-16,20,66,129,195
86070,2020-11-16,21,39,68,107
86071,2020-11-16,22,31,44,75
86072,2020-11-16,23,24,20,44
86073,2020-11-17,0,12,9,21
86074,2020-11-17,1,7,6,13
86075,2020-11-17,2,2,1,3
86076,2020-11-17,3,3,4,7
86077,2020-11-17,4,8,8,16
86078,2020-11-17,5,13,32,45
86079,2020-11-17,6,18,97,115
86080,2020-11-17,7,59,185,244
86081,2020-11-17,8,94,255,349
86082,2020-11-17,9,63,199,262
86083,2020-11-17,10,81,160,241
86084,2020-11-17,11,72,187,259
86085,2020-11-17,12,73,176,249
86086,2020-11-17,13,97,168,265
86087,2020-11-17,14,89,170,259
86088,2020-11-17,15,116,205,321
86089,2020-11-17,16,126,267,393
86090,2020-11-17,17,104,309,413
86091,2020-11-17,18,96,250,346
86092,2020-11-17,19,57,171,228
86093,2020-11-17,20,37,89,126
86094,2020-11-17,21,35,56,91
86095,2020-11-17,22,26,44,70
86096,2020-11-17,23,20,26,46
86097,2020-11-18,0,10,7,17
86098,2020-11-18,1,2,8,10
86099,2020-11-18,2,3,2,5
86100,2020-11-18,3,5,2,7
86101,2020-11-18,4,12,9,21
86102,2020-11-18,5,6,26,32
86103,2020-11-18,6,13,79,92
86104,2020-11-18,7,35,169,204
86105,2020-11-18,8,67,225,292
86106,2020-11-18,9,70,186,256
86107,2020-11-18,10,68,138,206
86108,2020-11-18,11,89,146,235
86109,2020-11-18,12,106,203,309
86110,2020-11-18,13,80,178,258
86111,2020-11-18,14,72,180,252
86112,2020-11-18,15,102,200,302
86113,2020-11-18,16,105,245,350
86114,2020-11-18,17,124,282,406
86115,2020-11-18,18,79,250,329
86116,2020-11-18,19,55,160,215
86117,2020-11-18,20,37,86,123
86118,2020-11-18,21,24,75,99
86119,2020-11-18,22,25,51,76
86120,2020-11-18,23,19,33,52
86121,2020-11-19,0,15,17,32
86122,2020-11-19,1,7,10,17
86123,2020-11-19,2,4,5,9
86124,2020-11-19,3,2,3,5
86125,2020-11-19,4,12,5,17
86126,2020-11-19,5,11,26,37
86127,2020-11-19,6,16,85,101
86128,2020-11-19,7,40,168,208
86129,2020-11-19,8,75,227,302
86130,2020-11-19,9,37,157,194
86131,2020-11-19,10,50,152,202
86132,2020-11-19,11,69,163,232
86133,2020-11-19,12,82,203,285
86134,2020-11-19,13,109,182,291
86135,2020-11-19,14,116,195,311
86136,2020-11-19,15,113,243,356
86137,2020-11-19,16,129,285,414
86138,2020-11-19,17,112,318,430
86139,2020-11-19,18,96,242,338
86140,2020-11-19,19,86,191,277
86141,2020-11-19,20,37,111,148
86142,2020-11-19,21,31,75,106
86143,2020-11-19,22,42,57,99
86144,2020-11-19,23,32,33,65
86145,2020-11-20,0,11,19,30
86146,2020-11-20,1,7,9,16
86147,2020-11-20,2,5,5,10
86148,2020-11-20,3,11,5,16
86149,2020-11-20,4,7,7,14
86150,2020-11-20,5,10,19,29
86151,2020-11-20,6,20,82,102
86152,2020-11-20,7,42,183,225
86153,2020-11-20,8,77,215,292
86154,2020-11-20,9,71,182,253
86155,2020-11-20,10,91,179,270
86156,2020-11-20,11,113,240,353
86157,2020-11-20,12,134,253,387
86158,2020-11-20,13,171,264,435
86159,2020-11-20,14,193,289,482
86160,2020-11-20,15,219,320,539
86161,2020-11-20,16,220,368,588
86162,2020-11-20,17,169,378,547
86163,2020-11-20,18,155,308,463
86164,2020-11-20,19,118,245,363
86165,2020-11-20,20,94,120,214
86166,2020-11-20,21,48,102,150
86167,2020-11-20,22,53,79,132
86168,2020-11-20,23,49,53,102
86169,2020-11-21,0,41,49,90
86170,2020-11-21,1,29,14,43
86171,2020-11-21,2,10,12,22
86172,2020-11-21,3,5,7,12
86173,2020-11-21,4,6,9,15
86174,2020-11-21,5,8,5,13
86175,2020-11-21,6,16,28,44
86176,2020-11-21,7,36,72,108
86177,2020-11-21,8,56,139,195
86178,2020-11-21,9,129,240,369
86179,2020-11-21,10,184,272,456
86180,2020-11-21,11,280,294,574
86181,2020-11-21,12,423,357,780
86182,2020-11-21,13,473,390,863
86183,2020-11-21,14,419,415,834
86184,2020-11-21,15,426,442,868
86185,2020-11-21,16,346,363,709
86186,2020-11-21,17,219,244,463
86187,2020-11-21,18,147,205,352
86188,2020-11-21,19,146,161,307
86189,2020-11-21,20,118,111,229
86190,2020-11-21,21,107,93,200
86191,2020-11-21,22,57,80,137
86192,2020-11-21,23,65,56,121
86193,2020-11-22,0,48,40,88
86194,2020-11-22,1,20,18,38
86195,2020-11-22,2,7,10,17
86196,2020-11-22,3,12,12,24
86197,2020-11-22,4,9,2,11
86198,2020-11-22,5,9,8,17
86199,2020-11-22,6,13,27,40
86200,2020-11-22,7,35,50,85
86201,2020-11-22,8,52,108,160
86202,2020-11-22,9,90,178,268
86203,2020-11-22,10,163,215,378
86204,2020-11-22,11,223,252,475
86205,2020-11-22,12,284,310,594
86206,2020-11-22,13,297,321,618
86207,2020-11-22,14,314,368,682
86208,2020-11-22,15,303,294,597
86209,2020-11-22,16,243,281,524
86210,2020-11-22,17,144,208,352
86211,2020-11-22,18,116,135,251
86212,2020-11-22,19,62,114,176
86213,2020-11-22,20,63,69,132
86214,2020-11-22,21,45,50,95
86215,2020-11-22,22,52,52,104
86216,2020-11-22,23,22,23,45
86217,2020-11-23,0,18,15,33
86218,2020-11-23,1,8,7,15
86219,2020-11-23,2,5,7,12
86220,2020-11-23,3,5,5,10
86221,2020-11-23,4,9,7,16
86222,2020-11-23,5,12,19,31
86223,2020-11-23,6,18,74,92
86224,2020-11-23,7,37,158,195
86225,2020-11-23,8,56,200,256
86226,2020-11-23,9,54,148,202
86227,2020-11-23,10,61,124,185
86228,2020-11-23,11,65,139,204
86229,2020-11-23,12,84,174,258
86230,2020-11-23,13,118,180,298
86231,2020-11-23,14,127,228,355
86232,2020-11-23,15,113,171,284
86233,2020-11-23,16,126,256,382
86234,2020-11-23,17,102,246,348
86235,2020-11-23,18,63,198,261
86236,2020-11-23,19,57,124,181
86237,2020-11-23,20,60,93,153
86238,2020-11-23,21,34,60,94
86239,2020-11-23,22,26,38,64
86240,2020-11-23,23,14,23,37
86241,2020-11-24,0,5,8,13
86242,2020-11-24,1,4,10,14
86243,2020-11-24,2,3,6,9
86244,2020-11-24,3,1,2,3
86245,2020-11-24,4,8,10,18
86246,2020-11-24,5,9,33,42
86247,2020-11-24,6,17,80,97
86248,2020-11-24,7,38,143,181
86249,2020-11-24,8,61,186,247
86250,2020-11-24,9,51,152,203
86251,2020-11-24,10,52,127,179
86252,2020-11-24,11,124,152,276
86253,2020-11-24,12,109,204,313
86254,2020-11-24,13,158,167,325
86255,2020-11-24,14,147,192,339
86256,2020-11-24,15,169,235,404
86257,2020-11-24,16,143,277,420
86258,2020-11-24,17,109,271,380
86259,2020-11-24,18,91,212,303
86260,2020-11-24,19,65,147,212
86261,2020-11-24,20,55,115,170
86262,2020-11-24,21,58,70,128
86263,2020-11-24,22,30,35,65
86264,2020-11-24,23,30,20,50
86265,2020-11-25,0,7,4,11
86266,2020-11-25,1,6,5,11
86267,2020-11-25,2,6,3,9
86268,2020-11-25,3,14,5,19
86269,2020-11-25,4,4,7,11
86270,2020-11-25,5,8,23,31
86271,2020-11-25,6,21,66,87
86272,2020-11-25,7,26,124,150
86273,2020-11-25,8,44,129,173
86274,2020-11-25,9,54,144,198
86275,2020-11-25,10,78,134,212
86276,2020-11-25,11,111,193,304
86277,2020-11-25,12,129,161,290
86278,2020-11-25,13,146,192,338
86279,2020-11-25,14,192,201,393
86280,2020-11-25,15,198,239,437
86281,2020-11-25,16,143,228,371
86282,2020-11-25,17,106,225,331
86283,2020-11-25,18,83,166,249
86284,2020-11-25,19,66,114,180
86285,2020-11-25,20,48,82,130
86286,2020-11-25,21,37,66,103
86287,2020-11-25,22,40,44,84
86288,2020-11-25,23,20,22,42
86289,2020-11-26,0,9,6,15
86290,2020-11-26,1,7,8,15
86291,2020-11-26,2,11,5,16
86292,2020-11-26,3,3,3,6
86293,2020-11-26,4,2,6,8
86294,2020-11-26,5,3,9,12
86295,2020-11-26,6,8,16,24
86296,2020-11-26,7,26,42,68
86297,2020-11-26,8,35,73,108
86298,2020-11-26,9,72,109,181
86299,2020-11-26,10,93,159,252
86300,2020-11-26,11,188,182,370
86301,2020-11-26,12,224,225,449
86302,2020-11-26,13,262,247,509
86303,2020-11-26,14,288,200,488
86304,2020-11-26,15,263,196,459
86305,2020-11-26,16,227,184,411
86306,2020-11-26,17,102,126,228
86307,2020-11-26,18,81,66,147
86308,2020-11-26,19,58,44,102
86309,2020-11-26,20,36,58,94
86310,2020-11-26,21,51,34,85
86311,2020-11-26,22,30,43,73
86312,2020-11-26,23,36,35,71
86313,2020-11-27,0,22,19,41
86314,2020-11-27,1,7,7,14
86315,2020-11-27,2,7,9,16
86316,2020-11-27,3,8,5,13
86317,2020-11-27,4,7,12,19
86318,2020-11-27,5,7,12,19
86319,2020-11-27,6,12,27,39
86320,2020-11-27,7,22,56,78
86321,2020-11-27,8,40,99,139
86322,2020-11-27,9,72,107,179
86323,2020-11-27,10,140,146,286
86324,2020-11-27,11,219,215,434
86325,2020-11-27,12,341,207,548
86326,2020-11-27,13,332,245,577
86327,2020-11-27,14,389,264,653
86328,2020-11-27,15,384,291,675
86329,2020-11-27,16,344,283,627
86330,2020-11-27,17,172,193,365
86331,2020-11-27,18,123,146,269
86332,2020-11-27,19,93,113,206
86333,2020-11-27,20,89,69,158
86334,2020-11-27,21,55,66,121
86335,2020-11-27,22,62,54,116
86336,2020-11-27,23,52,43,95
86337,2020-11-28,0,27,23,50
86338,2020-11-28,1,15,16,31
86339,2020-11-28,2,6,7,13
86340,2020-11-28,3,7,6,13
86341,2020-11-28,4,10,5,15
86342,2020-11-28,5,2,4,6
86343,2020-11-28,6,14,24,38
86344,2020-11-28,7,27,58,85
86345,2020-11-28,8,50,92,142
86346,2020-11-28,9,104,174,278
86347,2020-11-28,10,197,210,407
86348,2020-11-28,11,321,273,594
86349,2020-11-28,12,402,305,707
86350,2020-11-28,13,451,356,807
86351,2020-11-28,14,512,404,916
86352,2020-11-28,15,459,362,821
86353,2020-11-28,16,344,318,662
86354,2020-11-28,17,168,209,377
86355,2020-11-28,18,136,150,286
86356,2020-11-28,19,85,115,200
86357,2020-11-28,20,71,86,157
86358,2020-11-28,21,58,61,119
86359,2020-11-28,22,57,65,122
86360,2020-11-28,23,30,22,52
86361,2020-11-29,0,28,22,50
86362,2020-11-29,1,14,14,28
86363,2020-11-29,2,7,6,13
86364,2020-11-29,3,0,6,6
86365,2020-11-29,4,10,5,15
86366,2020-11-29,5,9,6,15
86367,2020-11-29,6,7,24,31
86368,2020-11-29,7,23,46,69
86369,2020-11-29,8,40,87,127
86370,2020-11-29,9,66,138,204
86371,2020-11-29,10,125,192,317
86372,2020-11-29,11,188,272,460
86373,2020-11-29,12,291,322,613
86374,2020-11-29,13,331,308,639
86375,2020-11-29,14,362,352,714
86376,2020-11-29,15,374,352,726
86377,2020-11-29,16,231,330,561
86378,2020-11-29,17,136,181,317
86379,2020-11-29,18,84,142,226
86380,2020-11-29,19,66,85,151
86381,2020-11-29,20,44,69,113
86382,2020-11-29,21,51,63,114
86383,2020-11-29,22,32,32,64
86384,2020-11-29,23,28,27,55
86385,2020-11-30,0,7,6,13
86386,2020-11-30,1,5,5,10
86387,2020-11-30,2,5,7,12
86388,2020-11-30,3,1,1,2
86389,2020-11-30,4,6,3,9
86390,2020-11-30,5,5,13,18
86391,2020-11-30,6,3,17,20
86392,2020-11-30,7,8,22,30
86393,2020-11-30,8,16,59,75
86394,2020-11-30,9,16,60,76
86395,2020-11-30,10,5,25,30
86396,2020-11-30,11,15,32,47
86397,2020-11-30,12,34,82,116
86398,2020-11-30,13,34,63,97
86399,2020-11-30,14,44,104,148
86400,2020-11-30,15,76,145,221
86401,2020-11-30,16,85,201,286
86402,2020-11-30,17,73,224,297
86403,2020-11-30,18,52,183,235
86404,2020-11-30,19,57,146,203
86405,2020-11-30,20,59,75,134
86406,2020-11-30,21,28,54,82
86407,2020-11-30,22,24,36,60
86408,2020-11-30,23,13,24,37
86409,2020-12-01,0,12,15,27
86410,2020-12-01,1,6,10,16
86411,2020-12-01,2,6,4,10
86412,2020-12-01,3,2,1,3
86413,2020-12-01,4,6,8,14
86414,2020-12-01,5,5,26,31
86415,2020-12-01,6,15,66,81
86416,2020-12-01,7,23,110,133
86417,2020-12-01,8,36,152,188
86418,2020-12-01,9,50,136,186
86419,2020-12-01,10,37,142,179
86420,2020-12-01,11,62,152,214
86421,2020-12-01,12,85,178,263
86422,2020-12-01,13,96,160,256
86423,2020-12-01,14,81,140,221
86424,2020-12-01,15,85,145,230
86425,2020-12-01,16,90,188,278
86426,2020-12-01,17,75,238,313
86427,2020-12-01,18,87,192,279
86428,2020-12-01,19,52,156,208
86429,2020-12-01,20,39,78,117
86430,2020-12-01,21,27,53,80
86431,2020-12-01,22,36,26,62
86432,2020-12-01,23,12,15,27
86433,2020-12-02,0,4,16,20
86434,2020-12-02,1,5,6,11
86435,2020-12-02,2,0,5,5
86436,2020-12-02,3,2,2,4
86437,2020-12-02,4,2,8,10
86438,2020-12-02,5,4,16,20
86439,2020-12-02,6,16,70,86
86440,2020-12-02,7,30,133,163
86441,2020-12-02,8,47,162,209
86442,2020-12-02,9,44,147,191
86443,2020-12-02,10,31,112,143
86444,2020-12-02,11,47,121,168
86445,2020-12-02,12,65,156,221
86446,2020-12-02,13,74,160,234
86447,2020-12-02,14,80,182,262
86448,2020-12-02,15,92,185,277
86449,2020-12-02,16,81,231,312
86450,2020-12-02,17,94,285,379
86451,2020-12-02,18,90,234,324
86452,2020-12-02,19,57,144,201
86453,2020-12-02,20,46,92,138
86454,2020-12-02,21,29,71,100
86455,2020-12-02,22,30,43,73
86456,2020-12-02,23,21,28,49
86457,2020-12-03,0,13,10,23
86458,2020-12-03,1,6,8,14
86459,2020-12-03,2,1,3,4
86460,2020-12-03,3,4,4,8
86461,2020-12-03,4,6,5,11
86462,2020-12-03,5,3,25,28
86463,2020-12-03,6,19,69,88
86464,2020-12-03,7,25,132,157
86465,2020-12-03,8,52,189,241
86466,2020-12-03,9,50,163,213
86467,2020-12-03,10,66,128,194
86468,2020-12-03,11,85,128,213
86469,2020-12-03,12,98,181,279
86470,2020-12-03,13,81,180,261
86471,2020-12-03,14,113,177,290
86472,2020-12-03,15,129,190,319
86473,2020-12-03,16,131,265,396
86474,2020-12-03,17,91,306,397
86475,2020-12-03,18,109,248,357
86476,2020-12-03,19,70,169,239
86477,2020-12-03,20,58,87,145
86478,2020-12-03,21,47,94,141
86479,2020-12-03,22,44,54,98
86480,2020-12-03,23,25,25,50
86481,2020-12-04,0,9,14,23
86482,2020-12-04,1,9,6,15
86483,2020-12-04,2,8,7,15
86484,2020-12-04,3,4,2,6
86485,2020-12-04,4,1,5,6
86486,2020-12-04,5,3,24,27
86487,2020-12-04,6,8,62,70
86488,2020-12-04,7,34,124,158
86489,2020-12-04,8,39,132,171
86490,2020-12-04,9,52,131,183
86491,2020-12-04,10,51,149,200
86492,2020-12-04,11,64,165,229
86493,2020-12-04,12,94,175,269
86494,2020-12-04,13,114,189,303
86495,2020-12-04,14,103,195,298
86496,2020-12-04,15,133,206,339
86497,2020-12-04,16,125,239,364
86498,2020-12-04,17,96,235,331
86499,2020-12-04,18,66,175,241
86500,2020-12-04,19,38,113,151
86501,2020-12-04,20,19,45,64
86502,2020-12-04,21,7,30,37
86503,2020-12-04,22,9,17,26
86504,2020-12-04,23,10,13,23
86505,2020-12-05,0,10,16,26
86506,2020-12-05,1,11,6,17
86507,2020-12-05,2,0,2,2
86508,2020-12-05,3,1,0,1
86509,2020-12-05,4,1,2,3
86510,2020-12-05,5,1,3,4
86511,2020-12-05,6,6,21,27
86512,2020-12-05,7,14,35,49
86513,2020-12-05,8,29,83,112
86514,2020-12-05,9,69,164,233
86515,2020-12-05,10,89,207,296
86516,2020-12-05,11,153,211,364
86517,2020-12-05,12,226,272,498
86518,2020-12-05,13,222,275,497
86519,2020-12-05,14,198,270,468
86520,2020-12-05,15,187,263,450
86521,2020-12-05,16,164,241,405
86522,2020-12-05,17,108,196,304
86523,2020-12-05,18,68,173,241
86524,2020-12-05,19,77,145,222
86525,2020-12-05,20,46,114,160
86526,2020-12-05,21,42,60,102
86527,2020-12-05,22,39,68,107
86528,2020-12-05,23,32,31,63
86529,2020-12-06,0,16,26,42
86530,2020-12-06,1,13,21,34
86531,2020-12-06,2,5,7,12
86532,2020-12-06,3,5,12,17
86533,2020-12-06,4,4,5,9
86534,2020-12-06,5,4,9,13
86535,2020-12-06,6,16,18,34
86536,2020-12-06,7,20,27,47
86537,2020-12-06,8,34,80,114
86538,2020-12-06,9,43,148,191
86539,2020-12-06,10,93,170,263
86540,2020-12-06,11,108,202,310
86541,2020-12-06,12,159,237,396
86542,2020-12-06,13,194,241,435
86543,2020-12-06,14,246,288,534
86544,2020-12-06,15,207,266,473
86545,2020-12-06,16,172,235,407
86546,2020-12-06,17,82,210,292
86547,2020-12-06,18,56,138,194
86548,2020-12-06,19,34,88,122
86549,2020-12-06,20,30,64,94
86550,2020-12-06,21,21,47,68
86551,2020-12-06,22,21,29,50
86552,2020-12-06,23,12,20,32
86553,2020-12-07,0,5,4,9
86554,2020-12-07,1,4,4,8
86555,2020-12-07,2,0,3,3
86556,2020-12-07,3,4,0,4
86557,2020-12-07,4,6,5,11
86558,2020-12-07,5,3,17,20
86559,2020-12-07,6,13,52,65
86560,2020-12-07,7,29,106,135
86561,2020-12-07,8,33,155,188
86562,2020-12-07,9,40,129,169
86563,2020-12-07,10,44,111,155
86564,2020-12-07,11,43,139,182
86565,2020-12-07,12,43,129,172
86566,2020-12-07,13,64,156,220
86567,2020-12-07,14,62,161,223
86568,2020-12-07,15,85,166,251
86569,2020-12-07,16,68,216,284
86570,2020-12-07,17,52,218,270
86571,2020-12-07,18,62,199,261
86572,2020-12-07,19,34,138,172
86573,2020-12-07,20,26,73,99
86574,2020-12-07,21,21,45,66
86575,2020-12-07,22,19,26,45
86576,2020-12-07,23,12,14,26
86577,2020-12-08,0,5,7,12
86578,2020-12-08,1,6,2,8
86579,2020-12-08,2,3,5,8
86580,2020-12-08,3,1,2,3
86581,2020-12-08,4,5,6,11
86582,2020-12-08,5,9,23,32
86583,2020-12-08,6,12,60,72
86584,2020-12-08,7,36,110,146
86585,2020-12-08,8,52,188,240
86586,2020-12-08,9,28,119,147
86587,2020-12-08,10,30,122,152
86588,2020-12-08,11,49,141,190
86589,2020-12-08,12,55,171,226
86590,2020-12-08,13,56,155,211
86591,2020-12-08,14,87,145,232
86592,2020-12-08,15,75,173,248
86593,2020-12-08,16,77,191,268
86594,2020-12-08,17,65,250,315
86595,2020-12-08,18,76,237,313
86596,2020-12-08,19,58,132,190
86597,2020-12-08,20,24,65,89
86598,2020-12-08,21,24,58,82
86599,2020-12-08,22,25,36,61
86600,2020-12-08,23,15,26,41
86601,2020-12-09,0,7,7,14
86602,2020-12-09,1,6,6,12
86603,2020-12-09,2,1,0,1
86604,2020-12-09,3,3,5,8
86605,2020-12-09,4,4,5,9
86606,2020-12-09,5,2,21,23
86607,2020-12-09,6,13,54,67
86608,2020-12-09,7,18,128,146
86609,2020-12-09,8,47,154,201
86610,2020-12-09,9,42,119,161
86611,2020-12-09,10,30,94,124
86612,2020-12-09,11,63,123,186
86613,2020-12-09,12,67,145,212
86614,2020-12-09,13,62,132,194
86615,2020-12-09,14,64,164,228
86616,2020-12-09,15,75,169,244
86617,2020-12-09,16,93,224,317
86618,2020-12-09,17,96,257,353
86619,2020-12-09,18,64,191,255
86620,2020-12-09,19,53,131,184
86621,2020-12-09,20,42,99,141
86622,2020-12-09,21,37,69,106
86623,2020-12-09,22,25,36,61
86624,2020-12-09,23,18,21,39
86625,2020-12-10,0,7,8,15
86626,2020-12-10,1,5,6,11
86627,2020-12-10,2,2,1,3
86628,2020-12-10,3,1,2,3
86629,2020-12-10,4,8,4,12
86630,2020-12-10,5,8,28,36
86631,2020-12-10,6,6,64,70
86632,2020-12-10,7,30,147,177
86633,2020-12-10,8,45,183,228
86634,2020-12-10,9,50,154,204
86635,2020-12-10,10,55,122,177
86636,2020-12-10,11,63,139,202
86637,2020-12-10,12,83,185,268
86638,2020-12-10,13,86,173,259
86639,2020-12-10,14,102,177,279
86640,2020-12-10,15,123,225,348
86641,2020-12-10,16,94,244,338
86642,2020-12-10,17,90,284,374
86643,2020-12-10,18,100,225,325
86644,2020-12-10,19,73,152,225
86645,2020-12-10,20,53,107,160
86646,2020-12-10,21,37,60,97
86647,2020-12-10,22,37,51,88
86648,2020-12-10,23,19,24,43
86649,2020-12-11,0,7,16,23
86650,2020-12-11,1,3,5,8
86651,2020-12-11,2,3,2,5
86652,2020-12-11,3,1,1,2
86653,2020-12-11,4,4,5,9
86654,2020-12-11,5,7,17,24
86655,2020-12-11,6,11,54,65
86656,2020-12-11,7,34,132,166
86657,2020-12-11,8,34,144,178
86658,2020-12-11,9,54,153,207
86659,2020-12-11,10,67,140,207
86660,2020-12-11,11,93,160,253
86661,2020-12-11,12,102,209,311
86662,2020-12-11,13,165,246,411
86663,2020-12-11,14,169,271,440
86664,2020-12-11,15,202,274,476
86665,2020-12-11,16,218,347,565
86666,2020-12-11,17,124,351,475
86667,2020-12-11,18,133,257,390
86668,2020-12-11,19,99,199,298
86669,2020-12-11,20,75,121,196
86670,2020-12-11,21,70,66,136
86671,2020-12-11,22,50,60,110
86672,2020-12-11,23,57,43,100
86673,2020-12-12,0,37,41,78
86674,2020-12-12,1,11,22,33
86675,2020-12-12,2,6,9,15
86676,2020-12-12,3,7,6,13
86677,2020-12-12,4,2,3,5
86678,2020-12-12,5,5,7,12
86679,2020-12-12,6,17,24,41
86680,2020-12-12,7,28,60,88
86681,2020-12-12,8,72,111,183
86682,2020-12-12,9,108,158,266
86683,2020-12-12,10,162,224,386
86684,2020-12-12,11,223,303,526
86685,2020-12-12,12,325,351,676
86686,2020-12-12,13,392,362,754
86687,2020-12-12,14,476,405,881
86688,2020-12-12,15,445,448,893
86689,2020-12-12,16,412,391,803
86690,2020-12-12,17,275,261,536
86691,2020-12-12,18,136,199,335
86692,2020-12-12,19,125,165,290
86693,2020-12-12,20,114,110,224
86694,2020-12-12,21,86,70,156
86695,2020-12-12,22,48,67,115
86696,2020-12-12,23,54,42,96
86697,2020-12-13,0,39,25,64
86698,2020-12-13,1,17,27,44
86699,2020-12-13,2,13,9,22
86700,2020-12-13,3,13,10,23
86701,2020-12-13,4,5,5,10
86702,2020-12-13,5,6,7,13
86703,2020-12-13,6,12,24,36
86704,2020-12-13,7,26,60,86
86705,2020-12-13,8,39,82,121
86706,2020-12-13,9,77,135,212
86707,2020-12-13,10,152,232,384
86708,2020-12-13,11,252,317,569
86709,2020-12-13,12,301,363,664
86710,2020-12-13,13,411,364,775
86711,2020-12-13,14,433,398,831
86712,2020-12-13,15,404,391,795
86713,2020-12-13,16,283,365,648
86714,2020-12-13,17,158,216,374
86715,2020-12-13,18,95,147,242
86716,2020-12-13,19,71,91,162
86717,2020-12-13,20,49,65,114
86718,2020-12-13,21,33,49,82
86719,2020-12-13,22,33,37,70
86720,2020-12-13,23,25,28,53
86721,2020-12-14,0,13,11,24
86722,2020-12-14,1,8,7,15
86723,2020-12-14,2,4,3,7
86724,2020-12-14,3,6,0,6
86725,2020-12-14,4,3,11,14
86726,2020-12-14,5,2,13,15
86727,2020-12-14,6,4,23,27
86728,2020-12-14,7,7,28,35
86729,2020-12-14,8,6,32,38
86730,2020-12-14,9,4,25,29
86731,2020-12-14,10,2,11,13
86732,2020-12-14,11,6,13,19
86733,2020-12-14,12,13,31,44
86734,2020-12-14,13,11,37,48
86735,2020-12-14,14,26,46,72
86736,2020-12-14,15,40,96,136
86737,2020-12-14,16,46,166,212
86738,2020-12-14,17,43,194,237
86739,2020-12-14,18,40,181,221
86740,2020-12-14,19,46,146,192
86741,2020-12-14,20,28,64,92
86742,2020-12-14,21,23,45,68
86743,2020-12-14,22,25,26,51
86744,2020-12-14,23,15,19,34
86745,2020-12-15,0,2,13,15
86746,2020-12-15,1,3,4,7
86747,2020-12-15,2,1,0,1
86748,2020-12-15,3,0,2,2
86749,2020-12-15,4,2,5,7
86750,2020-12-15,5,7,25,32
86751,2020-12-15,6,16,68,84
86752,2020-12-15,7,29,114,143
86753,2020-12-15,8,54,186,240
86754,2020-12-15,9,75,143,218
86755,2020-12-15,10,46,117,163
86756,2020-12-15,11,43,160,203
86757,2020-12-15,12,206,422,628
86758,2020-12-15,13,140,295,435
86759,2020-12-15,14,76,171,247
86760,2020-12-15,15,109,188,297
86761,2020-12-15,16,85,221,306
86762,2020-12-15,17,82,262,344
86763,2020-12-15,18,58,196,254
86764,2020-12-15,19,56,143,199
86765,2020-12-15,20,34,85,119
86766,2020-12-15,21,20,59,79
86767,2020-12-15,22,12,39,51
86768,2020-12-15,23,12,20,32
86769,2020-12-16,0,10,9,19
86770,2020-12-16,1,1,0,1
86771,2020-12-16,2,1,3,4
86772,2020-12-16,3,1,1,2
86773,2020-12-16,4,4,5,9
86774,2020-12-16,5,2,14,16
86775,2020-12-16,6,18,44,62
86776,2020-12-16,7,36,114,150
86777,2020-12-16,8,31,123,154
86778,2020-12-16,9,35,97,132
86779,2020-12-16,10,25,73,98
86780,2020-12-16,11,20,64,84
86781,2020-12-16,12,11,57,68
86782,2020-12-16,13,9,31,40
86783,2020-12-16,14,17,18,35
86784,2020-12-16,15,16,28,44
86785,2020-12-16,16,16,28,44
86786,2020-12-16,17,15,48,63
86787,2020-12-16,18,13,41,54
86788,2020-12-16,19,13,23,36
86789,2020-12-16,20,14,23,37
86790,2020-12-16,21,5,18,23
86791,2020-12-16,22,7,11,18
86792,2020-12-16,23,9,6,15
86793,2020-12-17,0,3,2,5
86794,2020-12-17,1,1,4,5
86795,2020-12-17,2,1,1,2
86796,2020-12-17,3,1,0,1
86797,2020-12-17,4,5,4,9
86798,2020-12-17,5,6,7,13
86799,2020-12-17,6,10,38,48
86800,2020-12-17,7,10,82,92
86801,2020-12-17,8,32,95,127
86802,2020-12-17,9,29,92,121
86803,2020-12-17,10,35,84,119
86804,2020-12-17,11,45,114,159
86805,2020-12-17,12,62,144,206
86806,2020-12-17,13,65,158,223
86807,2020-12-17,14,88,120,208
86808,2020-12-17,15,76,143,219
86809,2020-12-17,16,79,188,267
86810,2020-12-17,17,68,199,267
86811,2020-12-17,18,59,162,221
86812,2020-12-17,19,37,107,144
86813,2020-12-17,20,31,76,107
86814,2020-12-17,21,23,38,61
86815,2020-12-17,22,24,26,50
86816,2020-12-17,23,14,18,32
86817,2020-12-18,0,7,9,16
86818,2020-12-18,1,2,0,2
86819,2020-12-18,2,7,5,12
86820,2020-12-18,4,4,7,11
86821,2020-12-18,5,8,17,25
86822,2020-12-18,6,7,50,57
86823,2020-12-18,7,30,100,130
86824,2020-12-18,8,30,119,149
86825,2020-12-18,9,28,103,131
86826,2020-12-18,10,36,98,134
86827,2020-12-18,11,46,129,175
86828,2020-12-18,12,60,173,233
86829,2020-12-18,13,66,166,232
86830,2020-12-18,14,91,164,255
86831,2020-12-18,15,99,194,293
86832,2020-12-18,16,112,204,316
86833,2020-12-18,17,72,198,270
86834,2020-12-18,18,75,181,256
86835,2020-12-18,19,62,137,199
86836,2020-12-18,20,46,78,124
86837,2020-12-18,21,29,50,79
86838,2020-12-18,22,24,38,62
86839,2020-12-18,23,24,24,48
86840,2020-12-19,0,10,29,39
86841,2020-12-19,1,7,8,15
86842,2020-12-19,2,4,5,9
86843,2020-12-19,3,3,4,7
86844,2020-12-19,4,5,5,10
86845,2020-12-19,5,4,7,11
86846,2020-12-19,6,7,16,23
86847,2020-12-19,7,20,49,69
86848,2020-12-19,8,24,70,94
86849,2020-12-19,9,42,125,167
86850,2020-12-19,10,68,163,231
86851,2020-12-19,11,73,194,267
86852,2020-12-19,12,117,213,330
86853,2020-12-19,13,134,248,382
86854,2020-12-19,14,158,230,388
86855,2020-12-19,15,146,232,378
86856,2020-12-19,16,102,221,323
86857,2020-12-19,17,72,174,246
86858,2020-12-19,18,47,119,166
86859,2020-12-19,19,51,92,143
86860,2020-12-19,20,45,61,106
86861,2020-12-19,21,38,61,99
86862,2020-12-19,22,33,41,74
86863,2020-12-19,23,21,27,48
86864,2020-12-20,0,12,15,27
86865,2020-12-20,1,3,7,10
86866,2020-12-20,2,7,1,8
86867,2020-12-20,3,3,9,12
86868,2020-12-20,4,2,6,8
86869,2020-12-20,5,3,5,8
86870,2020-12-20,6,8,18,26
86871,2020-12-20,7,19,23,42
86872,2020-12-20,8,30,63,93
86873,2020-12-20,9,32,95,127
86874,2020-12-20,10,42,123,165
86875,2020-12-20,11,88,181,269
86876,2020-12-20,12,104,214,318
86877,2020-12-20,13,106,230,336
86878,2020-12-20,14,133,244,377
86879,2020-12-20,15,129,251,380
86880,2020-12-20,16,93,202,295
86881,2020-12-20,17,56,193,249
86882,2020-12-20,18,47,136,183
86883,2020-12-20,19,30,100,130
86884,2020-12-20,20,32,64,96
86885,2020-12-20,21,28,41,69
86886,2020-12-20,22,21,38,59
86887,2020-12-20,23,23,17,40
86888,2020-12-21,0,9,16,25
86889,2020-12-21,1,3,9,12
86890,2020-12-21,2,4,7,11
86891,2020-12-21,3,5,3,8
86892,2020-12-21,4,1,9,10
86893,2020-12-21,5,3,25,28
86894,2020-12-21,6,6,51,57
86895,2020-12-21,7,19,102,121
86896,2020-12-21,8,26,132,158
86897,2020-12-21,9,28,124,152
86898,2020-12-21,10,42,116,158
86899,2020-12-21,11,83,158,241
86900,2020-12-21,12,103,161,264
86901,2020-12-21,13,93,160,253
86902,2020-12-21,14,111,158,269
86903,2020-12-21,15,113,174,287
86904,2020-12-21,16,111,220,331
86905,2020-12-21,17,94,235,329
86906,2020-12-21,18,88,179,267
86907,2020-12-21,19,41,121,162
86908,2020-12-21,20,50,67,117
86909,2020-12-21,21,23,37,60
86910,2020-12-21,22,15,25,40
86911,2020-12-21,23,29,20,49
86912,2020-12-22,0,10,12,22
86913,2020-12-22,1,10,4,14
86914,2020-12-22,2,10,1,11
86915,2020-12-22,3,0,2,2
86916,2020-12-22,4,8,5,13
86917,2020-12-22,5,4,18,22
86918,2020-12-22,6,7,65,72
86919,2020-12-22,7,29,100,129
86920,2020-12-22,8,30,118,148
86921,2020-12-22,9,53,105,158
86922,2020-12-22,10,53,102,155
86923,2020-12-22,11,61,127,188
86924,2020-12-22,12,88,162,250
86925,2020-12-22,13,93,165,258
86926,2020-12-22,14,97,183,280
86927,2020-12-22,15,131,191,322
86928,2020-12-22,16,89,224,313
86929,2020-12-22,17,70,187,257
86930,2020-12-22,18,58,159,217
86931,2020-12-22,19,55,125,180
86932,2020-12-22,20,24,91,115
86933,2020-12-22,21,17,46,63
86934,2020-12-22,22,19,36,55
86935,2020-12-22,23,26,18,44
86936,2020-12-23,0,25,7,32
86937,2020-12-23,1,16,3,19
86938,2020-12-23,2,8,2,10
86939,2020-12-23,3,4,1,5
86940,2020-12-23,4,5,6,11
86941,2020-12-23,5,7,16,23
86942,2020-12-23,6,12,38,50
86943,2020-12-23,7,18,81,99
86944,2020-12-23,8,33,118,151
86945,2020-12-23,9,30,94,124
86946,2020-12-23,10,63,107,170
86947,2020-12-23,11,65,181,246
86948,2020-12-23,12,77,202,279
86949,2020-12-23,13,92,199,291
86950,2020-12-23,14,122,201,323
86951,2020-12-23,15,118,197,315
86952,2020-12-23,16,102,222,324
86953,2020-12-23,17,95,213,308
86954,2020-12-23,18,52,140,192
86955,2020-12-23,19,59,95,154
86956,2020-12-23,20,19,69,88
86957,2020-12-23,21,17,46,63
86958,2020-12-23,22,28,28,56
86959,2020-12-23,23,14,14,28
86960,2020-12-24,0,12,13,25
86961,2020-12-24,1,10,8,18
86962,2020-12-24,2,5,2,7
86963,2020-12-24,3,6,2,8
86964,2020-12-24,4,4,5,9
86965,2020-12-24,5,5,14,19
86966,2020-12-24,6,6,30,36
86967,2020-12-24,7,10,65,75
86968,2020-12-24,8,15,56,71
86969,2020-12-24,9,19,71,90
86970,2020-12-24,10,24,76,100
86971,2020-12-24,11,27,70,97
86972,2020-12-24,12,29,104,133
86973,2020-12-24,13,35,88,123
86974,2020-12-24,14,33,77,110
86975,2020-12-24,15,25,53,78
86976,2020-12-24,16,14,35,49
86977,2020-12-24,17,20,33,53
86978,2020-12-24,18,14,41,55
86979,2020-12-24,19,4,17,21
86980,2020-12-24,20,5,11,16
86981,2020-12-24,21,1,15,16
86982,2020-12-24,22,17,12,29
86983,2020-12-24,23,1,9,10
86984,2020-12-25,0,3,8,11
86985,2020-12-25,1,5,5,10
86986,2020-12-25,2,3,3,6
86987,2020-12-25,3,1,4,5
86988,2020-12-25,4,1,1,2
86989,2020-12-25,5,1,3,4
86990,2020-12-25,6,4,8,12
86991,2020-12-25,7,3,22,25
86992,2020-12-25,8,10,24,34
86993,2020-12-25,9,13,27,40
86994,2020-12-25,10,14,30,44
86995,2020-12-25,11,21,55,76
86996,2020-12-25,12,36,58,94
86997,2020-12-25,13,50,99,149
86998,2020-12-25,14,37,79,116
86999,2020-12-25,15,57,76,133
87000,2020-12-25,16,41,66,107
87001,2020-12-25,17,16,36,52
87002,2020-12-25,18,13,42,55
87003,2020-12-25,19,5,31,36
87004,2020-12-25,20,14,15,29
87005,2020-12-25,21,9,21,30
87006,2020-12-25,22,7,13,20
87007,2020-12-25,23,24,11,35
87008,2020-12-26,0,17,7,24
87009,2020-12-26,1,9,7,16
87010,2020-12-26,2,7,5,12
87011,2020-12-26,3,4,1,5
87012,2020-12-26,4,3,1,4
87013,2020-12-26,5,4,3,7
87014,2020-12-26,6,6,19,25
87015,2020-12-26,7,8,22,30
87016,2020-12-26,8,10,36,46
87017,2020-12-26,9,20,55,75
87018,2020-12-26,10,29,63,92
87019,2020-12-26,11,40,103,143
87020,2020-12-26,12,58,101,159
87021,2020-12-26,13,42,116,158
87022,2020-12-26,14,67,123,190
87023,2020-12-26,15,86,113,199
87024,2020-12-26,16,67,106,173
87025,2020-12-26,17,47,93,140
87026,2020-12-26,18,29,69,98
87027,2020-12-26,19,21,70,91
87028,2020-12-26,20,20,25,45
87029,2020-12-26,21,21,23,44
87030,2020-12-26,22,21,21,42
87031,2020-12-26,23,9,17,26
87032,2020-12-27,0,4,11,15
87033,2020-12-27,1,6,7,13
87034,2020-12-27,2,3,1,4
87035,2020-12-27,3,2,0,2
87036,2020-12-27,4,3,3,6
87037,2020-12-27,5,6,2,8
87038,2020-12-27,6,7,14,21
87039,2020-12-27,7,15,12,27
87040,2020-12-27,8,13,38,51
87041,2020-12-27,9,25,72,97
87042,2020-12-27,10,41,103,144
87043,2020-12-27,11,100,124,224
87044,2020-12-27,12,81,164,245
87045,2020-12-27,13,150,169,319
87046,2020-12-27,14,122,193,315
87047,2020-12-27,15,117,182,299
87048,2020-12-27,16,109,161,270
87049,2020-12-27,17,55,132,187
87050,2020-12-27,18,32,87,119
87051,2020-12-27,19,24,43,67
87052,2020-12-27,20,27,36,63
87053,2020-12-27,21,13,30,43
87054,2020-12-27,22,14,19,33
87055,2020-12-27,23,12,11,23
87056,2020-12-28,0,5,9,14
87057,2020-12-28,1,2,4,6
87058,2020-12-28,2,0,1,1
87059,2020-12-28,3,2,2,4
87060,2020-12-28,4,8,6,14
87061,2020-12-28,5,8,12,20
87062,2020-12-28,6,13,35,48
87063,2020-12-28,7,13,74,87
87064,2020-12-28,8,23,104,127
87065,2020-12-28,9,25,90,115
87066,2020-12-28,10,57,105,162
87067,2020-12-28,11,79,155,234
87068,2020-12-28,12,122,170,292
87069,2020-12-28,13,176,203,379
87070,2020-12-28,14,186,200,386
87071,2020-12-28,15,208,201,409
87072,2020-12-28,16,170,247,417
87073,2020-12-28,17,101,207,308
87074,2020-12-28,18,50,152,202
87075,2020-12-28,19,37,90,127
87076,2020-12-28,20,24,50,74
87077,2020-12-28,21,25,37,62
87078,2020-12-28,22,18,26,44
87079,2020-12-28,23,11,16,27
87080,2020-12-29,0,8,12,20
87081,2020-12-29,1,6,7,13
87082,2020-12-29,2,0,5,5
87083,2020-12-29,3,0,3,3
87084,2020-12-29,4,6,5,11
87085,2020-12-29,5,3,10,13
87086,2020-12-29,6,9,42,51
87087,2020-12-29,7,16,72,88
87088,2020-12-29,8,25,117,142
87089,2020-12-29,9,39,91,130
87090,2020-12-29,10,68,107,175
87091,2020-12-29,11,87,116,203
87092,2020-12-29,12,99,138,237
87093,2020-12-29,13,139,148,287
87094,2020-12-29,14,158,163,321
87095,2020-12-29,15,102,188,290
87096,2020-12-29,16,102,205,307
87097,2020-12-29,17,55,178,233
87098,2020-12-29,18,47,137,184
87099,2020-12-29,19,23,99,122
87100,2020-12-29,20,22,64,86
87101,2020-12-29,21,18,40,58
87102,2020-12-29,22,16,20,36
87103,2020-12-29,23,20,17,37
87104,2020-12-30,0,6,6,12
87105,2020-12-30,1,3,10,13
87106,2020-12-30,2,0,3,3
87107,2020-12-30,3,3,1,4
87108,2020-12-30,4,3,6,9
87109,2020-12-30,5,4,11,15
87110,2020-12-30,6,15,36,51
87111,2020-12-30,7,14,80,94
87112,2020-12-30,8,22,94,116
87113,2020-12-30,9,54,118,172
87114,2020-12-30,10,51,95,146
87115,2020-12-30,11,70,133,203
87116,2020-12-30,12,114,177,291
87117,2020-12-30,13,99,192,291
87118,2020-12-30,14,147,185,332
87119,2020-12-30,15,130,206,336
87120,2020-12-30,16,123,198,321
87121,2020-12-30,17,70,187,257
87122,2020-12-30,18,41,148,189
87123,2020-12-30,19,36,99,135
87124,2020-12-30,20,23,57,80
87125,2020-12-30,21,21,52,73
87126,2020-12-30,22,18,36,54
87127,2020-12-30,23,12,19,31
87128,2020-12-31,0,14,14,28
87129,2020-12-31,1,9,6,15
87130,2020-12-31,2,2,4,6
87131,2020-12-31,3,2,4,6
87132,2020-12-31,4,3,7,10
87133,2020-12-31,5,6,11,17
87134,2020-12-31,6,16,46,62
87135,2020-12-31,7,16,61,77
87136,2020-12-31,8,26,97,123
87137,2020-12-31,9,44,121,165
87138,2020-12-31,10,82,127,209
87139,2020-12-31,11,103,163,266
87140,2020-12-31,12,161,195,356
87141,2020-12-31,13,128,206,334
87142,2020-12-31,14,156,212,368
87143,2020-12-31,15,100,201,301
87144,2020-12-31,16,76,140,216
87145,2020-12-31,17,64,145,209
87146,2020-12-31,18,41,102,143
87147,2020-12-31,19,44,68,112
87148,2020-12-31,20,29,71,100
87149,2020-12-31,21,37,29,66
87150,2020-12-31,22,25,31,56
87151,2020-12-31,23,32,21,53
87152,2021-01-01,0,20,26,46
87153,2021-01-01,1,23,23,46
87154,2021-01-01,2,20,28,48
87155,2021-01-01,3,9,7,16
87156,2021-01-01,4,7,5,12
87157,2021-01-01,5,11,3,14
87158,2021-01-01,6,8,18,26
87159,2021-01-01,7,10,17,27
87160,2021-01-01,8,22,33,55
87161,2021-01-01,9,22,54,76
87162,2021-01-01,10,29,56,85
87163,2021-01-01,11,16,40,56
87164,2021-01-01,12,21,38,59
87165,2021-01-01,13,30,35,65
87166,2021-01-01,14,39,54,93
87167,2021-01-01,15,24,40,64
87168,2021-01-01,16,14,32,46
87169,2021-01-01,17,6,13,19
87170,2021-01-01,18,3,12,15
87171,2021-01-01,19,2,7,9
87172,2021-01-01,20,6,10,16
87173,2021-01-01,21,4,10,14
87174,2021-01-01,22,12,9,21
87175,2021-01-01,23,13,20,33
87176,2021-01-02,0,4,8,12
87177,2021-01-02,1,4,10,14
87178,2021-01-02,2,1,0,1
87179,2021-01-02,3,1,1,2
87180,2021-01-02,4,4,2,6
87181,2021-01-02,5,2,4,6
87182,2021-01-02,6,8,18,26
87183,2021-01-02,7,15,38,53
87184,2021-01-02,8,31,53,84
87185,2021-01-02,9,63,120,183
87186,2021-01-02,10,106,151,257
87187,2021-01-02,11,201,214,415
87188,2021-01-02,12,349,283,632
87189,2021-01-02,13,401,342,743
87190,2021-01-02,14,499,331,830
87191,2021-01-02,15,426,330,756
87192,2021-01-02,16,281,309,590
87193,2021-01-02,17,125,200,325
87194,2021-01-02,18,112,127,239
87195,2021-01-02,19,65,106,171
87196,2021-01-02,20,53,73,126
87197,2021-01-02,21,41,50,91
87198,2021-01-02,22,46,39,85
87199,2021-01-02,23,36,33,69
87200,2021-01-03,0,16,25,41
87201,2021-01-03,1,10,4,14
87202,2021-01-03,2,5,3,8
87203,2021-01-03,3,6,5,11
87204,2021-01-03,4,1,0,1
87205,2021-01-03,5,2,2,4
87206,2021-01-03,6,3,12,15
87207,2021-01-03,7,5,11,16
87208,2021-01-03,8,11,39,50
87209,2021-01-03,9,16,62,78
87210,2021-01-03,10,36,112,148
87211,2021-01-03,11,44,132,176
87212,2021-01-03,12,56,119,175
87213,2021-01-03,13,59,119,178
87214,2021-01-03,14,23,70,93
87215,2021-01-03,15,34,57,91
87216,2021-01-03,16,27,70,97
87217,2021-01-03,17,20,65,85
87218,2021-01-03,18,28,78,106
87219,2021-01-03,19,28,56,84
87220,2021-01-03,20,21,38,59
87221,2021-01-03,21,16,29,45
87222,2021-01-03,22,16,15,31
87223,2021-01-03,23,12,10,22
87224,2021-01-04,0,10,5,15
87225,2021-01-04,1,4,2,6
87226,2021-01-04,2,0,1,1
87227,2021-01-04,3,3,1,4
87228,2021-01-04,4,3,7,10
87229,2021-01-04,5,7,22,29
87230,2021-01-04,6,7,55,62
87231,2021-01-04,7,26,133,159
87232,2021-01-04,8,34,138,172
87233,2021-01-04,9,29,91,120
87234,2021-01-04,10,39,85,124
87235,2021-01-04,11,39,118,157
87236,2021-01-04,12,91,158,249
87237,2021-01-04,13,78,133,211
87238,2021-01-04,14,90,139,229
87239,2021-01-04,15,66,163,229
87240,2021-01-04,16,89,203,292
87241,2021-01-04,17,82,209,291
87242,2021-01-04,18,68,161,229
87243,2021-01-04,19,46,95,141
87244,2021-01-04,20,34,59,93
87245,2021-01-04,21,27,47,74
87246,2021-01-04,22,13,30,43
87247,2021-01-04,23,22,19,41
87248,2021-01-05,0,8,6,14
87249,2021-01-05,1,4,3,7
87250,2021-01-05,2,3,0,3
87251,2021-01-05,3,3,1,4
87252,2021-01-05,4,5,9,14
87253,2021-01-05,5,2,25,27
87254,2021-01-05,6,7,67,74
87255,2021-01-05,7,15,108,123
87256,2021-01-05,8,36,170,206
87257,2021-01-05,9,44,92,136
87258,2021-01-05,10,48,87,135
87259,2021-01-05,11,80,126,206
87260,2021-01-05,12,95,129,224
87261,2021-01-05,13,79,159,238
87262,2021-01-05,14,104,146,250
87263,2021-01-05,15,118,146,264
87264,2021-01-05,16,78,131,209
87265,2021-01-05,17,73,181,254
87266,2021-01-05,18,54,149,203
87267,2021-01-05,19,56,103,159
87268,2021-01-05,20,50,64,114
87269,2021-01-05,21,31,49,80
87270,2021-01-05,22,43,35,78
87271,2021-01-05,23,21,18,39
87272,2021-01-06,0,18,20,38
87273,2021-01-06,1,5,7,12
87274,2021-01-06,2,3,7,10
87275,2021-01-06,3,7,2,9
87276,2021-01-06,4,3,7,10
87277,2021-01-06,5,19,19,38
87278,2021-01-06,6,30,51,81
87279,2021-01-06,7,65,115,180
87280,2021-01-06,8,73,126,199
87281,2021-01-06,9,56,97,153
87282,2021-01-06,10,111,119,230
87283,2021-01-06,11,86,123,209
87284,2021-01-06,12,101,141,242
87285,2021-01-06,13,111,130,241
87286,2021-01-06,14,137,157,294
87287,2021-01-06,15,164,206,370
87288,2021-01-06,16,131,175,306
87289,2021-01-06,17,113,144,257
87290,2021-01-06,18,44,49,93
87291,2021-01-06,19,17,17,34
87292,2021-01-06,20,26,14,40
87293,2021-01-06,21,15,12,27
87294,2021-01-06,22,9,6,15
87295,2021-01-06,23,15,9,24
87296,2021-01-07,0,10,2,12
87297,2021-01-07,1,4,3,7
87298,2021-01-07,2,0,3,3
87299,2021-01-07,3,4,1,5
87300,2021-01-07,4,5,2,7
87301,2021-01-07,5,13,11,24
87302,2021-01-07,6,16,39,55
87303,2021-01-07,7,16,80,96
87304,2021-01-07,8,27,120,147
87305,2021-01-07,9,39,111,150
87306,2021-01-07,10,42,88,130
87307,2021-01-07,11,115,108,223
87308,2021-01-07,12,117,152,269
87309,2021-01-07,13,120,120,240
87310,2021-01-07,14,128,157,285
87311,2021-01-07,15,119,175,294
87312,2021-01-07,16,85,225,310
87313,2021-01-07,17,81,222,303
87314,2021-01-07,18,63,208,271
87315,2021-01-07,19,47,127,174
87316,2021-01-07,20,36,79,115
87317,2021-01-07,21,39,49,88
87318,2021-01-07,22,28,44,72
87319,2021-01-07,23,13,17,30
87320,2021-01-08,0,4,11,15
87321,2021-01-08,1,1,9,10
87322,2021-01-08,2,1,5,6
87323,2021-01-08,3,1,1,2
87324,2021-01-08,4,3,6,9
87325,2021-01-08,5,2,16,18
87326,2021-01-08,6,15,56,71
87327,2021-01-08,7,17,121,138
87328,2021-01-08,8,39,135,174
87329,2021-01-08,9,45,85,130
87330,2021-01-08,10,45,90,135
87331,2021-01-08,11,42,130,172
87332,2021-01-08,12,61,134,195
87333,2021-01-08,13,48,164,212
87334,2021-01-08,14,64,144,208
87335,2021-01-08,15,65,196,261
87336,2021-01-08,16,94,219,313
87337,2021-01-08,17,57,210,267
87338,2021-01-08,18,45,172,217
87339,2021-01-08,19,47,93,140
87340,2021-01-08,20,27,87,114
87341,2021-01-08,21,17,35,52
87342,2021-01-08,22,27,50,77
87343,2021-01-08,23,17,33,50
87344,2021-01-09,0,13,9,22
87345,2021-01-09,1,6,4,10
87346,2021-01-09,2,9,5,14
87347,2021-01-09,3,11,2,13
87348,2021-01-09,4,2,4,6
87349,2021-01-09,5,5,8,13
87350,2021-01-09,6,8,23,31
87351,2021-01-09,7,15,43,58
87352,2021-01-09,8,26,54,80
87353,2021-01-09,9,47,109,156
87354,2021-01-09,10,66,148,214
87355,2021-01-09,11,104,175,279
87356,2021-01-09,12,144,231,375
87357,2021-01-09,13,173,266,439
87358,2021-01-09,14,196,263,459
87359,2021-01-09,15,199,277,476
87360,2021-01-09,16,181,258,439
87361,2021-01-09,17,78,209,287
87362,2021-01-09,18,67,163,230
87363,2021-01-09,19,41,115,156
87364,2021-01-09,20,29,69,98
87365,2021-01-09,21,22,62,84
87366,2021-01-09,22,27,51,78
87367,2021-01-09,23,21,34,55
87368,2021-01-10,0,16,25,41
87369,2021-01-10,1,9,18,27
87370,2021-01-10,2,3,15,18
87371,2021-01-10,3,6,4,10
87372,2021-01-10,4,1,3,4
87373,2021-01-10,5,4,8,12
87374,2021-01-10,6,6,14,20
87375,2021-01-10,7,8,23,31
87376,2021-01-10,8,15,69,84
87377,2021-01-10,9,27,126,153
87378,2021-01-10,10,74,185,259
87379,2021-01-10,11,116,195,311
87380,2021-01-10,12,163,261,424
87381,2021-01-10,13,214,282,496
87382,2021-01-10,14,207,275,482
87383,2021-01-10,15,199,273,472
87384,2021-01-10,16,163,243,406
87385,2021-01-10,17,92,172,264
87386,2021-01-10,18,46,114,160
87387,2021-01-10,19,47,84,131
87388,2021-01-10,20,28,54,82
87389,2021-01-10,21,13,35,48
87390,2021-01-10,22,15,29,44
87391,2021-01-10,23,7,15,22
87392,2021-01-11,0,11,12,23
87393,2021-01-11,1,2,6,8
87394,2021-01-11,2,1,1,2
87395,2021-01-11,3,3,0,3
87396,2021-01-11,4,3,4,7
87397,2021-01-11,5,4,23,27
87398,2021-01-11,6,7,55,62
87399,2021-01-11,7,18,108,126
87400,2021-01-11,8,39,164,203
87401,2021-01-11,9,37,124,161
87402,2021-01-11,10,29,99,128
87403,2021-01-11,11,33,116,149
87404,2021-01-11,12,36,124,160
87405,2021-01-11,13,42,122,164
87406,2021-01-11,14,45,142,187
87407,2021-01-11,15,54,176,230
87408,2021-01-11,16,75,175,250
87409,2021-01-11,17,63,242,305
87410,2021-01-11,18,56,195,251
87411,2021-01-11,19,40,142,182
87412,2021-01-11,20,33,76,109
87413,2021-01-11,21,21,42,63
87414,2021-01-11,22,16,24,40
87415,2021-01-11,23,9,22,31
87416,2021-01-12,0,5,9,14
87417,2021-01-12,1,6,5,11
87418,2021-01-12,2,1,3,4
87419,2021-01-12,3,3,3,6
87420,2021-01-12,4,1,8,9
87421,2021-01-12,5,9,23,32
87422,2021-01-12,6,7,76,83
87423,2021-01-12,7,23,126,149
87424,2021-01-12,8,44,185,229
87425,2021-01-12,9,37,153,190
87426,2021-01-12,10,36,123,159
87427,2021-01-12,11,54,153,207
87428,2021-01-12,12,70,180,250
87429,2021-01-12,13,59,158,217
87430,2021-01-12,14,64,200,264
87431,2021-01-12,15,92,180,272
87432,2021-01-12,16,111,257,368
87433,2021-01-12,17,95,321,416
87434,2021-01-12,18,64,207,271
87435,2021-01-12,19,52,154,206
87436,2021-01-12,20,36,87,123
87437,2021-01-12,21,27,67,94
87438,2021-01-12,22,15,26,41
87439,2021-01-12,23,8,21,29
87440,2021-01-13,0,6,9,15
87441,2021-01-13,1,4,3,7
87442,2021-01-13,2,1,0,1
87443,2021-01-13,3,3,2,5
87444,2021-01-13,4,3,5,8
87445,2021-01-13,5,11,18,29
87446,2021-01-13,6,13,73,86
87447,2021-01-13,7,17,127,144
87448,2021-01-13,8,45,176,221
87449,2021-01-13,9,51,135,186
87450,2021-01-13,10,46,126,172
87451,2021-01-13,11,55,159,214
87452,2021-01-13,12,92,197,289
87453,2021-01-13,13,84,164,248
87454,2021-01-13,14,85,164,249
87455,2021-01-13,15,107,221,328
87456,2021-01-13,16,93,273,366
87457,2021-01-13,17,104,293,397
87458,2021-01-13,18,98,226,324
87459,2021-01-13,19,70,158,228
87460,2021-01-13,20,38,107,145
87461,2021-01-13,21,23,71,94
87462,2021-01-13,22,21,43,64
87463,2021-01-13,23,24,38,62
87464,2021-01-14,0,8,16,24
87465,2021-01-14,1,8,6,14
87466,2021-01-14,2,2,2,4
87467,2021-01-14,3,5,0,5
87468,2021-01-14,4,5,4,9
87469,2021-01-14,5,9,33,42
87470,2021-01-14,6,9,69,78
87471,2021-01-14,7,28,143,171
87472,2021-01-14,8,48,180,228
87473,2021-01-14,9,60,140,200
87474,2021-01-14,10,49,133,182
87475,2021-01-14,11,67,129,196
87476,2021-01-14,12,64,158,222
87477,2021-01-14,13,95,162,257
87478,2021-01-14,14,75,201,276
87479,2021-01-14,15,111,200,311
87480,2021-01-14,16,93,280,373
87481,2021-01-14,17,102,272,374
87482,2021-01-14,18,81,223,304
87483,2021-01-14,19,65,136,201
87484,2021-01-14,20,38,94,132
87485,2021-01-14,21,38,59,97
87486,2021-01-14,22,21,35,56
87487,2021-01-14,23,13,27,40
87488,2021-01-15,0,5,11,16
87489,2021-01-15,1,5,5,10
87490,2021-01-15,2,3,2,5
87491,2021-01-15,3,3,1,4
87492,2021-01-15,4,2,7,9
87493,2021-01-15,5,9,14,23
87494,2021-01-15,6,15,53,68
87495,2021-01-15,7,27,118,145
87496,2021-01-15,8,48,159,207
87497,2021-01-15,9,38,131,169
87498,2021-01-15,10,38,138,176
87499,2021-01-15,11,70,153,223
87500,2021-01-15,12,80,187,267
87501,2021-01-15,13,68,187,255
87502,2021-01-15,14,115,219,334
87503,2021-01-15,15,96,241,337
87504,2021-01-15,16,94,254,348
87505,2021-01-15,17,68,226,294
87506,2021-01-15,18,48,102,150
87507,2021-01-15,19,23,71,94
87508,2021-01-15,20,20,39,59
87509,2021-01-15,21,12,36,48
87510,2021-01-15,22,19,31,50
87511,2021-01-15,23,18,25,43
87512,2021-01-16,0,9,26,35
87513,2021-01-16,1,14,12,26
87514,2021-01-16,2,4,13,17
87515,2021-01-16,3,4,13,17
87516,2021-01-16,4,1,8,9
87517,2021-01-16,5,6,9,15
87518,2021-01-16,6,13,20,33
87519,2021-01-16,7,19,39,58
87520,2021-01-16,8,40,72,112
87521,2021-01-16,9,76,135,211
87522,2021-01-16,10,121,197,318
87523,2021-01-16,11,150,220,370
87524,2021-01-16,12,178,262,440
87525,2021-01-16,13,228,302,530
87526,2021-01-16,14,240,310,550
87527,2021-01-16,15,217,259,476
87528,2021-01-16,16,161,262,423
87529,2021-01-16,17,114,209,323
87530,2021-01-16,18,60,144,204
87531,2021-01-16,19,63,101,164
87532,2021-01-16,20,28,66,94
87533,2021-01-16,21,39,63,102
87534,2021-01-16,22,37,56,93
87535,2021-01-16,23,27,42,69
87536,2021-01-17,0,18,15,33
87537,2021-01-17,1,10,13,23
87538,2021-01-17,2,6,7,13
87539,2021-01-17,3,2,2,4
87540,2021-01-17,4,2,6,8
87541,2021-01-17,5,4,7,11
87542,2021-01-17,6,7,16,23
87543,2021-01-17,7,12,30,42
87544,2021-01-17,8,16,60,76
87545,2021-01-17,9,36,105,141
87546,2021-01-17,10,88,164,252
87547,2021-01-17,11,93,196,289
87548,2021-01-17,12,165,226,391
87549,2021-01-17,13,178,256,434
87550,2021-01-17,14,201,227,428
87551,2021-01-17,15,207,255,462
87552,2021-01-17,16,133,200,333
87553,2021-01-17,17,74,171,245
87554,2021-01-17,18,62,118,180
87555,2021-01-17,19,28,69,97
87556,2021-01-17,20,32,60,92
87557,2021-01-17,21,27,49,76
87558,2021-01-17,22,22,32,54
87559,2021-01-17,23,14,24,38
87560,2021-01-18,0,11,20,31
87561,2021-01-18,1,4,4,8
87562,2021-01-18,2,3,5,8
87563,2021-01-18,3,3,0,3
87564,2021-01-18,4,2,4,6
87565,2021-01-18,5,5,9,14
87566,2021-01-18,6,9,34,43
87567,2021-01-18,7,17,55,72
87568,2021-01-18,8,23,75,98
87569,2021-01-18,9,49,115,164
87570,2021-01-18,10,64,124,188
87571,2021-01-18,11,112,177,289
87572,2021-01-18,12,127,207,334
87573,2021-01-18,13,152,193,345
87574,2021-01-18,14,147,215,362
87575,2021-01-18,15,134,212,346
87576,2021-01-18,16,123,244,367
87577,2021-01-18,17,63,185,248
87578,2021-01-18,18,40,109,149
87579,2021-01-18,19,44,84,128
87580,2021-01-18,20,32,66,98
87581,2021-01-18,21,20,32,52
87582,2021-01-18,22,36,22,58
87583,2021-01-18,23,9,20,29
87584,2021-01-19,0,7,12,19
87585,2021-01-19,1,5,3,8
87586,2021-01-19,2,1,3,4
87587,2021-01-19,3,2,1,3
87588,2021-01-19,4,4,5,9
87589,2021-01-19,5,7,10,17
87590,2021-01-19,6,11,60,71
87591,2021-01-19,7,21,82,103
87592,2021-01-19,8,44,116,160
87593,2021-01-19,9,59,100,159
87594,2021-01-19,10,54,105,159
87595,2021-01-19,11,78,92,170
87596,2021-01-19,12,89,133,222
87597,2021-01-19,13,104,146,250
87598,2021-01-19,14,96,162,258
87599,2021-01-19,15,108,179,287
87600,2021-01-19,16,116,241,357
87601,2021-01-19,17,123,231,354
87602,2021-01-19,18,96,174,270
87603,2021-01-19,19,59,129,188
87604,2021-01-19,20,29,78,107
87605,2021-01-19,21,28,53,81
87606,2021-01-19,22,26,39,65
87607,2021-01-19,23,18,31,49
87608,2021-01-20,0,6,9,15
87609,2021-01-20,1,1,2,3
87610,2021-01-20,2,3,1,4
87611,2021-01-20,3,1,1,2
87612,2021-01-20,4,3,6,9
87613,2021-01-20,5,9,10,19
87614,2021-01-20,6,16,29,45
87615,2021-01-20,7,32,69,101
87616,2021-01-20,8,56,90,146
87617,2021-01-20,9,53,100,153
87618,2021-01-20,10,88,123,211
87619,2021-01-20,11,83,92,175
87620,2021-01-20,12,92,72,164
87621,2021-01-20,13,75,144,219
87622,2021-01-20,14,103,132,235
87623,2021-01-20,15,79,143,222
87624,2021-01-20,16,85,139,224
87625,2021-01-20,17,64,138,202
87626,2021-01-20,18,40,109,149
87627,2021-01-20,19,29,75,104
87628,2021-01-20,20,26,47,73
87629,2021-01-20,21,16,40,56
87630,2021-01-20,22,24,35,59
87631,2021-01-20,23,11,21,32
87632,2021-01-21,0,9,10,19
87633,2021-01-21,1,2,2,4
87634,2021-01-21,2,1,1,2
87635,2021-01-21,4,3,2,5
87636,2021-01-21,5,7,19,26
87637,2021-01-21,6,13,56,69
87638,2021-01-21,7,31,125,156
87639,2021-01-21,8,32,152,184
87640,2021-01-21,9,49,122,171
87641,2021-01-21,10,49,89,138
87642,2021-01-21,11,52,118,170
87643,2021-01-21,12,88,156,244
87644,2021-01-21,13,71,161,232
87645,2021-01-21,14,102,182,284
87646,2021-01-21,15,104,195,299
87647,2021-01-21,16,105,276,381
87648,2021-01-21,17,142,232,374
87649,2021-01-21,18,90,197,287
87650,2021-01-21,19,48,128,176
87651,2021-01-21,20,42,93,135
87652,2021-01-21,21,19,46,65
87653,2021-01-21,22,29,51,80
87654,2021-01-21,23,18,10,28
87655,2021-01-22,0,7,10,17
87656,2021-01-22,1,8,2,10
87657,2021-01-22,2,3,2,5
87658,2021-01-22,4,7,4,11
87659,2021-01-22,5,5,16,21
87660,2021-01-22,6,15,60,75
87661,2021-01-22,7,26,108,134
87662,2021-01-22,8,41,150,191
87663,2021-01-22,9,46,139,185
87664,2021-01-22,10,62,116,178
87665,2021-01-22,11,96,133,229
87666,2021-01-22,12,85,159,244
87667,2021-01-22,13,122,184,306
87668,2021-01-22,14,124,203,327
87669,2021-01-22,15,138,213,351
87670,2021-01-22,16,113,265,378
87671,2021-01-22,17,148,309,457
87672,2021-01-22,18,80,246,326
87673,2021-01-22,19,56,163,219
87674,2021-01-22,20,41,97,138
87675,2021-01-22,21,28,64,92
87676,2021-01-22,22,32,58,90
87677,2021-01-22,23,19,33,52
87678,2021-01-23,0,20,13,33
87679,2021-01-23,1,6,17,23
87680,2021-01-23,2,3,9,12
87681,2021-01-23,3,2,4,6
87682,2021-01-23,4,4,2,6
87683,2021-01-23,5,3,6,9
87684,2021-01-23,6,8,25,33
87685,2021-01-23,7,10,42,52
87686,2021-01-23,8,27,84,111
87687,2021-01-23,9,32,121,153
87688,2021-01-23,10,77,173,250
87689,2021-01-23,11,81,178,259
87690,2021-01-23,12,140,196,336
87691,2021-01-23,13,126,216,342
87692,2021-01-23,14,141,245,386
87693,2021-01-23,15,117,225,342
87694,2021-01-23,16,117,204,321
87695,2021-01-23,17,75,190,265
87696,2021-01-23,18,40,125,165
87697,2021-01-23,19,28,99,127
87698,2021-01-23,20,26,68,94
87699,2021-01-23,21,22,39,61
87700,2021-01-23,22,17,26,43
87701,2021-01-23,23,23,30,53
87702,2021-01-24,0,14,15,29
87703,2021-01-24,1,8,13,21
87704,2021-01-24,2,2,6,8
87705,2021-01-24,3,0,1,1
87706,2021-01-24,4,4,5,9
87707,2021-01-24,5,4,2,6
87708,2021-01-24,6,7,12,19
87709,2021-01-24,7,12,35,47
87710,2021-01-24,8,20,65,85
87711,2021-01-24,9,24,125,149
87712,2021-01-24,10,75,136,211
87713,2021-01-24,11,93,168,261
87714,2021-01-24,12,119,234,353
87715,2021-01-24,13,140,231,371
87716,2021-01-24,14,153,233,386
87717,2021-01-24,15,124,182,306
87718,2021-01-24,16,99,196,295
87719,2021-01-24,17,77,168,245
87720,2021-01-24,18,57,110,167
87721,2021-01-24,19,31,68,99
87722,2021-01-24,20,19,51,70
87723,2021-01-24,21,21,39,60
87724,2021-01-24,22,27,44,71
87725,2021-01-24,23,13,27,40
87726,2021-01-25,0,4,4,8
87727,2021-01-25,1,2,4,6
87728,2021-01-25,2,3,2,5
87729,2021-01-25,3,1,3,4
87730,2021-01-25,4,3,2,5
87731,2021-01-25,5,5,21,26
87732,2021-01-25,6,8,60,68
87733,2021-01-25,7,16,114,130
87734,2021-01-25,8,37,172,209
87735,2021-01-25,9,30,136,166
87736,2021-01-25,10,29,93,122
87737,2021-01-25,11,49,112,161
87738,2021-01-25,12,43,151,194
87739,2021-01-25,13,46,121,167
87740,2021-01-25,14,53,132,185
87741,2021-01-25,15,72,138,210
87742,2021-01-25,16,52,205,257
87743,2021-01-25,17,30,163,193
87744,2021-01-25,18,11,80,91
87745,2021-01-25,19,12,53,65
87746,2021-01-25,20,9,38,47
87747,2021-01-25,21,8,18,26
87748,2021-01-25,22,10,16,26
87749,2021-01-25,23,10,9,19
87750,2021-01-26,0,2,2,4
87751,2021-01-26,1,2,1,3
87752,2021-01-26,2,1,1,2
87753,2021-01-26,3,1,2,3
87754,2021-01-26,4,4,4,8
87755,2021-01-26,5,1,9,10
87756,2021-01-26,6,6,39,45
87757,2021-01-26,7,6,55,61
87758,2021-01-26,8,13,84,97
87759,2021-01-26,9,19,69,88
87760,2021-01-26,10,19,43,62
87761,2021-01-26,11,30,59,89
87762,2021-01-26,12,37,84,121
87763,2021-01-26,13,30,95,125
87764,2021-01-26,14,22,97,119
87765,2021-01-26,15,50,101,151
87766,2021-01-26,16,45,166,211
87767,2021-01-26,17,52,191,243
87768,2021-01-26,18,46,159,205
87769,2021-01-26,19,32,98,130
87770,2021-01-26,20,28,54,82
87771,2021-01-26,21,14,36,50
87772,2021-01-26,22,20,35,55
87773,2021-01-26,23,12,21,33
87774,2021-01-27,0,7,12,19
87775,2021-01-27,1,4,5,9
87776,2021-01-27,2,2,1,3
87777,2021-01-27,3,1,1,2
87778,2021-01-27,4,4,7,11
87779,2021-01-27,5,8,17,25
87780,2021-01-27,6,17,80,97
87781,2021-01-27,7,24,135,159
87782,2021-01-27,8,52,158,210
87783,2021-01-27,9,56,147,203
87784,2021-01-27,10,36,114,150
87785,2021-01-27,11,55,135,190
87786,2021-01-27,12,50,170,220
87787,2021-01-27,13,67,164,231
87788,2021-01-27,14,82,154,236
87789,2021-01-27,15,86,158,244
87790,2021-01-27,16,91,222,313
87791,2021-01-27,17,105,265,370
87792,2021-01-27,18,95,226,321
87793,2021-01-27,19,50,160,210
87794,2021-01-27,20,27,91,118
87795,2021-01-27,21,21,62,83
87796,2021-01-27,22,18,45,63
87797,2021-01-27,23,10,31,41
87798,2021-01-28,0,1,9,10
87799,2021-01-28,1,5,6,11
87800,2021-01-28,2,2,3,5
87801,2021-01-28,3,1,0,1
87802,2021-01-28,4,3,5,8
87803,2021-01-28,5,3,20,23
87804,2021-01-28,6,11,62,73
87805,2021-01-28,7,22,122,144
87806,2021-01-28,8,31,140,171
87807,2021-01-28,9,28,114,142
87808,2021-01-28,10,25,80,105
87809,2021-01-28,11,44,106,150
87810,2021-01-28,12,62,112,174
87811,2021-01-28,13,50,100,150
87812,2021-01-28,14,49,114,163
87813,2021-01-28,15,60,139,199
87814,2021-01-28,16,62,193,255
87815,2021-01-28,17,70,196,266
87816,2021-01-28,18,61,169,230
87817,2021-01-28,19,28,114,142
87818,2021-01-28,20,17,75,92
87819,2021-01-28,21,15,41,56
87820,2021-01-28,22,23,42,65
87821,2021-01-28,23,10,22,32
87822,2021-01-29,0,4,7,11
87823,2021-01-29,1,2,8,10
87824,2021-01-29,2,3,1,4
87825,2021-01-29,3,1,0,1
87826,2021-01-29,4,3,4,7
87827,2021-01-29,5,5,10,15
87828,2021-01-29,6,10,49,59
87829,2021-01-29,7,25,104,129
87830,2021-01-29,8,35,120,155
87831,2021-01-29,9,32,116,148
87832,2021-01-29,10,35,101,136
87833,2021-01-29,11,42,116,158
87834,2021-01-29,12,37,136,173
87835,2021-01-29,13,72,124,196
87836,2021-01-29,14,58,124,182
87837,2021-01-29,15,72,137,209
87838,2021-01-29,16,62,173,235
87839,2021-01-29,17,82,229,311
87840,2021-01-29,18,82,169,251
87841,2021-01-29,19,63,148,211
87842,2021-01-29,20,36,68,104
87843,2021-01-29,21,33,27,60
87844,2021-01-29,22,16,51,67
87845,2021-01-29,23,14,24,38
87846,2021-01-30,0,13,20,33
87847,2021-01-30,1,8,9,17
87848,2021-01-30,2,5,10,15
87849,2021-01-30,3,5,5,10
87850,2021-01-30,4,5,8,13
87851,2021-01-30,5,2,7,9
87852,2021-01-30,6,11,13,24
87853,2021-01-30,7,18,35,53
87854,2021-01-30,8,25,77,102
87855,2021-01-30,9,30,96,126
87856,2021-01-30,10,38,159,197
87857,2021-01-30,11,91,195,286
87858,2021-01-30,12,136,222,358
87859,2021-01-30,13,166,231,397
87860,2021-01-30,14,206,242,448
87861,2021-01-30,15,178,258,436
87862,2021-01-30,16,168,240,408
87863,2021-01-30,17,113,218,331
87864,2021-01-30,18,74,176,250
87865,2021-01-30,19,45,103,148
87866,2021-01-30,20,38,86,124
87867,2021-01-30,21,33,49,82
87868,2021-01-30,22,30,51,81
87869,2021-01-30,23,25,25,50
87870,2021-01-31,0,22,31,53
87871,2021-01-31,1,7,6,13
87872,2021-01-31,2,6,4,10
87873,2021-01-31,3,2,3,5
87874,2021-01-31,4,1,3,4
87875,2021-01-31,5,2,8,10
87876,2021-01-31,6,8,13,21
87877,2021-01-31,7,8,22,30
87878,2021-01-31,8,9,30,39
87879,2021-01-31,9,6,31,37
87880,2021-01-31,10,18,37,55
87881,2021-01-31,11,21,63,84
87882,2021-01-31,12,17,61,78
87883,2021-01-31,13,30,82,112
87884,2021-01-31,14,26,63,89
87885,2021-01-31,15,32,50,82
87886,2021-01-31,16,38,73,111
87887,2021-01-31,17,22,43,65
87888,2021-01-31,18,13,16,29
87889,2021-01-31,19,9,17,26
87890,2021-01-31,20,11,16,27
87891,2021-01-31,21,9,15,24
87892,2021-01-31,22,9,12,21
87893,2021-01-31,23,3,7,10
87894,2021-02-01,0,8,4,12
87895,2021-02-01,1,0,3,3
87896,2021-02-01,2,2,1,3
87897,2021-02-01,3,3,2,5
87898,2021-02-01,4,3,5,8
87899,2021-02-01,5,1,2,3
87900,2021-02-01,6,5,25,30
87901,2021-02-01,7,6,47,53
87902,2021-02-01,8,13,37,50
87903,2021-02-01,9,9,32,41
87904,2021-02-01,10,11,24,35
87905,2021-02-01,11,6,27,33
87906,2021-02-01,12,11,45,56
87907,2021-02-01,13,16,48,64
87908,2021-02-01,14,21,50,71
87909,2021-02-01,15,30,68,98
87910,2021-02-01,16,17,64,81
87911,2021-02-01,17,15,75,90
87912,2021-02-01,18,13,52,65
87913,2021-02-01,19,9,44,53
87914,2021-02-01,20,6,44,50
87915,2021-02-01,21,8,20,28
87916,2021-02-01,22,11,19,30
87917,2021-02-01,23,3,8,11
87918,2021-02-02,0,2,3,5
87919,2021-02-02,1,2,0,2
87920,2021-02-02,2,1,0,1
87921,2021-02-02,4,1,4,5
87922,2021-02-02,5,0,7,7
87923,2021-02-02,6,7,22,29
87924,2021-02-02,7,3,34,37
87925,2021-02-02,8,15,43,58
87926,2021-02-02,9,16,38,54
87927,2021-02-02,10,22,35,57
87928,2021-02-02,11,14,51,65
87929,2021-02-02,12,18,68,86
87930,2021-02-02,13,25,45,70
87931,2021-02-02,14,31,62,93
87932,2021-02-02,15,21,89,110
87933,2021-02-02,16,29,112,141
87934,2021-02-02,17,38,119,157
87935,2021-02-02,18,43,120,163
87936,2021-02-02,19,31,82,113
87937,2021-02-02,20,15,68,83
87938,2021-02-02,21,12,33,45
87939,2021-02-02,22,27,10,37
87940,2021-02-02,23,9,24,33
87941,2021-02-03,0,3,11,14
87942,2021-02-03,1,2,2,4
87943,2021-02-03,3,0,3,3
87944,2021-02-03,4,5,4,9
87945,2021-02-03,5,2,10,12
87946,2021-02-03,6,5,47,52
87947,2021-02-03,7,20,93,113
87948,2021-02-03,8,26,113,139
87949,2021-02-03,9,27,100,127
87950,2021-02-03,10,39,74,113
87951,2021-02-03,11,34,88,122
87952,2021-02-03,12,36,109,145
87953,2021-02-03,13,49,125,174
87954,2021-02-03,14,57,99,156
87955,2021-02-03,15,68,122,190
87956,2021-02-03,16,70,162,232
87957,2021-02-03,17,81,215,296
87958,2021-02-03,18,55,159,214
87959,2021-02-03,19,38,112,150
87960,2021-02-03,20,21,68,89
87961,2021-02-03,21,16,34,50
87962,2021-02-03,22,17,22,39
87963,2021-02-03,23,13,20,33
87964,2021-02-04,0,5,6,11
87965,2021-02-04,1,1,1,2
87966,2021-02-04,2,0,2,2
87967,2021-02-04,3,1,0,1
87968,2021-02-04,4,2,5,7
87969,2021-02-04,5,6,15,21
87970,2021-02-04,6,7,59,66
87971,2021-02-04,7,21,131,152
87972,2021-02-04,8,43,135,178
87973,2021-02-04,9,31,108,139
87974,2021-02-04,10,25,93,118
87975,2021-02-04,11,48,89,137
87976,2021-02-04,12,62,160,222
87977,2021-02-04,13,56,148,204
87978,2021-02-04,14,75,138,213
87979,2021-02-04,15,70,179,249
87980,2021-02-04,16,75,215,290
87981,2021-02-04,17,96,255,351
87982,2021-02-04,18,73,204,277
87983,2021-02-04,19,55,147,202
87984,2021-02-04,20,36,86,122
87985,2021-02-04,21,20,60,80
87986,2021-02-04,22,35,38,73
87987,2021-02-04,23,20,37,57
87988,2021-02-05,0,12,15,27
87989,2021-02-05,1,7,3,10
87990,2021-02-05,2,2,0,2
87991,2021-02-05,3,2,2,4
87992,2021-02-05,4,4,4,8
87993,2021-02-05,5,3,8,11
87994,2021-02-05,6,12,52,64
87995,2021-02-05,7,20,101,121
87996,2021-02-05,8,38,152,190
87997,2021-02-05,9,62,114,176
87998,2021-02-05,10,43,93,136
87999,2021-02-05,11,65,135,200
88000,2021-02-05,12,94,172,266
88001,2021-02-05,13,86,199,285
88002,2021-02-05,14,113,192,305
88003,2021-02-05,15,157,244,401
88004,2021-02-05,16,166,292,458
88005,2021-02-05,17,178,327,505
88006,2021-02-05,18,113,266,379
88007,2021-02-05,19,66,183,249
88008,2021-02-05,20,53,132,185
88009,2021-02-05,21,41,59,100
88010,2021-02-05,22,32,57,89
88011,2021-02-05,23,31,47,78
88012,2021-02-06,0,15,28,43
88013,2021-02-06,1,12,18,30
88014,2021-02-06,2,14,9,23
88015,2021-02-06,3,5,2,7
88016,2021-02-06,4,3,4,7
88017,2021-02-06,5,2,3,5
88018,2021-02-06,6,11,24,35
88019,2021-02-06,7,20,43,63
88020,2021-02-06,8,36,95,131
88021,2021-02-06,9,68,142,210
88022,2021-02-06,10,93,217,310
88023,2021-02-06,11,159,237,396
88024,2021-02-06,12,205,316,521
88025,2021-02-06,13,217,303,520
88026,2021-02-06,14,300,308,608
88027,2021-02-06,15,263,328,591
88028,2021-02-06,16,219,317,536
88029,2021-02-06,17,159,294,453
88030,2021-02-06,18,110,188,298
88031,2021-02-06,19,67,131,198
88032,2021-02-06,20,58,81,139
88033,2021-02-06,21,45,62,107
88034,2021-02-06,22,33,72,105
88035,2021-02-06,23,34,40,74
88036,2021-02-07,0,24,24,48
88037,2021-02-07,1,14,19,33
88038,2021-02-07,2,9,11,20
88039,2021-02-07,3,4,2,6
88040,2021-02-07,4,1,2,3
88041,2021-02-07,5,3,5,8
88042,2021-02-07,6,6,8,14
88043,2021-02-07,7,1,7,8
88044,2021-02-07,8,7,25,32
88045,2021-02-07,9,10,42,52
88046,2021-02-07,10,12,46,58
88047,2021-02-07,11,18,51,69
88048,2021-02-07,12,23,47,70
88049,2021-02-07,13,32,118,150
88050,2021-02-07,14,70,154,224
88051,2021-02-07,15,85,183,268
88052,2021-02-07,16,75,195,270
88053,2021-02-07,17,114,222,336
88054,2021-02-07,18,71,130,201
88055,2021-02-07,19,32,60,92
88056,2021-02-07,20,14,42,56
88057,2021-02-07,21,38,33,71
88058,2021-02-07,22,54,70,124
88059,2021-02-07,23,40,35,75
88060,2021-02-08,0,7,10,17
88061,2021-02-08,1,5,5,10
88062,2021-02-08,2,3,3,6
88063,2021-02-08,3,4,0,4
88064,2021-02-08,4,8,4,12
88065,2021-02-08,5,2,10,12
88066,2021-02-08,6,5,41,46
88067,2021-02-08,7,25,103,128
88068,2021-02-08,8,36,160,196
88069,2021-02-08,9,42,134,176
88070,2021-02-08,10,24,78,102
88071,2021-02-08,11,56,86,142
88072,2021-02-08,12,58,108,166
88073,2021-02-08,13,79,121,200
88074,2021-02-08,14,61,118,179
88075,2021-02-08,15,91,142,233
88076,2021-02-08,16,68,207,275
88077,2021-02-08,17,95,241,336
88078,2021-02-08,18,52,208,260
88079,2021-02-08,19,40,118,158
88080,2021-02-08,20,26,68,94
88081,2021-02-08,21,27,45,72
88082,2021-02-08,22,18,24,42
88083,2021-02-08,23,12,14,26
88084,2021-02-09,0,5,4,9
88085,2021-02-09,2,2,3,5
88086,2021-02-09,3,1,3,4
88087,2021-02-09,4,2,5,7
88088,2021-02-09,5,7,21,28
88089,2021-02-09,6,9,63,72
88090,2021-02-09,7,26,132,158
88091,2021-02-09,8,45,168,213
88092,2021-02-09,9,40,141,181
88093,2021-02-09,10,27,88,115
88094,2021-02-09,11,39,116,155
88095,2021-02-09,12,68,154,222
88096,2021-02-09,13,74,158,232
88097,2021-02-09,14,74,160,234
88098,2021-02-09,15,95,184,279
88099,2021-02-09,16,100,273,373
88100,2021-02-09,17,105,349,454
88101,2021-02-09,18,84,244,328
88102,2021-02-09,19,39,134,173
88103,2021-02-09,20,30,111,141
88104,2021-02-09,21,22,72,94
88105,2021-02-09,22,17,34,51
88106,2021-02-09,23,9,25,34
88107,2021-02-10,0,3,8,11
88108,2021-02-10,1,1,7,8
88109,2021-02-10,2,2,4,6
88110,2021-02-10,3,1,2,3
88111,2021-02-10,4,6,10,16
88112,2021-02-10,5,6,19,25
88113,2021-02-10,6,8,64,72
88114,2021-02-10,7,22,136,158
88115,2021-02-10,8,28,137,165
88116,2021-02-10,9,17,17,34
88117,2021-02-10,10,28,68,96
88118,2021-02-10,11,63,134,197
88119,2021-02-10,12,52,159,211
88120,2021-02-10,13,54,160,214
88121,2021-02-10,14,55,141,196
88122,2021-02-10,15,59,185,244
88123,2021-02-10,16,57,179,236
88124,2021-02-10,17,26,128,154
88125,2021-02-10,18,20,94,114
88126,2021-02-10,19,24,58,82
88127,2021-02-10,20,12,38,50
88128,2021-02-10,21,11,17,28
88129,2021-02-10,22,9,20,29
88130,2021-02-10,23,5,8,13
88131,2021-02-11,0,5,3,8
88132,2021-02-11,1,1,1,2
88133,2021-02-11,2,3,2,5
88134,2021-02-11,3,0,1,1
88135,2021-02-11,4,3,4,7
88136,2021-02-11,5,2,10,12
88137,2021-02-11,6,8,30,38
88138,2021-02-11,7,14,67,81
88139,2021-02-11,8,26,87,113
88140,2021-02-11,9,22,64,86
88141,2021-02-11,10,15,66,81
88142,2021-02-11,11,20,73,93
88143,2021-02-11,12,32,93,125
88144,2021-02-11,13,46,88,134
88145,2021-02-11,14,30,92,122
88146,2021-02-11,15,41,151,192
88147,2021-02-11,16,60,134,194
88148,2021-02-11,17,64,218,282
88149,2021-02-11,18,52,168,220
88150,2021-02-11,19,30,150,180
88151,2021-02-11,20,31,71,102
88152,2021-02-11,21,21,59,80
88153,2021-02-11,22,18,30,48
88154,2021-02-11,23,22,13,35
88155,2021-02-12,0,6,7,13
88156,2021-02-12,1,8,6,14
88157,2021-02-12,2,2,1,3
88158,2021-02-12,3,1,0,1
88159,2021-02-12,4,3,6,9
88160,2021-02-12,5,7,8,15
88161,2021-02-12,6,12,52,64
88162,2021-02-12,7,16,120,136
88163,2021-02-12,8,36,139,175
88164,2021-02-12,9,36,124,160
88165,2021-02-12,10,35,102,137
88166,2021-02-12,11,52,174,226
88167,2021-02-12,12,51,155,206
88168,2021-02-12,13,51,122,173
88169,2021-02-12,14,64,110,174
88170,2021-02-12,15,73,132,205
88171,2021-02-12,16,74,176,250
88172,2021-02-12,17,78,229,307
88173,2021-02-12,18,56,189,245
88174,2021-02-12,19,61,146,207
88175,2021-02-12,20,44,81,125
88176,2021-02-12,21,22,55,77
88177,2021-02-12,22,29,34,63
88178,2021-02-12,23,11,33,44
88179,2021-02-13,0,17,16,33
88180,2021-02-13,1,11,9,20
88181,2021-02-13,2,6,10,16
88182,2021-02-13,3,2,2,4
88183,2021-02-13,4,5,2,7
88184,2021-02-13,5,7,3,10
88185,2021-02-13,6,12,15,27
88186,2021-02-13,7,18,47,65
88187,2021-02-13,8,13,69,82
88188,2021-02-13,9,13,58,71
88189,2021-02-13,10,5,46,51
88190,2021-02-13,11,10,46,56
88191,2021-02-13,12,11,31,42
88192,2021-02-13,13,6,34,40
88193,2021-02-13,14,12,27,39
88194,2021-02-13,15,8,32,40
88195,2021-02-13,16,13,30,43
88196,2021-02-13,17,6,28,34
88197,2021-02-13,18,3,35,38
88198,2021-02-13,19,11,24,35
88199,2021-02-13,20,12,20,32
88200,2021-02-13,21,7,14,21
88201,2021-02-13,22,8,29,37
88202,2021-02-13,23,20,22,42
88203,2021-02-14,0,7,13,20
88204,2021-02-14,1,5,3,8
88205,2021-02-14,2,2,4,6
88206,2021-02-14,3,0,2,2
88207,2021-02-14,4,2,0,2
88208,2021-02-14,5,2,0,2
88209,2021-02-14,6,6,11,17
88210,2021-02-14,7,5,17,22
88211,2021-02-14,8,10,27,37
88212,2021-02-14,9,15,49,64
88213,2021-02-14,10,37,65,102
88214,2021-02-14,11,43,103,146
88215,2021-02-14,12,65,119,184
88216,2021-02-14,13,106,129,235
88217,2021-02-14,14,92,146,238
88218,2021-02-14,15,111,182,293
88219,2021-02-14,16,96,160,256
88220,2021-02-14,17,79,149,228
88221,2021-02-14,18,43,113,156
88222,2021-02-14,19,26,62,88
88223,2021-02-14,20,21,70,91
88224,2021-02-14,21,18,48,66
88225,2021-02-14,22,25,33,58
88226,2021-02-14,23,13,30,43
88227,2021-02-15,0,9,23,32
88228,2021-02-15,1,6,5,11
88229,2021-02-15,2,2,5,7
88230,2021-02-15,3,0,4,4
88231,2021-02-15,4,6,5,11
88232,2021-02-15,5,6,11,17
88233,2021-02-15,6,9,33,42
88234,2021-02-15,7,7,61,68
88235,2021-02-15,8,17,85,102
88236,2021-02-15,9,26,122,148
88237,2021-02-15,10,45,108,153
88238,2021-02-15,11,58,159,217
88239,2021-02-15,12,64,153,217
88240,2021-02-15,13,100,156,256
88241,2021-02-15,14,108,186,294
88242,2021-02-15,15,98,221,319
88243,2021-02-15,16,69,191,260
88244,2021-02-15,17,56,121,177
88245,2021-02-15,18,43,113,156
88246,2021-02-15,19,26,86,112
88247,2021-02-15,20,8,44,52
88248,2021-02-15,21,6,28,34
88249,2021-02-15,22,6,15,21
88250,2021-02-15,23,1,8,9
88251,2021-02-16,0,3,3,6
88252,2021-02-16,1,0,3,3
88253,2021-02-16,2,0,1,1
88254,2021-02-16,3,1,1,2
88255,2021-02-16,4,1,4,5
88256,2021-02-16,5,6,12,18
88257,2021-02-16,6,4,66,70
88258,2021-02-16,7,16,110,126
88259,2021-02-16,8,41,146,187
88260,2021-02-16,9,35,121,156
88261,2021-02-16,10,36,77,113
88262,2021-02-16,11,43,89,132
88263,2021-02-16,12,73,154,227
88264,2021-02-16,13,60,124,184
88265,2021-02-16,14,65,150,215
88266,2021-02-16,15,72,149,221
88267,2021-02-16,16,74,174,248
88268,2021-02-16,17,77,269,346
88269,2021-02-16,18,52,231,283
88270,2021-02-16,19,25,118,143
88271,2021-02-16,20,20,78,98
88272,2021-02-16,21,10,38,48
88273,2021-02-16,22,3,6,9
88274,2021-02-16,23,5,3,8
88275,2021-02-17,0,0,3,3
88276,2021-02-17,1,1,1,2
88277,2021-02-17,2,1,0,1
88278,2021-02-17,3,0,2,2
88279,2021-02-17,4,1,0,1
88280,2021-02-17,5,4,3,7
88281,2021-02-17,6,1,4,5
88282,2021-02-17,7,8,4,12
88283,2021-02-17,8,7,6,13
88284,2021-02-17,9,16,6,22
88285,2021-02-17,10,7,10,17
88286,2021-02-17,11,10,16,26
88287,2021-02-17,12,36,74,110
88288,2021-02-17,13,59,125,184
88289,2021-02-17,14,60,121,181
88290,2021-02-17,15,53,149,202
88291,2021-02-17,16,80,183,263
88292,2021-02-17,17,59,187,246
88293,2021-02-17,18,51,200,251
88294,2021-02-17,19,41,116,157
88295,2021-02-17,20,23,66,89
88296,2021-02-17,21,18,48,66
88297,2021-02-17,22,12,35,47
88298,2021-02-17,23,9,33,42
88299,2021-02-18,0,4,13,17
88300,2021-02-18,1,1,4,5
88301,2021-02-18,2,1,4,5
88302,2021-02-18,3,4,0,4
88303,2021-02-18,4,3,5,8
88304,2021-02-18,5,4,7,11
88305,2021-02-18,6,3,26,29
88306,2021-02-18,7,6,26,32
88307,2021-02-18,8,8,30,38
88308,2021-02-18,9,9,26,35
88309,2021-02-18,10,2,15,17
88310,2021-02-18,11,7,10,17
88311,2021-02-18,12,14,16,30
88312,2021-02-18,13,15,33,48
88313,2021-02-18,14,14,21,35
88314,2021-02-18,15,15,43,58
88315,2021-02-18,16,20,43,63
88316,2021-02-18,17,21,48,69
88317,2021-02-18,18,19,46,65
88318,2021-02-18,19,13,36,49
88319,2021-02-18,20,9,30,39
88320,2021-02-18,21,7,20,27
88321,2021-02-18,22,8,16,24
88322,2021-02-18,23,10,9,19
88323,2021-02-19,0,4,8,12
88324,2021-02-19,1,3,7,10
88325,2021-02-19,4,0,3,3
88326,2021-02-19,5,2,7,9
88327,2021-02-19,6,8,19,27
88328,2021-02-19,7,11,40,51
88329,2021-02-19,8,12,68,80
88330,2021-02-19,9,20,51,71
88331,2021-02-19,10,7,47,54
88332,2021-02-19,11,12,65,77
88333,2021-02-19,12,31,93,124
88334,2021-02-19,13,16,96,112
88335,2021-02-19,14,35,102,137
88336,2021-02-19,15,51,100,151
88337,2021-02-19,16,67,147,214
88338,2021-02-19,17,71,193,264
88339,2021-02-19,18,46,153,199
88340,2021-02-19,19,47,117,164
88341,2021-02-19,20,32,70,102
88342,2021-02-19,21,17,55,72
88343,2021-02-19,22,14,48,62
88344,2021-02-19,23,18,32,50
88345,2021-02-20,0,19,19,38
88346,2021-02-20,1,6,9,15
88347,2021-02-20,2,8,6,14
88348,2021-02-20,3,3,11,14
88349,2021-02-20,4,3,6,9
88350,2021-02-20,5,5,3,8
88351,2021-02-20,6,7,22,29
88352,2021-02-20,7,10,38,48
88353,2021-02-20,8,18,66,84
88354,2021-02-20,9,28,93,121
88355,2021-02-20,10,44,124,168
88356,2021-02-20,11,46,136,182
88357,2021-02-20,12,66,167,233
88358,2021-02-20,13,82,162,244
88359,2021-02-20,14,120,165,285
88360,2021-02-20,15,86,147,233
88361,2021-02-20,16,63,162,225
88362,2021-02-20,17,38,131,169
88363,2021-02-20,18,30,121,151
88364,2021-02-20,19,35,89,124
88365,2021-02-20,20,32,77,109
88366,2021-02-20,21,13,34,47
88367,2021-02-20,22,17,29,46
88368,2021-02-20,23,17,32,49
88369,2021-02-21,0,8,30,38
88370,2021-02-21,1,5,9,14
88371,2021-02-21,2,2,6,8
88372,2021-02-21,3,1,3,4
88373,2021-02-21,4,3,4,7
88374,2021-02-21,5,2,3,5
88375,2021-02-21,6,3,13,16
88376,2021-02-21,7,14,25,39
88377,2021-02-21,8,8,57,65
88378,2021-02-21,9,22,75,97
88379,2021-02-21,10,38,110,148
88380,2021-02-21,11,72,168,240
88381,2021-02-21,12,88,181,269
88382,2021-02-21,13,103,205,308
88383,2021-02-21,14,120,189,309
88384,2021-02-21,15,139,228,367
88385,2021-02-21,16,103,198,301
88386,2021-02-21,17,69,181,250
88387,2021-02-21,18,48,139,187
88388,2021-02-21,19,16,85,101
88389,2021-02-21,20,16,51,67
88390,2021-02-21,21,11,42,53
88391,2021-02-21,22,14,37,51
88392,2021-02-21,23,14,13,27
88393,2021-02-22,0,2,2,4
88394,2021-02-22,1,2,2,4
88395,2021-02-22,2,1,3,4
88396,2021-02-22,3,2,1,3
88397,2021-02-22,4,7,4,11
88398,2021-02-22,5,3,11,14
88399,2021-02-22,6,13,37,50
88400,2021-02-22,7,10,102,112
88401,2021-02-22,8,17,97,114
88402,2021-02-22,9,10,46,56
88403,2021-02-22,10,6,19,25
88404,2021-02-22,11,6,20,26
88405,2021-02-22,12,9,24,33
88406,2021-02-22,13,7,41,48
88407,2021-02-22,14,19,53,72
88408,2021-02-22,15,32,83,115
88409,2021-02-22,16,33,117,150
88410,2021-02-22,17,46,167,213
88411,2021-02-22,18,31,164,195
88412,2021-02-22,19,27,93,120
88413,2021-02-22,20,16,50,66
88414,2021-02-22,21,13,40,53
88415,2021-02-22,22,11,27,38
88416,2021-02-22,23,11,11,22
88417,2021-02-23,0,3,6,9
88418,2021-02-23,1,1,1,2
88419,2021-02-23,2,1,0,1
88420,2021-02-23,3,2,0,2
88421,2021-02-23,4,2,5,7
88422,2021-02-23,5,4,19,23
88423,2021-02-23,6,3,52,55
88424,2021-02-23,7,12,98,110
88425,2021-02-23,8,32,146,178
88426,2021-02-23,9,37,121,158
88427,2021-02-23,10,38,104,142
88428,2021-02-23,11,49,107,156
88429,2021-02-23,12,71,149,220
88430,2021-02-23,13,37,149,186
88431,2021-02-23,14,70,143,213
88432,2021-02-23,15,102,158,260
88433,2021-02-23,16,105,206,311
88434,2021-02-23,17,115,281,396
88435,2021-02-23,18,107,225,332
88436,2021-02-23,19,67,159,226
88437,2021-02-23,20,43,101,144
88438,2021-02-23,21,22,77,99
88439,2021-02-23,22,22,37,59
88440,2021-02-23,23,11,19,30
88441,2021-02-24,0,6,5,11
88442,2021-02-24,1,3,4,7
88443,2021-02-24,2,2,5,7
88444,2021-02-24,3,2,8,10
88445,2021-02-24,4,5,6,11
88446,2021-02-24,5,10,16,26
88447,2021-02-24,6,6,68,74
88448,2021-02-24,7,27,143,170
88449,2021-02-24,8,55,193,248
88450,2021-02-24,9,48,143,191
88451,2021-02-24,10,40,122,162
88452,2021-02-24,11,76,184,260
88453,2021-02-24,12,103,224,327
88454,2021-02-24,13,132,215,347
88455,2021-02-24,14,148,237,385
88456,2021-02-24,15,177,238,415
88457,2021-02-24,16,198,338,536
88458,2021-02-24,17,236,417,653
88459,2021-02-24,18,179,336,515
88460,2021-02-24,19,106,210,316
88461,2021-02-24,20,72,124,196
88462,2021-02-24,21,36,105,141
88463,2021-02-24,22,39,68,107
88464,2021-02-24,23,27,40,67
88465,2021-02-25,0,10,12,22
88466,2021-02-25,1,2,6,8
88467,2021-02-25,2,2,3,5
88468,2021-02-25,3,3,3,6
88469,2021-02-25,4,2,3,5
88470,2021-02-25,5,3,19,22
88471,2021-02-25,6,15,80,95
88472,2021-02-25,7,28,134,162
88473,2021-02-25,8,49,199,248
88474,2021-02-25,9,53,140,193
88475,2021-02-25,10,38,115,153
88476,2021-02-25,11,52,131,183
88477,2021-02-25,12,80,187,267
88478,2021-02-25,13,108,165,273
88479,2021-02-25,14,78,150,228
88480,2021-02-25,15,108,202,310
88481,2021-02-25,16,166,243,409
88482,2021-02-25,17,168,372,540
88483,2021-02-25,18,119,276,395
88484,2021-02-25,19,77,192,269
88485,2021-02-25,20,34,106,140
88486,2021-02-25,21,31,78,109
88487,2021-02-25,22,46,53,99
88488,2021-02-25,23,18,22,40
88489,2021-02-26,0,4,13,17
88490,2021-02-26,1,10,8,18
88491,2021-02-26,2,3,4,7
88492,2021-02-26,3,2,3,5
88493,2021-02-26,4,5,5,10
88494,2021-02-26,5,4,14,18
88495,2021-02-26,6,21,66,87
88496,2021-02-26,7,25,141,166
88497,2021-02-26,8,55,166,221
88498,2021-02-26,9,66,145,211
88499,2021-02-26,10,56,103,159
88500,2021-02-26,11,83,146,229
88501,2021-02-26,12,86,167,253
88502,2021-02-26,13,99,202,301
88503,2021-02-26,14,98,202,300
88504,2021-02-26,15,125,198,323
88505,2021-02-26,16,146,225,371
88506,2021-02-26,17,139,291,430
88507,2021-02-26,18,111,221,332
88508,2021-02-26,19,33,86,119
88509,2021-02-26,20,18,61,79
88510,2021-02-26,21,15,21,36
88511,2021-02-26,22,13,25,38
88512,2021-02-26,23,13,30,43
88513,2021-02-27,0,18,17,35
88514,2021-02-27,1,8,10,18
88515,2021-02-27,2,6,8,14
88516,2021-02-27,3,3,3,6
88517,2021-02-27,4,4,7,11
88518,2021-02-27,5,4,3,7
88519,2021-02-27,6,10,12,22
88520,2021-02-27,7,5,26,31
88521,2021-02-27,8,8,41,49
88522,2021-02-27,9,19,85,104
88523,2021-02-27,10,54,137,191
88524,2021-02-27,11,114,167,281
88525,2021-02-27,12,165,235,400
88526,2021-02-27,13,183,252,435
88527,2021-02-27,14,254,289,543
88528,2021-02-27,15,302,361,663
88529,2021-02-27,16,278,331,609
88530,2021-02-27,17,263,341,604
88531,2021-02-27,18,106,214,320
88532,2021-02-27,19,92,135,227
88533,2021-02-27,20,53,95,148
88534,2021-02-27,21,59,61,120
88535,2021-02-27,22,78,78,156
88536,2021-02-27,23,44,41,85
88537,2021-02-28,0,42,37,79
88538,2021-02-28,1,13,15,28
88539,2021-02-28,2,2,10,12
88540,2021-02-28,3,2,10,12
88541,2021-02-28,4,7,2,9
88542,2021-02-28,5,3,7,10
88543,2021-02-28,6,4,12,16
88544,2021-02-28,7,9,15,24
88545,2021-02-28,8,6,44,50
88546,2021-02-28,9,29,47,76
88547,2021-02-28,10,25,44,69
88548,2021-02-28,11,14,32,46
88549,2021-02-28,12,8,27,35
88550,2021-02-28,13,18,28,46
88551,2021-02-28,14,13,26,39
88552,2021-02-28,15,20,64,84
88553,2021-02-28,16,27,54,81
88554,2021-02-28,17,19,69,88
88555,2021-02-28,18,33,74,107
88556,2021-02-28,19,18,66,84
88557,2021-02-28,20,21,40,61
88558,2021-02-28,21,13,25,38
88559,2021-02-28,22,15,15,30
88560,2021-02-28,23,10,5,15
88561,2021-03-01,0,9,7,16
88562,2021-03-01,1,2,2,4
88563,2021-03-01,2,0,3,3
88564,2021-03-01,3,1,0,1
88565,2021-03-01,4,5,3,8
88566,2021-03-01,5,7,10,17
88567,2021-03-01,6,8,44,52
88568,2021-03-01,7,6,60,66
88569,2021-03-01,8,23,76,99
88570,2021-03-01,9,25,68,93
88571,2021-03-01,10,28,71,99
88572,2021-03-01,11,26,54,80
88573,2021-03-01,12,46,105,151
88574,2021-03-01,13,52,102,154
88575,2021-03-01,14,65,112,177
88576,2021-03-01,15,76,129,205
88577,2021-03-01,16,76,166,242
88578,2021-03-01,17,89,235,324
88579,2021-03-01,18,69,184,253
88580,2021-03-01,19,52,143,195
88581,2021-03-01,20,27,84,111
88582,2021-03-01,21,30,40,70
88583,2021-03-01,22,23,33,56
88584,2021-03-01,23,8,19,27
88585,2021-03-02,0,4,7,11
88586,2021-03-02,1,1,3,4
88587,2021-03-02,2,2,3,5
88588,2021-03-02,3,1,1,2
88589,2021-03-02,4,4,4,8
88590,2021-03-02,5,8,12,20
88591,2021-03-02,6,15,62,77
88592,2021-03-02,7,34,135,169
88593,2021-03-02,8,55,156,211
88594,2021-03-02,9,55,129,184
88595,2021-03-02,10,41,92,133
88596,2021-03-02,11,52,127,179
88597,2021-03-02,12,61,170,231
88598,2021-03-02,13,50,130,180
88599,2021-03-02,14,69,141,210
88600,2021-03-02,15,72,161,233
88601,2021-03-02,16,125,233,358
88602,2021-03-02,17,105,302,407
88603,2021-03-02,18,113,236,349
88604,2021-03-02,19,64,155,219
88605,2021-03-02,20,24,74,98
88606,2021-03-02,21,20,57,77
88607,2021-03-02,22,23,44,67
88608,2021-03-02,23,16,25,41
88609,2021-03-03,0,8,4,12
88610,2021-03-03,1,5,9,14
88611,2021-03-03,2,3,2,5
88612,2021-03-03,3,2,1,3
88613,2021-03-03,4,5,4,9
88614,2021-03-03,5,5,19,24
88615,2021-03-03,6,9,64,73
88616,2021-03-03,7,31,110,141
88617,2021-03-03,8,55,208,263
88618,2021-03-03,9,49,143,192
88619,2021-03-03,10,69,126,195
88620,2021-03-03,11,71,150,221
88621,2021-03-03,12,104,219,323
88622,2021-03-03,13,103,210,313
88623,2021-03-03,14,117,205,322
88624,2021-03-03,15,158,238,396
88625,2021-03-03,16,211,327,538
88626,2021-03-03,17,229,431,660
88627,2021-03-03,18,146,332,478
88628,2021-03-03,19,77,185,262
88629,2021-03-03,20,58,112,170
88630,2021-03-03,21,42,77,119
88631,2021-03-03,22,23,52,75
88632,2021-03-03,23,35,27,62
88633,2021-03-04,0,2,6,8
88634,2021-03-04,1,5,9,14
88635,2021-03-04,2,1,9,10
88636,2021-03-04,3,4,2,6
88637,2021-03-04,4,4,4,8
88638,2021-03-04,5,7,23,30
88639,2021-03-04,6,16,77,93
88640,2021-03-04,7,31,159,190
88641,2021-03-04,8,68,190,258
88642,2021-03-04,9,55,138,193
88643,2021-03-04,10,55,116,171
88644,2021-03-04,11,73,159,232
88645,2021-03-04,12,83,163,246
88646,2021-03-04,13,91,167,258
88647,2021-03-04,14,85,141,226
88648,2021-03-04,15,94,177,271
88649,2021-03-04,16,98,234,332
88650,2021-03-04,17,117,317,434
88651,2021-03-04,18,66,219,285
88652,2021-03-04,19,51,168,219
88653,2021-03-04,20,41,109,150
88654,2021-03-04,21,31,60,91
88655,2021-03-04,22,18,36,54
88656,2021-03-04,23,11,26,37
88657,2021-03-05,0,7,5,12
88658,2021-03-05,1,5,6,11
88659,2021-03-05,2,1,6,7
88660,2021-03-05,3,3,4,7
88661,2021-03-05,4,3,6,9
88662,2021-03-05,5,4,26,30
88663,2021-03-05,6,10,58,68
88664,2021-03-05,7,23,99,122
88665,2021-03-05,8,42,149,191
88666,2021-03-05,9,26,132,158
88667,2021-03-05,10,34,112,146
88668,2021-03-05,11,54,142,196
88669,2021-03-05,12,68,159,227
88670,2021-03-05,13,76,173,249
88671,2021-03-05,14,111,176,287
88672,2021-03-05,15,92,168,260
88673,2021-03-05,16,113,231,344
88674,2021-03-05,17,95,275,370
88675,2021-03-05,18,72,221,293
88676,2021-03-05,19,69,186,255
88677,2021-03-05,20,43,85,128
88678,2021-03-05,21,29,75,104
88679,2021-03-05,22,38,60,98
88680,2021-03-05,23,30,32,62
88681,2021-03-06,0,25,28,53
88682,2021-03-06,1,9,12,21
88683,2021-03-06,2,3,11,14
88684,2021-03-06,3,6,9,15
88685,2021-03-06,4,2,8,10
88686,2021-03-06,5,3,3,6
88687,2021-03-06,6,14,28,42
88688,2021-03-06,7,23,55,78
88689,2021-03-06,8,38,83,121
88690,2021-03-06,9,47,152,199
88691,2021-03-06,10,113,176,289
88692,2021-03-06,11,189,217,406
88693,2021-03-06,12,234,267,501
88694,2021-03-06,13,275,293,568
88695,2021-03-06,14,256,235,491
88696,2021-03-06,15,270,257,527
88697,2021-03-06,16,250,265,515
88698,2021-03-06,17,215,254,469
88699,2021-03-06,18,110,181,291
88700,2021-03-06,19,60,116,176
88701,2021-03-06,20,47,78,125
88702,2021-03-06,21,52,56,108
88703,2021-03-06,22,40,52,92
88704,2021-03-06,23,42,33,75
88705,2021-03-07,0,28,21,49
88706,2021-03-07,1,14,21,35
88707,2021-03-07,2,7,13,20
88708,2021-03-07,3,8,5,13
88709,2021-03-07,4,2,4,6
88710,2021-03-07,5,2,3,5
88711,2021-03-07,6,7,16,23
88712,2021-03-07,7,7,31,38
88713,2021-03-07,8,21,60,81
88714,2021-03-07,9,59,106,165
88715,2021-03-07,10,84,158,242
88716,2021-03-07,11,136,189,325
88717,2021-03-07,12,170,237,407
88718,2021-03-07,13,218,272,490
88719,2021-03-07,14,270,214,484
88720,2021-03-07,15,214,261,475
88721,2021-03-07,16,234,238,472
88722,2021-03-07,17,132,229,361
88723,2021-03-07,18,81,161,242
88724,2021-03-07,19,48,96,144
88725,2021-03-07,20,38,52,90
88726,2021-03-07,21,18,31,49
88727,2021-03-07,22,23,21,44
88728,2021-03-07,23,13,17,30
88729,2021-03-08,0,8,5,13
88730,2021-03-08,1,2,4,6
88731,2021-03-08,2,1,2,3
88732,2021-03-08,3,3,0,3
88733,2021-03-08,4,7,5,12
88734,2021-03-08,5,5,10,15
88735,2021-03-08,6,7,52,59
88736,2021-03-08,7,24,104,128
88737,2021-03-08,8,41,178,219
88738,2021-03-08,9,39,127,166
88739,2021-03-08,10,37,102,139
88740,2021-03-08,11,61,130,191
88741,2021-03-08,12,65,153,218
88742,2021-03-08,13,87,151,238
88743,2021-03-08,14,108,154,262
88744,2021-03-08,15,111,168,279
88745,2021-03-08,16,165,259,424
88746,2021-03-08,17,145,305,450
88747,2021-03-08,18,99,264,363
88748,2021-03-08,19,47,178,225
88749,2021-03-08,20,47,104,151
88750,2021-03-08,21,33,57,90
88751,2021-03-08,22,28,55,83
88752,2021-03-08,23,13,13,26
88753,2021-03-09,0,8,2,10
88754,2021-03-09,1,6,3,9
88755,2021-03-09,2,1,5,6
88756,2021-03-09,3,1,1,2
88757,2021-03-09,4,4,6,10
88758,2021-03-09,5,3,24,27
88759,2021-03-09,6,9,70,79
88760,2021-03-09,7,28,156,184
88761,2021-03-09,8,60,201,261
88762,2021-03-09,9,57,146,203
88763,2021-03-09,10,77,134,211
88764,2021-03-09,11,71,150,221
88765,2021-03-09,12,111,142,253
88766,2021-03-09,13,139,214,353
88767,2021-03-09,14,181,216,397
88768,2021-03-09,15,198,248,446
88769,2021-03-09,16,234,347,581
88770,2021-03-09,17,341,478,819
88771,2021-03-09,18,217,368,585
88772,2021-03-09,19,129,203,332
88773,2021-03-09,20,67,123,190
88774,2021-03-09,21,44,82,126
88775,2021-03-09,22,57,55,112
88776,2021-03-09,23,24,23,47
88777,2021-03-10,0,14,6,20
88778,2021-03-10,1,6,6,12
88779,2021-03-10,2,5,6,11
88780,2021-03-10,3,1,1,2
88781,2021-03-10,4,4,4,8
88782,2021-03-10,5,4,22,26
88783,2021-03-10,6,19,81,100
88784,2021-03-10,7,38,154,192
88785,2021-03-10,8,71,221,292
88786,2021-03-10,9,62,143,205
88787,2021-03-10,10,74,155,229
88788,2021-03-10,11,116,210,326
88789,2021-03-10,12,148,223,371
88790,2021-03-10,13,138,245,383
88791,2021-03-10,14,180,247,427
88792,2021-03-10,15,228,268,496
88793,2021-03-10,16,253,365,618
88794,2021-03-10,17,385,557,942
88795,2021-03-10,18,267,375,642
88796,2021-03-10,19,138,232,370
88797,2021-03-10,20,91,159,250
88798,2021-03-10,21,50,91,141
88799,2021-03-10,22,62,66,128
88800,2021-03-10,23,35,38,73
88801,2021-03-11,0,12,12,24
88802,2021-03-11,1,6,6,12
88803,2021-03-11,2,6,3,9
88804,2021-03-11,3,5,2,7
88805,2021-03-11,4,3,5,8
88806,2021-03-11,5,8,31,39
88807,2021-03-11,6,19,66,85
88808,2021-03-11,7,47,156,203
88809,2021-03-11,8,68,228,296
88810,2021-03-11,9,83,166,249
88811,2021-03-11,10,108,146,254
88812,2021-03-11,11,104,212,316
88813,2021-03-11,12,151,273,424
88814,2021-03-11,13,213,242,455
88815,2021-03-11,14,247,242,489
88816,2021-03-11,15,298,291,589
88817,2021-03-11,16,311,345,656
88818,2021-03-11,17,456,596,1052
88819,2021-03-11,18,292,443,735
88820,2021-03-11,19,153,271,424
88821,2021-03-11,20,103,165,268
88822,2021-03-11,21,90,140,230
88823,2021-03-11,22,86,87,173
88824,2021-03-11,23,44,38,82
88825,2021-03-12,0,16,15,31
88826,2021-03-12,1,3,8,11
88827,2021-03-12,2,6,2,8
88828,2021-03-12,3,5,3,8
88829,2021-03-12,4,3,11,14
88830,2021-03-12,5,15,26,41
88831,2021-03-12,6,26,67,93
88832,2021-03-12,7,56,154,210
88833,2021-03-12,8,72,226,298
88834,2021-03-12,9,80,157,237
88835,2021-03-12,10,85,143,228
88836,2021-03-12,11,123,208,331
88837,2021-03-12,12,124,188,312
88838,2021-03-12,13,132,172,304
88839,2021-03-12,14,201,236,437
88840,2021-03-12,15,206,293,499
88841,2021-03-12,16,318,376,694
88842,2021-03-12,17,385,438,823
88843,2021-03-12,18,270,356,626
88844,2021-03-12,19,160,208,368
88845,2021-03-12,20,108,143,251
88846,2021-03-12,21,107,104,211
88847,2021-03-12,22,131,95,226
88848,2021-03-12,23,80,74,154
88849,2021-03-13,0,42,40,82
88850,2021-03-13,1,29,29,58
88851,2021-03-13,2,19,11,30
88852,2021-03-13,3,10,4,14
88853,2021-03-13,4,5,6,11
88854,2021-03-13,5,5,9,14
88855,2021-03-13,6,14,24,38
88856,2021-03-13,7,22,54,76
88857,2021-03-13,8,71,107,178
88858,2021-03-13,9,115,172,287
88859,2021-03-13,10,214,233,447
88860,2021-03-13,11,348,311,659
88861,2021-03-13,12,408,361,769
88862,2021-03-13,13,489,344,833
88863,2021-03-13,14,515,362,877
88864,2021-03-13,15,534,329,863
88865,2021-03-13,16,517,355,872
88866,2021-03-13,17,385,321,706
88867,2021-03-13,18,242,242,484
88868,2021-03-13,19,145,163,308
88869,2021-03-13,20,77,89,166
88870,2021-03-13,21,90,72,162
88871,2021-03-13,22,111,75,186
88872,2021-03-13,23,90,45,135
88873,2021-03-14,0,50,33,83
88874,2021-03-14,1,21,16,37
88875,2021-03-14,3,14,13,27
88876,2021-03-14,4,10,5,15
88877,2021-03-14,5,7,3,10
88878,2021-03-14,6,10,17,27
88879,2021-03-14,7,11,29,40
88880,2021-03-14,8,31,67,98
88881,2021-03-14,9,73,115,188
88882,2021-03-14,10,157,183,340
88883,2021-03-14,11,251,260,511
88884,2021-03-14,12,369,295,664
88885,2021-03-14,13,432,386,818
88886,2021-03-14,14,460,353,813
88887,2021-03-14,15,463,340,803
88888,2021-03-14,16,457,317,774
88889,2021-03-14,17,336,290,626
88890,2021-03-14,18,204,215,419
88891,2021-03-14,19,124,153,277
88892,2021-03-14,20,59,74,133
88893,2021-03-14,21,44,68,112
88894,2021-03-14,22,30,38,68
88895,2021-03-14,23,27,22,49
88896,2021-03-15,0,7,3,10
88897,2021-03-15,1,1,5,6
88898,2021-03-15,2,1,5,6
88899,2021-03-15,3,3,2,5
88900,2021-03-15,4,3,7,10
88901,2021-03-15,5,3,16,19
88902,2021-03-15,6,19,46,65
88903,2021-03-15,7,23,113,136
88904,2021-03-15,8,42,158,200
88905,2021-03-15,9,39,121,160
88906,2021-03-15,10,39,72,111
88907,2021-03-15,11,42,99,141
88908,2021-03-15,12,93,134,227
88909,2021-03-15,13,87,138,225
88910,2021-03-15,14,99,144,243
88911,2021-03-15,15,118,169,287
88912,2021-03-15,16,164,197,361
88913,2021-03-15,17,169,308,477
88914,2021-03-15,18,113,259,372
88915,2021-03-15,19,74,181,255
88916,2021-03-15,20,36,85,121
88917,2021-03-15,21,28,69,97
88918,2021-03-15,22,30,39,69
88919,2021-03-15,23,16,24,40
88920,2021-03-16,0,8,6,14
88921,2021-03-16,1,4,4,8
88922,2021-03-16,2,2,1,3
88923,2021-03-16,3,1,2,3
88924,2021-03-16,4,4,3,7
88925,2021-03-16,5,5,24,29
88926,2021-03-16,6,13,63,76
88927,2021-03-16,7,27,119,146
88928,2021-03-16,8,39,178,217
88929,2021-03-16,9,50,126,176
88930,2021-03-16,10,42,98,140
88931,2021-03-16,11,62,122,184
88932,2021-03-16,12,74,132,206
88933,2021-03-16,13,63,135,198
88934,2021-03-16,14,81,135,216
88935,2021-03-16,15,80,143,223
88936,2021-03-16,16,103,191,294
88937,2021-03-16,17,91,271,362
88938,2021-03-16,18,91,275,366
88939,2021-03-16,19,67,195,262
88940,2021-03-16,20,53,92,145
88941,2021-03-16,21,18,65,83
88942,2021-03-16,22,31,36,67
88943,2021-03-16,23,20,14,34
88944,2021-03-17,0,9,13,22
88945,2021-03-17,1,0,3,3
88946,2021-03-17,2,3,2,5
88947,2021-03-17,3,1,2,3
88948,2021-03-17,4,12,5,17
88949,2021-03-17,5,12,28,40
88950,2021-03-17,6,14,70,84
88951,2021-03-17,7,26,128,154
88952,2021-03-17,8,49,192,241
88953,2021-03-17,9,34,148,182
88954,2021-03-17,10,59,106,165
88955,2021-03-17,11,89,124,213
88956,2021-03-17,12,95,186,281
88957,2021-03-17,13,136,174,310
88958,2021-03-17,14,132,149,281
88959,2021-03-17,15,137,176,313
88960,2021-03-17,16,120,224,344
88961,2021-03-17,17,185,375,560
88962,2021-03-17,18,167,351,518
88963,2021-03-17,19,119,222,341
88964,2021-03-17,20,72,130,202
88965,2021-03-17,21,57,94,151
88966,2021-03-17,22,46,80,126
88967,2021-03-17,23,36,37,73
88968,2021-03-18,0,15,17,32
88969,2021-03-18,1,8,3,11
88970,2021-03-18,2,5,10,15
88971,2021-03-18,3,4,3,7
88972,2021-03-18,4,2,9,11
88973,2021-03-18,5,6,16,22
88974,2021-03-18,6,6,29,35
88975,2021-03-18,7,13,46,59
88976,2021-03-18,8,21,87,108
88977,2021-03-18,9,18,64,82
88978,2021-03-18,10,28,68,96
88979,2021-03-18,11,39,61,100
88980,2021-03-18,12,19,72,91
88981,2021-03-18,13,27,57,84
88982,2021-03-18,14,33,43,76
88983,2021-03-18,15,50,98,148
88984,2021-03-18,16,36,113,149
88985,2021-03-18,17,45,158,203
88986,2021-03-18,18,50,192,242
88987,2021-03-18,19,35,102,137
88988,2021-03-18,20,21,80,101
88989,2021-03-18,21,26,51,77
88990,2021-03-18,22,29,40,69
88991,2021-03-18,23,22,26,48
88992,2021-03-19,0,18,14,32
88993,2021-03-19,1,9,3,12
88994,2021-03-19,2,5,6,11
88995,2021-03-19,3,3,5,8
88996,2021-03-19,4,4,11,15
88997,2021-03-19,5,8,22,30
88998,2021-03-19,6,12,48,60
88999,2021-03-19,7,23,133,156
89000,2021-03-19,8,47,158,205
89001,2021-03-19,9,44,134,178
89002,2021-03-19,10,55,132,187
89003,2021-03-19,11,85,136,221
89004,2021-03-19,12,123,186,309
89005,2021-03-19,13,138,145,283
89006,2021-03-19,14,131,179,310
89007,2021-03-19,15,182,230,412
89008,2021-03-19,16,175,234,409
89009,2021-03-19,17,197,354,551
89010,2021-03-19,18,196,344,540
89011,2021-03-19,19,119,225,344
89012,2021-03-19,20,63,99,162
89013,2021-03-19,21,46,81,127
89014,2021-03-19,22,49,71,120
89015,2021-03-19,23,41,67,108
89016,2021-03-20,0,33,38,71
89017,2021-03-20,1,11,17,28
89018,2021-03-20,2,8,7,15
89019,2021-03-20,3,8,9,17
89020,2021-03-20,4,6,6,12
89021,2021-03-20,5,4,8,12
89022,2021-03-20,6,15,18,33
89023,2021-03-20,7,30,52,82
89024,2021-03-20,8,49,76,125
89025,2021-03-20,9,81,136,217
89026,2021-03-20,10,183,217,400
89027,2021-03-20,11,325,291,616
89028,2021-03-20,12,404,335,739
89029,2021-03-20,13,404,366,770
89030,2021-03-20,14,513,371,884
89031,2021-03-20,15,530,347,877
89032,2021-03-20,16,501,344,845
89033,2021-03-20,17,448,365,813
89034,2021-03-20,18,308,339,647
89035,2021-03-20,19,174,226,400
89036,2021-03-20,20,106,106,212
89037,2021-03-20,21,74,82,156
89038,2021-03-20,22,104,62,166
89039,2021-03-20,23,59,57,116
89040,2021-03-21,0,75,52,127
89041,2021-03-21,1,21,8,29
89042,2021-03-21,2,7,13,20
89043,2021-03-21,3,6,3,9
89044,2021-03-21,4,4,3,7
89045,2021-03-21,5,9,5,14
89046,2021-03-21,6,16,14,30
89047,2021-03-21,7,9,29,38
89048,2021-03-21,8,38,87,125
89049,2021-03-21,9,93,160,253
89050,2021-03-21,10,153,241,394
89051,2021-03-21,11,267,259,526
89052,2021-03-21,12,403,362,765
89053,2021-03-21,13,512,395,907
89054,2021-03-21,14,525,428,953
89055,2021-03-21,15,523,442,965
89056,2021-03-21,16,496,412,908
89057,2021-03-21,17,374,359,733
89058,2021-03-21,18,304,270,574
89059,2021-03-21,19,120,162,282
89060,2021-03-21,20,98,93,191
89061,2021-03-21,21,45,49,94
89062,2021-03-21,22,51,35,86
89063,2021-03-21,23,31,28,59
89064,2021-03-22,0,12,17,29
89065,2021-03-22,1,3,5,8
89066,2021-03-22,2,6,5,11
89067,2021-03-22,3,0,3,3
89068,2021-03-22,4,6,8,14
89069,2021-03-22,5,4,22,26
89070,2021-03-22,6,22,58,80
89071,2021-03-22,7,30,129,159
89072,2021-03-22,8,61,180,241
89073,2021-03-22,9,70,148,218
89074,2021-03-22,10,75,135,210
89075,2021-03-22,11,104,137,241
89076,2021-03-22,12,116,196,312
89077,2021-03-22,13,168,137,305
89078,2021-03-22,14,185,219,404
89079,2021-03-22,15,174,235,409
89080,2021-03-22,16,236,255,491
89081,2021-03-22,17,258,428,686
89082,2021-03-22,18,276,383,659
89083,2021-03-22,19,177,244,421
89084,2021-03-22,20,85,132,217
89085,2021-03-22,21,73,89,162
89086,2021-03-22,22,41,34,75
89087,2021-03-22,23,36,30,66
89088,2021-03-23,0,23,13,36
89089,2021-03-23,1,19,3,22
89090,2021-03-23,2,1,1,2
89091,2021-03-23,3,2,4,6
89092,2021-03-23,4,6,7,13
89093,2021-03-23,5,6,26,32
89094,2021-03-23,6,19,70,89
89095,2021-03-23,7,31,161,192
89096,2021-03-23,8,71,254,325
89097,2021-03-23,9,60,157,217
89098,2021-03-23,10,92,124,216
89099,2021-03-23,11,106,154,260
89100,2021-03-23,12,155,211,366
89101,2021-03-23,13,155,163,318
89102,2021-03-23,14,151,196,347
89103,2021-03-23,15,175,234,409
89104,2021-03-23,16,218,343,561
89105,2021-03-23,17,261,431,692
89106,2021-03-23,18,223,440,663
89107,2021-03-23,19,184,295,479
89108,2021-03-23,20,97,140,237
89109,2021-03-23,21,85,92,177
89110,2021-03-23,22,57,61,118
89111,2021-03-23,23,32,26,58
89112,2021-03-24,0,16,9,25
89113,2021-03-24,1,3,3,6
89114,2021-03-24,2,9,3,12
89115,2021-03-24,3,1,1,2
89116,2021-03-24,4,9,5,14
89117,2021-03-24,5,5,15,20
89118,2021-03-24,6,12,43,55
89119,2021-03-24,7,9,55,64
89120,2021-03-24,8,23,95,118
89121,2021-03-24,9,26,89,115
89122,2021-03-24,10,8,23,31
89123,2021-03-24,11,11,44,55
89124,2021-03-24,12,7,40,47
89125,2021-03-24,13,5,30,35
89126,2021-03-24,14,13,45,58
89127,2021-03-24,15,23,74,97
89128,2021-03-24,16,24,91,115
89129,2021-03-24,17,43,173,216
89130,2021-03-24,18,79,199,278
89131,2021-03-24,19,61,156,217
89132,2021-03-24,20,39,110,149
89133,2021-03-24,21,40,89,129
89134,2021-03-24,22,41,37,78
89135,2021-03-24,23,15,36,51
89136,2021-03-25,0,13,14,27
89137,2021-03-25,1,8,6,14
89138,2021-03-25,2,6,5,11
89139,2021-03-25,3,4,1,5
89140,2021-03-25,4,5,6,11
89141,2021-03-25,5,7,19,26
89142,2021-03-25,6,19,67,86
89143,2021-03-25,7,44,145,189
89144,2021-03-25,8,63,216,279
89145,2021-03-25,9,65,166,231
89146,2021-03-25,10,74,160,234
89147,2021-03-25,11,101,150,251
89148,2021-03-25,12,117,213,330
89149,2021-03-25,13,119,178,297
89150,2021-03-25,14,145,195,340
89151,2021-03-25,15,138,204,342
89152,2021-03-25,16,170,244,414
89153,2021-03-25,17,220,472,692
89154,2021-03-25,18,170,356,526
89155,2021-03-25,19,123,240,363
89156,2021-03-25,20,91,161,252
89157,2021-03-25,21,65,121,186
89158,2021-03-25,22,70,95,165
89159,2021-03-25,23,56,36,92
89160,2021-03-26,0,25,22,47
89161,2021-03-26,1,11,12,23
89162,2021-03-26,2,6,6,12
89163,2021-03-26,3,5,3,8
89164,2021-03-26,4,5,6,11
89165,2021-03-26,5,10,24,34
89166,2021-03-26,6,17,78,95
89167,2021-03-26,7,51,143,194
89168,2021-03-26,8,73,228,301
89169,2021-03-26,9,74,184,258
89170,2021-03-26,10,122,184,306
89171,2021-03-26,11,167,241,408
89172,2021-03-26,12,234,259,493
89173,2021-03-26,13,261,294,555
89174,2021-03-26,14,303,286,589
89175,2021-03-26,15,335,334,669
89176,2021-03-26,16,400,424,824
89177,2021-03-26,17,513,531,1044
89178,2021-03-26,18,454,484,938
89179,2021-03-26,19,342,311,653
89180,2021-03-26,20,199,206,405
89181,2021-03-26,21,127,141,268
89182,2021-03-26,22,131,98,229
89183,2021-03-26,23,117,85,202
89184,2021-03-27,0,96,69,165
89185,2021-03-27,1,43,34,77
89186,2021-03-27,2,21,9,30
89187,2021-03-27,3,10,12,22
89188,2021-03-27,4,5,9,14
89189,2021-03-27,5,5,13,18
89190,2021-03-27,6,27,35,62
89191,2021-03-27,7,45,93,138
89192,2021-03-27,8,105,163,268
89193,2021-03-27,9,248,270,518
89194,2021-03-27,10,430,365,795
89195,2021-03-27,11,594,433,1027
89196,2021-03-27,12,814,459,1273
89197,2021-03-27,13,989,477,1466
89198,2021-03-27,14,1008,457,1465
89199,2021-03-27,15,929,453,1382
89200,2021-03-27,16,871,448,1319
89201,2021-03-27,17,654,360,1014
89202,2021-03-27,18,465,304,769
89203,2021-03-27,19,295,232,527
89204,2021-03-27,20,171,134,305
89205,2021-03-27,21,163,95,258
89206,2021-03-27,22,137,97,234
89207,2021-03-27,23,105,84,189
89208,2021-03-28,0,126,66,192
89209,2021-03-28,1,61,22,83
89210,2021-03-28,2,27,18,45
89211,2021-03-28,3,11,9,20
89212,2021-03-28,4,5,5,10
89213,2021-03-28,5,5,8,13
89214,2021-03-28,6,9,15,24
89215,2021-03-28,7,8,7,15
89216,2021-03-28,8,8,30,38
89217,2021-03-28,9,14,53,67
89218,2021-03-28,10,82,136,218
89219,2021-03-28,11,141,159,300
89220,2021-03-28,12,124,161,285
89221,2021-03-28,13,143,183,326
89222,2021-03-28,14,229,197,426
89223,2021-03-28,15,296,249,545
89224,2021-03-28,16,258,273,531
89225,2021-03-28,17,236,185,421
89226,2021-03-28,18,33,51,84
89227,2021-03-28,19,53,78,131
89228,2021-03-28,20,60,66,126
89229,2021-03-28,21,49,48,97
89230,2021-03-28,22,26,38,64
89231,2021-03-28,23,23,14,37
89232,2021-03-29,0,13,11,24
89233,2021-03-29,1,4,6,10
89234,2021-03-29,2,1,3,4
89235,2021-03-29,3,4,0,4
89236,2021-03-29,4,7,8,15
89237,2021-03-29,5,9,26,35
89238,2021-03-29,6,23,61,84
89239,2021-03-29,7,39,159,198
89240,2021-03-29,8,66,238,304
89241,2021-03-29,9,85,152,237
89242,2021-03-29,10,105,134,239
89243,2021-03-29,11,182,164,346
89244,2021-03-29,12,216,204,420
89245,2021-03-29,13,224,216,440
89246,2021-03-29,14,272,207,479
89247,2021-03-29,15,301,246,547
89248,2021-03-29,16,297,326,623
89249,2021-03-29,17,330,496,826
89250,2021-03-29,18,327,464,791
89251,2021-03-29,19,223,310,533
89252,2021-03-29,20,117,182,299
89253,2021-03-29,21,81,89,170
89254,2021-03-29,22,48,55,103
89255,2021-03-29,23,20,28,48
89256,2021-03-30,0,16,11,27
89257,2021-03-30,1,10,4,14
89258,2021-03-30,2,1,4,5
89259,2021-03-30,3,2,1,3
89260,2021-03-30,4,8,8,16
89261,2021-03-30,5,6,24,30
89262,2021-03-30,6,63,112,175
89263,2021-03-30,7,92,201,293
89264,2021-03-30,8,130,274,404
89265,2021-03-30,9,112,178,290
89266,2021-03-30,10,177,164,341
89267,2021-03-30,11,220,189,409
89268,2021-03-30,12,355,272,627
89269,2021-03-30,13,300,242,542
89270,2021-03-30,14,347,273,620
89271,2021-03-30,15,389,305,694
89272,2021-03-30,16,459,396,855
89273,2021-03-30,17,677,629,1306
89274,2021-03-30,18,649,564,1213
89275,2021-03-30,19,366,383,749
89276,2021-03-30,20,204,247,451
89277,2021-03-30,21,105,124,229
89278,2021-03-30,22,66,92,158
89279,2021-03-30,23,48,49,97
89280,2021-03-31,0,18,17,35
89281,2021-03-31,1,16,1,17
89282,2021-03-31,2,1,2,3
89283,2021-03-31,3,5,5,10
89284,2021-03-31,4,9,6,15
89285,2021-03-31,5,16,19,35
89286,2021-03-31,6,46,94,140
89287,2021-03-31,7,80,186,266
89288,2021-03-31,8,105,264,369
89289,2021-03-31,9,103,207,310
89290,2021-03-31,10,92,167,259
89291,2021-03-31,11,148,184,332
89292,2021-03-31,12,106,190,296
89293,2021-03-31,13,20,64,84
89294,2021-03-31,14,16,34,50
89295,2021-03-31,15,26,50,76
89296,2021-03-31,16,24,54,78
89297,2021-03-31,17,31,104,135
89298,2021-03-31,18,66,198,264
89299,2021-03-31,19,61,158,219
89300,2021-03-31,20,48,95,143
89301,2021-03-31,21,35,64,99
89302,2021-03-31,22,39,39,78
89303,2021-03-31,23,27,37,64
89304,2021-04-01,0,15,8,23
89305,2021-04-01,1,10,2,12
89306,2021-04-01,2,3,3,6
89307,2021-04-01,3,2,0,2
89308,2021-04-01,4,4,4,8
89309,2021-04-01,5,4,8,12
89310,2021-04-01,6,11,39,50
89311,2021-04-01,7,36,100,136
89312,2021-04-01,8,65,181,246
89313,2021-04-01,9,82,150,232
89314,2021-04-01,10,127,155,282
89315,2021-04-01,11,144,131,275
89316,2021-04-01,12,159,168,327
89317,2021-04-01,13,156,170,326
89318,2021-04-01,14,143,149,292
89319,2021-04-01,15,147,169,316
89320,2021-04-01,16,151,203,354
89321,2021-04-01,17,148,283,431
89322,2021-04-01,18,133,292,425
89323,2021-04-01,19,104,165,269
89324,2021-04-01,20,68,122,190
89325,2021-04-01,21,44,87,131
89326,2021-04-01,22,41,43,84
89327,2021-04-01,23,26,38,64
89328,2021-04-02,0,16,12,28
89329,2021-04-02,1,4,4,8
89330,2021-04-02,2,2,3,5
89331,2021-04-02,3,3,1,4
89332,2021-04-02,4,5,8,13
89333,2021-04-02,5,6,14,20
89334,2021-04-02,6,29,52,81
89335,2021-04-02,7,42,123,165
89336,2021-04-02,8,71,136,207
89337,2021-04-02,9,85,140,225
89338,2021-04-02,10,123,151,274
89339,2021-04-02,11,140,160,300
89340,2021-04-02,12,171,165,336
89341,2021-04-02,13,211,195,406
89342,2021-04-02,14,257,179,436
89343,2021-04-02,15,251,215,466
89344,2021-04-02,16,246,243,489
89345,2021-04-02,17,265,276,541
89346,2021-04-02,18,214,296,510
89347,2021-04-02,19,132,232,364
89348,2021-04-02,20,87,120,207
89349,2021-04-02,21,63,71,134
89350,2021-04-02,22,49,51,100
89351,2021-04-02,23,67,57,124
89352,2021-04-03,0,56,27,83
89353,2021-04-03,1,24,12,36
89354,2021-04-03,2,4,8,12
89355,2021-04-03,3,5,2,7
89356,2021-04-03,4,5,5,10
89357,2021-04-03,5,4,3,7
89358,2021-04-03,6,37,23,60
89359,2021-04-03,7,37,53,90
89360,2021-04-03,8,73,84,157
89361,2021-04-03,9,190,191,381
89362,2021-04-03,10,298,217,515
89363,2021-04-03,11,513,284,797
89364,2021-04-03,12,645,299,944
89365,2021-04-03,13,767,372,1139
89366,2021-04-03,14,917,332,1249
89367,2021-04-03,15,821,367,1188
89368,2021-04-03,16,786,345,1131
89369,2021-04-03,17,763,316,1079
89370,2021-04-03,18,512,287,799
89371,2021-04-03,19,322,193,515
89372,2021-04-03,20,154,102,256
89373,2021-04-03,21,107,94,201
89374,2021-04-03,22,64,70,134
89375,2021-04-03,23,98,56,154
89376,2021-04-04,0,52,54,106
89377,2021-04-04,1,36,31,67
89378,2021-04-04,2,14,13,27
89379,2021-04-04,3,7,2,9
89380,2021-04-04,4,5,5,10
89381,2021-04-04,5,4,6,10
89382,2021-04-04,6,28,36,64
89383,2021-04-04,7,41,50,91
89384,2021-04-04,8,98,103,201
89385,2021-04-04,9,195,145,340
89386,2021-04-04,10,375,243,618
89387,2021-04-04,11,513,304,817
89388,2021-04-04,12,633,339,972
89389,2021-04-04,13,819,372,1191
89390,2021-04-04,14,864,374,1238
89391,2021-04-04,15,903,454,1357
89392,2021-04-04,16,760,398,1158
89393,2021-04-04,17,715,349,1064
89394,2021-04-04,18,576,295,871
89395,2021-04-04,19,366,204,570
89396,2021-04-04,20,176,119,295
89397,2021-04-04,21,130,72,202
89398,2021-04-04,22,80,50,130
89399,2021-04-04,23,50,31,81
89400,2021-04-05,0,27,8,35
89401,2021-04-05,1,13,4,17
89402,2021-04-05,2,4,3,7
89403,2021-04-05,3,7,1,8
89404,2021-04-05,4,10,4,14
89405,2021-04-05,5,12,23,35
89406,2021-04-05,6,27,76,103
89407,2021-04-05,7,60,149,209
89408,2021-04-05,8,81,223,304
89409,2021-04-05,9,94,142,236
89410,2021-04-05,10,175,134,309
89411,2021-04-05,11,233,182,415
89412,2021-04-05,12,309,208,517
89413,2021-04-05,13,344,215,559
89414,2021-04-05,14,333,210,543
89415,2021-04-05,15,317,261,578
89416,2021-04-05,16,382,346,728
89417,2021-04-05,17,404,525,929
89418,2021-04-05,18,411,441,852
89419,2021-04-05,19,287,324,611
89420,2021-04-05,20,124,145,269
89421,2021-04-05,21,74,99,173
89422,2021-04-05,22,65,64,129
89423,2021-04-05,23,42,46,88
89424,2021-04-06,0,16,28,44
89425,2021-04-06,1,21,19,40
89426,2021-04-06,2,15,3,18
89427,2021-04-06,3,4,3,7
89428,2021-04-06,4,7,5,12
89429,2021-04-06,5,7,31,38
89430,2021-04-06,6,26,100,126
89431,2021-04-06,7,62,221,283
89432,2021-04-06,8,105,254,359
89433,2021-04-06,9,104,201,305
89434,2021-04-06,10,126,176,302
89435,2021-04-06,11,183,198,381
89436,2021-04-06,12,241,242,483
89437,2021-04-06,13,251,265,516
89438,2021-04-06,14,262,246,508
89439,2021-04-06,15,290,249,539
89440,2021-04-06,16,325,343,668
89441,2021-04-06,17,383,551,934
89442,2021-04-06,18,437,449,886
89443,2021-04-06,19,297,344,641
89444,2021-04-06,20,157,214,371
89445,2021-04-06,21,105,130,235
89446,2021-04-06,22,74,84,158
89447,2021-04-06,23,32,50,82
89448,2021-04-07,0,22,17,39
89449,2021-04-07,1,12,4,16
89450,2021-04-07,2,5,6,11
89451,2021-04-07,3,4,5,9
89452,2021-04-07,4,4,6,10
89453,2021-04-07,5,9,21,30
89454,2021-04-07,6,24,89,113
89455,2021-04-07,7,60,186,246
89456,2021-04-07,8,91,310,401
89457,2021-04-07,9,90,188,278
89458,2021-04-07,10,149,173,322
89459,2021-04-07,11,205,188,393
89460,2021-04-07,12,233,266,499
89461,2021-04-07,13,264,262,526
89462,2021-04-07,14,257,242,499
89463,2021-04-07,15,294,298,592
89464,2021-04-07,16,325,325,650
89465,2021-04-07,17,376,552,928
89466,2021-04-07,18,351,480,831
89467,2021-04-07,19,265,313,578
89468,2021-04-07,20,164,227,391
89469,2021-04-07,21,98,140,238
89470,2021-04-07,22,108,94,202
89471,2021-04-07,23,51,43,94
89472,2021-04-08,0,34,25,59
89473,2021-04-08,1,11,7,18
89474,2021-04-08,2,7,6,13
89475,2021-04-08,3,5,1,6
89476,2021-04-08,4,11,10,21
89477,2021-04-08,5,9,22,31
89478,2021-04-08,6,25,93,118
89479,2021-04-08,7,65,170,235
89480,2021-04-08,8,84,262,346
89481,2021-04-08,9,104,205,309
89482,2021-04-08,10,118,164,282
89483,2021-04-08,11,197,190,387
89484,2021-04-08,12,229,223,452
89485,2021-04-08,13,287,239,526
89486,2021-04-08,14,277,253,530
89487,2021-04-08,15,276,284,560
89488,2021-04-08,16,300,355,655
89489,2021-04-08,17,357,531,888
89490,2021-04-08,18,355,498,853
89491,2021-04-08,19,244,390,634
89492,2021-04-08,20,122,237,359
89493,2021-04-08,21,95,140,235
89494,2021-04-08,22,85,86,171
89495,2021-04-08,23,61,41,102
89496,2021-04-09,0,35,24,59
89497,2021-04-09,1,8,5,13
89498,2021-04-09,2,6,4,10
89499,2021-04-09,3,4,3,7
89500,2021-04-09,4,3,7,10
89501,2021-04-09,5,2,8,10
89502,2021-04-09,6,17,47,64
89503,2021-04-09,7,36,137,173
89504,2021-04-09,8,57,195,252
89505,2021-04-09,9,68,162,230
89506,2021-04-09,10,85,160,245
89507,2021-04-09,11,115,181,296
89508,2021-04-09,12,194,205,399
89509,2021-04-09,13,198,221,419
89510,2021-04-09,14,210,231,441
89511,2021-04-09,15,254,303,557
89512,2021-04-09,16,226,309,535
89513,2021-04-09,17,139,324,463
89514,2021-04-09,18,160,325,485
89515,2021-04-09,19,142,235,377
89516,2021-04-09,20,110,147,257
89517,2021-04-09,21,109,102,211
89518,2021-04-09,22,60,94,154
89519,2021-04-09,23,85,79,164
89520,2021-04-10,0,62,43,105
89521,2021-04-10,1,32,25,57
89522,2021-04-10,2,21,14,35
89523,2021-04-10,3,5,9,14
89524,2021-04-10,4,4,6,10
89525,2021-04-10,5,6,8,14
89526,2021-04-10,6,20,35,55
89527,2021-04-10,7,36,77,113
89528,2021-04-10,8,89,139,228
89529,2021-04-10,9,157,251,408
89530,2021-04-10,10,274,240,514
89531,2021-04-10,11,411,302,713
89532,2021-04-10,12,518,379,897
89533,2021-04-10,13,666,424,1090
89534,2021-04-10,14,740,377,1117
89535,2021-04-10,15,708,404,1112
89536,2021-04-10,16,687,380,1067
89537,2021-04-10,17,642,398,1040
89538,2021-04-10,18,519,353,872
89539,2021-04-10,19,379,308,687
89540,2021-04-10,20,244,173,417
89541,2021-04-10,21,177,155,332
89542,2021-04-10,22,179,123,302
89543,2021-04-10,23,139,87,226
89544,2021-04-11,0,83,45,128
89545,2021-04-11,1,25,17,42
89546,2021-04-11,2,15,12,27
89547,2021-04-11,3,4,6,10
89548,2021-04-11,4,3,3,6
89549,2021-04-11,5,2,8,10
89550,2021-04-11,6,10,24,34
89551,2021-04-11,7,17,33,50
89552,2021-04-11,8,69,93,162
89553,2021-04-11,9,203,202,405
89554,2021-04-11,10,286,271,557
89555,2021-04-11,11,443,351,794
89556,2021-04-11,12,593,402,995
89557,2021-04-11,13,634,403,1037
89558,2021-04-11,14,603,436,1039
89559,2021-04-11,15,691,467,1158
89560,2021-04-11,16,556,411,967
89561,2021-04-11,17,436,352,788
89562,2021-04-11,18,234,271,505
89563,2021-04-11,19,193,209,402
89564,2021-04-11,20,70,109,179
89565,2021-04-11,21,63,80,143
89566,2021-04-11,22,73,48,121
89567,2021-04-11,23,61,33,94
89568,2021-04-12,0,33,24,57
89569,2021-04-12,1,18,5,23
89570,2021-04-12,2,2,3,5
89571,2021-04-12,3,9,5,14
89572,2021-04-12,4,8,10,18
89573,2021-04-12,5,14,27,41
89574,2021-04-12,6,35,71,106
89575,2021-04-12,7,45,171,216
89576,2021-04-12,8,78,236,314
89577,2021-04-12,9,82,180,262
89578,2021-04-12,10,102,169,271
89579,2021-04-12,11,148,207,355
89580,2021-04-12,12,133,204,337
89581,2021-04-12,13,77,169,246
89582,2021-04-12,14,113,176,289
89583,2021-04-12,15,117,180,297
89584,2021-04-12,16,179,244,423
89585,2021-04-12,17,191,373,564
89586,2021-04-12,18,151,325,476
89587,2021-04-12,19,123,254,377
89588,2021-04-12,20,54,139,193
89589,2021-04-12,21,44,56,100
89590,2021-04-12,22,19,27,46
89591,2021-04-12,23,19,31,50
89592,2021-04-13,0,20,13,33
89593,2021-04-13,1,8,5,13
89594,2021-04-13,2,8,1,9
89595,2021-04-13,3,4,0,4
89596,2021-04-13,4,8,13,21
89597,2021-04-13,5,9,32,41
89598,2021-04-13,6,18,102,120
89599,2021-04-13,7,45,146,191
89600,2021-04-13,8,73,269,342
89601,2021-04-13,9,84,206,290
89602,2021-04-13,10,107,144,251
89603,2021-04-13,11,121,198,319
89604,2021-04-13,12,120,222,342
89605,2021-04-13,13,153,206,359
89606,2021-04-13,14,131,235,366
89607,2021-04-13,15,185,265,450
89608,2021-04-13,16,163,298,461
89609,2021-04-13,17,282,512,794
89610,2021-04-13,18,255,489,744
89611,2021-04-13,19,235,315,550
89612,2021-04-13,20,109,228,337
89613,2021-04-13,21,65,99,164
89614,2021-04-13,22,54,84,138
89615,2021-04-13,23,43,44,87
89616,2021-04-14,0,27,16,43
89617,2021-04-14,1,13,5,18
89618,2021-04-14,2,7,2,9
89619,2021-04-14,3,6,2,8
89620,2021-04-14,4,6,11,17
89621,2021-04-14,5,9,25,34
89622,2021-04-14,6,25,91,116
89623,2021-04-14,7,56,162,218
89624,2021-04-14,8,73,273,346
89625,2021-04-14,9,68,201,269
89626,2021-04-14,10,107,179,286
89627,2021-04-14,11,68,140,208
89628,2021-04-14,12,56,119,175
89629,2021-04-14,13,61,111,172
89630,2021-04-14,14,64,104,168
89631,2021-04-14,15,36,101,137
89632,2021-04-14,16,41,84,125
89633,2021-04-14,17,59,142,201
89634,2021-04-14,18,36,149,185
89635,2021-04-14,19,27,96,123
89636,2021-04-14,20,15,58,73
89637,2021-04-14,21,14,47,61
89638,2021-04-14,22,24,45,69
89639,2021-04-14,23,34,20,54
89640,2021-04-15,0,14,7,21
89641,2021-04-15,1,6,5,11
89642,2021-04-15,2,2,5,7
89643,2021-04-15,3,3,2,5
89644,2021-04-15,4,5,13,18
89645,2021-04-15,5,10,30,40
89646,2021-04-15,6,24,70,94
89647,2021-04-15,7,61,147,208
89648,2021-04-15,8,78,276,354
89649,2021-04-15,9,99,218,317
89650,2021-04-15,10,106,176,282
89651,2021-04-15,11,147,227,374
89652,2021-04-15,12,163,269,432
89653,2021-04-15,13,170,275,445
89654,2021-04-15,14,221,231,452
89655,2021-04-15,15,227,238,465
89656,2021-04-15,16,214,345,559
89657,2021-04-15,17,369,529,898
89658,2021-04-15,18,280,457,737
89659,2021-04-15,19,186,341,527
89660,2021-04-15,20,96,176,272
89661,2021-04-15,21,69,128,197
89662,2021-04-15,22,68,97,165
89663,2021-04-15,23,65,66,131
89664,2021-04-16,0,30,30,60
89665,2021-04-16,1,12,8,20
89666,2021-04-16,2,4,5,9
89667,2021-04-16,3,4,11,15
89668,2021-04-16,4,3,12,15
89669,2021-04-16,5,6,16,22
89670,2021-04-16,6,22,70,92
89671,2021-04-16,7,38,146,184
89672,2021-04-16,8,76,230,306
89673,2021-04-16,9,83,180,263
89674,2021-04-16,10,128,161,289
89675,2021-04-16,11,116,193,309
89676,2021-04-16,12,146,208,354
89677,2021-04-16,13,179,227,406
89678,2021-04-16,14,195,238,433
89679,2021-04-16,15,213,258,471
89680,2021-04-16,16,234,322,556
89681,2021-04-16,17,243,423,666
89682,2021-04-16,18,246,395,641
89683,2021-04-16,19,183,295,478
89684,2021-04-16,20,75,190,265
89685,2021-04-16,21,73,112,185
89686,2021-04-16,22,62,104,166
89687,2021-04-16,23,72,97,169
89688,2021-04-17,0,65,54,119
89689,2021-04-17,1,25,33,58
89690,2021-04-17,2,16,21,37
89691,2021-04-17,3,6,13,19
89692,2021-04-17,4,2,4,6
89693,2021-04-17,5,5,12,17
89694,2021-04-17,6,19,35,54
89695,2021-04-17,7,21,67,88
89696,2021-04-17,8,58,134,192
89697,2021-04-17,9,150,209,359
89698,2021-04-17,10,261,302,563
89699,2021-04-17,11,342,338,680
89700,2021-04-17,12,431,404,835
89701,2021-04-17,13,447,388,835
89702,2021-04-17,14,550,355,905
89703,2021-04-17,15,469,364,833
89704,2021-04-17,16,479,373,852
89705,2021-04-17,17,384,326,710
89706,2021-04-17,18,353,344,697
89707,2021-04-17,19,247,247,494
89708,2021-04-17,20,170,183,353
89709,2021-04-17,21,116,97,213
89710,2021-04-17,22,144,119,263
89711,2021-04-17,23,147,95,242
89712,2021-04-18,0,98,50,148
89713,2021-04-18,1,63,34,97
89714,2021-04-18,2,24,15,39
89715,2021-04-18,3,16,8,24
89716,2021-04-18,4,7,1,8
89717,2021-04-18,5,10,14,24
89718,2021-04-18,6,9,32,41
89719,2021-04-18,7,31,44,75
89720,2021-04-18,8,75,133,208
89721,2021-04-18,9,136,203,339
89722,2021-04-18,10,293,271,564
89723,2021-04-18,11,358,314,672
89724,2021-04-18,12,393,370,763
89725,2021-04-18,13,547,395,942
89726,2021-04-18,14,591,430,1021
89727,2021-04-18,15,522,445,967
89728,2021-04-18,16,440,366,806
89729,2021-04-18,17,345,337,682
89730,2021-04-18,18,250,246,496
89731,2021-04-18,19,174,193,367
89732,2021-04-18,20,137,120,257
89733,2021-04-18,21,98,93,191
89734,2021-04-18,22,58,56,114
89735,2021-04-18,23,52,39,91
89736,2021-04-19,0,36,16,52
89737,2021-04-19,1,10,4,14
89738,2021-04-19,2,9,5,14
89739,2021-04-19,3,2,2,4
89740,2021-04-19,4,9,10,19
89741,2021-04-19,5,8,30,38
89742,2021-04-19,6,26,76,102
89743,2021-04-19,7,51,144,195
89744,2021-04-19,8,80,242,322
89745,2021-04-19,9,68,167,235
89746,2021-04-19,10,55,89,144
89747,2021-04-19,11,67,115,182
89748,2021-04-19,12,99,155,254
89749,2021-04-19,13,118,162,280
89750,2021-04-19,14,155,199,354
89751,2021-04-19,15,173,216,389
89752,2021-04-19,16,191,277,468
89753,2021-04-19,17,274,445,719
89754,2021-04-19,18,255,404,659
89755,2021-04-19,19,153,302,455
89756,2021-04-19,20,82,183,265
89757,2021-04-19,21,47,117,164
89758,2021-04-19,22,68,64,132
89759,2021-04-19,23,34,38,72
89760,2021-04-20,0,16,12,28
89761,2021-04-20,1,5,8,13
89762,2021-04-20,2,4,5,9
89763,2021-04-20,3,4,0,4
89764,2021-04-20,4,7,8,15
89765,2021-04-20,5,5,37,42
89766,2021-04-20,6,24,95,119
89767,2021-04-20,7,54,184,238
89768,2021-04-20,8,84,288,372
89769,2021-04-20,9,113,217,330
89770,2021-04-20,10,128,198,326
89771,2021-04-20,11,140,195,335
89772,2021-04-20,12,189,293,482
89773,2021-04-20,13,215,273,488
89774,2021-04-20,14,210,253,463
89775,2021-04-20,15,242,299,541
89776,2021-04-20,16,269,380,649
89777,2021-04-20,17,410,556,966
89778,2021-04-20,18,400,558,958
89779,2021-04-20,19,257,406,663
89780,2021-04-20,20,148,222,370
89781,2021-04-20,21,102,147,249
89782,2021-04-20,22,74,112,186
89783,2021-04-20,23,57,69,126
89784,2021-04-21,0,18,34,52
89785,2021-04-21,1,11,13,24
89786,2021-04-21,2,2,3,5
89787,2021-04-21,3,3,5,8
89788,2021-04-21,4,9,11,20
89789,2021-04-21,5,9,23,32
89790,2021-04-21,6,28,86,114
89791,2021-04-21,7,59,181,240
89792,2021-04-21,8,85,286,371
89793,2021-04-21,9,82,199,281
89794,2021-04-21,10,100,156,256
89795,2021-04-21,11,116,185,301
89796,2021-04-21,12,102,219,321
89797,2021-04-21,13,94,150,244
89798,2021-04-21,14,101,164,265
89799,2021-04-21,15,122,220,342
89800,2021-04-21,16,113,255,368
89801,2021-04-21,17,150,336,486
89802,2021-04-21,18,143,325,468
89803,2021-04-21,19,96,258,354
89804,2021-04-21,20,70,117,187
89805,2021-04-21,21,54,103,157
89806,2021-04-21,22,38,64,102
89807,2021-04-21,23,38,36,74
89808,2021-04-22,0,12,11,23
89809,2021-04-22,1,2,8,10
89810,2021-04-22,2,0,2,2
89811,2021-04-22,3,2,3,5
89812,2021-04-22,4,4,7,11
89813,2021-04-22,5,6,22,28
89814,2021-04-22,6,24,84,108
89815,2021-04-22,7,45,149,194
89816,2021-04-22,8,67,229,296
89817,2021-04-22,9,71,156,227
89818,2021-04-22,10,56,141,197
89819,2021-04-22,11,70,159,229
89820,2021-04-22,12,76,154,230
89821,2021-04-22,13,99,171,270
89822,2021-04-22,14,119,169,288
89823,2021-04-22,15,89,155,244
89824,2021-04-22,16,113,229,342
89825,2021-04-22,17,159,302,461
89826,2021-04-22,18,174,320,494
89827,2021-04-22,19,127,258,385
89828,2021-04-22,20,56,153,209
89829,2021-04-22,21,70,119,189
89830,2021-04-22,22,45,75,120
89831,2021-04-22,23,49,49,98
89832,2021-04-23,0,30,20,50
89833,2021-04-23,1,8,10,18
89834,2021-04-23,2,4,3,7
89835,2021-04-23,3,2,5,7
89836,2021-04-23,4,3,6,9
89837,2021-04-23,5,10,26,36
89838,2021-04-23,6,13,78,91
89839,2021-04-23,7,52,160,212
89840,2021-04-23,8,78,221,299
89841,2021-04-23,9,86,187,273
89842,2021-04-23,10,107,182,289
89843,2021-04-23,11,167,225,392
89844,2021-04-23,12,194,270,464
89845,2021-04-23,13,202,284,486
89846,2021-04-23,14,290,312,602
89847,2021-04-23,15,257,300,557
89848,2021-04-23,16,283,380,663
89849,2021-04-23,17,336,418,754
89850,2021-04-23,18,239,416,655
89851,2021-04-23,19,229,299,528
89852,2021-04-23,20,136,197,333
89853,2021-04-23,21,103,153,256
89854,2021-04-23,22,106,123,229
89855,2021-04-23,23,88,112,200
89856,2021-04-24,0,64,83,147
89857,2021-04-24,1,47,42,89
89858,2021-04-24,2,19,22,41
89859,2021-04-24,3,6,9,15
89860,2021-04-24,4,8,4,12
89861,2021-04-24,5,2,14,16
89862,2021-04-24,6,23,28,51
89863,2021-04-24,7,41,70,111
89864,2021-04-24,8,75,153,228
89865,2021-04-24,9,146,260,406
89866,2021-04-24,10,255,320,575
89867,2021-04-24,11,323,428,751
89868,2021-04-24,12,368,436,804
89869,2021-04-24,13,455,419,874
89870,2021-04-24,14,444,390,834
89871,2021-04-24,15,414,350,764
89872,2021-04-24,16,410,338,748
89873,2021-04-24,17,295,297,592
89874,2021-04-24,18,155,190,345
89875,2021-04-24,19,43,83,126
89876,2021-04-24,20,25,64,89
89877,2021-04-24,21,17,40,57
89878,2021-04-24,22,13,29,42
89879,2021-04-24,23,24,18,42
89880,2021-04-25,0,23,24,47
89881,2021-04-25,1,6,11,17
89882,2021-04-25,2,3,3,6
89883,2021-04-25,3,7,4,11
89884,2021-04-25,4,5,5,10
89885,2021-04-25,5,3,9,12
89886,2021-04-25,6,8,15,23
89887,2021-04-25,7,4,29,33
89888,2021-04-25,8,45,86,131
89889,2021-04-25,9,85,166,251
89890,2021-04-25,10,199,215,414
89891,2021-04-25,11,245,294,539
89892,2021-04-25,12,332,289,621
89893,2021-04-25,13,360,351,711
89894,2021-04-25,14,365,356,721
89895,2021-04-25,15,359,357,716
89896,2021-04-25,16,327,324,651
89897,2021-04-25,17,324,341,665
89898,2021-04-25,18,228,240,468
89899,2021-04-25,19,146,249,395
89900,2021-04-25,20,107,137,244
89901,2021-04-25,21,71,81,152
89902,2021-04-25,22,54,58,112
89903,2021-04-25,23,59,34,93
89904,2021-04-26,0,31,22,53
89905,2021-04-26,1,12,14,26
89906,2021-04-26,2,11,3,14
89907,2021-04-26,3,4,3,7
89908,2021-04-26,4,8,5,13
89909,2021-04-26,5,12,36,48
89910,2021-04-26,6,23,86,109
89911,2021-04-26,7,39,159,198
89912,2021-04-26,8,81,275,356
89913,2021-04-26,9,73,175,248
89914,2021-04-26,10,95,135,230
89915,2021-04-26,11,112,164,276
89916,2021-04-26,12,132,205,337
89917,2021-04-26,13,176,206,382
89918,2021-04-26,14,135,207,342
89919,2021-04-26,15,186,250,436
89920,2021-04-26,16,199,321,520
89921,2021-04-26,17,254,473,727
89922,2021-04-26,18,235,463,698
89923,2021-04-26,19,172,349,521
89924,2021-04-26,20,112,175,287
89925,2021-04-26,21,76,120,196
89926,2021-04-26,22,59,53,112
89927,2021-04-26,23,46,46,92
89928,2021-04-27,0,25,26,51
89929,2021-04-27,1,4,3,7
89930,2021-04-27,2,4,5,9
89931,2021-04-27,3,6,3,9
89932,2021-04-27,4,7,9,16
89933,2021-04-27,5,11,34,45
89934,2021-04-27,6,20,100,120
89935,2021-04-27,7,56,210,266
89936,2021-04-27,8,107,334,441
89937,2021-04-27,9,91,213,304
89938,2021-04-27,10,115,210,325
89939,2021-04-27,11,156,211,367
89940,2021-04-27,12,172,255,427
89941,2021-04-27,13,207,280,487
89942,2021-04-27,14,183,237,420
89943,2021-04-27,15,217,279,496
89944,2021-04-27,16,248,346,594
89945,2021-04-27,17,316,511,827
89946,2021-04-27,18,378,566,944
89947,2021-04-27,19,278,365,643
89948,2021-04-27,20,167,253,420
89949,2021-04-27,21,128,182,310
89950,2021-04-27,22,95,114,209
89951,2021-04-27,23,73,51,124
89952,2021-04-28,0,19,27,46
89953,2021-04-28,1,15,11,26
89954,2021-04-28,2,10,3,13
89955,2021-04-28,3,4,3,7
89956,2021-04-28,4,10,6,16
89957,2021-04-28,5,11,34,45
89958,2021-04-28,6,28,98,126
89959,2021-04-28,7,55,166,221
89960,2021-04-28,8,91,315,406
89961,2021-04-28,9,85,229,314
89962,2021-04-28,10,96,186,282
89963,2021-04-28,11,126,196,322
89964,2021-04-28,12,144,236,380
89965,2021-04-28,13,171,220,391
89966,2021-04-28,14,157,259,416
89967,2021-04-28,15,171,247,418
89968,2021-04-28,16,219,339,558
89969,2021-04-28,17,292,539,831
89970,2021-04-28,18,306,495,801
89971,2021-04-28,19,241,357,598
89972,2021-04-28,20,176,270,446
89973,2021-04-28,21,132,146,278
89974,2021-04-28,22,89,113,202
89975,2021-04-28,23,63,59,122
89976,2021-04-29,0,41,19,60
89977,2021-04-29,1,22,10,32
89978,2021-04-29,2,5,6,11
89979,2021-04-29,3,4,5,9
89980,2021-04-29,4,10,10,20
89981,2021-04-29,5,13,37,50
89982,2021-04-29,6,26,89,115
89983,2021-04-29,7,52,227,279
89984,2021-04-29,8,94,309,403
89985,2021-04-29,9,75,228,303
89986,2021-04-29,10,86,164,250
89987,2021-04-29,11,133,198,331
89988,2021-04-29,12,136,222,358
89989,2021-04-29,13,125,231,356
89990,2021-04-29,14,157,228,385
89991,2021-04-29,15,192,243,435
89992,2021-04-29,16,196,329,525
89993,2021-04-29,17,208,455,663
89994,2021-04-29,18,208,447,655
89995,2021-04-29,19,176,305,481
89996,2021-04-29,20,130,205,335
89997,2021-04-29,21,94,164,258
89998,2021-04-29,22,118,113,231
89999,2021-04-29,23,45,56,101
90000,2021-04-30,0,32,38,70
90001,2021-04-30,1,11,11,22
90002,2021-04-30,2,18,12,30
90003,2021-04-30,3,8,7,15
90004,2021-04-30,4,7,12,19
90005,2021-04-30,5,15,29,44
90006,2021-04-30,6,20,99,119
90007,2021-04-30,7,59,214,273
90008,2021-04-30,8,107,260,367
90009,2021-04-30,9,103,207,310
90010,2021-04-30,10,106,190,296
90011,2021-04-30,11,173,250,423
90012,2021-04-30,12,160,249,409
90013,2021-04-30,13,215,261,476
90014,2021-04-30,14,215,223,438
90015,2021-04-30,15,230,299,529
90016,2021-04-30,16,215,290,505
90017,2021-04-30,17,214,348,562
90018,2021-04-30,18,122,292,414
90019,2021-04-30,19,132,200,332
90020,2021-04-30,20,105,125,230
90021,2021-04-30,21,71,88,159
90022,2021-04-30,22,64,91,155
90023,2021-04-30,23,73,82,155
90024,2021-05-01,0,55,41,96
90025,2021-05-01,1,24,18,42
90026,2021-05-01,2,15,12,27
90027,2021-05-01,3,6,13,19
90028,2021-05-01,4,9,3,12
90029,2021-05-01,5,6,9,15
90030,2021-05-01,6,20,40,60
90031,2021-05-01,7,38,60,98
90032,2021-05-01,8,94,128,222
90033,2021-05-01,9,163,226,389
90034,2021-05-01,10,254,317,571
90035,2021-05-01,11,407,394,801
90036,2021-05-01,12,444,397,841
90037,2021-05-01,13,540,425,965
90038,2021-05-01,14,506,413,919
90039,2021-05-01,15,579,436,1015
90040,2021-05-01,16,550,435,985
90041,2021-05-01,17,434,415,849
90042,2021-05-01,18,422,344,766
90043,2021-05-01,19,315,289,604
90044,2021-05-01,20,215,182,397
90045,2021-05-01,21,171,150,321
90046,2021-05-01,22,155,117,272
90047,2021-05-01,23,128,123,251
90048,2021-05-02,0,99,100,199
90049,2021-05-02,1,44,38,82
90050,2021-05-02,2,26,16,42
90051,2021-05-02,3,14,13,27
90052,2021-05-02,4,14,7,21
90053,2021-05-02,5,11,12,23
90054,2021-05-02,6,19,35,54
90055,2021-05-02,7,37,54,91
90056,2021-05-02,8,81,144,225
90057,2021-05-02,9,151,198,349
90058,2021-05-02,10,284,312,596
90059,2021-05-02,11,366,355,721
90060,2021-05-02,12,457,433,890
90061,2021-05-02,13,497,409,906
90062,2021-05-02,14,518,411,929
90063,2021-05-02,15,472,421,893
90064,2021-05-02,16,452,394,846
90065,2021-05-02,17,414,336,750
90066,2021-05-02,18,318,314,632
90067,2021-05-02,19,277,278,555
90068,2021-05-02,20,147,197,344
90069,2021-05-02,21,130,125,255
90070,2021-05-02,22,107,87,194
90071,2021-05-02,23,53,43,96
90072,2021-05-03,0,34,30,64
90073,2021-05-03,1,17,12,29
90074,2021-05-03,2,15,3,18
90075,2021-05-03,3,6,8,14
90076,2021-05-03,4,11,11,22
90077,2021-05-03,5,8,27,35
90078,2021-05-03,6,12,64,76
90079,2021-05-03,7,63,152,215
90080,2021-05-03,8,89,252,341
90081,2021-05-03,9,100,185,285
90082,2021-05-03,10,100,152,252
90083,2021-05-03,11,87,177,264
90084,2021-05-03,12,101,191,292
90085,2021-05-03,13,142,195,337
90086,2021-05-03,14,152,209,361
90087,2021-05-03,15,189,227,416
90088,2021-05-03,16,147,292,439
90089,2021-05-03,17,190,367,557
90090,2021-05-03,18,137,390,527
90091,2021-05-03,19,121,243,364
90092,2021-05-03,20,70,149,219
90093,2021-05-03,21,73,117,190
90094,2021-05-03,22,64,73,137
90095,2021-05-03,23,24,26,50
90096,2021-05-04,0,18,8,26
90097,2021-05-04,1,8,5,13
90098,2021-05-04,2,8,3,11
90099,2021-05-04,3,2,4,6
90100,2021-05-04,4,8,11,19
90101,2021-05-04,5,11,34,45
90102,2021-05-04,6,39,97,136
90103,2021-05-04,7,74,213,287
90104,2021-05-04,8,123,319,442
90105,2021-05-04,9,112,212,324
90106,2021-05-04,10,114,203,317
90107,2021-05-04,11,138,217,355
90108,2021-05-04,12,172,258,430
90109,2021-05-04,13,161,246,407
90110,2021-05-04,14,200,243,443
90111,2021-05-04,15,207,273,480
90112,2021-05-04,16,161,350,511
90113,2021-05-04,17,45,120,165
90114,2021-05-04,18,89,204,293
90115,2021-05-04,19,116,267,383
90116,2021-05-04,20,108,197,305
90117,2021-05-04,21,86,122,208
90118,2021-05-04,22,95,88,183
90119,2021-05-04,23,49,60,109
90120,2021-05-05,0,32,14,46
90121,2021-05-05,1,11,6,17
90122,2021-05-05,2,3,5,8
90123,2021-05-05,3,6,1,7
90124,2021-05-05,4,12,18,30
90125,2021-05-05,5,14,30,44
90126,2021-05-05,6,25,99,124
90127,2021-05-05,7,39,129,168
90128,2021-05-05,8,51,164,215
90129,2021-05-05,9,43,118,161
90130,2021-05-05,10,63,138,201
90131,2021-05-05,11,75,187,262
90132,2021-05-05,12,122,246,368
90133,2021-05-05,13,111,225,336
90134,2021-05-05,14,119,213,332
90135,2021-05-05,15,157,242,399
90136,2021-05-05,16,164,363,527
90137,2021-05-05,17,277,545,822
90138,2021-05-05,18,299,533,832
90139,2021-05-05,19,212,399,611
90140,2021-05-05,20,124,238,362
90141,2021-05-05,21,106,186,292
90142,2021-05-05,22,106,108,214
90143,2021-05-05,23,73,57,130
90144,2021-05-06,0,21,37,58
90145,2021-05-06,1,11,15,26
90146,2021-05-06,2,5,5,10
90147,2021-05-06,3,3,7,10
90148,2021-05-06,4,10,8,18
90149,2021-05-06,5,10,32,42
90150,2021-05-06,6,26,95,121
90151,2021-05-06,7,69,218,287
90152,2021-05-06,8,102,316,418
90153,2021-05-06,9,109,229,338
90154,2021-05-06,10,136,188,324
90155,2021-05-06,11,169,233,402
90156,2021-05-06,12,191,270,461
90157,2021-05-06,13,170,256,426
90158,2021-05-06,14,213,263,476
90159,2021-05-06,15,286,320,606
90160,2021-05-06,16,223,362,585
90161,2021-05-06,17,305,477,782
90162,2021-05-06,18,298,539,837
90163,2021-05-06,19,289,380,669
90164,2021-05-06,20,178,260,438
90165,2021-05-06,21,100,149,249
90166,2021-05-06,22,99,128,227
90167,2021-05-06,23,59,75,134
90168,2021-05-07,0,38,21,59
90169,2021-05-07,1,18,15,33
90170,2021-05-07,2,5,6,11
90171,2021-05-07,3,7,2,9
90172,2021-05-07,4,9,11,20
90173,2021-05-07,5,22,22,44
90174,2021-05-07,6,29,103,132
90175,2021-05-07,7,65,201,266
90176,2021-05-07,8,114,300,414
90177,2021-05-07,9,116,255,371
90178,2021-05-07,10,164,222,386
90179,2021-05-07,11,180,267,447
90180,2021-05-07,12,190,265,455
90181,2021-05-07,13,202,295,497
90182,2021-05-07,14,256,243,499
90183,2021-05-07,15,135,217,352
90184,2021-05-07,16,121,196,317
90185,2021-05-07,17,86,149,235
90186,2021-05-07,18,71,158,229
90187,2021-05-07,19,75,136,211
90188,2021-05-07,20,61,117,178
90189,2021-05-07,21,57,100,157
90190,2021-05-07,22,58,84,142
90191,2021-05-07,23,80,85,165
90192,2021-05-08,0,92,61,153
90193,2021-05-08,1,31,34,65
90194,2021-05-08,2,13,16,29
90195,2021-05-08,3,12,9,21
90196,2021-05-08,4,5,4,9
90197,2021-05-08,5,10,15,25
90198,2021-05-08,6,25,35,60
90199,2021-05-08,7,22,45,67
90200,2021-05-08,8,48,109,157
90201,2021-05-08,9,128,198,326
90202,2021-05-08,10,219,270,489
90203,2021-05-08,11,367,346,713
90204,2021-05-08,12,374,385,759
90205,2021-05-08,13,389,333,722
90206,2021-05-08,14,376,313,689
90207,2021-05-08,15,418,349,767
90208,2021-05-08,16,342,351,693
90209,2021-05-08,17,315,302,617
90210,2021-05-08,18,252,304,556
90211,2021-05-08,19,246,285,531
90212,2021-05-08,20,182,191,373
90213,2021-05-08,21,125,123,248
90214,2021-05-08,22,120,94,214
90215,2021-05-08,23,117,99,216
90216,2021-05-09,0,96,67,163
90217,2021-05-09,1,39,27,66
90218,2021-05-09,2,16,24,40
90219,2021-05-09,3,13,15,28
90220,2021-05-09,4,11,3,14
90221,2021-05-09,5,8,8,16
90222,2021-05-09,6,13,20,33
90223,2021-05-09,7,24,40,64
90224,2021-05-09,8,59,110,169
90225,2021-05-09,9,95,187,282
90226,2021-05-09,10,178,237,415
90227,2021-05-09,11,220,284,504
90228,2021-05-09,12,303,283,586
90229,2021-05-09,13,316,297,613
90230,2021-05-09,14,412,341,753
90231,2021-05-09,15,343,362,705
90232,2021-05-09,16,322,335,657
90233,2021-05-09,17,249,325,574
90234,2021-05-09,18,256,277,533
90235,2021-05-09,19,178,201,379
90236,2021-05-09,20,92,131,223
90237,2021-05-09,21,69,109,178
90238,2021-05-09,22,76,84,160
90239,2021-05-09,23,60,51,111
90240,2021-05-10,0,29,27,56
90241,2021-05-10,1,21,5,26
90242,2021-05-10,2,5,2,7
90243,2021-05-10,3,11,4,15
90244,2021-05-10,4,14,11,25
90245,2021-05-10,5,15,37,52
90246,2021-05-10,6,41,85,126
90247,2021-05-10,7,54,188,242
90248,2021-05-10,8,85,255,340
90249,2021-05-10,9,81,203,284
90250,2021-05-10,10,73,187,260
90251,2021-05-10,11,118,172,290
90252,2021-05-10,12,156,215,371
90253,2021-05-10,13,190,247,437
90254,2021-05-10,14,188,223,411
90255,2021-05-10,15,233,246,479
90256,2021-05-10,16,265,339,604
90257,2021-05-10,17,283,479,762
90258,2021-05-10,18,293,516,809
90259,2021-05-10,19,205,377,582
90260,2021-05-10,20,142,221,363
90261,2021-05-10,21,97,132,229
90262,2021-05-10,22,67,106,173
90263,2021-05-10,23,27,39,66
90264,2021-05-11,0,22,19,41
90265,2021-05-11,1,7,5,12
90266,2021-05-11,2,10,4,14
90267,2021-05-11,3,8,2,10
90268,2021-05-11,4,10,10,20
90269,2021-05-11,5,7,33,40
90270,2021-05-11,6,22,103,125
90271,2021-05-11,7,67,209,276
90272,2021-05-11,8,108,357,465
90273,2021-05-11,9,87,273,360
90274,2021-05-11,10,111,201,312
90275,2021-05-11,11,140,238,378
90276,2021-05-11,12,182,293,475
90277,2021-05-11,13,177,252,429
90278,2021-05-11,14,187,248,435
90279,2021-05-11,15,211,294,505
90280,2021-05-11,16,223,360,583
90281,2021-05-11,17,279,518,797
90282,2021-05-11,18,312,503,815
90283,2021-05-11,19,246,394,640
90284,2021-05-11,20,116,230,346
90285,2021-05-11,21,92,172,264
90286,2021-05-11,22,71,114,185
90287,2021-05-11,23,56,64,120
90288,2021-05-12,0,31,25,56
90289,2021-05-12,1,9,10,19
90290,2021-05-12,2,2,2,4
90291,2021-05-12,3,5,1,6
90292,2021-05-12,4,5,8,13
90293,2021-05-12,5,15,28,43
90294,2021-05-12,6,28,110,138
90295,2021-05-12,7,68,221,289
90296,2021-05-12,8,97,303,400
90297,2021-05-12,9,95,231,326
90298,2021-05-12,10,108,193,301
90299,2021-05-12,11,145,216,361
90300,2021-05-12,12,175,216,391
90301,2021-05-12,13,175,246,421
90302,2021-05-12,14,196,253,449
90303,2021-05-12,15,198,323,521
90304,2021-05-12,16,230,392,622
90305,2021-05-12,17,320,518,838
90306,2021-05-12,18,361,574,935
90307,2021-05-12,19,261,372,633
90308,2021-05-12,20,129,261,390
90309,2021-05-12,21,115,169,284
90310,2021-05-12,22,89,120,209
90311,2021-05-12,23,76,69,145
90312,2021-05-13,0,27,36,63
90313,2021-05-13,1,11,9,20
90314,2021-05-13,2,1,11,12
90315,2021-05-13,3,4,9,13
90316,2021-05-13,4,10,14,24
90317,2021-05-13,5,16,41,57
90318,2021-05-13,6,36,120,156
90319,2021-05-13,7,57,215,272
90320,2021-05-13,8,126,296,422
90321,2021-05-13,9,127,234,361
90322,2021-05-13,10,111,186,297
90323,2021-05-13,11,160,240,400
90324,2021-05-13,12,185,265,450
90325,2021-05-13,13,207,288,495
90326,2021-05-13,14,210,276,486
90327,2021-05-13,15,244,292,536
90328,2021-05-13,16,286,363,649
90329,2021-05-13,17,330,534,864
90330,2021-05-13,18,386,551,937
90331,2021-05-13,19,336,406,742
90332,2021-05-13,20,206,260,466
90333,2021-05-13,21,124,200,324
90334,2021-05-13,22,169,167,336
90335,2021-05-13,23,125,86,211
90336,2021-05-14,0,69,62,131
90337,2021-05-14,1,18,16,34
90338,2021-05-14,2,13,5,18
90339,2021-05-14,3,6,5,11
90340,2021-05-14,4,5,9,14
90341,2021-05-14,5,14,29,43
90342,2021-05-14,6,27,93,120
90343,2021-05-14,7,63,202,265
90344,2021-05-14,8,107,311,418
90345,2021-05-14,9,103,237,340
90346,2021-05-14,10,170,231,401
90347,2021-05-14,11,220,275,495
90348,2021-05-14,12,244,296,540
90349,2021-05-14,13,290,306,596
90350,2021-05-14,14,267,301,568
90351,2021-05-14,15,330,321,651
90352,2021-05-14,16,359,419,778
90353,2021-05-14,17,377,543,920
90354,2021-05-14,18,378,502,880
90355,2021-05-14,19,266,329,595
90356,2021-05-14,20,213,244,457
90357,2021-05-14,21,165,172,337
90358,2021-05-14,22,151,155,306
90359,2021-05-14,23,129,167,296
90360,2021-05-15,0,135,114,249
90361,2021-05-15,1,61,39,100
90362,2021-05-15,2,35,23,58
90363,2021-05-15,3,7,6,13
90364,2021-05-15,4,9,6,15
90365,2021-05-15,5,11,14,25
90366,2021-05-15,6,32,53,85
90367,2021-05-15,7,56,103,159
90368,2021-05-15,8,93,188,281
90369,2021-05-15,9,249,258,507
90370,2021-05-15,10,380,356,736
90371,2021-05-15,11,550,445,995
90372,2021-05-15,12,604,466,1070
90373,2021-05-15,13,674,450,1124
90374,2021-05-15,14,717,457,1174
90375,2021-05-15,15,654,426,1080
90376,2021-05-15,16,568,476,1044
90377,2021-05-15,17,627,478,1105
90378,2021-05-15,18,571,376,947
90379,2021-05-15,19,378,283,661
90380,2021-05-15,20,265,224,489
90381,2021-05-15,21,207,185,392
90382,2021-05-15,22,192,141,333
90383,2021-05-15,23,196,135,331
90384,2021-05-16,0,150,94,244
90385,2021-05-16,1,71,39,110
90386,2021-05-16,2,28,24,52
90387,2021-05-16,3,17,16,33
90388,2021-05-16,4,10,8,18
90389,2021-05-16,5,8,6,14
90390,2021-05-16,6,29,27,56
90391,2021-05-16,7,47,57,104
90392,2021-05-16,8,89,163,252
90393,2021-05-16,9,185,239,424
90394,2021-05-16,10,281,327,608
90395,2021-05-16,11,423,364,787
90396,2021-05-16,12,493,465,958
90397,2021-05-16,13,528,404,932
90398,2021-05-16,14,486,417,903
90399,2021-05-16,15,351,306,657
90400,2021-05-16,16,308,276,584
90401,2021-05-16,17,223,230,453
90402,2021-05-16,18,178,241,419
90403,2021-05-16,19,194,239,433
90404,2021-05-16,20,122,136,258
90405,2021-05-16,21,78,106,184
90406,2021-05-16,22,96,83,179
90407,2021-05-16,23,63,42,105
90408,2021-05-17,0,25,25,50
90409,2021-05-17,1,26,9,35
90410,2021-05-17,2,8,3,11
90411,2021-05-17,3,7,6,13
90412,2021-05-17,4,14,10,24
90413,2021-05-17,5,17,25,42
90414,2021-05-17,6,45,92,137
90415,2021-05-17,7,59,193,252
90416,2021-05-17,8,101,340,441
90417,2021-05-17,9,111,223,334
90418,2021-05-17,10,142,211,353
90419,2021-05-17,11,171,224,395
90420,2021-05-17,12,214,245,459
90421,2021-05-17,13,228,231,459
90422,2021-05-17,14,226,240,466
90423,2021-05-17,15,260,306,566
90424,2021-05-17,16,230,384,614
90425,2021-05-17,17,307,541,848
90426,2021-05-17,18,317,553,870
90427,2021-05-17,19,299,387,686
90428,2021-05-17,20,175,268,443
90429,2021-05-17,21,110,144,254
90430,2021-05-17,22,101,95,196
90431,2021-05-17,23,61,44,105
90432,2021-05-18,0,22,25,47
90433,2021-05-18,1,16,7,23
90434,2021-05-18,2,8,8,16
90435,2021-05-18,3,4,3,7
90436,2021-05-18,4,6,4,10
90437,2021-05-18,5,14,42,56
90438,2021-05-18,6,36,118,154
90439,2021-05-18,7,84,250,334
90440,2021-05-18,8,110,382,492
90441,2021-05-18,9,126,254,380
90442,2021-05-18,10,154,206,360
90443,2021-05-18,11,169,271,440
90444,2021-05-18,12,218,315,533
90445,2021-05-18,13,215,252,467
90446,2021-05-18,14,222,256,478
90447,2021-05-18,15,212,283,495
90448,2021-05-18,16,263,368,631
90449,2021-05-18,17,353,584,937
90450,2021-05-18,18,363,573,936
90451,2021-05-18,19,313,451,764
90452,2021-05-18,20,217,314,531
90453,2021-05-18,21,117,215,332
90454,2021-05-18,22,88,131,219
90455,2021-05-18,23,73,93,166
90456,2021-05-19,0,28,36,64
90457,2021-05-19,1,16,12,28
90458,2021-05-19,2,12,3,15
90459,2021-05-19,3,6,5,11
90460,2021-05-19,4,14,8,22
90461,2021-05-19,5,18,41,59
90462,2021-05-19,6,41,139,180
90463,2021-05-19,7,76,249,325
90464,2021-05-19,8,124,345,469
90465,2021-05-19,9,115,267,382
90466,2021-05-19,10,130,215,345
90467,2021-05-19,11,177,267,444
90468,2021-05-19,12,178,290,468
90469,2021-05-19,13,237,267,504
90470,2021-05-19,14,207,275,482
90471,2021-05-19,15,252,316,568
90472,2021-05-19,16,266,359,625
90473,2021-05-19,17,396,553,949
90474,2021-05-19,18,431,566,997
90475,2021-05-19,19,297,471,768
90476,2021-05-19,20,188,344,532
90477,2021-05-19,21,147,197,344
90478,2021-05-19,22,104,153,257
90479,2021-05-19,23,80,83,163
90480,2021-05-20,0,46,44,90
90481,2021-05-20,1,10,8,18
90482,2021-05-20,2,8,12,20
90483,2021-05-20,3,7,4,11
90484,2021-05-20,4,8,10,18
90485,2021-05-20,5,16,26,42
90486,2021-05-20,6,48,118,166
90487,2021-05-20,7,82,258,340
90488,2021-05-20,8,136,381,517
90489,2021-05-20,9,124,236,360
90490,2021-05-20,10,140,223,363
90491,2021-05-20,11,176,199,375
90492,2021-05-20,12,211,231,442
90493,2021-05-20,13,223,254,477
90494,2021-05-20,14,210,249,459
90495,2021-05-20,15,251,303,554
90496,2021-05-20,16,261,353,614
90497,2021-05-20,17,346,574,920
90498,2021-05-20,18,346,511,857
90499,2021-05-20,19,282,438,720
90500,2021-05-20,20,226,339,565
90501,2021-05-20,21,124,218,342
90502,2021-05-20,22,129,156,285
90503,2021-05-20,23,102,91,193
90504,2021-05-21,0,34,41,75
90505,2021-05-21,1,13,17,30
90506,2021-05-21,2,7,9,16
90507,2021-05-21,3,4,8,12
90508,2021-05-21,4,11,6,17
90509,2021-05-21,5,14,30,44
90510,2021-05-21,6,45,129,174
90511,2021-05-21,7,98,273,371
90512,2021-05-21,8,166,373,539
90513,2021-05-21,9,141,299,440
90514,2021-05-21,10,228,275,503
90515,2021-05-21,11,224,257,481
90516,2021-05-21,12,244,314,558
90517,2021-05-21,13,309,309,618
90518,2021-05-21,14,326,286,612
90519,2021-05-21,15,358,321,679
90520,2021-05-21,16,399,407,806
90521,2021-05-21,17,466,542,1008
90522,2021-05-21,18,391,521,912
90523,2021-05-21,19,365,407,772
90524,2021-05-21,20,288,297,585
90525,2021-05-21,21,225,212,437
90526,2021-05-21,22,199,175,374
90527,2021-05-21,23,184,131,315
90528,2021-05-22,0,177,137,314
90529,2021-05-22,1,111,68,179
90530,2021-05-22,2,58,52,110
90531,2021-05-22,3,24,15,39
90532,2021-05-22,4,7,8,15
90533,2021-05-22,5,21,20,41
90534,2021-05-22,6,23,53,76
90535,2021-05-22,7,65,115,180
90536,2021-05-22,8,152,198,350
90537,2021-05-22,9,263,311,574
90538,2021-05-22,10,412,366,778
90539,2021-05-22,11,484,413,897
90540,2021-05-22,12,530,430,960
90541,2021-05-22,13,584,408,992
90542,2021-05-22,14,607,440,1047
90543,2021-05-22,15,561,428,989
90544,2021-05-22,16,505,376,881
90545,2021-05-22,17,401,394,795
90546,2021-05-22,18,432,337,769
90547,2021-05-22,19,387,358,745
90548,2021-05-22,20,284,246,530
90549,2021-05-22,21,220,190,410
90550,2021-05-22,22,212,145,357
90551,2021-05-22,23,230,151,381
90552,2021-05-23,0,183,119,302
90553,2021-05-23,1,102,83,185
90554,2021-05-23,2,68,46,114
90555,2021-05-23,3,23,16,39
90556,2021-05-23,4,20,16,36
90557,2021-05-23,5,17,25,42
90558,2021-05-23,6,33,42,75
90559,2021-05-23,7,56,86,142
90560,2021-05-23,8,122,162,284
90561,2021-05-23,9,256,264,520
90562,2021-05-23,10,337,355,692
90563,2021-05-23,11,431,346,777
90564,2021-05-23,12,474,361,835
90565,2021-05-23,13,457,356,813
90566,2021-05-23,14,412,335,747
90567,2021-05-23,15,447,371,818
90568,2021-05-23,16,421,342,763
90569,2021-05-23,17,337,333,670
90570,2021-05-23,18,302,289,591
90571,2021-05-23,19,241,274,515
90572,2021-05-23,20,193,204,397
90573,2021-05-23,21,162,156,318
90574,2021-05-23,22,127,124,251
90575,2021-05-23,23,93,51,144
90576,2021-05-24,0,41,35,76
90577,2021-05-24,1,17,14,31
90578,2021-05-24,2,13,10,23
90579,2021-05-24,3,7,7,14
90580,2021-05-24,4,9,9,18
90581,2021-05-24,5,12,27,39
90582,2021-05-24,6,38,79,117
90583,2021-05-24,7,41,126,167
90584,2021-05-24,8,73,223,296
90585,2021-05-24,9,91,193,284
90586,2021-05-24,10,120,178,298
90587,2021-05-24,11,143,175,318
90588,2021-05-24,12,157,225,382
90589,2021-05-24,13,148,161,309
90590,2021-05-24,14,81,98,179
90591,2021-05-24,15,88,142,230
90592,2021-05-24,16,56,102,158
90593,2021-05-24,17,34,120,154
90594,2021-05-24,18,51,131,182
90595,2021-05-24,19,64,167,231
90596,2021-05-24,20,53,99,152
90597,2021-05-24,21,57,78,135
90598,2021-05-24,22,55,75,130
90599,2021-05-24,23,37,41,78
90600,2021-05-25,0,27,26,53
90601,2021-05-25,1,13,10,23
90602,2021-05-25,2,6,7,13
90603,2021-05-25,3,6,5,11
90604,2021-05-25,4,9,10,19
90605,2021-05-25,5,11,30,41
90606,2021-05-25,6,45,127,172
90607,2021-05-25,7,69,261,330
90608,2021-05-25,8,120,356,476
90609,2021-05-25,9,111,233,344
90610,2021-05-25,10,128,203,331
90611,2021-05-25,11,213,230,443
90612,2021-05-25,12,146,283,429
90613,2021-05-25,13,199,234,433
90614,2021-05-25,14,229,262,491
90615,2021-05-25,15,234,302,536
90616,2021-05-25,16,262,388,650
90617,2021-05-25,17,334,599,933
90618,2021-05-25,18,356,576,932
90619,2021-05-25,19,299,434,733
90620,2021-05-25,20,230,322,552
90621,2021-05-25,21,114,202,316
90622,2021-05-25,22,131,154,285
90623,2021-05-25,23,81,62,143
90624,2021-05-26,0,44,31,75
90625,2021-05-26,1,19,15,34
90626,2021-05-26,2,6,7,13
90627,2021-05-26,3,2,7,9
90628,2021-05-26,4,11,9,20
90629,2021-05-26,5,13,36,49
90630,2021-05-26,6,51,137,188
90631,2021-05-26,7,55,250,305
90632,2021-05-26,8,125,370,495
90633,2021-05-26,9,100,266,366
90634,2021-05-26,10,135,209,344
90635,2021-05-26,11,149,222,371
90636,2021-05-26,12,161,259,420
90637,2021-05-26,13,154,222,376
90638,2021-05-26,14,192,212,404
90639,2021-05-26,15,212,265,477
90640,2021-05-26,16,231,324,555
90641,2021-05-26,17,176,333,509
90642,2021-05-26,18,227,468,695
90643,2021-05-26,19,262,384,646
90644,2021-05-26,20,95,173,268
90645,2021-05-26,21,25,78,103
90646,2021-05-26,22,69,78,147
90647,2021-05-26,23,70,64,134
90648,2021-05-27,0,20,30,50
90649,2021-05-27,1,11,9,20
90650,2021-05-27,2,3,4,7
90651,2021-05-27,3,7,3,10
90652,2021-05-27,4,9,6,15
90653,2021-05-27,5,13,47,60
90654,2021-05-27,6,43,111,154
90655,2021-05-27,7,94,227,321
90656,2021-05-27,8,132,357,489
90657,2021-05-27,9,123,233,356
90658,2021-05-27,10,155,230,385
90659,2021-05-27,11,193,211,404
90660,2021-05-27,12,192,266,458
90661,2021-05-27,13,197,250,447
90662,2021-05-27,14,212,264,476
90663,2021-05-27,15,265,262,527
90664,2021-05-27,16,288,383,671
90665,2021-05-27,17,350,544,894
90666,2021-05-27,18,357,560,917
90667,2021-05-27,19,286,406,692
90668,2021-05-27,20,230,345,575
90669,2021-05-27,21,182,233,415
90670,2021-05-27,22,119,150,269
90671,2021-05-27,23,114,89,203
90672,2021-05-28,0,72,53,125
90673,2021-05-28,1,23,16,39
90674,2021-05-28,2,14,13,27
90675,2021-05-28,3,11,6,17
90676,2021-05-28,4,8,13,21
90677,2021-05-28,5,9,33,42
90678,2021-05-28,6,47,105,152
90679,2021-05-28,7,78,218,296
90680,2021-05-28,8,97,274,371
90681,2021-05-28,9,141,246,387
90682,2021-05-28,10,198,224,422
90683,2021-05-28,11,236,262,498
90684,2021-05-28,12,319,321,640
90685,2021-05-28,13,278,258,536
90686,2021-05-28,14,205,238,443
90687,2021-05-28,15,314,336,650
90688,2021-05-28,16,317,325,642
90689,2021-05-28,17,245,337,582
90690,2021-05-28,18,203,272,475
90691,2021-05-28,19,19,36,55
90692,2021-05-28,20,32,73,105
90693,2021-05-28,21,42,54,96
90694,2021-05-28,22,24,34,58
90695,2021-05-28,23,45,74,119
90696,2021-05-29,0,34,36,70
90697,2021-05-29,1,24,27,51
90698,2021-05-29,2,15,12,27
90699,2021-05-29,3,5,2,7
90700,2021-05-29,4,0,3,3
90701,2021-05-29,5,6,2,8
90702,2021-05-29,6,12,21,33
90703,2021-05-29,7,12,26,38
90704,2021-05-29,8,17,55,72
90705,2021-05-29,9,37,77,114
90706,2021-05-29,10,39,75,114
90707,2021-05-29,11,67,105,172
90708,2021-05-29,12,139,160,299
90709,2021-05-29,13,98,121,219
90710,2021-05-29,14,109,150,259
90711,2021-05-29,15,132,190,322
90712,2021-05-29,16,204,199,403
90713,2021-05-29,17,191,192,383
90714,2021-05-29,18,102,131,233
90715,2021-05-29,19,73,121,194
90716,2021-05-29,20,75,79,154
90717,2021-05-29,21,65,92,157
90718,2021-05-29,22,65,64,129
90719,2021-05-29,23,53,63,116
90720,2021-05-30,0,42,43,85
90721,2021-05-30,1,35,31,66
90722,2021-05-30,2,28,17,45
90723,2021-05-30,3,18,11,29
90724,2021-05-30,4,5,2,7
90725,2021-05-30,5,2,6,8
90726,2021-05-30,6,9,12,21
90727,2021-05-30,7,19,36,55
90728,2021-05-30,8,51,87,138
90729,2021-05-30,9,94,114,208
90730,2021-05-30,10,176,193,369
90731,2021-05-30,11,384,219,603
90732,2021-05-30,12,404,275,679
90733,2021-05-30,13,432,268,700
90734,2021-05-30,14,353,206,559
90735,2021-05-30,15,443,230,673
90736,2021-05-30,16,347,240,587
90737,2021-05-30,17,286,205,491
90738,2021-05-30,18,301,230,531
90739,2021-05-30,19,192,172,364
90740,2021-05-30,20,129,132,261
90741,2021-05-30,21,117,103,220
90742,2021-05-30,22,92,83,175
90743,2021-05-30,23,100,78,178
90744,2021-05-31,0,77,61,138
90745,2021-05-31,1,33,21,54
90746,2021-05-31,2,20,8,28
90747,2021-05-31,3,9,7,16
90748,2021-05-31,4,7,6,13
90749,2021-05-31,5,11,13,24
90750,2021-05-31,6,27,46,73
90751,2021-05-31,7,33,64,97
90752,2021-05-31,8,111,112,223
90753,2021-05-31,9,244,189,433
90754,2021-05-31,10,402,266,668
90755,2021-05-31,11,503,303,806
90756,2021-05-31,12,610,336,946
90757,2021-05-31,13,647,419,1066
90758,2021-05-31,14,740,417,1157
90759,2021-05-31,15,632,409,1041
90760,2021-05-31,16,567,405,972
90761,2021-05-31,17,503,404,907
90762,2021-05-31,18,438,405,843
90763,2021-05-31,19,304,278,582
90764,2021-05-31,20,206,233,439
90765,2021-05-31,21,174,167,341
90766,2021-05-31,22,108,138,246
90767,2021-05-31,23,74,50,124
90768,2021-06-01,0,31,11,42
90769,2021-06-01,1,19,10,29
90770,2021-06-01,2,6,9,15
90771,2021-06-01,3,5,2,7
90772,2021-06-01,4,7,13,20
90773,2021-06-01,5,11,37,48
90774,2021-06-01,6,38,109,147
90775,2021-06-01,7,68,236,304
90776,2021-06-01,8,137,315,452
90777,2021-06-01,9,106,241,347
90778,2021-06-01,10,142,186,328
90779,2021-06-01,11,198,195,393
90780,2021-06-01,12,163,257,420
90781,2021-06-01,13,172,252,424
90782,2021-06-01,14,204,255,459
90783,2021-06-01,15,226,253,479
90784,2021-06-01,16,273,352,625
90785,2021-06-01,17,311,544,855
90786,2021-06-01,18,302,565,867
90787,2021-06-01,19,240,370,610
90788,2021-06-01,20,187,278,465
90789,2021-06-01,21,131,154,285
90790,2021-06-01,22,90,99,189
90791,2021-06-01,23,78,73,151
90792,2021-06-02,0,18,13,31
90793,2021-06-02,1,17,5,22
90794,2021-06-02,2,4,1,5
90795,2021-06-02,3,4,4,8
90796,2021-06-02,4,5,3,8
90797,2021-06-02,5,23,44,67
90798,2021-06-02,6,40,131,171
90799,2021-06-02,7,66,250,316
90800,2021-06-02,8,137,407,544
90801,2021-06-02,9,117,235,352
90802,2021-06-02,10,105,215,320
90803,2021-06-02,11,166,233,399
90804,2021-06-02,12,202,213,415
90805,2021-06-02,13,196,234,430
90806,2021-06-02,14,223,255,478
90807,2021-06-02,15,260,297,557
90808,2021-06-02,16,255,397,652
90809,2021-06-02,17,331,561,892
90810,2021-06-02,18,339,537,876
90811,2021-06-02,19,295,448,743
90812,2021-06-02,20,199,296,495
90813,2021-06-02,21,130,172,302
90814,2021-06-02,22,88,133,221
90815,2021-06-02,23,68,67,135
90816,2021-06-03,0,26,25,51
90817,2021-06-03,1,12,9,21
90818,2021-06-03,2,12,8,20
90819,2021-06-03,3,5,3,8
90820,2021-06-03,4,7,11,18
90821,2021-06-03,5,17,36,53
90822,2021-06-03,6,35,107,142
90823,2021-06-03,7,62,222,284
90824,2021-06-03,8,131,380,511
90825,2021-06-03,9,126,247,373
90826,2021-06-03,10,143,219,362
90827,2021-06-03,11,196,223,419
90828,2021-06-03,12,190,253,443
90829,2021-06-03,13,225,242,467
90830,2021-06-03,14,250,249,499
90831,2021-06-03,15,256,309,565
90832,2021-06-03,16,241,336,577
90833,2021-06-03,17,253,518,771
90834,2021-06-03,18,104,191,295
90835,2021-06-03,19,95,190,285
90836,2021-06-03,20,110,187,297
90837,2021-06-03,21,125,158,283
90838,2021-06-03,22,70,115,185
90839,2021-06-03,23,83,72,155
90840,2021-06-04,0,43,43,86
90841,2021-06-04,1,8,12,20
90842,2021-06-04,2,15,7,22
90843,2021-06-04,3,9,8,17
90844,2021-06-04,4,7,7,14
90845,2021-06-04,5,20,31,51
90846,2021-06-04,6,42,111,153
90847,2021-06-04,7,69,253,322
90848,2021-06-04,8,123,351,474
90849,2021-06-04,9,125,259,384
90850,2021-06-04,10,170,232,402
90851,2021-06-04,11,240,258,498
90852,2021-06-04,12,186,238,424
90853,2021-06-04,13,198,196,394
90854,2021-06-04,14,260,263,523
90855,2021-06-04,15,284,326,610
90856,2021-06-04,16,301,409,710
90857,2021-06-04,17,409,557,966
90858,2021-06-04,18,414,537,951
90859,2021-06-04,19,348,417,765
90860,2021-06-04,20,301,318,619
90861,2021-06-04,21,180,226,406
90862,2021-06-04,22,161,173,334
90863,2021-06-04,23,148,160,308
90864,2021-06-05,0,149,112,261
90865,2021-06-05,1,128,69,197
90866,2021-06-05,2,73,44,117
90867,2021-06-05,3,25,16,41
90868,2021-06-05,4,22,7,29
90869,2021-06-05,5,23,22,45
90870,2021-06-05,6,36,44,80
90871,2021-06-05,7,56,96,152
90872,2021-06-05,8,145,197,342
90873,2021-06-05,9,250,312,562
90874,2021-06-05,10,376,374,750
90875,2021-06-05,11,452,426,878
90876,2021-06-05,12,512,437,949
90877,2021-06-05,13,515,418,933
90878,2021-06-05,14,545,366,911
90879,2021-06-05,15,492,380,872
90880,2021-06-05,16,498,389,887
90881,2021-06-05,17,401,289,690
90882,2021-06-05,18,327,331,658
90883,2021-06-05,19,350,322,672
90884,2021-06-05,20,288,313,601
90885,2021-06-05,21,204,168,372
90886,2021-06-05,22,191,176,367
90887,2021-06-05,23,227,148,375
90888,2021-06-06,0,176,125,301
90889,2021-06-06,1,102,71,173
90890,2021-06-06,2,60,42,102
90891,2021-06-06,3,59,19,78
90892,2021-06-06,4,16,7,23
90893,2021-06-06,5,15,18,33
90894,2021-06-06,6,37,23,60
90895,2021-06-06,7,48,80,128
90896,2021-06-06,8,106,165,271
90897,2021-06-06,9,175,246,421
90898,2021-06-06,10,242,337,579
90899,2021-06-06,11,333,375,708
90900,2021-06-06,12,353,334,687
90901,2021-06-06,13,341,405,746
90902,2021-06-06,14,372,319,691
90903,2021-06-06,15,311,317,628
90904,2021-06-06,16,324,300,624
90905,2021-06-06,17,252,306,558
90906,2021-06-06,18,329,289,618
90907,2021-06-06,19,270,252,522
90908,2021-06-06,20,230,230,460
90909,2021-06-06,21,135,172,307
90910,2021-06-06,22,107,91,198
90911,2021-06-06,23,75,70,145
90912,2021-06-07,0,56,30,86
90913,2021-06-07,1,16,21,37
90914,2021-06-07,2,19,6,25
90915,2021-06-07,3,8,2,10
90916,2021-06-07,4,13,7,20
90917,2021-06-07,5,17,40,57
90918,2021-06-07,6,61,132,193
90919,2021-06-07,7,98,253,351
90920,2021-06-07,8,126,398,524
90921,2021-06-07,9,101,256,357
90922,2021-06-07,10,116,149,265
90923,2021-06-07,11,148,186,334
90924,2021-06-07,12,181,244,425
90925,2021-06-07,13,190,208,398
90926,2021-06-07,14,143,204,347
90927,2021-06-07,15,145,232,377
90928,2021-06-07,16,223,308,531
90929,2021-06-07,17,268,512,780
90930,2021-06-07,18,283,508,791
90931,2021-06-07,19,227,383,610
90932,2021-06-07,20,177,292,469
90933,2021-06-07,21,113,172,285
90934,2021-06-07,22,73,99,172
90935,2021-06-07,23,49,45,94
90936,2021-06-08,0,28,16,44
90937,2021-06-08,1,9,6,15
90938,2021-06-08,2,9,7,16
90939,2021-06-08,3,6,5,11
90940,2021-06-08,4,16,6,22
90941,2021-06-08,5,23,49,72
90942,2021-06-08,6,54,147,201
90943,2021-06-08,7,98,298,396
90944,2021-06-08,8,135,414,549
90945,2021-06-08,9,116,245,361
90946,2021-06-08,10,122,184,306
90947,2021-06-08,11,131,215,346
90948,2021-06-08,12,166,233,399
90949,2021-06-08,13,176,196,372
90950,2021-06-08,14,158,213,371
90951,2021-06-08,15,187,243,430
90952,2021-06-08,16,194,338,532
90953,2021-06-08,17,281,545,826
90954,2021-06-08,18,303,593,896
90955,2021-06-08,19,247,422,669
90956,2021-06-08,20,177,301,478
90957,2021-06-08,21,138,221,359
90958,2021-06-08,22,75,114,189
90959,2021-06-08,23,56,52,108
90960,2021-06-09,0,35,32,67
90961,2021-06-09,1,17,9,26
90962,2021-06-09,2,5,14,19
90963,2021-06-09,3,4,3,7
90964,2021-06-09,4,7,13,20
90965,2021-06-09,5,23,62,85
90966,2021-06-09,6,61,178,239
90967,2021-06-09,7,100,281,381
90968,2021-06-09,8,136,425,561
90969,2021-06-09,9,127,249,376
90970,2021-06-09,10,124,188,312
90971,2021-06-09,11,135,212,347
90972,2021-06-09,12,176,239,415
90973,2021-06-09,13,193,253,446
90974,2021-06-09,14,201,220,421
90975,2021-06-09,15,211,263,474
90976,2021-06-09,16,226,338,564
90977,2021-06-09,17,314,519,833
90978,2021-06-09,18,331,514,845
90979,2021-06-09,19,214,445,659
90980,2021-06-09,20,181,279,460
90981,2021-06-09,21,134,207,341
90982,2021-06-09,22,106,132,238
90983,2021-06-09,23,81,76,157
90984,2021-06-10,0,39,32,71
90985,2021-06-10,1,21,15,36
90986,2021-06-10,2,8,5,13
90987,2021-06-10,3,6,4,10
90988,2021-06-10,4,13,5,18
90989,2021-06-10,5,19,49,68
90990,2021-06-10,6,48,128,176
90991,2021-06-10,7,88,264,352
90992,2021-06-10,8,132,424,556
90993,2021-06-10,9,152,250,402
90994,2021-06-10,10,134,191,325
90995,2021-06-10,11,179,242,421
90996,2021-06-10,12,184,264,448
90997,2021-06-10,13,158,225,383
90998,2021-06-10,14,112,167,279
90999,2021-06-10,15,167,243,410
91000,2021-06-10,16,126,185,311
91001,2021-06-10,17,49,86,135
91002,2021-06-10,18,52,138,190
91003,2021-06-10,19,67,138,205
91004,2021-06-10,20,63,140,203
91005,2021-06-10,21,68,110,178
91006,2021-06-10,22,73,91,164
91007,2021-06-10,23,44,53,97
91008,2021-06-11,0,23,27,50
91009,2021-06-11,1,13,22,35
91010,2021-06-11,2,5,12,17
91011,2021-06-11,3,6,9,15
91012,2021-06-11,4,7,3,10
91013,2021-06-11,5,12,25,37
91014,2021-06-11,6,27,68,95
91015,2021-06-11,7,28,103,131
91016,2021-06-11,8,17,80,97
91017,2021-06-11,9,22,82,104
91018,2021-06-11,10,23,53,76
91019,2021-06-11,11,19,42,61
91020,2021-06-11,12,12,36,48
91021,2021-06-11,13,56,102,158
91022,2021-06-11,14,108,183,291
91023,2021-06-11,15,104,171,275
91024,2021-06-11,16,126,185,311
91025,2021-06-11,17,157,335,492
91026,2021-06-11,18,187,341,528
91027,2021-06-11,19,127,265,392
91028,2021-06-11,20,111,206,317
91029,2021-06-11,21,102,148,250
91030,2021-06-11,22,132,114,246
91031,2021-06-11,23,128,116,244
91032,2021-06-12,0,115,90,205
91033,2021-06-12,1,106,70,176
91034,2021-06-12,2,101,80,181
91035,2021-06-12,3,89,59,148
91036,2021-06-12,4,30,13,43
91037,2021-06-12,5,18,16,34
91038,2021-06-12,6,29,45,74
91039,2021-06-12,7,56,117,173
91040,2021-06-12,8,128,176,304
91041,2021-06-12,9,187,267,454
91042,2021-06-12,10,306,330,636
91043,2021-06-12,11,408,412,820
91044,2021-06-12,12,542,429,971
91045,2021-06-12,13,605,472,1077
91046,2021-06-12,14,610,479,1089
91047,2021-06-12,15,573,387,960
91048,2021-06-12,16,518,436,954
91049,2021-06-12,17,505,455,960
91050,2021-06-12,18,410,464,874
91051,2021-06-12,19,394,362,756
91052,2021-06-12,20,334,282,616
91053,2021-06-12,21,263,255,518
91054,2021-06-12,22,273,196,469
91055,2021-06-12,23,367,200,567
91056,2021-06-13,0,309,180,489
91057,2021-06-13,1,191,103,294
91058,2021-06-13,2,207,100,307
91059,2021-06-13,3,122,52,174
91060,2021-06-13,4,27,15,42
91061,2021-06-13,5,17,19,36
91062,2021-06-13,6,31,34,65
91063,2021-06-13,7,62,78,140
91064,2021-06-13,8,127,143,270
91065,2021-06-13,9,209,234,443
91066,2021-06-13,10,369,290,659
91067,2021-06-13,11,396,357,753
91068,2021-06-13,12,458,387,845
91069,2021-06-13,13,475,372,847
91070,2021-06-13,14,391,306,697
91071,2021-06-13,15,293,223,516
91072,2021-06-13,16,379,298,677
91073,2021-06-13,17,383,342,725
91074,2021-06-13,18,316,309,625
91075,2021-06-13,19,293,286,579
91076,2021-06-13,20,203,202,405
91077,2021-06-13,21,144,149,293
91078,2021-06-13,22,140,109,249
91079,2021-06-13,23,85,56,141
91080,2021-06-14,0,28,26,54
91081,2021-06-14,1,21,14,35
91082,2021-06-14,2,16,4,20
91083,2021-06-14,3,7,5,12
91084,2021-06-14,4,11,12,23
91085,2021-06-14,5,16,38,54
91086,2021-06-14,6,37,140,177
91087,2021-06-14,7,76,242,318
91088,2021-06-14,8,157,375,532
91089,2021-06-14,9,131,196,327
91090,2021-06-14,10,151,191,342
91091,2021-06-14,11,180,187,367
91092,2021-06-14,12,201,263,464
91093,2021-06-14,13,224,227,451
91094,2021-06-14,14,241,207,448
91095,2021-06-14,15,244,226,470
91096,2021-06-14,16,295,333,628
91097,2021-06-14,17,343,543,886
91098,2021-06-14,18,362,568,930
91099,2021-06-14,19,333,401,734
91100,2021-06-14,20,220,300,520
91101,2021-06-14,21,123,183,306
91102,2021-06-14,22,108,107,215
91103,2021-06-14,23,8,12,20
91104,2021-06-15,0,8,14,22
91105,2021-06-15,1,11,8,19
91106,2021-06-15,2,4,6,10
91107,2021-06-15,3,7,4,11
91108,2021-06-15,4,10,9,19
91109,2021-06-15,5,23,51,74
91110,2021-06-15,6,52,151,203
91111,2021-06-15,7,74,294,368
91112,2021-06-15,8,142,469,611
91113,2021-06-15,9,119,284,403
91114,2021-06-15,10,154,193,347
91115,2021-06-15,11,186,229,415
91116,2021-06-15,12,224,271,495
91117,2021-06-15,13,254,250,504
91118,2021-06-15,14,252,244,496
91119,2021-06-15,15,277,251,528
91120,2021-06-15,16,286,378,664
91121,2021-06-15,17,375,664,1039
91122,2021-06-15,18,406,626,1032
91123,2021-06-15,19,229,338,567
91124,2021-06-15,20,283,350,633
91125,2021-06-15,21,220,260,480
91126,2021-06-15,22,217,172,389
91127,2021-06-15,23,110,73,183
91128,2021-06-16,0,45,25,70
91129,2021-06-16,1,21,8,29
91130,2021-06-16,2,18,10,28
91131,2021-06-16,3,4,6,10
91132,2021-06-16,4,7,4,11
91133,2021-06-16,5,28,45,73
91134,2021-06-16,6,55,144,199
91135,2021-06-16,7,94,302,396
91136,2021-06-16,8,158,419,577
91137,2021-06-16,9,143,253,396
91138,2021-06-16,10,149,210,359
91139,2021-06-16,11,169,240,409
91140,2021-06-16,12,200,270,470
91141,2021-06-16,13,227,278,505
91142,2021-06-16,14,231,246,477
91143,2021-06-16,15,288,309,597
91144,2021-06-16,16,270,429,699
91145,2021-06-16,17,364,628,992
91146,2021-06-16,18,427,686,1113
91147,2021-06-16,19,386,522,908
91148,2021-06-16,20,293,362,655
91149,2021-06-16,21,208,247,455
91150,2021-06-16,22,143,177,320
91151,2021-06-16,23,80,101,181
91152,2021-06-17,0,39,27,66
91153,2021-06-17,1,21,8,29
91154,2021-06-17,2,9,10,19
91155,2021-06-17,3,5,7,12
91156,2021-06-17,4,9,10,19
91157,2021-06-17,5,32,44,76
91158,2021-06-17,6,49,137,186
91159,2021-06-17,7,80,286,366
91160,2021-06-17,8,141,456,597
91161,2021-06-17,9,124,261,385
91162,2021-06-17,10,161,180,341
91163,2021-06-17,11,211,234,445
91164,2021-06-17,12,216,251,467
91165,2021-06-17,13,271,258,529
91166,2021-06-17,14,283,260,543
91167,2021-06-17,15,323,326,649
91168,2021-06-17,16,355,400,755
91169,2021-06-17,17,406,674,1080
91170,2021-06-17,18,397,595,992
91171,2021-06-17,19,369,501,870
91172,2021-06-17,20,343,396,739
91173,2021-06-17,21,221,241,462
91174,2021-06-17,22,184,204,388
91175,2021-06-17,23,146,139,285
91176,2021-06-18,0,78,51,129
91177,2021-06-18,1,58,51,109
91178,2021-06-18,2,39,8,47
91179,2021-06-18,3,19,7,26
91180,2021-06-18,4,14,11,25
91181,2021-06-18,5,18,44,62
91182,2021-06-18,6,43,99,142
91183,2021-06-18,7,66,184,250
91184,2021-06-18,8,124,309,433
91185,2021-06-18,9,183,278,461
91186,2021-06-18,10,263,289,552
91187,2021-06-18,11,363,373,736
91188,2021-06-18,12,416,350,766
91189,2021-06-18,13,429,337,766
91190,2021-06-18,14,435,398,833
91191,2021-06-18,15,451,410,861
91192,2021-06-18,16,450,399,849
91193,2021-06-18,17,475,537,1012
91194,2021-06-18,18,513,465,978
91195,2021-06-18,19,341,413,754
91196,2021-06-18,20,328,288,616
91197,2021-06-18,21,281,232,513
91198,2021-06-18,22,245,193,438
91199,2021-06-18,23,239,179,418
91200,2021-06-19,0,165,119,284
91201,2021-06-19,1,131,77,208
91202,2021-06-19,2,120,72,192
91203,2021-06-19,3,49,28,77
91204,2021-06-19,4,21,17,38
91205,2021-06-19,5,22,30,52
91206,2021-06-19,6,38,59,97
91207,2021-06-19,7,70,94,164
91208,2021-06-19,8,109,202,311
91209,2021-06-19,9,215,286,501
91210,2021-06-19,10,401,346,747
91211,2021-06-19,11,549,438,987
91212,2021-06-19,12,462,373,835
91213,2021-06-19,13,558,349,907
91214,2021-06-19,14,611,357,968
91215,2021-06-19,15,575,393,968
91216,2021-06-19,16,536,367,903
91217,2021-06-19,17,441,359,800
91218,2021-06-19,18,374,338,712
91219,2021-06-19,19,353,289,642
91220,2021-06-19,20,307,270,577
91221,2021-06-19,21,226,171,397
91222,2021-06-19,22,220,209,429
91223,2021-06-19,23,199,166,365
91224,2021-06-20,0,138,94,232
91225,2021-06-20,1,97,70,167
91226,2021-06-20,2,88,54,142
91227,2021-06-20,3,61,19,80
91228,2021-06-20,4,25,17,42
91229,2021-06-20,5,19,17,36
91230,2021-06-20,6,41,31,72
91231,2021-06-20,7,49,72,121
91232,2021-06-20,8,143,169,312
91233,2021-06-20,9,215,242,457
91234,2021-06-20,10,347,304,651
91235,2021-06-20,11,453,335,788
91236,2021-06-20,12,397,365,762
91237,2021-06-20,13,444,347,791
91238,2021-06-20,14,484,389,873
91239,2021-06-20,15,448,344,792
91240,2021-06-20,16,424,321,745
91241,2021-06-20,17,330,317,647
91242,2021-06-20,18,327,344,671
91243,2021-06-20,19,277,279,556
91244,2021-06-20,20,263,232,495
91245,2021-06-20,21,179,167,346
91246,2021-06-20,22,140,129,269
91247,2021-06-20,23,80,72,152
91248,2021-06-21,0,32,31,63
91249,2021-06-21,1,23,14,37
91250,2021-06-21,2,13,10,23
91251,2021-06-21,3,5,5,10
91252,2021-06-21,4,13,14,27
91253,2021-06-21,5,24,48,72
91254,2021-06-21,6,55,125,180
91255,2021-06-21,7,78,267,345
91256,2021-06-21,8,157,357,514
91257,2021-06-21,9,113,261,374
91258,2021-06-21,10,153,176,329
91259,2021-06-21,11,196,199,395
91260,2021-06-21,12,196,259,455
91261,2021-06-21,13,212,215,427
91262,2021-06-21,14,211,210,421
91263,2021-06-21,15,200,219,419
91264,2021-06-21,16,231,313,544
91265,2021-06-21,17,277,561,838
91266,2021-06-21,18,217,376,593
91267,2021-06-21,19,155,308,463
91268,2021-06-21,20,146,246,392
91269,2021-06-21,21,124,143,267
91270,2021-06-21,22,77,106,183
91271,2021-06-21,23,26,39,65
91272,2021-06-22,0,31,25,56
91273,2021-06-22,1,13,18,31
91274,2021-06-22,2,5,8,13
91275,2021-06-22,3,2,3,5
91276,2021-06-22,4,9,8,17
91277,2021-06-22,5,31,49,80
91278,2021-06-22,6,52,150,202
91279,2021-06-22,7,76,251,327
91280,2021-06-22,8,88,335,423
91281,2021-06-22,9,78,215,293
91282,2021-06-22,10,70,81,151
91283,2021-06-22,11,58,114,172
91284,2021-06-22,12,23,45,68
91285,2021-06-22,13,38,62,100
91286,2021-06-22,14,71,118,189
91287,2021-06-22,15,87,165,252
91288,2021-06-22,16,215,280,495
91289,2021-06-22,17,278,581,859
91290,2021-06-22,18,305,555,860
91291,2021-06-22,19,266,439,705
91292,2021-06-22,20,188,335,523
91293,2021-06-22,21,160,191,351
91294,2021-06-22,22,113,150,263
91295,2021-06-22,23,74,77,151
91296,2021-06-23,0,29,20,49
91297,2021-06-23,1,16,11,27
91298,2021-06-23,2,8,13,21
91299,2021-06-23,3,3,3,6
91300,2021-06-23,4,7,12,19
91301,2021-06-23,5,17,55,72
91302,2021-06-23,6,42,161,203
91303,2021-06-23,7,105,336,441
91304,2021-06-23,8,155,456,611
91305,2021-06-23,9,151,302,453
91306,2021-06-23,10,180,226,406
91307,2021-06-23,11,240,264,504
91308,2021-06-23,12,254,279,533
91309,2021-06-23,13,256,318,574
91310,2021-06-23,14,264,304,568
91311,2021-06-23,15,317,317,634
91312,2021-06-23,16,339,392,731
91313,2021-06-23,17,438,687,1125
91314,2021-06-23,18,429,721,1150
91315,2021-06-23,19,398,541,939
91316,2021-06-23,20,298,375,673
91317,2021-06-23,21,232,287,519
91318,2021-06-23,22,155,168,323
91319,2021-06-23,23,96,95,191
91320,2021-06-24,0,28,32,60
91321,2021-06-24,1,20,12,32
91322,2021-06-24,2,15,8,23
91323,2021-06-24,3,4,3,7
91324,2021-06-24,4,10,7,17
91325,2021-06-24,5,21,57,78
91326,2021-06-24,6,44,154,198
91327,2021-06-24,7,86,289,375
91328,2021-06-24,8,170,409,579
91329,2021-06-24,9,149,293,442
91330,2021-06-24,10,195,215,410
91331,2021-06-24,11,247,272,519
91332,2021-06-24,12,246,287,533
91333,2021-06-24,13,266,257,523
91334,2021-06-24,14,286,268,554
91335,2021-06-24,15,285,314,599
91336,2021-06-24,16,321,390,711
91337,2021-06-24,17,459,652,1111
91338,2021-06-24,18,445,676,1121
91339,2021-06-24,19,361,552,913
91340,2021-06-24,20,330,406,736
91341,2021-06-24,21,196,287,483
91342,2021-06-24,22,176,198,374
91343,2021-06-24,23,133,115,248
91344,2021-06-25,0,67,62,129
91345,2021-06-25,1,52,43,95
91346,2021-06-25,2,29,13,42
91347,2021-06-25,3,15,7,22
91348,2021-06-25,4,10,7,17
91349,2021-06-25,5,20,46,66
91350,2021-06-25,6,48,107,155
91351,2021-06-25,7,91,269,360
91352,2021-06-25,8,137,357,494
91353,2021-06-25,9,180,282,462
91354,2021-06-25,10,221,225,446
91355,2021-06-25,11,326,276,602
91356,2021-06-25,12,253,251,504
91357,2021-06-25,13,224,76,300
91358,2021-06-25,14,377,306,683
91359,2021-06-25,15,329,310,639
91360,2021-06-25,16,411,473,884
91361,2021-06-25,17,383,538,921
91362,2021-06-25,18,418,548,966
91363,2021-06-25,19,386,461,847
91364,2021-06-25,20,362,333,695
91365,2021-06-25,21,224,199,423
91366,2021-06-25,22,243,186,429
91367,2021-06-25,23,218,177,395
91368,2021-06-26,0,153,104,257
91369,2021-06-26,1,126,75,201
91370,2021-06-26,2,122,68,190
91371,2021-06-26,3,72,31,103
91372,2021-06-26,4,20,11,31
91373,2021-06-26,5,12,18,30
91374,2021-06-26,6,18,39,57
91375,2021-06-26,7,21,45,66
91376,2021-06-26,8,86,165,251
91377,2021-06-26,9,195,292,487
91378,2021-06-26,10,375,350,725
91379,2021-06-26,11,447,412,859
91380,2021-06-26,12,494,395,889
91381,2021-06-26,13,557,365,922
91382,2021-06-26,14,539,395,934
91383,2021-06-26,15,569,388,957
91384,2021-06-26,16,456,316,772
91385,2021-06-26,17,547,340,887
91386,2021-06-26,18,416,372,788
91387,2021-06-26,19,427,320,747
91388,2021-06-26,20,338,255,593
91389,2021-06-26,21,264,191,455
91390,2021-06-26,22,181,171,352
91391,2021-06-26,23,207,151,358
91392,2021-06-27,0,183,134,317
91393,2021-06-27,1,136,99,235
91394,2021-06-27,2,121,60,181
91395,2021-06-27,3,82,30,112
91396,2021-06-27,4,17,13,30
91397,2021-06-27,5,20,12,32
91398,2021-06-27,6,24,41,65
91399,2021-06-27,7,64,79,143
91400,2021-06-27,8,126,175,301
91401,2021-06-27,9,224,266,490
91402,2021-06-27,10,297,272,569
91403,2021-06-27,11,392,345,737
91404,2021-06-27,12,430,341,771
91405,2021-06-27,13,365,332,697
91406,2021-06-27,14,468,341,809
91407,2021-06-27,15,396,324,720
91408,2021-06-27,16,351,324,675
91409,2021-06-27,17,293,319,612
91410,2021-06-27,18,279,280,559
91411,2021-06-27,19,287,286,573
91412,2021-06-27,20,264,252,516
91413,2021-06-27,21,165,168,333
91414,2021-06-27,22,108,88,196
91415,2021-06-27,23,67,79,146
91416,2021-06-28,0,45,25,70
91417,2021-06-28,1,33,18,51
91418,2021-06-28,2,6,6,12
91419,2021-06-28,3,12,6,18
91420,2021-06-28,4,9,4,13
91421,2021-06-28,5,21,36,57
91422,2021-06-28,6,41,128,169
91423,2021-06-28,7,81,255,336
91424,2021-06-28,8,120,356,476
91425,2021-06-28,9,140,241,381
91426,2021-06-28,10,163,201,364
91427,2021-06-28,11,175,211,386
91428,2021-06-28,12,202,242,444
91429,2021-06-28,13,202,203,405
91430,2021-06-28,14,205,215,420
91431,2021-06-28,15,206,228,434
91432,2021-06-28,16,258,322,580
91433,2021-06-28,17,270,477,747
91434,2021-06-28,18,365,517,882
91435,2021-06-28,19,240,377,617
91436,2021-06-28,20,230,311,541
91437,2021-06-28,21,140,239,379
91438,2021-06-28,22,132,139,271
91439,2021-06-28,23,96,63,159
91440,2021-06-29,0,30,35,65
91441,2021-06-29,1,25,14,39
91442,2021-06-29,2,10,7,17
91443,2021-06-29,3,6,9,15
91444,2021-06-29,4,16,8,24
91445,2021-06-29,5,23,53,76
91446,2021-06-29,6,50,159,209
91447,2021-06-29,7,88,323,411
91448,2021-06-29,8,138,437,575
91449,2021-06-29,9,124,283,407
91450,2021-06-29,10,148,210,358
91451,2021-06-29,11,150,212,362
91452,2021-06-29,12,151,234,385
91453,2021-06-29,13,121,200,321
91454,2021-06-29,14,151,200,351
91455,2021-06-29,15,181,229,410
91456,2021-06-29,16,258,383,641
91457,2021-06-29,17,305,515,820
91458,2021-06-29,18,340,569,909
91459,2021-06-29,19,293,405,698
91460,2021-06-29,20,197,340,537
91461,2021-06-29,21,196,233,429
91462,2021-06-29,22,148,160,308
91463,2021-06-29,23,71,86,157
91464,2021-06-30,0,40,23,63
91465,2021-06-30,1,24,14,38
91466,2021-06-30,2,8,12,20
91467,2021-06-30,3,2,4,6
91468,2021-06-30,4,11,8,19
91469,2021-06-30,5,17,56,73
91470,2021-06-30,6,64,159,223
91471,2021-06-30,7,109,304,413
91472,2021-06-30,8,155,413,568
91473,2021-06-30,9,139,276,415
91474,2021-06-30,10,150,195,345
91475,2021-06-30,11,168,201,369
91476,2021-06-30,12,191,204,395
91477,2021-06-30,13,186,243,429
91478,2021-06-30,14,143,248,391
91479,2021-06-30,15,190,276,466
91480,2021-06-30,16,207,322,529
91481,2021-06-30,17,293,503,796
91482,2021-06-30,18,302,511,813
91483,2021-06-30,19,271,403,674
91484,2021-06-30,20,168,251,419
91485,2021-06-30,21,136,174,310
91486,2021-06-30,22,67,78,145
91487,2021-06-30,23,61,75,136
91488,2021-07-01,0,43,45,88
91489,2021-07-01,1,13,17,30
91490,2021-07-01,2,21,10,31
91491,2021-07-01,3,9,7,16
91492,2021-07-01,4,11,16,27
91493,2021-07-01,5,24,58,82
91494,2021-07-01,6,41,130,171
91495,2021-07-01,7,110,266,376
91496,2021-07-01,8,148,427,575
91497,2021-07-01,9,177,269,446
91498,2021-07-01,10,152,243,395
91499,2021-07-01,11,173,239,412
91500,2021-07-01,12,223,254,477
91501,2021-07-01,13,171,228,399
91502,2021-07-01,14,235,246,481
91503,2021-07-01,15,61,80,141
91504,2021-07-01,16,171,265,436
91505,2021-07-01,17,244,442,686
91506,2021-07-01,18,279,431,710
91507,2021-07-01,19,192,343,535
91508,2021-07-01,20,141,247,388
91509,2021-07-01,21,26,67,93
91510,2021-07-01,22,54,70,124
91511,2021-07-01,23,60,50,110
91512,2021-07-02,0,41,34,75
91513,2021-07-02,1,18,28,46
91514,2021-07-02,2,12,10,22
91515,2021-07-02,3,2,7,9
91516,2021-07-02,4,13,13,26
91517,2021-07-02,5,7,42,49
91518,2021-07-02,6,27,67,94
91519,2021-07-02,7,32,133,165
91520,2021-07-02,8,66,225,291
91521,2021-07-02,9,96,204,300
91522,2021-07-02,10,183,233,416
91523,2021-07-02,11,259,254,513
91524,2021-07-02,12,263,280,543
91525,2021-07-02,13,348,336,684
91526,2021-07-02,14,359,360,719
91527,2021-07-02,15,394,358,752
91528,2021-07-02,16,460,413,873
91529,2021-07-02,17,482,504,986
91530,2021-07-02,18,412,502,914
91531,2021-07-02,19,383,422,805
91532,2021-07-02,20,298,296,594
91533,2021-07-02,21,214,213,427
91534,2021-07-02,22,247,204,451
91535,2021-07-02,23,178,154,332
91536,2021-07-03,0,153,145,298
91537,2021-07-03,1,91,84,175
91538,2021-07-03,2,91,68,159
91539,2021-07-03,3,62,29,91
91540,2021-07-03,4,20,7,27
91541,2021-07-03,5,27,26,53
91542,2021-07-03,6,40,46,86
91543,2021-07-03,7,64,101,165
91544,2021-07-03,8,122,168,290
91545,2021-07-03,9,262,292,554
91546,2021-07-03,10,370,357,727
91547,2021-07-03,11,580,396,976
91548,2021-07-03,12,661,436,1097
91549,2021-07-03,13,685,413,1098
91550,2021-07-03,14,750,406,1156
91551,2021-07-03,15,653,359,1012
91552,2021-07-03,16,755,333,1088
91553,2021-07-03,17,623,337,960
91554,2021-07-03,18,519,391,910
91555,2021-07-03,19,526,297,823
91556,2021-07-03,20,264,193,457
91557,2021-07-03,21,130,135,265
91558,2021-07-03,22,190,121,311
91559,2021-07-03,23,206,153,359
91560,2021-07-04,0,217,104,321
91561,2021-07-04,1,148,96,244
91562,2021-07-04,2,87,61,148
91563,2021-07-04,3,66,35,101
91564,2021-07-04,4,23,8,31
91565,2021-07-04,5,20,20,40
91566,2021-07-04,6,42,37,79
91567,2021-07-04,7,75,69,144
91568,2021-07-04,8,142,131,273
91569,2021-07-04,9,297,228,525
91570,2021-07-04,10,554,330,884
91571,2021-07-04,11,705,329,1034
91572,2021-07-04,12,718,318,1036
91573,2021-07-04,13,771,266,1037
91574,2021-07-04,14,823,363,1186
91575,2021-07-04,15,867,337,1204
91576,2021-07-04,16,869,317,1186
91577,2021-07-04,17,777,272,1049
91578,2021-07-04,18,789,281,1070
91579,2021-07-04,19,876,324,1200
91580,2021-07-04,20,958,326,1284
91581,2021-07-04,21,787,288,1075
91582,2021-07-04,22,702,301,1003
91583,2021-07-04,23,501,227,728
91584,2021-07-05,0,404,153,557
91585,2021-07-05,1,201,88,289
91586,2021-07-05,2,91,53,144
91587,2021-07-05,3,42,28,70
91588,2021-07-05,4,21,19,40
91589,2021-07-05,5,27,32,59
91590,2021-07-05,6,43,58,101
91591,2021-07-05,7,48,64,112
91592,2021-07-05,8,116,136,252
91593,2021-07-05,9,244,200,444
91594,2021-07-05,10,355,249,604
91595,2021-07-05,11,463,285,748
91596,2021-07-05,12,514,303,817
91597,2021-07-05,13,534,330,864
91598,2021-07-05,14,521,326,847
91599,2021-07-05,15,529,330,859
91600,2021-07-05,16,471,341,812
91601,2021-07-05,17,493,353,846
91602,2021-07-05,18,440,355,795
91603,2021-07-05,19,332,287,619
91604,2021-07-05,20,323,268,591
91605,2021-07-05,21,203,164,367
91606,2021-07-05,22,136,132,268
91607,2021-07-05,23,91,62,153
91608,2021-07-06,0,37,23,60
91609,2021-07-06,1,32,12,44
91610,2021-07-06,2,24,11,35
91611,2021-07-06,3,9,9,18
91612,2021-07-06,4,13,14,27
91613,2021-07-06,5,20,67,87
91614,2021-07-06,6,46,123,169
91615,2021-07-06,7,78,294,372
91616,2021-07-06,8,129,414,543
91617,2021-07-06,9,147,258,405
91618,2021-07-06,10,191,215,406
91619,2021-07-06,11,224,196,420
91620,2021-07-06,12,248,232,480
91621,2021-07-06,13,234,245,479
91622,2021-07-06,14,251,231,482
91623,2021-07-06,15,215,254,469
91624,2021-07-06,16,269,355,624
91625,2021-07-06,17,272,484,756
91626,2021-07-06,18,325,544,869
91627,2021-07-06,19,298,407,705
91628,2021-07-06,20,248,318,566
91629,2021-07-06,21,171,188,359
91630,2021-07-06,22,128,136,264
91631,2021-07-06,23,62,68,130
91632,2021-07-07,0,36,24,60
91633,2021-07-07,1,24,10,34
91634,2021-07-07,2,8,5,13
91635,2021-07-07,3,11,7,18
91636,2021-07-07,4,9,7,16
91637,2021-07-07,5,23,68,91
91638,2021-07-07,6,61,140,201
91639,2021-07-07,7,78,328,406
91640,2021-07-07,8,132,457,589
91641,2021-07-07,9,142,285,427
91642,2021-07-07,10,154,189,343
91643,2021-07-07,11,151,206,357
91644,2021-07-07,12,165,238,403
91645,2021-07-07,13,205,251,456
91646,2021-07-07,14,218,224,442
91647,2021-07-07,15,199,263,462
91648,2021-07-07,16,229,341,570
91649,2021-07-07,17,288,544,832
91650,2021-07-07,18,317,606,923
91651,2021-07-07,19,259,438,697
91652,2021-07-07,20,228,348,576
91653,2021-07-07,21,179,207,386
91654,2021-07-07,22,134,144,278
91655,2021-07-07,23,86,80,166
91656,2021-07-08,0,29,39,68
91657,2021-07-08,1,19,18,37
91658,2021-07-08,2,11,11,22
91659,2021-07-08,3,8,16,24
91660,2021-07-08,4,13,10,23
91661,2021-07-08,5,24,71,95
91662,2021-07-08,6,49,147,196
91663,2021-07-08,7,83,294,377
91664,2021-07-08,8,138,430,568
91665,2021-07-08,9,177,278,455
91666,2021-07-08,10,163,215,378
91667,2021-07-08,11,190,210,400
91668,2021-07-08,12,224,257,481
91669,2021-07-08,13,202,243,445
91670,2021-07-08,14,134,186,320
91671,2021-07-08,15,155,161,316
91672,2021-07-08,16,206,341,547
91673,2021-07-08,17,276,509,785
91674,2021-07-08,18,234,420,654
91675,2021-07-08,19,80,229,309
91676,2021-07-08,20,54,136,190
91677,2021-07-08,21,42,69,111
91678,2021-07-08,22,59,86,145
91679,2021-07-08,23,63,79,142
91680,2021-07-09,0,17,43,60
91681,2021-07-09,1,12,13,25
91682,2021-07-09,2,6,6,12
91683,2021-07-09,3,10,6,16
91684,2021-07-09,4,7,10,17
91685,2021-07-09,5,18,54,72
91686,2021-07-09,6,52,135,187
91687,2021-07-09,7,98,252,350
91688,2021-07-09,8,149,381,530
91689,2021-07-09,9,153,263,416
91690,2021-07-09,10,198,217,415
91691,2021-07-09,11,247,239,486
91692,2021-07-09,12,297,277,574
91693,2021-07-09,13,253,283,536
91694,2021-07-09,14,282,302,584
91695,2021-07-09,15,289,324,613
91696,2021-07-09,16,142,172,314
91697,2021-07-09,17,133,271,404
91698,2021-07-09,18,221,414,635
91699,2021-07-09,19,274,358,632
91700,2021-07-09,20,279,288,567
91701,2021-07-09,21,189,199,388
91702,2021-07-09,22,151,169,320
91703,2021-07-09,23,172,142,314
91704,2021-07-10,0,123,86,209
91705,2021-07-10,1,112,81,193
91706,2021-07-10,2,103,62,165
91707,2021-07-10,3,57,26,83
91708,2021-07-10,4,22,15,37
91709,2021-07-10,5,21,35,56
91710,2021-07-10,6,32,68,100
91711,2021-07-10,7,69,115,184
91712,2021-07-10,8,151,206,357
91713,2021-07-10,9,318,317,635
91714,2021-07-10,10,396,396,792
91715,2021-07-10,11,502,431,933
91716,2021-07-10,12,516,438,954
91717,2021-07-10,13,632,453,1085
91718,2021-07-10,14,540,429,969
91719,2021-07-10,15,627,453,1080
91720,2021-07-10,16,605,376,981
91721,2021-07-10,17,542,345,887
91722,2021-07-10,18,545,419,964
91723,2021-07-10,19,451,387,838
91724,2021-07-10,20,367,260,627
91725,2021-07-10,21,293,197,490
91726,2021-07-10,22,237,212,449
91727,2021-07-10,23,236,174,410
91728,2021-07-11,0,161,136,297
91729,2021-07-11,1,164,115,279
91730,2021-07-11,2,119,73,192
91731,2021-07-11,3,80,32,112
91732,2021-07-11,4,26,18,44
91733,2021-07-11,5,24,16,40
91734,2021-07-11,6,30,36,66
91735,2021-07-11,7,75,81,156
91736,2021-07-11,8,139,164,303
91737,2021-07-11,9,226,211,437
91738,2021-07-11,10,370,315,685
91739,2021-07-11,11,386,402,788
91740,2021-07-11,12,443,369,812
91741,2021-07-11,13,403,388,791
91742,2021-07-11,14,542,444,986
91743,2021-07-11,15,391,310,701
91744,2021-07-11,16,342,287,629
91745,2021-07-11,17,299,308,607
91746,2021-07-11,18,402,389,791
91747,2021-07-11,19,370,316,686
91748,2021-07-11,20,294,267,561
91749,2021-07-11,21,200,158,358
91750,2021-07-11,22,108,134,242
91751,2021-07-11,23,74,64,138
91752,2021-07-12,0,20,31,51
91753,2021-07-12,1,21,18,39
91754,2021-07-12,2,7,13,20
91755,2021-07-12,3,4,10,14
91756,2021-07-12,4,12,11,23
91757,2021-07-12,5,16,58,74
91758,2021-07-12,6,39,135,174
91759,2021-07-12,7,71,332,403
91760,2021-07-12,8,136,406,542
91761,2021-07-12,9,133,297,430
91762,2021-07-12,10,231,163,394
91763,2021-07-12,11,245,209,454
91764,2021-07-12,12,189,224,413
91765,2021-07-12,13,242,246,488
91766,2021-07-12,14,218,215,433
91767,2021-07-12,15,233,230,463
91768,2021-07-12,16,252,317,569
91769,2021-07-12,17,304,538,842
91770,2021-07-12,18,296,604,900
91771,2021-07-12,19,286,395,681
91772,2021-07-12,20,223,318,541
91773,2021-07-12,21,153,190,343
91774,2021-07-12,22,126,127,253
91775,2021-07-12,23,56,57,113
91776,2021-07-13,0,31,26,57
91777,2021-07-13,1,22,12,34
91778,2021-07-13,2,9,11,20
91779,2021-07-13,3,10,7,17
91780,2021-07-13,4,11,16,27
91781,2021-07-13,5,21,68,89
91782,2021-07-13,6,42,162,204
91783,2021-07-13,7,104,336,440
91784,2021-07-13,8,143,465,608
91785,2021-07-13,9,173,271,444
91786,2021-07-13,10,165,177,342
91787,2021-07-13,11,154,242,396
91788,2021-07-13,12,203,251,454
91789,2021-07-13,13,161,248,409
91790,2021-07-13,14,171,252,423
91791,2021-07-13,15,193,225,418
91792,2021-07-13,16,240,353,593
91793,2021-07-13,17,332,576,908
91794,2021-07-13,18,347,637,984
91795,2021-07-13,19,322,482,804
91796,2021-07-13,20,251,332,583
91797,2021-07-13,21,164,235,399
91798,2021-07-13,22,142,161,303
91799,2021-07-13,23,76,96,172
91800,2021-07-14,0,39,26,65
91801,2021-07-14,1,26,18,44
91802,2021-07-14,2,22,13,35
91803,2021-07-14,3,13,3,16
91804,2021-07-14,4,11,8,19
91805,2021-07-14,5,22,62,84
91806,2021-07-14,6,58,156,214
91807,2021-07-14,7,87,375,462
91808,2021-07-14,8,158,483,641
91809,2021-07-14,9,134,284,418
91810,2021-07-14,10,161,215,376
91811,2021-07-14,11,192,227,419
91812,2021-07-14,12,197,239,436
91813,2021-07-14,13,208,242,450
91814,2021-07-14,14,200,246,446
91815,2021-07-14,15,212,262,474
91816,2021-07-14,16,219,337,556
91817,2021-07-14,17,237,483,720
91818,2021-07-14,18,273,494,767
91819,2021-07-14,19,254,463,717
91820,2021-07-14,20,260,328,588
91821,2021-07-14,21,193,241,434
91822,2021-07-14,22,147,212,359
91823,2021-07-14,23,105,110,215
91824,2021-07-15,0,59,47,106
91825,2021-07-15,1,32,31,63
91826,2021-07-15,2,13,17,30
91827,2021-07-15,3,3,8,11
91828,2021-07-15,4,14,15,29
91829,2021-07-15,5,29,61,90
91830,2021-07-15,6,47,144,191
91831,2021-07-15,7,83,310,393
91832,2021-07-15,8,164,481,645
91833,2021-07-15,9,155,313,468
91834,2021-07-15,10,176,204,380
91835,2021-07-15,11,195,195,390
91836,2021-07-15,12,214,224,438
91837,2021-07-15,13,222,258,480
91838,2021-07-15,14,249,223,472
91839,2021-07-15,15,268,273,541
91840,2021-07-15,16,304,385,689
91841,2021-07-15,17,386,573,959
91842,2021-07-15,18,450,570,1020
91843,2021-07-15,19,335,504,839
91844,2021-07-15,20,274,399,673
91845,2021-07-15,21,207,266,473
91846,2021-07-15,22,178,179,357
91847,2021-07-15,23,120,118,238
91848,2021-07-16,0,53,42,95
91849,2021-07-16,1,39,42,81
91850,2021-07-16,2,25,18,43
91851,2021-07-16,3,11,8,19
91852,2021-07-16,4,15,9,24
91853,2021-07-16,5,33,57,90
91854,2021-07-16,6,47,135,182
91855,2021-07-16,7,80,285,365
91856,2021-07-16,8,154,406,560
91857,2021-07-16,9,171,285,456
91858,2021-07-16,10,249,231,480
91859,2021-07-16,11,260,218,478
91860,2021-07-16,12,245,248,493
91861,2021-07-16,13,241,252,493
91862,2021-07-16,14,270,300,570
91863,2021-07-16,15,287,289,576
91864,2021-07-16,16,283,411,694
91865,2021-07-16,17,366,543,909
91866,2021-07-16,18,384,518,902
91867,2021-07-16,19,403,394,797
91868,2021-07-16,20,318,332,650
91869,2021-07-16,21,265,251,516
91870,2021-07-16,22,272,185,457
91871,2021-07-16,23,252,207,459
91872,2021-07-17,0,218,158,376
91873,2021-07-17,1,137,106,243
91874,2021-07-17,2,160,68,228
91875,2021-07-17,3,50,23,73
91876,2021-07-17,4,20,14,34
91877,2021-07-17,5,22,17,39
91878,2021-07-17,6,48,69,117
91879,2021-07-17,7,69,126,195
91880,2021-07-17,8,154,202,356
91881,2021-07-17,9,267,298,565
91882,2021-07-17,10,374,377,751
91883,2021-07-17,11,478,366,844
91884,2021-07-17,12,484,393,877
91885,2021-07-17,13,460,345,805
91886,2021-07-17,14,509,288,797
91887,2021-07-17,15,463,323,786
91888,2021-07-17,16,358,313,671
91889,2021-07-17,17,300,253,553
91890,2021-07-17,18,322,298,620
91891,2021-07-17,19,285,255,540
91892,2021-07-17,20,262,233,495
91893,2021-07-17,21,201,194,395
91894,2021-07-17,22,243,173,416
91895,2021-07-17,23,224,140,364
91896,2021-07-18,0,186,105,291
91897,2021-07-18,1,166,69,235
91898,2021-07-18,2,103,64,167
91899,2021-07-18,3,77,39,116
91900,2021-07-18,4,25,22,47
91901,2021-07-18,5,16,20,36
91902,2021-07-18,6,30,34,64
91903,2021-07-18,7,71,82,153
91904,2021-07-18,8,120,147,267
91905,2021-07-18,9,240,286,526
91906,2021-07-18,10,393,340,733
91907,2021-07-18,11,447,326,773
91908,2021-07-18,12,464,403,867
91909,2021-07-18,13,498,399,897
91910,2021-07-18,14,539,360,899
91911,2021-07-18,15,575,353,928
91912,2021-07-18,16,525,372,897
91913,2021-07-18,17,488,390,878
91914,2021-07-18,18,403,385,788
91915,2021-07-18,19,315,310,625
91916,2021-07-18,20,270,230,500
91917,2021-07-18,21,162,182,344
91918,2021-07-18,22,107,123,230
91919,2021-07-18,23,76,74,150
91920,2021-07-19,0,61,24,85
91921,2021-07-19,1,19,24,43
91922,2021-07-19,2,12,37,49
91923,2021-07-19,3,6,31,37
91924,2021-07-19,4,9,8,17
91925,2021-07-19,5,11,53,64
91926,2021-07-19,6,51,132,183
91927,2021-07-19,7,79,291,370
91928,2021-07-19,8,137,433,570
91929,2021-07-19,9,155,258,413
91930,2021-07-19,10,184,190,374
91931,2021-07-19,11,203,191,394
91932,2021-07-19,12,249,228,477
91933,2021-07-19,13,271,194,465
91934,2021-07-19,14,280,204,484
91935,2021-07-19,15,234,244,478
91936,2021-07-19,16,260,331,591
91937,2021-07-19,17,355,575,930
91938,2021-07-19,18,366,656,1022
91939,2021-07-19,19,272,445,717
91940,2021-07-19,20,228,329,557
91941,2021-07-19,21,157,230,387
91942,2021-07-19,22,133,172,305
91943,2021-07-19,23,72,72,144
91944,2021-07-20,0,31,25,56
91945,2021-07-20,1,21,20,41
91946,2021-07-20,2,13,8,21
91947,2021-07-20,3,6,8,14
91948,2021-07-20,4,6,14,20
91949,2021-07-20,5,25,74,99
91950,2021-07-20,6,64,164,228
91951,2021-07-20,7,95,370,465
91952,2021-07-20,8,157,548,705
91953,2021-07-20,9,128,256,384
91954,2021-07-20,10,150,174,324
91955,2021-07-20,11,157,202,359
91956,2021-07-20,12,188,242,430
91957,2021-07-20,13,214,230,444
91958,2021-07-20,14,209,225,434
91959,2021-07-20,15,227,257,484
91960,2021-07-20,16,264,399,663
91961,2021-07-20,17,378,668,1046
91962,2021-07-20,18,376,653,1029
91963,2021-07-20,19,314,462,776
91964,2021-07-20,20,234,390,624
91965,2021-07-20,21,180,228,408
91966,2021-07-20,22,125,157,282
91967,2021-07-20,23,101,103,204
91968,2021-07-21,0,64,50,114
91969,2021-07-21,1,26,16,42
91970,2021-07-21,2,9,10,19
91971,2021-07-21,3,8,6,14
91972,2021-07-21,4,10,8,18
91973,2021-07-21,5,30,60,90
91974,2021-07-21,6,53,135,188
91975,2021-07-21,7,108,342,450
91976,2021-07-21,8,164,533,697
91977,2021-07-21,9,161,355,516
91978,2021-07-21,10,159,200,359
91979,2021-07-21,11,199,205,404
91980,2021-07-21,12,202,233,435
91981,2021-07-21,13,155,203,358
91982,2021-07-21,14,226,220,446
91983,2021-07-21,15,223,261,484
91984,2021-07-21,16,260,352,612
91985,2021-07-21,17,354,609,963
91986,2021-07-21,18,344,585,929
91987,2021-07-21,19,322,423,745
91988,2021-07-21,20,238,335,573
91989,2021-07-21,21,211,274,485
91990,2021-07-21,22,194,194,388
91991,2021-07-21,23,106,110,216
91992,2021-07-22,0,40,39,79
91993,2021-07-22,1,19,24,43
91994,2021-07-22,2,14,22,36
91995,2021-07-22,3,8,23,31
91996,2021-07-22,4,16,33,49
91997,2021-07-22,5,16,67,83
91998,2021-07-22,6,58,127,185
91999,2021-07-22,7,101,346,447
92000,2021-07-22,8,149,428,577
92001,2021-07-22,9,154,290,444
92002,2021-07-22,10,140,183,323
92003,2021-07-22,11,171,208,379
92004,2021-07-22,12,204,258,462
92005,2021-07-22,13,158,268,426
92006,2021-07-22,14,198,247,445
92007,2021-07-22,15,234,275,509
92008,2021-07-22,16,301,364,665
92009,2021-07-22,17,447,680,1127
92010,2021-07-22,18,472,630,1102
92011,2021-07-22,19,370,484,854
92012,2021-07-22,20,276,353,629
92013,2021-07-22,21,231,234,465
92014,2021-07-22,22,157,161,318
92015,2021-07-22,23,123,109,232
92016,2021-07-23,0,64,37,101
92017,2021-07-23,1,46,24,70
92018,2021-07-23,2,24,16,40
92019,2021-07-23,3,11,12,23
92020,2021-07-23,4,13,14,27
92021,2021-07-23,5,18,39,57
92022,2021-07-23,6,61,145,206
92023,2021-07-23,7,91,270,361
92024,2021-07-23,8,152,383,535
92025,2021-07-23,9,133,276,409
92026,2021-07-23,10,160,207,367
92027,2021-07-23,11,234,265,499
92028,2021-07-23,12,280,275,555
92029,2021-07-23,13,308,287,595
92030,2021-07-23,14,346,265,611
92031,2021-07-23,15,313,319,632
92032,2021-07-23,16,380,412,792
92033,2021-07-23,17,418,572,990
92034,2021-07-23,18,406,552,958
92035,2021-07-23,19,426,487,913
92036,2021-07-23,20,348,336,684
92037,2021-07-23,21,239,241,480
92038,2021-07-23,22,212,186,398
92039,2021-07-23,23,163,151,314
92040,2021-07-24,0,202,128,330
92041,2021-07-24,1,136,133,269
92042,2021-07-24,2,111,77,188
92043,2021-07-24,3,68,42,110
92044,2021-07-24,4,22,13,35
92045,2021-07-24,5,22,20,42
92046,2021-07-24,6,39,43,82
92047,2021-07-24,7,57,107,164
92048,2021-07-24,8,123,213,336
92049,2021-07-24,9,219,306,525
92050,2021-07-24,10,413,347,760
92051,2021-07-24,11,477,418,895
92052,2021-07-24,12,533,384,917
92053,2021-07-24,13,532,390,922
92054,2021-07-24,14,583,380,963
92055,2021-07-24,15,641,353,994
92056,2021-07-24,16,578,350,928
92057,2021-07-24,17,443,334,777
92058,2021-07-24,18,339,291,630
92059,2021-07-24,19,187,201,388
92060,2021-07-24,20,197,206,403
92061,2021-07-24,21,178,184,362
92062,2021-07-24,22,152,123,275
92063,2021-07-24,23,188,134,322
92064,2021-07-25,0,142,90,232
92065,2021-07-25,1,192,93,285
92066,2021-07-25,2,115,46,161
92067,2021-07-25,3,56,32,88
92068,2021-07-25,4,25,30,55
92069,2021-07-25,5,18,22,40
92070,2021-07-25,6,23,45,68
92071,2021-07-25,7,62,79,141
92072,2021-07-25,8,132,132,264
92073,2021-07-25,9,202,250,452
92074,2021-07-25,10,271,306,577
92075,2021-07-25,11,377,367,744
92076,2021-07-25,12,397,366,763
92077,2021-07-25,13,425,339,764
92078,2021-07-25,14,435,340,775
92079,2021-07-25,15,431,292,723
92080,2021-07-25,16,386,339,725
92081,2021-07-25,17,303,361,664
92082,2021-07-25,18,318,284,602
92083,2021-07-25,19,291,284,575
92084,2021-07-25,20,227,213,440
92085,2021-07-25,21,156,136,292
92086,2021-07-25,22,139,143,282
92087,2021-07-25,23,87,70,157
92088,2021-07-26,0,45,20,65
92089,2021-07-26,1,22,6,28
92090,2021-07-26,2,18,11,29
92091,2021-07-26,3,12,5,17
92092,2021-07-26,4,15,16,31
92093,2021-07-26,5,16,51,67
92094,2021-07-26,6,39,133,172
92095,2021-07-26,7,48,295,343
92096,2021-07-26,8,140,456,596
92097,2021-07-26,9,119,292,411
92098,2021-07-26,10,122,149,271
92099,2021-07-26,11,182,171,353
92100,2021-07-26,12,190,232,422
92101,2021-07-26,13,172,236,408
92102,2021-07-26,14,185,213,398
92103,2021-07-26,15,205,219,424
92104,2021-07-26,16,211,316,527
92105,2021-07-26,17,306,565,871
92106,2021-07-26,18,326,597,923
92107,2021-07-26,19,123,269,392
92108,2021-07-26,20,116,212,328
92109,2021-07-26,21,106,142,248
92110,2021-07-26,22,92,115,207
92111,2021-07-26,23,49,50,99
92112,2021-07-27,0,27,13,40
92113,2021-07-27,1,10,7,17
92114,2021-07-27,2,8,13,21
92115,2021-07-27,3,2,4,6
92116,2021-07-27,4,13,17,30
92117,2021-07-27,5,18,56,74
92118,2021-07-27,6,45,150,195
92119,2021-07-27,7,77,348,425
92120,2021-07-27,8,153,521,674
92121,2021-07-27,9,133,261,394
92122,2021-07-27,10,125,171,296
92123,2021-07-27,11,147,206,353
92124,2021-07-27,12,167,216,383
92125,2021-07-27,13,171,220,391
92126,2021-07-27,14,185,196,381
92127,2021-07-27,15,206,237,443
92128,2021-07-27,16,212,365,577
92129,2021-07-27,17,298,594,892
92130,2021-07-27,18,319,603,922
92131,2021-07-27,19,303,434,737
92132,2021-07-27,20,221,382,603
92133,2021-07-27,21,171,207,378
92134,2021-07-27,22,127,140,267
92135,2021-07-27,23,71,82,153
92136,2021-07-28,0,42,25,67
92137,2021-07-28,1,8,10,18
92138,2021-07-28,2,4,11,15
92139,2021-07-28,3,8,2,10
92140,2021-07-28,4,10,14,24
92141,2021-07-28,5,20,51,71
92142,2021-07-28,6,41,138,179
92143,2021-07-28,7,90,366,456
92144,2021-07-28,8,160,527,687
92145,2021-07-28,9,138,315,453
92146,2021-07-28,10,125,195,320
92147,2021-07-28,11,189,212,401
92148,2021-07-28,12,157,261,418
92149,2021-07-28,13,161,222,383
92150,2021-07-28,14,196,226,422
92151,2021-07-28,15,201,261,462
92152,2021-07-28,16,246,400,646
92153,2021-07-28,17,340,620,960
92154,2021-07-28,18,359,598,957
92155,2021-07-28,19,331,450,781
92156,2021-07-28,20,261,307,568
92157,2021-07-28,21,160,273,433
92158,2021-07-28,22,40,96,136
92159,2021-07-28,23,46,65,111
92160,2021-07-29,0,33,39,72
92161,2021-07-29,1,36,29,65
92162,2021-07-29,2,12,11,23
92163,2021-07-29,3,7,7,14
92164,2021-07-29,4,16,13,29
92165,2021-07-29,5,28,42,70
92166,2021-07-29,6,48,146,194
92167,2021-07-29,7,63,296,359
92168,2021-07-29,8,135,488,623
92169,2021-07-29,9,141,289,430
92170,2021-07-29,10,151,200,351
92171,2021-07-29,11,207,222,429
92172,2021-07-29,12,189,279,468
92173,2021-07-29,13,211,252,463
92174,2021-07-29,14,208,268,476
92175,2021-07-29,15,261,265,526
92176,2021-07-29,16,272,376,648
92177,2021-07-29,17,237,475,712
92178,2021-07-29,18,346,488,834
92179,2021-07-29,19,290,416,706
92180,2021-07-29,20,210,318,528
92181,2021-07-29,21,190,245,435
92182,2021-07-29,22,154,139,293
92183,2021-07-29,23,91,106,197
92184,2021-07-30,0,54,38,92
92185,2021-07-30,1,39,25,64
92186,2021-07-30,2,23,14,37
92187,2021-07-30,3,13,8,21
92188,2021-07-30,4,12,11,23
92189,2021-07-30,5,18,38,56
92190,2021-07-30,6,50,124,174
92191,2021-07-30,7,82,298,380
92192,2021-07-30,8,145,422,567
92193,2021-07-30,9,181,264,445
92194,2021-07-30,10,192,209,401
92195,2021-07-30,11,218,254,472
92196,2021-07-30,12,231,280,511
92197,2021-07-30,13,244,246,490
92198,2021-07-30,14,302,290,592
92199,2021-07-30,15,311,306,617
92200,2021-07-30,16,316,433,749
92201,2021-07-30,17,379,571,950
92202,2021-07-30,18,396,548,944
92203,2021-07-30,19,326,375,701
92204,2021-07-30,20,226,312,538
92205,2021-07-30,21,211,246,457
92206,2021-07-30,22,210,210,420
92207,2021-07-30,23,211,164,375
92208,2021-07-31,0,160,133,293
92209,2021-07-31,1,127,93,220
92210,2021-07-31,2,144,70,214
92211,2021-07-31,3,73,33,106
92212,2021-07-31,4,19,22,41
92213,2021-07-31,5,23,15,38
92214,2021-07-31,6,33,47,80
92215,2021-07-31,7,52,88,140
92216,2021-07-31,8,138,213,351
92217,2021-07-31,9,234,290,524
92218,2021-07-31,10,353,357,710
92219,2021-07-31,11,413,369,782
92220,2021-07-31,12,482,407,889
92221,2021-07-31,13,534,364,898
92222,2021-07-31,14,539,362,901
92223,2021-07-31,15,640,385,1025
92224,2021-07-31,16,551,378,929
92225,2021-07-31,17,538,416,954
92226,2021-07-31,18,425,343,768
92227,2021-07-31,19,359,339,698
92228,2021-07-31,20,305,208,513
92229,2021-07-31,21,251,181,432
92230,2021-07-31,22,286,193,479
92231,2021-07-31,23,223,144,367
92232,2021-08-01,0,146,104,250
92233,2021-08-01,1,115,83,198
92234,2021-08-01,2,77,44,121
92235,2021-08-01,3,61,21,82
92236,2021-08-01,4,23,14,37
92237,2021-08-01,5,9,12,21
92238,2021-08-01,6,8,15,23
92239,2021-08-01,7,16,46,62
92240,2021-08-01,8,52,94,146
92241,2021-08-01,9,168,176,344
92242,2021-08-01,10,234,248,482
92243,2021-08-01,11,203,221,424
92244,2021-08-01,12,269,242,511
92245,2021-08-01,13,89,90,179
92246,2021-08-01,14,130,161,291
92247,2021-08-01,15,272,282,554
92248,2021-08-01,16,333,326,659
92249,2021-08-01,17,328,326,654
92250,2021-08-01,18,299,300,599
92251,2021-08-01,19,277,305,582
92252,2021-08-01,20,235,225,460
92253,2021-08-01,21,112,132,244
92254,2021-08-01,22,59,62,121
92255,2021-08-01,23,78,55,133
92256,2021-08-02,0,24,35,59
92257,2021-08-02,1,23,9,32
92258,2021-08-02,2,22,4,26
92259,2021-08-02,3,9,10,19
92260,2021-08-02,4,11,12,23
92261,2021-08-02,5,22,43,65
92262,2021-08-02,6,48,160,208
92263,2021-08-02,7,80,275,355
92264,2021-08-02,8,107,410,517
92265,2021-08-02,9,156,294,450
92266,2021-08-02,10,164,181,345
92267,2021-08-02,11,218,226,444
92268,2021-08-02,12,258,248,506
92269,2021-08-02,13,297,242,539
92270,2021-08-02,14,287,222,509
92271,2021-08-02,15,296,259,555
92272,2021-08-02,16,341,358,699
92273,2021-08-02,17,416,602,1018
92274,2021-08-02,18,367,668,1035
92275,2021-08-02,19,321,447,768
92276,2021-08-02,20,215,327,542
92277,2021-08-02,21,179,183,362
92278,2021-08-02,22,127,157,284
92279,2021-08-02,23,66,83,149
92280,2021-08-03,0,31,25,56
92281,2021-08-03,1,25,10,35
92282,2021-08-03,2,14,6,20
92283,2021-08-03,3,8,3,11
92284,2021-08-03,4,13,9,22
92285,2021-08-03,5,23,59,82
92286,2021-08-03,6,48,150,198
92287,2021-08-03,7,86,361,447
92288,2021-08-03,8,165,472,637
92289,2021-08-03,9,167,284,451
92290,2021-08-03,10,170,176,346
92291,2021-08-03,11,173,213,386
92292,2021-08-03,12,230,300,530
92293,2021-08-03,13,238,286,524
92294,2021-08-03,14,252,289,541
92295,2021-08-03,15,296,263,559
92296,2021-08-03,16,311,385,696
92297,2021-08-03,17,417,664,1081
92298,2021-08-03,18,402,669,1071
92299,2021-08-03,19,299,450,749
92300,2021-08-03,20,255,351,606
92301,2021-08-03,21,178,248,426
92302,2021-08-03,22,121,109,230
92303,2021-08-03,23,63,81,144
92304,2021-08-04,0,44,30,74
92305,2021-08-04,1,18,16,34
92306,2021-08-04,2,15,16,31
92307,2021-08-04,3,10,5,15
92308,2021-08-04,4,9,15,24
92309,2021-08-04,5,27,57,84
92310,2021-08-04,6,44,130,174
92311,2021-08-04,7,87,319,406
92312,2021-08-04,8,154,452,606
92313,2021-08-04,9,138,300,438
92314,2021-08-04,10,155,208,363
92315,2021-08-04,11,237,253,490
92316,2021-08-04,12,241,254,495
92317,2021-08-04,13,247,272,519
92318,2021-08-04,14,293,255,548
92319,2021-08-04,15,295,287,582
92320,2021-08-04,16,289,382,671
92321,2021-08-04,17,404,646,1050
92322,2021-08-04,18,423,593,1016
92323,2021-08-04,19,340,449,789
92324,2021-08-04,20,254,384,638
92325,2021-08-04,21,176,206,382
92326,2021-08-04,22,169,183,352
92327,2021-08-04,23,112,102,214
92328,2021-08-05,0,36,32,68
92329,2021-08-05,1,19,23,42
92330,2021-08-05,2,11,14,25
92331,2021-08-05,3,7,4,11
92332,2021-08-05,4,10,11,21
92333,2021-08-05,5,24,47,71
92334,2021-08-05,6,50,159,209
92335,2021-08-05,7,80,308,388
92336,2021-08-05,8,161,437,598
92337,2021-08-05,9,160,272,432
92338,2021-08-05,10,154,192,346
92339,2021-08-05,11,243,253,496
92340,2021-08-05,12,249,267,516
92341,2021-08-05,13,244,299,543
92342,2021-08-05,14,262,264,526
92343,2021-08-05,15,261,289,550
92344,2021-08-05,16,317,353,670
92345,2021-08-05,17,433,639,1072
92346,2021-08-05,18,408,640,1048
92347,2021-08-05,19,390,449,839
92348,2021-08-05,20,299,363,662
92349,2021-08-05,21,201,280,481
92350,2021-08-05,22,170,179,349
92351,2021-08-05,23,103,94,197
92352,2021-08-06,0,45,37,82
92353,2021-08-06,1,38,26,64
92354,2021-08-06,2,24,12,36
92355,2021-08-06,3,8,7,15
92356,2021-08-06,4,12,10,22
92357,2021-08-06,5,19,34,53
92358,2021-08-06,6,58,136,194
92359,2021-08-06,7,93,285,378
92360,2021-08-06,8,131,388,519
92361,2021-08-06,9,156,277,433
92362,2021-08-06,10,184,204,388
92363,2021-08-06,11,264,220,484
92364,2021-08-06,12,265,273,538
92365,2021-08-06,13,273,283,556
92366,2021-08-06,14,304,301,605
92367,2021-08-06,15,303,322,625
92368,2021-08-06,16,344,393,737
92369,2021-08-06,17,452,579,1031
92370,2021-08-06,18,421,486,907
92371,2021-08-06,19,346,392,738
92372,2021-08-06,20,287,292,579
92373,2021-08-06,21,218,211,429
92374,2021-08-06,22,192,149,341
92375,2021-08-06,23,150,144,294
92376,2021-08-07,0,95,91,186
92377,2021-08-07,1,114,81,195
92378,2021-08-07,2,73,53,126
92379,2021-08-07,3,46,18,64
92380,2021-08-07,4,19,16,35
92381,2021-08-07,5,16,22,38
92382,2021-08-07,6,33,46,79
92383,2021-08-07,7,54,92,146
92384,2021-08-07,8,135,200,335
92385,2021-08-07,9,241,312,553
92386,2021-08-07,10,391,336,727
92387,2021-08-07,11,310,275,585
92388,2021-08-07,12,160,151,311
92389,2021-08-07,13,99,96,195
92390,2021-08-07,14,130,142,272
92391,2021-08-07,15,236,219,455
92392,2021-08-07,16,282,248,530
92393,2021-08-07,17,385,321,706
92394,2021-08-07,18,390,308,698
92395,2021-08-07,19,330,272,602
92396,2021-08-07,20,212,204,416
92397,2021-08-07,21,174,138,312
92398,2021-08-07,22,167,132,299
92399,2021-08-07,23,155,112,267
92400,2021-08-08,0,148,92,240
92401,2021-08-08,1,103,62,165
92402,2021-08-08,2,64,46,110
92403,2021-08-08,3,61,32,93
92404,2021-08-08,4,20,16,36
92405,2021-08-08,5,10,16,26
92406,2021-08-08,6,36,31,67
92407,2021-08-08,7,60,81,141
92408,2021-08-08,8,132,147,279
92409,2021-08-08,9,265,224,489
92410,2021-08-08,10,361,303,664
92411,2021-08-08,11,516,376,892
92412,2021-08-08,12,507,358,865
92413,2021-08-08,13,522,377,899
92414,2021-08-08,14,481,343,824
92415,2021-08-08,15,458,333,791
92416,2021-08-08,16,448,334,782
92417,2021-08-08,17,455,360,815
92418,2021-08-08,18,409,312,721
92419,2021-08-08,19,371,306,677
92420,2021-08-08,20,290,221,511
92421,2021-08-08,21,176,157,333
92422,2021-08-08,22,212,143,355
92423,2021-08-08,23,156,65,221
92424,2021-08-09,0,62,26,88
92425,2021-08-09,1,26,20,46
92426,2021-08-09,2,9,7,16
92427,2021-08-09,3,4,6,10
92428,2021-08-09,4,14,11,25
92429,2021-08-09,5,22,41,63
92430,2021-08-09,6,51,116,167
92431,2021-08-09,7,80,269,349
92432,2021-08-09,8,142,417,559
92433,2021-08-09,9,133,271,404
92434,2021-08-09,10,150,184,334
92435,2021-08-09,11,165,193,358
92436,2021-08-09,12,258,178,436
92437,2021-08-09,13,219,209,428
92438,2021-08-09,14,230,190,420
92439,2021-08-09,15,255,270,525
92440,2021-08-09,16,234,330,564
92441,2021-08-09,17,293,525,818
92442,2021-08-09,18,232,509,741
92443,2021-08-09,19,183,300,483
92444,2021-08-09,20,148,226,374
92445,2021-08-09,21,119,150,269
92446,2021-08-09,22,105,88,193
92447,2021-08-09,23,67,83,150
92448,2021-08-10,0,24,24,48
92449,2021-08-10,1,13,7,20
92450,2021-08-10,2,14,10,24
92451,2021-08-10,3,7,6,13
92452,2021-08-10,4,13,8,21
92453,2021-08-10,5,17,52,69
92454,2021-08-10,6,42,150,192
92455,2021-08-10,7,78,331,409
92456,2021-08-10,8,162,469,631
92457,2021-08-10,9,136,281,417
92458,2021-08-10,10,150,201,351
92459,2021-08-10,11,178,248,426
92460,2021-08-10,12,207,261,468
92461,2021-08-10,13,192,232,424
92462,2021-08-10,14,198,211,409
92463,2021-08-10,15,194,245,439
92464,2021-08-10,16,217,354,571
92465,2021-08-10,17,228,466,694
92466,2021-08-10,18,36,121,157
92467,2021-08-10,19,99,214,313
92468,2021-08-10,20,113,209,322
92469,2021-08-10,21,92,124,216
92470,2021-08-10,22,83,113,196
92471,2021-08-10,23,60,56,116
92472,2021-08-11,0,37,31,68
92473,2021-08-11,1,12,28,40
92474,2021-08-11,2,10,4,14
92475,2021-08-11,3,11,8,19
92476,2021-08-11,4,14,16,30
92477,2021-08-11,5,25,50,75
92478,2021-08-11,6,50,151,201
92479,2021-08-11,7,86,343,429
92480,2021-08-11,8,129,442,571
92481,2021-08-11,9,139,307,446
92482,2021-08-11,10,177,184,361
92483,2021-08-11,11,165,210,375
92484,2021-08-11,12,153,261,414
92485,2021-08-11,13,178,233,411
92486,2021-08-11,14,125,228,353
92487,2021-08-11,15,198,241,439
92488,2021-08-11,16,193,383,576
92489,2021-08-11,17,152,354,506
92490,2021-08-11,18,167,343,510
92491,2021-08-11,19,173,286,459
92492,2021-08-11,20,160,216,376
92493,2021-08-11,21,113,184,297
92494,2021-08-11,22,110,117,227
92495,2021-08-11,23,70,67,137
92496,2021-08-12,0,35,51,86
92497,2021-08-12,1,13,22,35
92498,2021-08-12,2,11,7,18
92499,2021-08-12,3,7,4,11
92500,2021-08-12,4,17,13,30
92501,2021-08-12,5,26,54,80
92502,2021-08-12,6,70,142,212
92503,2021-08-12,7,85,320,405
92504,2021-08-12,8,144,441,585
92505,2021-08-12,9,160,262,422
92506,2021-08-12,10,138,186,324
92507,2021-08-12,11,160,194,354
92508,2021-08-12,12,192,236,428
92509,2021-08-12,13,194,221,415
92510,2021-08-12,14,158,206,364
92511,2021-08-12,15,200,206,406
92512,2021-08-12,16,225,308,533
92513,2021-08-12,17,294,497,791
92514,2021-08-12,18,331,478,809
92515,2021-08-12,19,323,371,694
92516,2021-08-12,20,257,291,548
92517,2021-08-12,21,203,197,400
92518,2021-08-12,22,134,164,298
92519,2021-08-12,23,103,88,191
92520,2021-08-13,0,53,52,105
92521,2021-08-13,1,26,24,50
92522,2021-08-13,2,32,21,53
92523,2021-08-13,3,7,9,16
92524,2021-08-13,4,15,15,30
92525,2021-08-13,5,17,43,60
92526,2021-08-13,6,49,124,173
92527,2021-08-13,7,77,255,332
92528,2021-08-13,8,141,376,517
92529,2021-08-13,9,150,231,381
92530,2021-08-13,10,184,187,371
92531,2021-08-13,11,218,249,467
92532,2021-08-13,12,272,267,539
92533,2021-08-13,13,211,265,476
92534,2021-08-13,14,239,208,447
92535,2021-08-13,15,241,280,521
92536,2021-08-13,16,272,329,601
92537,2021-08-13,17,245,427,672
92538,2021-08-13,18,104,202,306
92539,2021-08-13,19,72,128,200
92540,2021-08-13,20,48,82,130
92541,2021-08-13,21,71,115,186
92542,2021-08-13,22,104,111,215
92543,2021-08-13,23,115,96,211
92544,2021-08-14,0,104,69,173
92545,2021-08-14,1,99,82,181
92546,2021-08-14,2,69,53,122
92547,2021-08-14,3,31,10,41
92548,2021-08-14,4,23,15,38
92549,2021-08-14,5,17,20,37
92550,2021-08-14,6,38,48,86
92551,2021-08-14,7,63,108,171
92552,2021-08-14,8,144,229,373
92553,2021-08-14,9,246,319,565
92554,2021-08-14,10,327,349,676
92555,2021-08-14,11,387,358,745
92556,2021-08-14,12,412,376,788
92557,2021-08-14,13,428,354,782
92558,2021-08-14,14,394,316,710
92559,2021-08-14,15,410,309,719
92560,2021-08-14,16,401,246,647
92561,2021-08-14,17,382,325,707
92562,2021-08-14,18,332,292,624
92563,2021-08-14,19,285,282,567
92564,2021-08-14,20,240,216,456
92565,2021-08-14,21,207,203,410
92566,2021-08-14,22,160,135,295
92567,2021-08-14,23,119,104,223
92568,2021-08-15,0,33,49,82
92569,2021-08-15,1,25,34,59
92570,2021-08-15,2,55,28,83
92571,2021-08-15,3,12,14,26
92572,2021-08-15,4,11,11,22
92573,2021-08-15,5,10,16,26
92574,2021-08-15,6,23,35,58
92575,2021-08-15,7,51,67,118
92576,2021-08-15,8,106,146,252
92577,2021-08-15,9,186,237,423
92578,2021-08-15,10,333,289,622
92579,2021-08-15,11,394,327,721
92580,2021-08-15,12,460,341,801
92581,2021-08-15,13,427,348,775
92582,2021-08-15,14,447,394,841
92583,2021-08-15,15,466,371,837
92584,2021-08-15,16,429,358,787
92585,2021-08-15,17,331,316,647
92586,2021-08-15,18,317,312,629
92587,2021-08-15,19,346,253,599
92588,2021-08-15,20,211,237,448
92589,2021-08-15,21,119,138,257
92590,2021-08-15,22,145,113,258
92591,2021-08-15,23,85,52,137
92592,2021-08-16,0,30,31,61
92593,2021-08-16,1,31,7,38
92594,2021-08-16,2,18,7,25
92595,2021-08-16,3,4,13,17
92596,2021-08-16,4,7,12,19
92597,2021-08-16,5,17,38,55
92598,2021-08-16,6,34,116,150
92599,2021-08-16,7,80,266,346
92600,2021-08-16,8,107,381,488
92601,2021-08-16,9,138,195,333
92602,2021-08-16,10,119,154,273
92603,2021-08-16,11,54,57,111
92604,2021-08-16,12,129,136,265
92605,2021-08-16,13,171,184,355
92606,2021-08-16,14,198,184,382
92607,2021-08-16,15,182,216,398
92608,2021-08-16,16,131,210,341
92609,2021-08-16,17,171,376,547
92610,2021-08-16,18,89,201,290
92611,2021-08-16,19,73,153,226
92612,2021-08-16,20,52,115,167
92613,2021-08-16,21,62,114,176
92614,2021-08-16,22,69,75,144
92615,2021-08-16,23,40,50,90
92616,2021-08-17,0,22,15,37
92617,2021-08-17,1,6,5,11
92618,2021-08-17,2,4,2,6
92619,2021-08-17,3,5,3,8
92620,2021-08-17,4,7,14,21
92621,2021-08-17,5,11,43,54
92622,2021-08-17,6,37,131,168
92623,2021-08-17,7,69,268,337
92624,2021-08-17,8,98,395,493
92625,2021-08-17,9,111,260,371
92626,2021-08-17,10,106,173,279
92627,2021-08-17,11,131,198,329
92628,2021-08-17,12,202,219,421
92629,2021-08-17,13,167,197,364
92630,2021-08-17,14,187,219,406
92631,2021-08-17,15,206,237,443
92632,2021-08-17,16,242,322,564
92633,2021-08-17,17,346,622,968
92634,2021-08-17,18,337,570,907
92635,2021-08-17,19,231,392,623
92636,2021-08-17,20,217,275,492
92637,2021-08-17,21,122,200,322
92638,2021-08-17,22,140,138,278
92639,2021-08-17,23,76,84,160
92640,2021-08-18,0,37,35,72
92641,2021-08-18,1,4,21,25
92642,2021-08-18,2,11,3,14
92643,2021-08-18,3,3,6,9
92644,2021-08-18,4,9,14,23
92645,2021-08-18,5,22,38,60
92646,2021-08-18,6,42,126,168
92647,2021-08-18,7,74,280,354
92648,2021-08-18,8,111,470,581
92649,2021-08-18,9,123,278,401
92650,2021-08-18,10,126,206,332
92651,2021-08-18,11,154,210,364
92652,2021-08-18,12,108,187,295
92653,2021-08-18,13,123,130,253
92654,2021-08-18,14,146,198,344
92655,2021-08-18,15,197,245,442
92656,2021-08-18,16,223,340,563
92657,2021-08-18,17,306,603,909
92658,2021-08-18,18,294,570,864
92659,2021-08-18,19,277,452,729
92660,2021-08-18,20,231,338,569
92661,2021-08-18,21,169,213,382
92662,2021-08-18,22,133,164,297
92663,2021-08-18,23,72,84,156
92664,2021-08-19,0,53,28,81
92665,2021-08-19,1,22,23,45
92666,2021-08-19,2,19,13,32
92667,2021-08-19,3,2,7,9
92668,2021-08-19,4,9,15,24
92669,2021-08-19,5,20,40,60
92670,2021-08-19,6,49,132,181
92671,2021-08-19,7,89,302,391
92672,2021-08-19,8,142,424,566
92673,2021-08-19,9,132,279,411
92674,2021-08-19,10,184,197,381
92675,2021-08-19,11,166,255,421
92676,2021-08-19,12,223,249,472
92677,2021-08-19,13,222,276,498
92678,2021-08-19,14,192,258,450
92679,2021-08-19,15,232,275,507
92680,2021-08-19,16,270,347,617
92681,2021-08-19,17,381,601,982
92682,2021-08-19,18,350,544,894
92683,2021-08-19,19,209,313,522
92684,2021-08-19,20,93,178,271
92685,2021-08-19,21,127,171,298
92686,2021-08-19,22,142,141,283
92687,2021-08-19,23,95,74,169
92688,2021-08-20,0,52,45,97
92689,2021-08-20,1,28,20,48
92690,2021-08-20,2,14,9,23
92691,2021-08-20,3,10,17,27
92692,2021-08-20,4,5,11,16
92693,2021-08-20,5,8,27,35
92694,2021-08-20,6,16,50,66
92695,2021-08-20,7,17,49,66
92696,2021-08-20,8,14,41,55
92697,2021-08-20,9,7,28,35
92698,2021-08-20,10,23,49,72
92699,2021-08-20,11,97,156,253
92700,2021-08-20,12,147,190,337
92701,2021-08-20,13,183,238,421
92702,2021-08-20,14,256,266,522
92703,2021-08-20,15,258,341,599
92704,2021-08-20,16,323,371,694
92705,2021-08-20,17,377,481,858
92706,2021-08-20,18,364,513,877
92707,2021-08-20,19,339,436,775
92708,2021-08-20,20,212,298,510
92709,2021-08-20,21,182,198,380
92710,2021-08-20,22,169,160,329
92711,2021-08-20,23,147,120,267
92712,2021-08-21,0,81,75,156
92713,2021-08-21,1,121,96,217
92714,2021-08-21,2,107,57,164
92715,2021-08-21,3,59,40,99
92716,2021-08-21,4,26,22,48
92717,2021-08-21,5,20,20,40
92718,2021-08-21,6,39,51,90
92719,2021-08-21,7,53,104,157
92720,2021-08-21,8,157,208,365
92721,2021-08-21,9,213,314,527
92722,2021-08-21,10,306,401,707
92723,2021-08-21,11,410,402,812
92724,2021-08-21,12,369,359,728
92725,2021-08-21,13,327,349,676
92726,2021-08-21,14,355,282,637
92727,2021-08-21,15,255,184,439
92728,2021-08-21,16,363,316,679
92729,2021-08-21,17,402,327,729
92730,2021-08-21,18,376,369,745
92731,2021-08-21,19,321,321,642
92732,2021-08-21,20,284,235,519
92733,2021-08-21,21,189,214,403
92734,2021-08-21,22,210,213,423
92735,2021-08-21,23,196,143,339
92736,2021-08-22,0,145,137,282
92737,2021-08-22,1,154,91,245
92738,2021-08-22,2,106,70,176
92739,2021-08-22,3,57,38,95
92740,2021-08-22,4,27,15,42
92741,2021-08-22,5,17,25,42
92742,2021-08-22,6,27,33,60
92743,2021-08-22,7,49,54,103
92744,2021-08-22,8,121,134,255
92745,2021-08-22,9,173,244,417
92746,2021-08-22,10,291,293,584
92747,2021-08-22,11,366,360,726
92748,2021-08-22,12,365,376,741
92749,2021-08-22,13,399,369,768
92750,2021-08-22,14,424,354,778
92751,2021-08-22,15,450,353,803
92752,2021-08-22,16,393,328,721
92753,2021-08-22,17,357,310,667
92754,2021-08-22,18,297,319,616
92755,2021-08-22,19,239,276,515
92756,2021-08-22,20,172,192,364
92757,2021-08-22,21,130,144,274
92758,2021-08-22,22,112,112,224
92759,2021-08-22,23,49,67,116
92760,2021-08-23,0,50,30,80
92761,2021-08-23,1,13,18,31
92762,2021-08-23,2,7,6,13
92763,2021-08-23,3,7,4,11
92764,2021-08-23,4,21,12,33
92765,2021-08-23,5,14,42,56
92766,2021-08-23,6,47,136,183
92767,2021-08-23,7,71,307,378
92768,2021-08-23,8,137,435,572
92769,2021-08-23,9,152,263,415
92770,2021-08-23,10,187,191,378
92771,2021-08-23,11,177,211,388
92772,2021-08-23,12,221,237,458
92773,2021-08-23,13,176,260,436
92774,2021-08-23,14,192,224,416
92775,2021-08-23,15,199,280,479
92776,2021-08-23,16,226,347,573
92777,2021-08-23,17,329,589,918
92778,2021-08-23,18,287,579,866
92779,2021-08-23,19,273,437,710
92780,2021-08-23,20,218,312,530
92781,2021-08-23,21,127,180,307
92782,2021-08-23,22,105,119,224
92783,2021-08-23,23,32,39,71
92784,2021-08-24,0,18,14,32
92785,2021-08-24,1,27,7,34
92786,2021-08-24,2,17,5,22
92787,2021-08-24,3,3,7,10
92788,2021-08-24,4,10,17,27
92789,2021-08-24,5,26,45,71
92790,2021-08-24,6,43,145,188
92791,2021-08-24,7,96,368,464
92792,2021-08-24,8,138,488,626
92793,2021-08-24,9,120,306,426
92794,2021-08-24,10,125,206,331
92795,2021-08-24,11,155,257,412
92796,2021-08-24,12,191,286,477
92797,2021-08-24,13,182,248,430
92798,2021-08-24,14,166,247,413
92799,2021-08-24,15,178,282,460
92800,2021-08-24,16,199,392,591
92801,2021-08-24,17,286,630,916
92802,2021-08-24,18,324,617,941
92803,2021-08-24,19,272,512,784
92804,2021-08-24,20,207,338,545
92805,2021-08-24,21,160,190,350
92806,2021-08-24,22,102,156,258
92807,2021-08-24,23,76,71,147
92808,2021-08-25,0,21,24,45
92809,2021-08-25,1,12,14,26
92810,2021-08-25,2,10,6,16
92811,2021-08-25,3,7,4,11
92812,2021-08-25,4,12,11,23
92813,2021-08-25,5,18,56,74
92814,2021-08-25,6,48,175,223
92815,2021-08-25,7,111,352,463
92816,2021-08-25,8,144,491,635
92817,2021-08-25,9,130,279,409
92818,2021-08-25,10,122,225,347
92819,2021-08-25,11,128,224,352
92820,2021-08-25,12,167,254,421
92821,2021-08-25,13,138,268,406
92822,2021-08-25,14,166,244,410
92823,2021-08-25,15,190,303,493
92824,2021-08-25,16,178,373,551
92825,2021-08-25,17,303,631,934
92826,2021-08-25,18,330,603,933
92827,2021-08-25,19,248,498,746
92828,2021-08-25,20,173,327,500
92829,2021-08-25,21,72,155,227
92830,2021-08-25,22,60,108,168
92831,2021-08-25,23,85,86,171
92832,2021-08-26,0,27,38,65
92833,2021-08-26,1,20,21,41
92834,2021-08-26,2,10,4,14
92835,2021-08-26,3,9,6,15
92836,2021-08-26,4,15,18,33
92837,2021-08-26,5,27,44,71
92838,2021-08-26,6,54,153,207
92839,2021-08-26,7,91,356,447
92840,2021-08-26,8,140,474,614
92841,2021-08-26,9,155,313,468
92842,2021-08-26,10,147,194,341
92843,2021-08-26,11,142,235,377
92844,2021-08-26,12,168,272,440
92845,2021-08-26,13,151,256,407
92846,2021-08-26,14,179,273,452
92847,2021-08-26,15,110,155,265
92848,2021-08-26,16,63,122,185
92849,2021-08-26,17,232,457,689
92850,2021-08-26,18,262,514,776
92851,2021-08-26,19,245,468,713
92852,2021-08-26,20,169,307,476
92853,2021-08-26,21,157,252,409
92854,2021-08-26,22,131,187,318
92855,2021-08-26,23,106,86,192
92856,2021-08-27,0,57,49,106
92857,2021-08-27,1,51,37,88
92858,2021-08-27,2,22,25,47
92859,2021-08-27,3,9,9,18
92860,2021-08-27,4,10,10,20
92861,2021-08-27,5,15,35,50
92862,2021-08-27,6,56,145,201
92863,2021-08-27,7,113,336,449
92864,2021-08-27,8,143,440,583
92865,2021-08-27,9,146,292,438
92866,2021-08-27,10,165,238,403
92867,2021-08-27,11,207,276,483
92868,2021-08-27,12,204,307,511
92869,2021-08-27,13,215,281,496
92870,2021-08-27,14,269,314,583
92871,2021-08-27,15,277,407,684
92872,2021-08-27,16,96,137,233
92873,2021-08-27,17,144,318,462
92874,2021-08-27,18,217,421,638
92875,2021-08-27,19,236,398,634
92876,2021-08-27,20,174,237,411
92877,2021-08-27,21,138,194,332
92878,2021-08-27,22,149,171,320
92879,2021-08-27,23,131,145,276
92880,2021-08-28,0,131,113,244
92881,2021-08-28,1,127,70,197
92882,2021-08-28,2,81,48,129
92883,2021-08-28,3,41,25,66
92884,2021-08-28,4,13,16,29
92885,2021-08-28,5,30,23,53
92886,2021-08-28,6,34,62,96
92887,2021-08-28,7,71,129,200
92888,2021-08-28,8,146,232,378
92889,2021-08-28,9,236,341,577
92890,2021-08-28,10,317,408,725
92891,2021-08-28,11,398,459,857
92892,2021-08-28,12,519,465,984
92893,2021-08-28,13,450,353,803
92894,2021-08-28,14,491,347,838
92895,2021-08-28,15,437,388,825
92896,2021-08-28,16,352,386,738
92897,2021-08-28,17,386,376,762
92898,2021-08-28,18,347,368,715
92899,2021-08-28,19,375,359,734
92900,2021-08-28,20,276,241,517
92901,2021-08-28,21,218,216,434
92902,2021-08-28,22,224,208,432
92903,2021-08-28,23,227,185,412
92904,2021-08-29,0,230,137,367
92905,2021-08-29,1,131,88,219
92906,2021-08-29,2,108,59,167
92907,2021-08-29,3,72,26,98
92908,2021-08-29,4,26,21,47
92909,2021-08-29,5,13,27,40
92910,2021-08-29,6,34,45,79
92911,2021-08-29,7,45,96,141
92912,2021-08-29,8,87,175,262
92913,2021-08-29,9,215,258,473
92914,2021-08-29,10,274,291,565
92915,2021-08-29,11,266,331,597
92916,2021-08-29,12,344,388,732
92917,2021-08-29,13,361,414,775
92918,2021-08-29,14,383,408,791
92919,2021-08-29,15,373,386,759
92920,2021-08-29,16,354,363,717
92921,2021-08-29,17,317,386,703
92922,2021-08-29,18,284,358,642
92923,2021-08-29,19,231,308,539
92924,2021-08-29,20,134,186,320
92925,2021-08-29,21,108,149,257
92926,2021-08-29,22,87,103,190
92927,2021-08-29,23,49,59,108
92928,2021-08-30,0,22,27,49
92929,2021-08-30,1,16,19,35
92930,2021-08-30,2,13,13,26
92931,2021-08-30,3,6,5,11
92932,2021-08-30,4,11,14,25
92933,2021-08-30,5,23,46,69
92934,2021-08-30,6,55,168,223
92935,2021-08-30,7,93,360,453
92936,2021-08-30,8,150,514,664
92937,2021-08-30,9,119,301,420
92938,2021-08-30,10,139,224,363
92939,2021-08-30,11,143,231,374
92940,2021-08-30,12,155,288,443
92941,2021-08-30,13,156,228,384
92942,2021-08-30,14,163,263,426
92943,2021-08-30,15,184,310,494
92944,2021-08-30,16,212,437,649
92945,2021-08-30,17,245,620,865
92946,2021-08-30,18,270,546,816
92947,2021-08-30,19,259,431,690
92948,2021-08-30,20,137,274,411
92949,2021-08-30,21,95,212,307
92950,2021-08-30,22,91,132,223
92951,2021-08-30,23,64,64,128
92952,2021-08-31,0,22,16,38
92953,2021-08-31,1,9,7,16
92954,2021-08-31,2,4,3,7
92955,2021-08-31,3,5,5,10
92956,2021-08-31,4,14,14,28
92957,2021-08-31,5,18,52,70
92958,2021-08-31,6,57,171,228
92959,2021-08-31,7,99,430,529
92960,2021-08-31,8,130,534,664
92961,2021-08-31,9,129,395,524
92962,2021-08-31,10,144,248,392
92963,2021-08-31,11,168,277,445
92964,2021-08-31,12,139,340,479
92965,2021-08-31,13,134,276,410
92966,2021-08-31,14,147,281,428
92967,2021-08-31,15,174,347,521
92968,2021-08-31,16,198,445,643
92969,2021-08-31,17,301,678,979
92970,2021-08-31,18,279,648,927
92971,2021-08-31,19,207,452,659
92972,2021-08-31,20,131,273,404
92973,2021-08-31,21,94,165,259
92974,2021-08-31,22,69,123,192
92975,2021-08-31,23,55,84,139
92976,2021-09-01,0,11,12,23
92977,2021-09-01,1,4,8,12
92978,2021-09-01,2,6,10,16
92979,2021-09-01,3,6,2,8
92980,2021-09-01,4,8,10,18
92981,2021-09-01,5,16,35,51
92982,2021-09-01,6,39,129,168
92983,2021-09-01,7,93,305,398
92984,2021-09-01,8,123,432,555
92985,2021-09-01,9,95,325,420
92986,2021-09-01,10,89,217,306
92987,2021-09-01,11,119,258,377
92988,2021-09-01,12,121,308,429
92989,2021-09-01,13,64,173,237
92990,2021-09-01,14,58,172,230
92991,2021-09-01,15,48,109,157
92992,2021-09-01,16,84,256,340
92993,2021-09-01,17,136,392,528
92994,2021-09-01,18,35,129,164
92995,2021-09-01,19,54,179,233
92996,2021-09-01,20,60,154,214
92997,2021-09-01,21,68,109,177
92998,2021-09-01,22,37,94,131
92999,2021-09-01,23,42,43,85
93000,2021-09-02,0,27,23,50
93001,2021-09-02,1,11,6,17
93002,2021-09-02,2,13,8,21
93003,2021-09-02,3,12,8,20
93004,2021-09-02,4,13,14,27
93005,2021-09-02,5,21,36,57
93006,2021-09-02,6,61,156,217
93007,2021-09-02,7,106,365,471
93008,2021-09-02,8,185,507,692
93009,2021-09-02,9,153,386,539
93010,2021-09-02,10,159,232,391
93011,2021-09-02,11,162,315,477
93012,2021-09-02,12,192,344,536
93013,2021-09-02,13,220,310,530
93014,2021-09-02,14,217,353,570
93015,2021-09-02,15,255,360,615
93016,2021-09-02,16,283,492,775
93017,2021-09-02,17,408,789,1197
93018,2021-09-02,18,438,777,1215
93019,2021-09-02,19,354,563,917
93020,2021-09-02,20,231,380,611
93021,2021-09-02,21,191,271,462
93022,2021-09-02,22,132,184,316
93023,2021-09-02,23,131,115,246
93024,2021-09-03,0,72,63,135
93025,2021-09-03,1,44,50,94
93026,2021-09-03,2,22,28,50
93027,2021-09-03,3,10,12,22
93028,2021-09-03,4,13,14,27
93029,2021-09-03,5,25,46,71
93030,2021-09-03,6,46,146,192
93031,2021-09-03,7,113,348,461
93032,2021-09-03,8,133,425,558
93033,2021-09-03,9,142,344,486
93034,2021-09-03,10,168,286,454
93035,2021-09-03,11,225,307,532
93036,2021-09-03,12,323,350,673
93037,2021-09-03,13,322,368,690
93038,2021-09-03,14,357,437,794
93039,2021-09-03,15,424,510,934
93040,2021-09-03,16,405,577,982
93041,2021-09-03,17,452,631,1083
93042,2021-09-03,18,457,537,994
93043,2021-09-03,19,363,423,786
93044,2021-09-03,20,259,310,569
93045,2021-09-03,21,177,205,382
93046,2021-09-03,22,209,179,388
93047,2021-09-03,23,171,169,340
93048,2021-09-04,0,144,125,269
93049,2021-09-04,1,108,87,195
93050,2021-09-04,2,78,55,133
93051,2021-09-04,3,53,31,84
93052,2021-09-04,4,20,17,37
93053,2021-09-04,5,15,21,36
93054,2021-09-04,6,36,60,96
93055,2021-09-04,7,57,100,157
93056,2021-09-04,8,145,185,330
93057,2021-09-04,9,267,275,542
93058,2021-09-04,10,391,376,767
93059,2021-09-04,11,455,398,853
93060,2021-09-04,12,584,373,957
93061,2021-09-04,13,533,433,966
93062,2021-09-04,14,591,370,961
93063,2021-09-04,15,654,400,1054
93064,2021-09-04,16,612,383,995
93065,2021-09-04,17,534,382,916
93066,2021-09-04,18,527,355,882
93067,2021-09-04,19,434,339,773
93068,2021-09-04,20,294,214,508
93069,2021-09-04,21,248,186,434
93070,2021-09-04,22,223,155,378
93071,2021-09-04,23,221,101,322
93072,2021-09-05,0,131,88,219
93073,2021-09-05,1,100,84,184
93074,2021-09-05,2,111,55,166
93075,2021-09-05,3,43,20,63
93076,2021-09-05,4,17,11,28
93077,2021-09-05,5,15,24,39
93078,2021-09-05,6,34,39,73
93079,2021-09-05,7,45,84,129
93080,2021-09-05,8,104,148,252
93081,2021-09-05,9,275,223,498
93082,2021-09-05,10,383,263,646
93083,2021-09-05,11,450,327,777
93084,2021-09-05,12,472,361,833
93085,2021-09-05,13,480,330,810
93086,2021-09-05,14,442,273,715
93087,2021-09-05,15,354,242,596
93088,2021-09-05,16,526,288,814
93089,2021-09-05,17,522,315,837
93090,2021-09-05,18,379,294,673
93091,2021-09-05,19,344,234,578
93092,2021-09-05,20,196,189,385
93093,2021-09-05,21,174,130,304
93094,2021-09-05,22,122,137,259
93095,2021-09-05,23,143,87,230
93096,2021-09-06,0,92,68,160
93097,2021-09-06,1,63,40,103
93098,2021-09-06,2,58,24,82
93099,2021-09-06,3,17,14,31
93100,2021-09-06,4,22,23,45
93101,2021-09-06,5,19,22,41
93102,2021-09-06,6,39,48,87
93103,2021-09-06,7,52,95,147
93104,2021-09-06,8,121,191,312
93105,2021-09-06,9,227,263,490
93106,2021-09-06,10,387,318,705
93107,2021-09-06,11,488,447,935
93108,2021-09-06,12,566,406,972
93109,2021-09-06,13,567,431,998
93110,2021-09-06,14,551,407,958
93111,2021-09-06,15,506,407,913
93112,2021-09-06,16,484,435,919
93113,2021-09-06,17,454,414,868
93114,2021-09-06,18,396,405,801
93115,2021-09-06,19,326,336,662
93116,2021-09-06,20,218,223,441
93117,2021-09-06,21,119,153,272
93118,2021-09-06,22,102,105,207
93119,2021-09-06,23,57,63,120
93120,2021-09-07,0,36,33,69
93121,2021-09-07,1,10,15,25
93122,2021-09-07,2,15,17,32
93123,2021-09-07,3,9,7,16
93124,2021-09-07,4,15,13,28
93125,2021-09-07,5,23,61,84
93126,2021-09-07,6,40,150,190
93127,2021-09-07,7,94,354,448
93128,2021-09-07,8,120,550,670
93129,2021-09-07,9,159,327,486
93130,2021-09-07,10,173,213,386
93131,2021-09-07,11,187,207,394
93132,2021-09-07,12,194,309,503
93133,2021-09-07,13,202,257,459
93134,2021-09-07,14,228,256,484
93135,2021-09-07,15,243,353,596
93136,2021-09-07,16,277,451,728
93137,2021-09-07,17,340,747,1087
93138,2021-09-07,18,312,698,1010
93139,2021-09-07,19,255,493,748
93140,2021-09-07,20,172,320,492
93141,2021-09-07,21,112,236,348
93142,2021-09-07,22,65,125,190
93143,2021-09-07,23,53,77,130
93144,2021-09-08,0,27,36,63
93145,2021-09-08,1,9,9,18
93146,2021-09-08,2,8,4,12
93147,2021-09-08,3,7,5,12
93148,2021-09-08,4,10,11,21
93149,2021-09-08,5,34,53,87
93150,2021-09-08,6,53,172,225
93151,2021-09-08,7,119,428,547
93152,2021-09-08,8,166,585,751
93153,2021-09-08,9,123,379,502
93154,2021-09-08,10,131,241,372
93155,2021-09-08,11,146,268,414
93156,2021-09-08,12,138,293,431
93157,2021-09-08,13,168,299,467
93158,2021-09-08,14,147,287,434
93159,2021-09-08,15,168,349,517
93160,2021-09-08,16,201,435,636
93161,2021-09-08,17,357,702,1059
93162,2021-09-08,18,368,703,1071
93163,2021-09-08,19,300,554,854
93164,2021-09-08,20,196,364,560
93165,2021-09-08,21,127,251,378
93166,2021-09-08,22,104,158,262
93167,2021-09-08,23,113,127,240
93168,2021-09-09,0,32,49,81
93169,2021-09-09,1,9,15,24
93170,2021-09-09,2,9,6,15
93171,2021-09-09,3,1,6,7
93172,2021-09-09,4,11,13,24
93173,2021-09-09,5,18,35,53
93174,2021-09-09,6,43,143,186
93175,2021-09-09,7,90,385,475
93176,2021-09-09,8,143,488,631
93177,2021-09-09,9,112,315,427
93178,2021-09-09,10,114,230,344
93179,2021-09-09,11,136,245,381
93180,2021-09-09,12,145,303,448
93181,2021-09-09,13,156,273,429
93182,2021-09-09,14,183,290,473
93183,2021-09-09,15,203,337,540
93184,2021-09-09,16,210,475,685
93185,2021-09-09,17,353,740,1093
93186,2021-09-09,18,348,727,1075
93187,2021-09-09,19,315,549,864
93188,2021-09-09,20,171,393,564
93189,2021-09-09,21,150,256,406
93190,2021-09-09,22,126,166,292
93191,2021-09-09,23,96,135,231
93192,2021-09-10,0,87,85,172
93193,2021-09-10,1,41,46,87
93194,2021-09-10,2,18,19,37
93195,2021-09-10,3,14,13,27
93196,2021-09-10,4,15,22,37
93197,2021-09-10,5,23,52,75
93198,2021-09-10,6,50,137,187
93199,2021-09-10,7,93,353,446
93200,2021-09-10,8,145,545,690
93201,2021-09-10,9,145,360,505
93202,2021-09-10,10,182,260,442
93203,2021-09-10,11,209,310,519
93204,2021-09-10,12,227,358,585
93205,2021-09-10,13,282,361,643
93206,2021-09-10,14,268,358,626
93207,2021-09-10,15,347,414,761
93208,2021-09-10,16,314,557,871
93209,2021-09-10,17,504,797,1301
93210,2021-09-10,18,425,624,1049
93211,2021-09-10,19,339,460,799
93212,2021-09-10,20,251,383,634
93213,2021-09-10,21,175,250,425
93214,2021-09-10,22,205,209,414
93215,2021-09-10,23,158,175,333
93216,2021-09-11,0,148,123,271
93217,2021-09-11,1,99,115,214
93218,2021-09-11,2,96,67,163
93219,2021-09-11,3,39,21,60
93220,2021-09-11,4,13,10,23
93221,2021-09-11,5,18,26,44
93222,2021-09-11,6,33,60,93
93223,2021-09-11,7,61,119,180
93224,2021-09-11,8,123,221,344
93225,2021-09-11,9,249,360,609
93226,2021-09-11,10,321,452,773
93227,2021-09-11,11,470,470,940
93228,2021-09-11,12,508,532,1040
93229,2021-09-11,13,543,485,1028
93230,2021-09-11,14,578,479,1057
93231,2021-09-11,15,536,483,1019
93232,2021-09-11,16,519,469,988
93233,2021-09-11,17,528,428,956
93234,2021-09-11,18,430,433,863
93235,2021-09-11,19,307,362,669
93236,2021-09-11,20,235,292,527
93237,2021-09-11,21,215,207,422
93238,2021-09-11,22,201,185,386
93239,2021-09-11,23,183,190,373
93240,2021-09-12,0,175,149,324
93241,2021-09-12,1,93,118,211
93242,2021-09-12,2,113,78,191
93243,2021-09-12,3,35,32,67
93244,2021-09-12,4,19,15,34
93245,2021-09-12,5,13,37,50
93246,2021-09-12,6,76,94,170
93247,2021-09-12,7,73,100,173
93248,2021-09-12,8,106,178,284
93249,2021-09-12,9,281,311,592
93250,2021-09-12,10,346,398,744
93251,2021-09-12,11,452,446,898
93252,2021-09-12,12,511,462,973
93253,2021-09-12,13,401,467,868
93254,2021-09-12,14,468,400,868
93255,2021-09-12,15,426,421,847
93256,2021-09-12,16,404,412,816
93257,2021-09-12,17,413,421,834
93258,2021-09-12,18,311,387,698
93259,2021-09-12,19,247,374,621
93260,2021-09-12,20,138,224,362
93261,2021-09-12,21,129,164,293
93262,2021-09-12,22,99,102,201
93263,2021-09-12,23,77,68,145
93264,2021-09-13,0,22,24,46
93265,2021-09-13,1,13,17,30
93266,2021-09-13,2,8,10,18
93267,2021-09-13,3,5,7,12
93268,2021-09-13,4,13,14,27
93269,2021-09-13,5,30,54,84
93270,2021-09-13,6,51,145,196
93271,2021-09-13,7,103,361,464
93272,2021-09-13,8,127,522,649
93273,2021-09-13,9,140,319,459
93274,2021-09-13,10,143,187,330
93275,2021-09-13,11,160,220,380
93276,2021-09-13,12,186,295,481
93277,2021-09-13,13,145,276,421
93278,2021-09-13,14,175,300,475
93279,2021-09-13,15,172,306,478
93280,2021-09-13,16,226,404,630
93281,2021-09-13,17,292,723,1015
93282,2021-09-13,18,326,657,983
93283,2021-09-13,19,267,542,809
93284,2021-09-13,20,142,286,428
93285,2021-09-13,21,107,272,379
93286,2021-09-13,22,98,155,253
93287,2021-09-13,23,42,58,100
93288,2021-09-14,0,20,20,40
93289,2021-09-14,1,11,10,21
93290,2021-09-14,2,6,8,14
93291,2021-09-14,3,3,10,13
93292,2021-09-14,4,12,14,26
93293,2021-09-14,5,33,58,91
93294,2021-09-14,6,55,133,188
93295,2021-09-14,7,104,393,497
93296,2021-09-14,8,155,588,743
93297,2021-09-14,9,129,354,483
93298,2021-09-14,10,108,236,344
93299,2021-09-14,11,127,276,403
93300,2021-09-14,12,152,320,472
93301,2021-09-14,13,176,303,479
93302,2021-09-14,14,182,256,438
93303,2021-09-14,15,180,317,497
93304,2021-09-14,16,219,443,662
93305,2021-09-14,17,337,755,1092
93306,2021-09-14,18,358,754,1112
93307,2021-09-14,19,251,580,831
93308,2021-09-14,20,172,364,536
93309,2021-09-14,21,145,263,408
93310,2021-09-14,22,127,176,303
93311,2021-09-14,23,83,100,183
93312,2021-09-15,0,33,23,56
93313,2021-09-15,1,9,15,24
93314,2021-09-15,2,4,17,21
93315,2021-09-15,3,3,6,9
93316,2021-09-15,4,5,15,20
93317,2021-09-15,5,24,45,69
93318,2021-09-15,6,66,180,246
93319,2021-09-15,7,108,419,527
93320,2021-09-15,8,179,624,803
93321,2021-09-15,9,117,374,491
93322,2021-09-15,10,123,273,396
93323,2021-09-15,11,151,276,427
93324,2021-09-15,12,147,290,437
93325,2021-09-15,13,133,269,402
93326,2021-09-15,14,162,307,469
93327,2021-09-15,15,178,368,546
93328,2021-09-15,16,210,444,654
93329,2021-09-15,17,373,770,1143
93330,2021-09-15,18,378,732,1110
93331,2021-09-15,19,305,577,882
93332,2021-09-15,20,193,335,528
93333,2021-09-15,21,179,267,446
93334,2021-09-15,22,110,187,297
93335,2021-09-15,23,64,100,164
93336,2021-09-16,0,39,40,79
93337,2021-09-16,1,23,25,48
93338,2021-09-16,2,8,11,19
93339,2021-09-16,3,6,10,16
93340,2021-09-16,4,8,21,29
93341,2021-09-16,5,20,55,75
93342,2021-09-16,6,48,140,188
93343,2021-09-16,7,114,380,494
93344,2021-09-16,8,146,566,712
93345,2021-09-16,9,123,374,497
93346,2021-09-16,10,160,269,429
93347,2021-09-16,11,156,257,413
93348,2021-09-16,12,221,354,575
93349,2021-09-16,13,203,296,499
93350,2021-09-16,14,162,183,345
93351,2021-09-16,15,86,126,212
93352,2021-09-16,16,94,204,298
93353,2021-09-16,17,64,185,249
93354,2021-09-16,18,68,172,240
93355,2021-09-16,19,45,146,191
93356,2021-09-16,20,45,156,201
93357,2021-09-16,21,70,163,233
93358,2021-09-16,22,90,153,243
93359,2021-09-16,23,62,85,147
93360,2021-09-17,0,59,44,103
93361,2021-09-17,1,27,34,61
93362,2021-09-17,2,21,24,45
93363,2021-09-17,3,19,17,36
93364,2021-09-17,4,10,12,22
93365,2021-09-17,5,27,47,74
93366,2021-09-17,6,51,124,175
93367,2021-09-17,7,87,298,385
93368,2021-09-17,8,128,432,560
93369,2021-09-17,9,113,248,361
93370,2021-09-17,10,94,156,250
93371,2021-09-17,11,126,268,394
93372,2021-09-17,12,221,302,523
93373,2021-09-17,13,233,318,551
93374,2021-09-17,14,260,400,660
93375,2021-09-17,15,291,383,674
93376,2021-09-17,16,312,511,823
93377,2021-09-17,17,390,622,1012
93378,2021-09-17,18,356,601,957
93379,2021-09-17,19,301,456,757
93380,2021-09-17,20,201,298,499
93381,2021-09-17,21,170,207,377
93382,2021-09-17,22,175,232,407
93383,2021-09-17,23,177,167,344
93384,2021-09-18,0,114,118,232
93385,2021-09-18,1,96,106,202
93386,2021-09-18,2,100,76,176
93387,2021-09-18,3,47,48,95
93388,2021-09-18,4,19,16,35
93389,2021-09-18,5,13,19,32
93390,2021-09-18,6,38,62,100
93391,2021-09-18,7,50,122,172
93392,2021-09-18,8,96,231,327
93393,2021-09-18,9,217,322,539
93394,2021-09-18,10,354,334,688
93395,2021-09-18,11,425,489,914
93396,2021-09-18,12,497,495,992
93397,2021-09-18,13,474,515,989
93398,2021-09-18,14,506,487,993
93399,2021-09-18,15,530,508,1038
93400,2021-09-18,16,413,444,857
93401,2021-09-18,17,418,391,809
93402,2021-09-18,18,376,421,797
93403,2021-09-18,19,415,429,844
93404,2021-09-18,20,277,273,550
93405,2021-09-18,21,187,221,408
93406,2021-09-18,22,171,188,359
93407,2021-09-18,23,239,194,433
93408,2021-09-19,0,127,121,248
93409,2021-09-19,1,125,114,239
93410,2021-09-19,2,97,66,163
93411,2021-09-19,3,48,51,99
93412,2021-09-19,4,15,26,41
93413,2021-09-19,5,12,23,35
93414,2021-09-19,6,55,48,103
93415,2021-09-19,7,84,102,186
93416,2021-09-19,8,111,190,301
93417,2021-09-19,9,258,258,516
93418,2021-09-19,10,353,430,783
93419,2021-09-19,11,431,416,847
93420,2021-09-19,12,543,492,1035
93421,2021-09-19,13,454,410,864
93422,2021-09-19,14,452,375,827
93423,2021-09-19,15,446,448,894
93424,2021-09-19,16,483,491,974
93425,2021-09-19,17,397,468,865
93426,2021-09-19,18,334,441,775
93427,2021-09-19,19,245,375,620
93428,2021-09-19,20,173,226,399
93429,2021-09-19,21,108,151,259
93430,2021-09-19,22,103,93,196
93431,2021-09-19,23,58,67,125
93432,2021-09-20,0,38,31,69
93433,2021-09-20,1,19,15,34
93434,2021-09-20,2,10,13,23
93435,2021-09-20,3,4,7,11
93436,2021-09-20,4,14,15,29
93437,2021-09-20,5,23,50,73
93438,2021-09-20,6,55,170,225
93439,2021-09-20,7,89,407,496
93440,2021-09-20,8,160,531,691
93441,2021-09-20,9,138,370,508
93442,2021-09-20,10,152,243,395
93443,2021-09-20,11,166,249,415
93444,2021-09-20,12,201,306,507
93445,2021-09-20,13,199,294,493
93446,2021-09-20,14,209,260,469
93447,2021-09-20,15,217,358,575
93448,2021-09-20,16,256,432,688
93449,2021-09-20,17,359,717,1076
93450,2021-09-20,18,364,773,1137
93451,2021-09-20,19,215,521,736
93452,2021-09-20,20,179,326,505
93453,2021-09-20,21,109,242,351
93454,2021-09-20,22,98,124,222
93455,2021-09-20,23,50,65,115
93456,2021-09-21,0,24,26,50
93457,2021-09-21,1,13,16,29
93458,2021-09-21,2,11,18,29
93459,2021-09-21,3,3,12,15
93460,2021-09-21,4,6,11,17
93461,2021-09-21,5,18,67,85
93462,2021-09-21,6,55,165,220
93463,2021-09-21,7,99,430,529
93464,2021-09-21,8,157,620,777
93465,2021-09-21,9,121,401,522
93466,2021-09-21,10,114,246,360
93467,2021-09-21,11,140,320,460
93468,2021-09-21,12,146,351,497
93469,2021-09-21,13,170,302,472
93470,2021-09-21,14,181,273,454
93471,2021-09-21,15,194,336,530
93472,2021-09-21,16,219,512,731
93473,2021-09-21,17,372,790,1162
93474,2021-09-21,18,338,763,1101
93475,2021-09-21,19,263,555,818
93476,2021-09-21,20,193,370,563
93477,2021-09-21,21,147,243,390
93478,2021-09-21,22,102,203,305
93479,2021-09-21,23,50,84,134
93480,2021-09-22,0,16,32,48
93481,2021-09-22,1,15,16,31
93482,2021-09-22,2,10,14,24
93483,2021-09-22,3,6,8,14
93484,2021-09-22,4,11,10,21
93485,2021-09-22,5,21,55,76
93486,2021-09-22,6,53,157,210
93487,2021-09-22,7,66,347,413
93488,2021-09-22,8,159,533,692
93489,2021-09-22,9,93,325,418
93490,2021-09-22,10,61,190,251
93491,2021-09-22,11,86,237,323
93492,2021-09-22,12,86,208,294
93493,2021-09-22,13,131,270,401
93494,2021-09-22,14,91,224,315
93495,2021-09-22,15,71,205,276
93496,2021-09-22,16,70,302,372
93497,2021-09-22,17,59,224,283
93498,2021-09-22,18,75,321,396
93499,2021-09-22,19,76,293,369
93500,2021-09-22,20,73,232,305
93501,2021-09-22,21,59,210,269
93502,2021-09-22,22,58,143,201
93503,2021-09-22,23,52,78,130
93504,2021-09-23,0,26,27,53
93505,2021-09-23,1,5,9,14
93506,2021-09-23,2,3,14,17
93507,2021-09-23,3,0,2,2
93508,2021-09-23,4,6,10,16
93509,2021-09-23,5,16,27,43
93510,2021-09-23,6,8,48,56
93511,2021-09-23,7,15,74,89
93512,2021-09-23,8,38,143,181
93513,2021-09-23,9,49,243,292
93514,2021-09-23,10,64,218,282
93515,2021-09-23,11,116,265,381
93516,2021-09-23,12,113,307,420
93517,2021-09-23,13,157,295,452
93518,2021-09-23,14,164,345,509
93519,2021-09-23,15,202,358,560
93520,2021-09-23,16,274,473,747
93521,2021-09-23,17,331,747,1078
93522,2021-09-23,18,374,715,1089
93523,2021-09-23,19,258,551,809
93524,2021-09-23,20,171,336,507
93525,2021-09-23,21,109,301,410
93526,2021-09-23,22,107,176,283
93527,2021-09-23,23,109,142,251
93528,2021-09-24,0,87,90,177
93529,2021-09-24,1,39,65,104
93530,2021-09-24,2,31,35,66
93531,2021-09-24,3,10,12,22
93532,2021-09-24,4,15,13,28
93533,2021-09-24,5,33,55,88
93534,2021-09-24,6,34,145,179
93535,2021-09-24,7,85,343,428
93536,2021-09-24,8,142,534,676
93537,2021-09-24,9,137,400,537
93538,2021-09-24,10,192,277,469
93539,2021-09-24,11,212,312,524
93540,2021-09-24,12,247,415,662
93541,2021-09-24,13,250,328,578
93542,2021-09-24,14,325,383,708
93543,2021-09-24,15,348,457,805
93544,2021-09-24,16,355,554,909
93545,2021-09-24,17,478,755,1233
93546,2021-09-24,18,451,764,1215
93547,2021-09-24,19,373,521,894
93548,2021-09-24,20,221,323,544
93549,2021-09-24,21,176,224,400
93550,2021-09-24,22,144,201,345
93551,2021-09-24,23,143,161,304
93552,2021-09-25,0,120,120,240
93553,2021-09-25,1,96,106,202
93554,2021-09-25,2,95,64,159
93555,2021-09-25,3,40,33,73
93556,2021-09-25,4,15,17,32
93557,2021-09-25,5,20,27,47
93558,2021-09-25,6,34,58,92
93559,2021-09-25,7,64,119,183
93560,2021-09-25,8,107,203,310
93561,2021-09-25,9,253,371,624
93562,2021-09-25,10,393,416,809
93563,2021-09-25,11,533,486,1019
93564,2021-09-25,12,592,524,1116
93565,2021-09-25,13,651,491,1142
93566,2021-09-25,14,697,480,1177
93567,2021-09-25,15,627,501,1128
93568,2021-09-25,16,598,490,1088
93569,2021-09-25,17,564,491,1055
93570,2021-09-25,18,410,461,871
93571,2021-09-25,19,348,402,750
93572,2021-09-25,20,217,243,460
93573,2021-09-25,21,195,284,479
93574,2021-09-25,22,189,199,388
93575,2021-09-25,23,186,181,367
93576,2021-09-26,0,166,144,310
93577,2021-09-26,1,145,96,241
93578,2021-09-26,2,89,65,154
93579,2021-09-26,3,41,43,84
93580,2021-09-26,4,19,13,32
93581,2021-09-26,5,18,18,36
93582,2021-09-26,6,24,35,59
93583,2021-09-26,7,41,70,111
93584,2021-09-26,8,70,194,264
93585,2021-09-26,9,209,302,511
93586,2021-09-26,10,350,405,755
93587,2021-09-26,11,445,422,867
93588,2021-09-26,12,505,497,1002
93589,2021-09-26,13,486,465,951
93590,2021-09-26,14,519,478,997
93591,2021-09-26,15,432,449,881
93592,2021-09-26,16,523,448,971
93593,2021-09-26,17,457,496,953
93594,2021-09-26,18,347,445,792
93595,2021-09-26,19,235,336,571
93596,2021-09-26,20,179,214,393
93597,2021-09-26,21,121,166,287
93598,2021-09-26,22,81,120,201
93599,2021-09-26,23,66,84,150
93600,2021-09-27,0,34,24,58
93601,2021-09-27,1,14,22,36
93602,2021-09-27,2,10,11,21
93603,2021-09-27,3,1,8,9
93604,2021-09-27,4,17,13,30
93605,2021-09-27,5,14,42,56
93606,2021-09-27,6,44,156,200
93607,2021-09-27,7,85,384,469
93608,2021-09-27,8,117,513,630
93609,2021-09-27,9,131,320,451
93610,2021-09-27,10,123,206,329
93611,2021-09-27,11,176,239,415
93612,2021-09-27,12,166,291,457
93613,2021-09-27,13,204,320,524
93614,2021-09-27,14,169,310,479
93615,2021-09-27,15,182,359,541
93616,2021-09-27,16,230,521,751
93617,2021-09-27,17,310,759,1069
93618,2021-09-27,18,330,795,1125
93619,2021-09-27,19,223,564,787
93620,2021-09-27,20,142,324,466
93621,2021-09-27,21,92,240,332
93622,2021-09-27,22,81,147,228
93623,2021-09-27,23,45,63,108
93624,2021-09-28,0,23,21,44
93625,2021-09-28,1,14,16,30
93626,2021-09-28,2,4,6,10
93627,2021-09-28,3,5,10,15
93628,2021-09-28,4,9,23,32
93629,2021-09-28,5,23,54,77
93630,2021-09-28,6,44,163,207
93631,2021-09-28,7,95,439,534
93632,2021-09-28,8,159,607,766
93633,2021-09-28,9,140,380,520
93634,2021-09-28,10,129,248,377
93635,2021-09-28,11,106,222,328
93636,2021-09-28,12,105,291,396
93637,2021-09-28,13,101,305,406
93638,2021-09-28,14,149,303,452
93639,2021-09-28,15,168,339,507
93640,2021-09-28,16,234,467,701
93641,2021-09-28,17,323,751,1074
93642,2021-09-28,18,310,721,1031
93643,2021-09-28,19,209,568,777
93644,2021-09-28,20,137,343,480
93645,2021-09-28,21,156,272,428
93646,2021-09-28,22,105,155,260
93647,2021-09-28,23,62,86,148
93648,2021-09-29,0,27,34,61
93649,2021-09-29,1,23,10,33
93650,2021-09-29,2,7,6,13
93651,2021-09-29,3,4,2,6
93652,2021-09-29,4,13,12,25
93653,2021-09-29,5,23,59,82
93654,2021-09-29,6,55,157,212
93655,2021-09-29,7,93,446,539
93656,2021-09-29,8,134,598,732
93657,2021-09-29,9,140,384,524
93658,2021-09-29,10,121,243,364
93659,2021-09-29,11,139,263,402
93660,2021-09-29,12,142,320,462
93661,2021-09-29,13,168,324,492
93662,2021-09-29,14,166,314,480
93663,2021-09-29,15,186,376,562
93664,2021-09-29,16,247,503,750
93665,2021-09-29,17,381,843,1224
93666,2021-09-29,18,411,760,1171
93667,2021-09-29,19,259,591,850
93668,2021-09-29,20,166,306,472
93669,2021-09-29,21,175,290,465
93670,2021-09-29,22,147,213,360
93671,2021-09-29,23,67,85,152
93672,2021-09-30,0,30,33,63
93673,2021-09-30,1,13,19,32
93674,2021-09-30,2,3,12,15
93675,2021-09-30,3,1,6,7
93676,2021-09-30,4,7,17,24
93677,2021-09-30,5,31,46,77
93678,2021-09-30,6,39,163,202
93679,2021-09-30,7,84,372,456
93680,2021-09-30,8,135,553,688
93681,2021-09-30,9,112,379,491
93682,2021-09-30,10,149,241,390
93683,2021-09-30,11,153,247,400
93684,2021-09-30,12,172,369,541
93685,2021-09-30,13,165,346,511
93686,2021-09-30,14,198,327,525
93687,2021-09-30,15,224,379,603
93688,2021-09-30,16,286,551,837
93689,2021-09-30,17,378,819,1197
93690,2021-09-30,18,396,789,1185
93691,2021-09-30,19,264,564,828
93692,2021-09-30,20,197,341,538
93693,2021-09-30,21,175,296,471
93694,2021-09-30,22,135,183,318
93695,2021-09-30,23,107,131,238
93696,2021-10-01,0,39,45,84
93697,2021-10-01,1,45,45,90
93698,2021-10-01,2,25,16,41
93699,2021-10-01,3,4,13,17
93700,2021-10-01,4,8,19,27
93701,2021-10-01,5,23,42,65
93702,2021-10-01,6,52,139,191
93703,2021-10-01,7,93,357,450
93704,2021-10-01,8,138,467,605
93705,2021-10-01,9,142,340,482
93706,2021-10-01,10,196,277,473
93707,2021-10-01,11,197,301,498
93708,2021-10-01,12,304,404,708
93709,2021-10-01,13,278,371,649
93710,2021-10-01,14,313,390,703
93711,2021-10-01,15,315,476,791
93712,2021-10-01,16,412,563,975
93713,2021-10-01,17,461,773,1234
93714,2021-10-01,18,496,738,1234
93715,2021-10-01,19,356,449,805
93716,2021-10-01,20,185,269,454
93717,2021-10-01,21,212,224,436
93718,2021-10-01,22,187,220,407
93719,2021-10-01,23,205,204,409
93720,2021-10-02,0,135,168,303
93721,2021-10-02,1,80,78,158
93722,2021-10-02,2,63,64,127
93723,2021-10-02,3,34,26,60
93724,2021-10-02,4,8,12,20
93725,2021-10-02,5,11,20,31
93726,2021-10-02,6,33,47,80
93727,2021-10-02,7,54,106,160
93728,2021-10-02,8,141,259,400
93729,2021-10-02,9,309,348,657
93730,2021-10-02,10,419,444,863
93731,2021-10-02,11,643,514,1157
93732,2021-10-02,12,595,527,1122
93733,2021-10-02,13,673,561,1234
93734,2021-10-02,14,680,573,1253
93735,2021-10-02,15,740,583,1323
93736,2021-10-02,16,641,532,1173
93737,2021-10-02,17,498,458,956
93738,2021-10-02,18,475,485,960
93739,2021-10-02,19,344,371,715
93740,2021-10-02,20,304,316,620
93741,2021-10-02,21,218,226,444
93742,2021-10-02,22,164,159,323
93743,2021-10-02,23,211,169,380
93744,2021-10-03,0,138,143,281
93745,2021-10-03,1,128,89,217
93746,2021-10-03,2,95,77,172
93747,2021-10-03,3,65,56,121
93748,2021-10-03,4,18,17,35
93749,2021-10-03,5,20,25,45
93750,2021-10-03,6,31,43,74
93751,2021-10-03,7,37,72,109
93752,2021-10-03,8,126,152,278
93753,2021-10-03,9,227,301,528
93754,2021-10-03,10,405,452,857
93755,2021-10-03,11,536,479,1015
93756,2021-10-03,12,502,495,997
93757,2021-10-03,13,562,490,1052
93758,2021-10-03,14,593,489,1082
93759,2021-10-03,15,494,427,921
93760,2021-10-03,16,463,430,893
93761,2021-10-03,17,425,489,914
93762,2021-10-03,18,343,420,763
93763,2021-10-03,19,323,391,714
93764,2021-10-03,20,150,196,346
93765,2021-10-03,21,118,157,275
93766,2021-10-03,22,88,118,206
93767,2021-10-03,23,82,56,138
93768,2021-10-04,0,42,31,73
93769,2021-10-04,1,26,18,44
93770,2021-10-04,2,15,6,21
93771,2021-10-04,3,2,4,6
93772,2021-10-04,4,13,14,27
93773,2021-10-04,5,17,44,61
93774,2021-10-04,6,54,150,204
93775,2021-10-04,7,78,374,452
93776,2021-10-04,8,112,490,602
93777,2021-10-04,9,103,325,428
93778,2021-10-04,10,150,241,391
93779,2021-10-04,11,178,225,403
93780,2021-10-04,12,203,312,515
93781,2021-10-04,13,202,286,488
93782,2021-10-04,14,219,282,501
93783,2021-10-04,15,229,350,579
93784,2021-10-04,16,223,414,637
93785,2021-10-04,17,313,678,991
93786,2021-10-04,18,336,680,1016
93787,2021-10-04,19,168,457,625
93788,2021-10-04,20,117,279,396
93789,2021-10-04,21,98,203,301
93790,2021-10-04,22,75,129,204
93791,2021-10-04,23,66,95,161
93792,2021-10-05,0,36,36,72
93793,2021-10-05,1,12,12,24
93794,2021-10-05,2,4,5,9
93795,2021-10-05,3,4,4,8
93796,2021-10-05,4,11,16,27
93797,2021-10-05,5,17,53,70
93798,2021-10-05,6,45,169,214
93799,2021-10-05,7,95,420,515
93800,2021-10-05,8,126,571,697
93801,2021-10-05,9,130,369,499
93802,2021-10-05,10,141,236,377
93803,2021-10-05,11,162,255,417
93804,2021-10-05,12,145,303,448
93805,2021-10-05,13,189,271,460
93806,2021-10-05,14,202,286,488
93807,2021-10-05,15,184,296,480
93808,2021-10-05,16,217,474,691
93809,2021-10-05,17,286,729,1015
93810,2021-10-05,18,313,678,991
93811,2021-10-05,19,191,496,687
93812,2021-10-05,20,119,308,427
93813,2021-10-05,21,115,229,344
93814,2021-10-05,22,79,150,229
93815,2021-10-05,23,51,85,136
93816,2021-10-06,0,20,23,43
93817,2021-10-06,1,5,12,17
93818,2021-10-06,2,10,11,21
93819,2021-10-06,3,1,5,6
93820,2021-10-06,4,7,16,23
93821,2021-10-06,5,17,50,67
93822,2021-10-06,6,38,142,180
93823,2021-10-06,7,61,342,403
93824,2021-10-06,8,119,490,609
93825,2021-10-06,9,90,325,415
93826,2021-10-06,10,99,208,307
93827,2021-10-06,11,138,224,362
93828,2021-10-06,12,143,281,424
93829,2021-10-06,13,136,298,434
93830,2021-10-06,14,186,285,471
93831,2021-10-06,15,209,335,544
93832,2021-10-06,16,228,466,694
93833,2021-10-06,17,303,738,1041
93834,2021-10-06,18,289,766,1055
93835,2021-10-06,19,213,549,762
93836,2021-10-06,20,159,334,493
93837,2021-10-06,21,104,257,361
93838,2021-10-06,22,108,167,275
93839,2021-10-06,23,67,87,154
93840,2021-10-07,0,36,58,94
93841,2021-10-07,1,25,20,45
93842,2021-10-07,2,12,11,23
93843,2021-10-07,3,9,6,15
93844,2021-10-07,4,13,19,32
93845,2021-10-07,5,16,51,67
93846,2021-10-07,6,51,166,217
93847,2021-10-07,7,89,345,434
93848,2021-10-07,8,141,570,711
93849,2021-10-07,9,127,379,506
93850,2021-10-07,10,153,274,427
93851,2021-10-07,11,158,277,435
93852,2021-10-07,12,176,378,554
93853,2021-10-07,13,175,309,484
93854,2021-10-07,14,237,346,583
93855,2021-10-07,15,255,354,609
93856,2021-10-07,16,266,472,738
93857,2021-10-07,17,391,793,1184
93858,2021-10-07,18,395,772,1167
93859,2021-10-07,19,240,551,791
93860,2021-10-07,20,198,378,576
93861,2021-10-07,21,159,283,442
93862,2021-10-07,22,127,212,339
93863,2021-10-07,23,111,122,233
93864,2021-10-08,0,44,53,97
93865,2021-10-08,1,30,33,63
93866,2021-10-08,2,30,27,57
93867,2021-10-08,3,5,11,16
93868,2021-10-08,4,9,21,30
93869,2021-10-08,5,25,39,64
93870,2021-10-08,6,48,139,187
93871,2021-10-08,7,85,274,359
93872,2021-10-08,8,133,471,604
93873,2021-10-08,9,176,352,528
93874,2021-10-08,10,220,267,487
93875,2021-10-08,11,270,338,608
93876,2021-10-08,12,285,380,665
93877,2021-10-08,13,287,378,665
93878,2021-10-08,14,377,393,770
93879,2021-10-08,15,404,434,838
93880,2021-10-08,16,406,468,874
93881,2021-10-08,17,408,636,1044
93882,2021-10-08,18,392,577,969
93883,2021-10-08,19,296,413,709
93884,2021-10-08,20,201,253,454
93885,2021-10-08,21,158,218,376
93886,2021-10-08,22,180,190,370
93887,2021-10-08,23,166,186,352
93888,2021-10-09,0,98,125,223
93889,2021-10-09,1,115,88,203
93890,2021-10-09,2,63,61,124
93891,2021-10-09,3,40,31,71
93892,2021-10-09,4,12,20,32
93893,2021-10-09,5,14,37,51
93894,2021-10-09,6,24,47,71
93895,2021-10-09,7,56,96,152
93896,2021-10-09,8,140,224,364
93897,2021-10-09,9,231,331,562
93898,2021-10-09,10,425,400,825
93899,2021-10-09,11,575,463,1038
93900,2021-10-09,12,584,465,1049
93901,2021-10-09,13,627,496,1123
93902,2021-10-09,14,676,478,1154
93903,2021-10-09,15,686,408,1094
93904,2021-10-09,16,607,416,1023
93905,2021-10-09,17,564,411,975
93906,2021-10-09,18,392,405,797
93907,2021-10-09,19,296,324,620
93908,2021-10-09,20,259,223,482
93909,2021-10-09,21,217,200,417
93910,2021-10-09,22,155,179,334
93911,2021-10-09,23,152,117,269
93912,2021-10-10,0,137,132,269
93913,2021-10-10,1,106,78,184
93914,2021-10-10,2,71,54,125
93915,2021-10-10,3,28,30,58
93916,2021-10-10,4,19,13,32
93917,2021-10-10,5,8,26,34
93918,2021-10-10,6,22,34,56
93919,2021-10-10,7,33,60,93
93920,2021-10-10,8,92,133,225
93921,2021-10-10,9,206,240,446
93922,2021-10-10,10,331,309,640
93923,2021-10-10,11,433,363,796
93924,2021-10-10,12,469,433,902
93925,2021-10-10,13,487,436,923
93926,2021-10-10,14,500,355,855
93927,2021-10-10,15,520,385,905
93928,2021-10-10,16,461,390,851
93929,2021-10-10,17,518,401,919
93930,2021-10-10,18,333,372,705
93931,2021-10-10,19,218,276,494
93932,2021-10-10,20,158,159,317
93933,2021-10-10,21,114,128,242
93934,2021-10-10,22,118,109,227
93935,2021-10-10,23,88,88,176
93936,2021-10-11,0,64,54,118
93937,2021-10-11,1,31,20,51
93938,2021-10-11,2,17,21,38
93939,2021-10-11,3,16,16,32
93940,2021-10-11,4,17,22,39
93941,2021-10-11,5,11,43,54
93942,2021-10-11,6,42,111,153
93943,2021-10-11,7,63,175,238
93944,2021-10-11,8,88,274,362
93945,2021-10-11,9,147,284,431
93946,2021-10-11,10,234,326,560
93947,2021-10-11,11,293,294,587
93948,2021-10-11,12,324,363,687
93949,2021-10-11,13,301,351,652
93950,2021-10-11,14,327,359,686
93951,2021-10-11,15,376,419,795
93952,2021-10-11,16,361,429,790
93953,2021-10-11,17,376,559,935
93954,2021-10-11,18,253,507,760
93955,2021-10-11,19,135,386,521
93956,2021-10-11,20,149,228,377
93957,2021-10-11,21,93,184,277
93958,2021-10-11,22,66,114,180
93959,2021-10-11,23,30,72,102
93960,2021-10-12,0,29,18,47
93961,2021-10-12,1,19,8,27
93962,2021-10-12,2,4,15,19
93963,2021-10-12,3,4,5,9
93964,2021-10-12,4,10,17,27
93965,2021-10-12,5,19,48,67
93966,2021-10-12,6,47,157,204
93967,2021-10-12,7,87,367,454
93968,2021-10-12,8,144,557,701
93969,2021-10-12,9,115,308,423
93970,2021-10-12,10,106,182,288
93971,2021-10-12,11,166,194,360
93972,2021-10-12,12,180,301,481
93973,2021-10-12,13,187,267,454
93974,2021-10-12,14,212,261,473
93975,2021-10-12,15,216,346,562
93976,2021-10-12,16,236,478,714
93977,2021-10-12,17,332,751,1083
93978,2021-10-12,18,266,645,911
93979,2021-10-12,19,137,392,529
93980,2021-10-12,20,93,266,359
93981,2021-10-12,21,92,214,306
93982,2021-10-12,22,77,139,216
93983,2021-10-12,23,41,90,131
93984,2021-10-13,0,31,25,56
93985,2021-10-13,1,12,12,24
93986,2021-10-13,2,9,12,21
93987,2021-10-13,3,4,9,13
93988,2021-10-13,4,6,8,14
93989,2021-10-13,5,23,64,87
93990,2021-10-13,6,43,177,220
93991,2021-10-13,7,73,437,510
93992,2021-10-13,8,153,596,749
93993,2021-10-13,9,139,388,527
93994,2021-10-13,10,142,267,409
93995,2021-10-13,11,161,235,396
93996,2021-10-13,12,180,340,520
93997,2021-10-13,13,183,302,485
93998,2021-10-13,14,232,330,562
93999,2021-10-13,15,248,373,621
94000,2021-10-13,16,256,489,745
94001,2021-10-13,17,437,838,1275
94002,2021-10-13,18,369,852,1221
94003,2021-10-13,19,251,596,847
94004,2021-10-13,20,168,321,489
94005,2021-10-13,21,137,262,399
94006,2021-10-13,22,126,210,336
94007,2021-10-13,23,109,106,215
94008,2021-10-14,0,26,40,66
94009,2021-10-14,1,13,27,40
94010,2021-10-14,2,15,11,26
94011,2021-10-14,3,2,4,6
94012,2021-10-14,4,9,18,27
94013,2021-10-14,5,23,52,75
94014,2021-10-14,6,42,148,190
94015,2021-10-14,7,105,388,493
94016,2021-10-14,8,175,594,769
94017,2021-10-14,9,140,380,520
94018,2021-10-14,10,144,274,418
94019,2021-10-14,11,201,229,430
94020,2021-10-14,12,212,359,571
94021,2021-10-14,13,233,352,585
94022,2021-10-14,14,253,338,591
94023,2021-10-14,15,261,363,624
94024,2021-10-14,16,342,552,894
94025,2021-10-14,17,454,769,1223
94026,2021-10-14,18,484,832,1316
94027,2021-10-14,19,301,610,911
94028,2021-10-14,20,205,356,561
94029,2021-10-14,21,197,292,489
94030,2021-10-14,22,139,222,361
94031,2021-10-14,23,123,156,279
94032,2021-10-15,0,62,65,127
94033,2021-10-15,1,39,33,72
94034,2021-10-15,2,26,25,51
94035,2021-10-15,3,2,11,13
94036,2021-10-15,4,4,16,20
94037,2021-10-15,5,20,41,61
94038,2021-10-15,6,43,144,187
94039,2021-10-15,7,99,354,453
94040,2021-10-15,8,173,480,653
94041,2021-10-15,9,191,384,575
94042,2021-10-15,10,264,286,550
94043,2021-10-15,11,316,303,619
94044,2021-10-15,12,360,388,748
94045,2021-10-15,13,331,381,712
94046,2021-10-15,14,411,353,764
94047,2021-10-15,15,432,455,887
94048,2021-10-15,16,471,549,1020
94049,2021-10-15,17,488,704,1192
94050,2021-10-15,18,443,659,1102
94051,2021-10-15,19,336,442,778
94052,2021-10-15,20,259,315,574
94053,2021-10-15,21,213,226,439
94054,2021-10-15,22,185,195,380
94055,2021-10-15,23,232,218,450
94056,2021-10-16,0,162,172,334
94057,2021-10-16,1,112,134,246
94058,2021-10-16,2,116,81,197
94059,2021-10-16,3,35,38,73
94060,2021-10-16,4,15,15,30
94061,2021-10-16,5,14,28,42
94062,2021-10-16,6,27,45,72
94063,2021-10-16,7,51,110,161
94064,2021-10-16,8,153,230,383
94065,2021-10-16,9,294,330,624
94066,2021-10-16,10,434,443,877
94067,2021-10-16,11,552,506,1058
94068,2021-10-16,12,537,442,979
94069,2021-10-16,13,621,477,1098
94070,2021-10-16,14,297,292,589
94071,2021-10-16,15,114,127,241
94072,2021-10-16,16,54,74,128
94073,2021-10-16,17,174,181,355
94074,2021-10-16,18,201,228,429
94075,2021-10-16,19,226,258,484
94076,2021-10-16,20,149,156,305
94077,2021-10-16,21,161,186,347
94078,2021-10-16,22,191,191,382
94079,2021-10-16,23,163,159,322
94080,2021-10-17,0,136,155,291
94081,2021-10-17,1,108,114,222
94082,2021-10-17,2,79,53,132
94083,2021-10-17,3,43,28,71
94084,2021-10-17,4,10,14,24
94085,2021-10-17,5,11,23,34
94086,2021-10-17,6,12,37,49
94087,2021-10-17,7,33,58,91
94088,2021-10-17,8,99,160,259
94089,2021-10-17,9,197,264,461
94090,2021-10-17,10,367,378,745
94091,2021-10-17,11,409,427,836
94092,2021-10-17,12,476,428,904
94093,2021-10-17,13,554,411,965
94094,2021-10-17,14,499,446,945
94095,2021-10-17,15,461,446,907
94096,2021-10-17,16,404,476,880
94097,2021-10-17,17,359,391,750
94098,2021-10-17,18,306,368,674
94099,2021-10-17,19,162,253,415
94100,2021-10-17,20,95,179,274
94101,2021-10-17,21,74,120,194
94102,2021-10-17,22,53,111,164
94103,2021-10-17,23,47,74,121
94104,2021-10-18,0,27,34,61
94105,2021-10-18,1,18,11,29
94106,2021-10-18,2,3,13,16
94107,2021-10-18,3,3,5,8
94108,2021-10-18,4,8,14,22
94109,2021-10-18,5,19,39,58
94110,2021-10-18,6,37,134,171
94111,2021-10-18,7,76,356,432
94112,2021-10-18,8,167,537,704
94113,2021-10-18,9,138,322,460
94114,2021-10-18,10,131,225,356
94115,2021-10-18,11,165,237,402
94116,2021-10-18,12,197,271,468
94117,2021-10-18,13,203,248,451
94118,2021-10-18,14,222,275,497
94119,2021-10-18,15,232,313,545
94120,2021-10-18,16,248,444,692
94121,2021-10-18,17,375,805,1180
94122,2021-10-18,18,324,715,1039
94123,2021-10-18,19,174,495,669
94124,2021-10-18,20,122,306,428
94125,2021-10-18,21,81,221,302
94126,2021-10-18,22,62,112,174
94127,2021-10-18,23,38,65,103
94128,2021-10-19,0,22,23,45
94129,2021-10-19,1,13,5,18
94130,2021-10-19,2,5,9,14
94131,2021-10-19,3,5,6,11
94132,2021-10-19,4,5,21,26
94133,2021-10-19,5,15,48,63
94134,2021-10-19,6,49,166,215
94135,2021-10-19,7,103,397,500
94136,2021-10-19,8,203,634,837
94137,2021-10-19,9,136,366,502
94138,2021-10-19,10,121,239,360
94139,2021-10-19,11,145,235,380
94140,2021-10-19,12,177,349,526
94141,2021-10-19,13,190,319,509
94142,2021-10-19,14,198,339,537
94143,2021-10-19,15,227,381,608
94144,2021-10-19,16,278,492,770
94145,2021-10-19,17,413,793,1206
94146,2021-10-19,18,370,809,1179
94147,2021-10-19,19,224,528,752
94148,2021-10-19,20,170,341,511
94149,2021-10-19,21,152,311,463
94150,2021-10-19,22,129,212,341
94151,2021-10-19,23,57,88,145
94152,2021-10-20,0,11,37,48
94153,2021-10-20,1,10,14,24
94154,2021-10-20,2,3,7,10
94155,2021-10-20,3,0,6,6
94156,2021-10-20,4,6,8,14
94157,2021-10-20,5,22,43,65
94158,2021-10-20,6,46,149,195
94159,2021-10-20,7,115,408,523
94160,2021-10-20,8,208,626,834
94161,2021-10-20,9,144,423,567
94162,2021-10-20,10,132,244,376
94163,2021-10-20,11,168,312,480
94164,2021-10-20,12,174,315,489
94165,2021-10-20,13,189,288,477
94166,2021-10-20,14,194,328,522
94167,2021-10-20,15,237,341,578
94168,2021-10-20,16,270,492,762
94169,2021-10-20,17,396,842,1238
94170,2021-10-20,18,402,837,1239
94171,2021-10-20,19,246,540,786
94172,2021-10-20,20,158,327,485
94173,2021-10-20,21,165,318,483
94174,2021-10-20,22,117,231,348
94175,2021-10-20,23,77,116,193
94176,2021-10-21,0,23,31,54
94177,2021-10-21,1,17,23,40
94178,2021-10-21,2,9,10,19
94179,2021-10-21,3,4,8,12
94180,2021-10-21,4,10,7,17
94181,2021-10-21,5,24,48,72
94182,2021-10-21,6,45,153,198
94183,2021-10-21,7,83,357,440
94184,2021-10-21,8,175,629,804
94185,2021-10-21,9,192,374,566
94186,2021-10-21,10,144,269,413
94187,2021-10-21,11,185,271,456
94188,2021-10-21,12,257,333,590
94189,2021-10-21,13,241,350,591
94190,2021-10-21,14,277,333,610
94191,2021-10-21,15,286,388,674
94192,2021-10-21,16,322,549,871
94193,2021-10-21,17,511,844,1355
94194,2021-10-21,18,445,825,1270
94195,2021-10-21,19,266,553,819
94196,2021-10-21,20,201,371,572
94197,2021-10-21,21,153,275,428
94198,2021-10-21,22,143,221,364
94199,2021-10-21,23,123,137,260
94200,2021-10-22,0,49,66,115
94201,2021-10-22,1,32,43,75
94202,2021-10-22,2,18,19,37
94203,2021-10-22,3,4,14,18
94204,2021-10-22,4,7,10,17
94205,2021-10-22,5,15,47,62
94206,2021-10-22,6,51,146,197
94207,2021-10-22,7,111,331,442
94208,2021-10-22,8,171,512,683
94209,2021-10-22,9,165,337,502
94210,2021-10-22,10,246,281,527
94211,2021-10-22,11,249,299,548
94212,2021-10-22,12,296,368,664
94213,2021-10-22,13,325,367,692
94214,2021-10-22,14,436,409,845
94215,2021-10-22,15,424,465,889
94216,2021-10-22,16,471,522,993
94217,2021-10-22,17,622,724,1346
94218,2021-10-22,18,493,678,1171
94219,2021-10-22,19,277,446,723
94220,2021-10-22,20,224,294,518
94221,2021-10-22,21,218,219,437
94222,2021-10-22,22,181,210,391
94223,2021-10-22,23,126,163,289
94224,2021-10-23,0,100,113,213
94225,2021-10-23,1,113,119,232
94226,2021-10-23,2,85,71,156
94227,2021-10-23,3,37,42,79
94228,2021-10-23,4,19,16,35
94229,2021-10-23,5,10,16,26
94230,2021-10-23,6,22,32,54
94231,2021-10-23,7,43,96,139
94232,2021-10-23,8,160,191,351
94233,2021-10-23,9,273,294,567
94234,2021-10-23,10,396,349,745
94235,2021-10-23,11,527,450,977
94236,2021-10-23,12,564,449,1013
94237,2021-10-23,13,568,475,1043
94238,2021-10-23,14,599,482,1081
94239,2021-10-23,15,640,492,1132
94240,2021-10-23,16,506,479,985
94241,2021-10-23,17,482,424,906
94242,2021-10-23,18,411,462,873
94243,2021-10-23,19,258,322,580
94244,2021-10-23,20,222,249,471
94245,2021-10-23,21,165,183,348
94246,2021-10-23,22,172,161,333
94247,2021-10-23,23,129,159,288
94248,2021-10-24,0,147,143,290
94249,2021-10-24,1,107,89,196
94250,2021-10-24,2,68,57,125
94251,2021-10-24,3,28,33,61
94252,2021-10-24,4,13,15,28
94253,2021-10-24,5,13,20,33
94254,2021-10-24,6,19,40,59
94255,2021-10-24,7,29,59,88
94256,2021-10-24,8,90,122,212
94257,2021-10-24,9,169,243,412
94258,2021-10-24,10,346,356,702
94259,2021-10-24,11,386,418,804
94260,2021-10-24,12,535,476,1011
94261,2021-10-24,13,511,414,925
94262,2021-10-24,14,537,465,1002
94263,2021-10-24,15,532,459,991
94264,2021-10-24,16,480,486,966
94265,2021-10-24,17,433,478,911
94266,2021-10-24,18,264,396,660
94267,2021-10-24,19,189,249,438
94268,2021-10-24,20,137,166,303
94269,2021-10-24,21,105,163,268
94270,2021-10-24,22,83,126,209
94271,2021-10-24,23,43,86,129
94272,2021-10-25,0,33,26,59
94273,2021-10-25,1,19,13,32
94274,2021-10-25,2,4,6,10
94275,2021-10-25,3,5,5,10
94276,2021-10-25,4,10,11,21
94277,2021-10-25,5,17,39,56
94278,2021-10-25,6,49,143,192
94279,2021-10-25,7,90,373,463
94280,2021-10-25,8,162,592,754
94281,2021-10-25,9,128,358,486
94282,2021-10-25,10,129,243,372
94283,2021-10-25,11,209,276,485
94284,2021-10-25,12,203,351,554
94285,2021-10-25,13,206,343,549
94286,2021-10-25,14,224,323,547
94287,2021-10-25,15,220,411,631
94288,2021-10-25,16,263,546,809
94289,2021-10-25,17,178,520,698
94290,2021-10-25,18,78,304,382
94291,2021-10-25,19,59,219,278
94292,2021-10-25,20,6,52,58
94293,2021-10-25,21,9,38,47
94294,2021-10-25,22,9,23,32
94295,2021-10-25,23,15,24,39
94296,2021-10-26,0,4,15,19
94297,2021-10-26,1,2,5,7
94298,2021-10-26,2,4,9,13
94299,2021-10-26,3,6,4,10
94300,2021-10-26,4,2,10,12
94301,2021-10-26,5,18,43,61
94302,2021-10-26,6,28,156,184
94303,2021-10-26,7,83,456,539
94304,2021-10-26,8,148,645,793
94305,2021-10-26,9,105,432,537
94306,2021-10-26,10,93,252,345
94307,2021-10-26,11,123,299,422
94308,2021-10-26,12,150,376,526
94309,2021-10-26,13,133,351,484
94310,2021-10-26,14,162,317,479
94311,2021-10-26,15,143,406,549
94312,2021-10-26,16,165,520,685
94313,2021-10-26,17,239,784,1023
94314,2021-10-26,18,189,735,924
94315,2021-10-26,19,104,500,604
94316,2021-10-26,20,79,308,387
94317,2021-10-26,21,72,278,350
94318,2021-10-26,22,67,182,249
94319,2021-10-26,23,29,84,113
94320,2021-10-27,0,16,43,59
94321,2021-10-27,1,7,12,19
94322,2021-10-27,2,4,6,10
94323,2021-10-27,3,5,2,7
94324,2021-10-27,4,4,13,17
94325,2021-10-27,5,14,53,67
94326,2021-10-27,6,37,149,186
94327,2021-10-27,7,91,470,561
94328,2021-10-27,8,152,727,879
94329,2021-10-27,9,114,441,555
94330,2021-10-27,10,92,298,390
94331,2021-10-27,11,108,328,436
94332,2021-10-27,12,145,413,558
94333,2021-10-27,13,151,354,505
94334,2021-10-27,14,148,374,522
94335,2021-10-27,15,198,473,671
94336,2021-10-27,16,231,617,848
94337,2021-10-27,17,330,1043,1373
94338,2021-10-27,18,288,982,1270
94339,2021-10-27,19,154,604,758
94340,2021-10-27,20,132,344,476
94341,2021-10-27,21,129,407,536
94342,2021-10-27,22,124,280,404
94343,2021-10-27,23,43,128,171
94344,2021-10-28,0,15,66,81
94345,2021-10-28,1,25,22,47
94346,2021-10-28,2,11,9,20
94347,2021-10-28,3,4,6,10
94348,2021-10-28,4,7,9,16
94349,2021-10-28,5,17,60,77
94350,2021-10-28,6,33,155,188
94351,2021-10-28,7,71,448,519
94352,2021-10-28,8,132,681,813
94353,2021-10-28,9,120,468,588
94354,2021-10-28,10,122,298,420
94355,2021-10-28,11,129,293,422
94356,2021-10-28,12,165,365,530
94357,2021-10-28,13,198,414,612
94358,2021-10-28,14,166,366,532
94359,2021-10-28,15,192,419,611
94360,2021-10-28,16,237,630,867
94361,2021-10-28,17,294,953,1247
94362,2021-10-28,18,290,932,1222
94363,2021-10-28,19,172,581,753
94364,2021-10-28,20,154,391,545
94365,2021-10-28,21,117,328,445
94366,2021-10-28,22,119,268,387
94367,2021-10-28,23,69,150,219
94368,2021-10-29,0,41,64,105
94369,2021-10-29,1,20,35,55
94370,2021-10-29,2,19,25,44
94371,2021-10-29,3,6,11,17
94372,2021-10-29,4,3,8,11
94373,2021-10-29,5,10,35,45
94374,2021-10-29,6,20,62,82
94375,2021-10-29,7,31,195,226
94376,2021-10-29,8,47,254,301
94377,2021-10-29,9,25,111,136
94378,2021-10-29,10,22,85,107
94379,2021-10-29,11,31,86,117
94380,2021-10-29,12,26,57,83
94381,2021-10-29,13,20,61,81
94382,2021-10-29,14,15,68,83
94383,2021-10-29,15,32,108,140
94384,2021-10-29,16,35,98,133
94385,2021-10-29,17,39,172,211
94386,2021-10-29,18,87,252,339
94387,2021-10-29,19,86,275,361
94388,2021-10-29,20,72,223,295
94389,2021-10-29,21,95,192,287
94390,2021-10-29,22,88,153,241
94391,2021-10-29,23,69,117,186
94392,2021-10-30,0,64,95,159
94393,2021-10-30,1,86,122,208
94394,2021-10-30,2,41,87,128
94395,2021-10-30,3,20,30,50
94396,2021-10-30,4,16,19,35
94397,2021-10-30,5,6,16,22
94398,2021-10-30,6,19,43,62
94399,2021-10-30,7,37,92,129
94400,2021-10-30,8,80,184,264
94401,2021-10-30,9,134,346,480
94402,2021-10-30,10,244,477,721
94403,2021-10-30,11,345,594,939
94404,2021-10-30,12,400,589,989
94405,2021-10-30,13,399,614,1013
94406,2021-10-30,14,427,645,1072
94407,2021-10-30,15,453,612,1065
94408,2021-10-30,16,414,605,1019
94409,2021-10-30,17,344,527,871
94410,2021-10-30,18,268,495,763
94411,2021-10-30,19,217,436,653
94412,2021-10-30,20,146,283,429
94413,2021-10-30,21,143,259,402
94414,2021-10-30,22,135,190,325
94415,2021-10-30,23,146,210,356
94416,2021-10-31,0,155,204,359
94417,2021-10-31,1,165,185,350
94418,2021-10-31,2,176,148,324
94419,2021-10-31,3,81,97,178
94420,2021-10-31,4,26,25,51
94421,2021-10-31,5,12,21,33
94422,2021-10-31,6,16,37,53
94423,2021-10-31,7,25,51,76
94424,2021-10-31,8,73,147,220
94425,2021-10-31,9,105,254,359
94426,2021-10-31,10,214,407,621
94427,2021-10-31,11,268,508,776
94428,2021-10-31,12,372,602,974
94429,2021-10-31,13,385,570,955
94430,2021-10-31,14,385,528,913
94431,2021-10-31,15,328,526,854
94432,2021-10-31,16,381,586,967
94433,2021-10-31,17,333,572,905
94434,2021-10-31,18,192,441,633
94435,2021-10-31,19,128,307,435
94436,2021-10-31,20,99,254,353
94437,2021-10-31,21,70,178,248
94438,2021-10-31,22,64,143,207
94439,2021-10-31,23,38,80,118
94440,2021-11-01,0,22,40,62
94441,2021-11-01,1,17,21,38
94442,2021-11-01,2,17,8,25
94443,2021-11-01,3,3,6,9
94444,2021-11-01,4,5,12,17
94445,2021-11-01,5,14,43,57
94446,2021-11-01,6,32,114,146
94447,2021-11-01,7,62,365,427
94448,2021-11-01,8,112,533,645
94449,2021-11-01,9,83,379,462
94450,2021-11-01,10,118,278,396
94451,2021-11-01,11,125,293,418
94452,2021-11-01,12,194,361,555
94453,2021-11-01,13,172,303,475
94454,2021-11-01,14,166,331,497
94455,2021-11-01,15,192,412,604
94456,2021-11-01,16,251,552,803
94457,2021-11-01,17,273,891,1164
94458,2021-11-01,18,228,771,999
94459,2021-11-01,19,148,486,634
94460,2021-11-01,20,91,280,371
94461,2021-11-01,21,65,208,273
94462,2021-11-01,22,53,143,196
94463,2021-11-01,23,27,78,105
94464,2021-11-02,0,21,29,50
94465,2021-11-02,1,11,15,26
94466,2021-11-02,2,6,12,18
94467,2021-11-02,3,1,2,3
94468,2021-11-02,4,4,13,17
94469,2021-11-02,5,15,42,57
94470,2021-11-02,6,40,160,200
94471,2021-11-02,7,62,393,455
94472,2021-11-02,8,116,644,760
94473,2021-11-02,9,83,360,443
94474,2021-11-02,10,71,228,299
94475,2021-11-02,11,35,165,200
94476,2021-11-02,12,30,163,193
94477,2021-11-02,13,30,132,162
94478,2021-11-02,14,22,145,167
94479,2021-11-02,15,43,171,214
94480,2021-11-02,16,45,221,266
94481,2021-11-02,17,101,521,622
94482,2021-11-02,18,123,548,671
94483,2021-11-02,19,81,391,472
94484,2021-11-02,20,75,246,321
94485,2021-11-02,21,61,181,242
94486,2021-11-02,22,52,151,203
94487,2021-11-02,23,33,62,95
94488,2021-11-03,0,18,36,54
94489,2021-11-03,1,9,17,26
94490,2021-11-03,2,5,10,15
94491,2021-11-03,3,3,7,10
94492,2021-11-03,4,6,6,12
94493,2021-11-03,5,11,45,56
94494,2021-11-03,6,33,150,183
94495,2021-11-03,7,65,394,459
94496,2021-11-03,8,128,582,710
94497,2021-11-03,9,72,417,489
94498,2021-11-03,10,71,254,325
94499,2021-11-03,11,78,241,319
94500,2021-11-03,12,107,355,462
94501,2021-11-03,13,115,331,446
94502,2021-11-03,14,124,331,455
94503,2021-11-03,15,151,414,565
94504,2021-11-03,16,166,535,701
94505,2021-11-03,17,240,840,1080
94506,2021-11-03,18,201,748,949
94507,2021-11-03,19,106,537,643
94508,2021-11-03,20,78,294,372
94509,2021-11-03,21,73,265,338
94510,2021-11-03,22,46,187,233
94511,2021-11-03,23,45,83,128
94512,2021-11-04,0,17,23,40
94513,2021-11-04,1,5,14,19
94514,2021-11-04,2,3,9,12
94515,2021-11-04,3,8,5,13
94516,2021-11-04,4,7,4,11
94517,2021-11-04,5,17,45,62
94518,2021-11-04,6,30,149,179
94519,2021-11-04,7,54,349,403
94520,2021-11-04,8,91,611,702
94521,2021-11-04,9,74,411,485
94522,2021-11-04,10,72,268,340
94523,2021-11-04,11,82,262,344
94524,2021-11-04,12,136,352,488
94525,2021-11-04,13,116,308,424
94526,2021-11-04,14,162,315,477
94527,2021-11-04,15,195,407,602
94528,2021-11-04,16,171,491,662
94529,2021-11-04,17,229,824,1053
94530,2021-11-04,18,215,763,978
94531,2021-11-04,19,158,487,645
94532,2021-11-04,20,104,336,440
94533,2021-11-04,21,77,256,333
94534,2021-11-04,22,76,175,251
94535,2021-11-04,23,51,121,172
94536,2021-11-05,0,24,48,72
94537,2021-11-05,1,17,35,52
94538,2021-11-05,2,11,9,20
94539,2021-11-05,3,3,9,12
94540,2021-11-05,4,6,8,14
94541,2021-11-05,5,12,48,60
94542,2021-11-05,6,31,123,154
94543,2021-11-05,7,43,305,348
94544,2021-11-05,8,86,425,511
94545,2021-11-05,9,137,349,486
94546,2021-11-05,10,117,259,376
94547,2021-11-05,11,165,321,486
94548,2021-11-05,12,183,403,586
94549,2021-11-05,13,217,362,579
94550,2021-11-05,14,252,451,703
94551,2021-11-05,15,266,427,693
94552,2021-11-05,16,271,525,796
94553,2021-11-05,17,302,745,1047
94554,2021-11-05,18,245,603,848
94555,2021-11-05,19,166,455,621
94556,2021-11-05,20,104,300,404
94557,2021-11-05,21,97,210,307
94558,2021-11-05,22,95,183,278
94559,2021-11-05,23,73,134,207
94560,2021-11-06,0,65,148,213
94561,2021-11-06,1,41,97,138
94562,2021-11-06,2,32,65,97
94563,2021-11-06,3,20,20,40
94564,2021-11-06,4,12,9,21
94565,2021-11-06,5,8,7,15
94566,2021-11-06,6,18,39,57
94567,2021-11-06,7,20,90,110
94568,2021-11-06,8,57,199,256
94569,2021-11-06,9,110,287,397
94570,2021-11-06,10,191,370,561
94571,2021-11-06,11,307,490,797
94572,2021-11-06,12,366,499,865
94573,2021-11-06,13,379,530,909
94574,2021-11-06,14,442,545,987
94575,2021-11-06,15,398,581,979
94576,2021-11-06,16,476,614,1090
94577,2021-11-06,17,380,599,979
94578,2021-11-06,18,237,434,671
94579,2021-11-06,19,146,335,481
94580,2021-11-06,20,118,299,417
94581,2021-11-06,21,99,217,316
94582,2021-11-06,22,103,228,331
94583,2021-11-06,23,92,191,283
94584,2021-11-07,0,91,147,238
94585,2021-11-07,1,94,136,230
94586,2021-11-07,2,28,30,58
94587,2021-11-07,3,10,6,16
94588,2021-11-07,4,13,11,24
94589,2021-11-07,5,8,12,20
94590,2021-11-07,6,14,38,52
94591,2021-11-07,7,26,78,104
94592,2021-11-07,8,66,184,250
94593,2021-11-07,9,164,323,487
94594,2021-11-07,10,239,466,705
94595,2021-11-07,11,244,513,757
94596,2021-11-07,12,331,580,911
94597,2021-11-07,13,334,634,968
94598,2021-11-07,14,323,597,920
94599,2021-11-07,15,287,608,895
94600,2021-11-07,16,298,563,861
94601,2021-11-07,17,214,492,706
94602,2021-11-07,18,109,338,447
94603,2021-11-07,19,74,202,276
94604,2021-11-07,20,77,227,304
94605,2021-11-07,21,64,149,213
94606,2021-11-07,22,52,127,179
94607,2021-11-07,23,34,58,92
94608,2021-11-08,0,18,24,42
94609,2021-11-08,1,8,11,19
94610,2021-11-08,2,7,8,15
94611,2021-11-08,3,3,2,5
94612,2021-11-08,4,3,11,14
94613,2021-11-08,5,9,49,58
94614,2021-11-08,6,33,169,202
94615,2021-11-08,7,56,430,486
94616,2021-11-08,8,89,601,690
94617,2021-11-08,9,77,367,444
94618,2021-11-08,10,127,291,418
94619,2021-11-08,11,127,278,405
94620,2021-11-08,12,142,365,507
94621,2021-11-08,13,143,371,514
94622,2021-11-08,14,177,351,528
94623,2021-11-08,15,191,454,645
94624,2021-11-08,16,206,603,809
94625,2021-11-08,17,225,815,1040
94626,2021-11-08,18,172,734,906
94627,2021-11-08,19,92,430,522
94628,2021-11-08,20,83,306,389
94629,2021-11-08,21,95,256,351
94630,2021-11-08,22,45,142,187
94631,2021-11-08,23,35,58,93
94632,2021-11-09,0,16,25,41
94633,2021-11-09,1,6,10,16
94634,2021-11-09,2,3,4,7
94635,2021-11-09,3,3,5,8
94636,2021-11-09,4,3,13,16
94637,2021-11-09,5,13,47,60
94638,2021-11-09,6,28,170,198
94639,2021-11-09,7,78,454,532
94640,2021-11-09,8,135,745,880
94641,2021-11-09,9,116,436,552
94642,2021-11-09,10,131,299,430
94643,2021-11-09,11,144,333,477
94644,2021-11-09,12,163,414,577
94645,2021-11-09,13,138,367,505
94646,2021-11-09,14,174,405,579
94647,2021-11-09,15,233,473,706
94648,2021-11-09,16,245,673,918
94649,2021-11-09,17,247,900,1147
94650,2021-11-09,18,219,795,1014
94651,2021-11-09,19,142,521,663
94652,2021-11-09,20,121,356,477
94653,2021-11-09,21,97,258,355
94654,2021-11-09,22,64,182,246
94655,2021-11-09,23,42,94,136
94656,2021-11-10,0,19,28,47
94657,2021-11-10,1,8,15,23
94658,2021-11-10,2,6,9,15
94659,2021-11-10,3,2,3,5
94660,2021-11-10,4,6,11,17
94661,2021-11-10,5,15,38,53
94662,2021-11-10,6,33,191,224
94663,2021-11-10,7,95,525,620
94664,2021-11-10,8,156,804,960
94665,2021-11-10,9,116,472,588
94666,2021-11-10,10,112,339,451
94667,2021-11-10,11,125,307,432
94668,2021-11-10,12,166,422,588
94669,2021-11-10,13,161,402,563
94670,2021-11-10,14,172,426,598
94671,2021-11-10,15,221,504,725
94672,2021-11-10,16,241,668,909
94673,2021-11-10,17,272,952,1224
94674,2021-11-10,18,212,799,1011
94675,2021-11-10,19,191,603,794
94676,2021-11-10,20,134,402,536
94677,2021-11-10,21,102,307,409
94678,2021-11-10,22,85,207,292
94679,2021-11-10,23,64,143,207
94680,2021-11-11,0,34,70,104
94681,2021-11-11,1,30,38,68
94682,2021-11-11,2,16,21,37
94683,2021-11-11,3,6,7,13
94684,2021-11-11,4,13,13,26
94685,2021-11-11,5,18,29,47
94686,2021-11-11,6,32,116,148
94687,2021-11-11,7,71,278,349
94688,2021-11-11,8,109,497,606
94689,2021-11-11,9,140,443,583
94690,2021-11-11,10,162,427,589
94691,2021-11-11,11,226,497,723
94692,2021-11-11,12,273,560,833
94693,2021-11-11,13,265,533,798
94694,2021-11-11,14,313,578,891
94695,2021-11-11,15,333,598,931
94696,2021-11-11,16,317,647,964
94697,2021-11-11,17,284,749,1033
94698,2021-11-11,18,184,659,843
94699,2021-11-11,19,163,452,615
94700,2021-11-11,20,111,329,440
94701,2021-11-11,21,119,261,380
94702,2021-11-11,22,109,185,294
94703,2021-11-11,23,85,145,230
94704,2021-11-12,0,56,83,139
94705,2021-11-12,1,31,31,62
94706,2021-11-12,2,4,14,18
94707,2021-11-12,3,6,3,9
94708,2021-11-12,4,4,7,11
94709,2021-11-12,5,4,17,21
94710,2021-11-12,6,17,65,82
94711,2021-11-12,7,29,156,185
94712,2021-11-12,8,43,218,261
94713,2021-11-12,9,93,272,365
94714,2021-11-12,10,132,275,407
94715,2021-11-12,11,190,342,532
94716,2021-11-12,12,215,412,627
94717,2021-11-12,13,261,440,701
94718,2021-11-12,14,349,487,836
94719,2021-11-12,15,395,549,944
94720,2021-11-12,16,381,668,1049
94721,2021-11-12,17,332,685,1017
94722,2021-11-12,18,230,572,802
94723,2021-11-12,19,163,428,591
94724,2021-11-12,20,161,354,515
94725,2021-11-12,21,134,262,396
94726,2021-11-12,22,75,172,247
94727,2021-11-12,23,92,196,288
94728,2021-11-13,0,79,140,219
94729,2021-11-13,1,69,107,176
94730,2021-11-13,2,52,60,112
94731,2021-11-13,3,29,24,53
94732,2021-11-13,4,13,12,25
94733,2021-11-13,5,21,18,39
94734,2021-11-13,6,29,72,101
94735,2021-11-13,7,139,220,359
94736,2021-11-13,8,166,275,441
94737,2021-11-13,9,306,422,728
94738,2021-11-13,10,408,507,915
94739,2021-11-13,11,336,444,780
94740,2021-11-13,12,234,374,608
94741,2021-11-13,13,345,482,827
94742,2021-11-13,14,395,450,845
94743,2021-11-13,15,386,494,880
94744,2021-11-13,16,289,489,778
94745,2021-11-13,17,218,395,613
94746,2021-11-13,18,120,344,464
94747,2021-11-13,19,95,258,353
94748,2021-11-13,20,88,190,278
94749,2021-11-13,21,59,177,236
94750,2021-11-13,22,75,152,227
94751,2021-11-13,23,73,127,200
94752,2021-11-14,0,52,130,182
94753,2021-11-14,1,81,105,186
94754,2021-11-14,2,31,61,92
94755,2021-11-14,3,14,17,31
94756,2021-11-14,4,7,18,25
94757,2021-11-14,5,10,11,21
94758,2021-11-14,6,8,29,37
94759,2021-11-14,7,30,51,81
94760,2021-11-14,8,57,139,196
94761,2021-11-14,9,120,278,398
94762,2021-11-14,10,192,373,565
94763,2021-11-14,11,206,442,648
94764,2021-11-14,12,234,437,671
94765,2021-11-14,13,245,466,711
94766,2021-11-14,14,295,446,741
94767,2021-11-14,15,204,435,639
94768,2021-11-14,16,187,403,590
94769,2021-11-14,17,147,351,498
94770,2021-11-14,18,91,272,363
94771,2021-11-14,19,81,206,287
94772,2021-11-14,20,46,147,193
94773,2021-11-14,21,58,145,203
94774,2021-11-14,22,42,102,144
94775,2021-11-14,23,38,55,93
94776,2021-11-15,0,15,24,39
94777,2021-11-15,1,7,8,15
94778,2021-11-15,2,10,7,17
94779,2021-11-15,3,3,2,5
94780,2021-11-15,4,9,4,13
94781,2021-11-15,5,18,33,51
94782,2021-11-15,6,39,140,179
94783,2021-11-15,7,62,353,415
94784,2021-11-15,8,100,520,620
94785,2021-11-15,9,54,298,352
94786,2021-11-15,10,83,223,306
94787,2021-11-15,11,100,228,328
94788,2021-11-15,12,113,252,365
94789,2021-11-15,13,109,248,357
94790,2021-11-15,14,107,293,400
94791,2021-11-15,15,109,318,427
94792,2021-11-15,16,131,428,559
94793,2021-11-15,17,130,611,741
94794,2021-11-15,18,115,548,663
94795,2021-11-15,19,59,388,447
94796,2021-11-15,20,42,217,259
94797,2021-11-15,21,53,198,251
94798,2021-11-15,22,29,108,137
94799,2021-11-15,23,17,56,73
94800,2021-11-16,0,15,27,42
94801,2021-11-16,1,8,9,17
94802,2021-11-16,2,4,3,7
94803,2021-11-16,3,5,5,10
94804,2021-11-16,4,1,7,8
94805,2021-11-16,5,11,43,54
94806,2021-11-16,6,23,156,179
94807,2021-11-16,7,58,409,467
94808,2021-11-16,8,96,635,731
94809,2021-11-16,9,94,400,494
94810,2021-11-16,10,119,229,348
94811,2021-11-16,11,92,266,358
94812,2021-11-16,12,117,358,475
94813,2021-11-16,13,105,292,397
94814,2021-11-16,14,104,353,457
94815,2021-11-16,15,135,377,512
94816,2021-11-16,16,142,537,679
94817,2021-11-16,17,164,726,890
94818,2021-11-16,18,135,599,734
94819,2021-11-16,19,114,449,563
94820,2021-11-16,20,80,348,428
94821,2021-11-16,21,60,209,269
94822,2021-11-16,22,60,186,246
94823,2021-11-16,23,31,82,113
94824,2021-11-17,0,15,27,42
94825,2021-11-17,1,9,9,18
94826,2021-11-17,2,3,1,4
94827,2021-11-17,3,1,7,8
94828,2021-11-17,4,3,7,10
94829,2021-11-17,5,12,41,53
94830,2021-11-17,6,32,154,186
94831,2021-11-17,7,77,417,494
94832,2021-11-17,8,119,641,760
94833,2021-11-17,9,106,408,514
94834,2021-11-17,10,107,276,383
94835,2021-11-17,11,115,303,418
94836,2021-11-17,12,107,391,498
94837,2021-11-17,13,130,345,475
94838,2021-11-17,14,148,399,547
94839,2021-11-17,15,189,434,623
94840,2021-11-17,16,183,571,754
94841,2021-11-17,17,207,799,1006
94842,2021-11-17,18,151,713,864
94843,2021-11-17,19,126,514,640
94844,2021-11-17,20,93,353,446
94845,2021-11-17,21,82,249,331
94846,2021-11-17,22,69,196,265
94847,2021-11-17,23,34,130,164
94848,2021-11-18,0,26,33,59
94849,2021-11-18,1,8,15,23
94850,2021-11-18,2,10,12,22
94851,2021-11-18,3,4,3,7
94852,2021-11-18,4,7,8,15
94853,2021-11-18,5,9,48,57
94854,2021-11-18,6,34,143,177
94855,2021-11-18,7,67,427,494
94856,2021-11-18,8,130,623,753
94857,2021-11-18,9,127,419,546
94858,2021-11-18,10,115,291,406
94859,2021-11-18,11,165,311,476
94860,2021-11-18,12,174,438,612
94861,2021-11-18,13,205,410,615
94862,2021-11-18,14,205,475,680
94863,2021-11-18,15,204,480,684
94864,2021-11-18,16,245,669,914
94865,2021-11-18,17,223,772,995
94866,2021-11-18,18,144,522,666
94867,2021-11-18,19,69,307,376
94868,2021-11-18,20,52,223,275
94869,2021-11-18,21,50,172,222
94870,2021-11-18,22,67,164,231
94871,2021-11-18,23,54,129,183
94872,2021-11-19,0,20,53,73
94873,2021-11-19,1,13,19,32
94874,2021-11-19,2,9,12,21
94875,2021-11-19,3,5,8,13
94876,2021-11-19,4,8,10,18
94877,2021-11-19,5,9,34,43
94878,2021-11-19,6,31,141,172
94879,2021-11-19,7,69,360,429
94880,2021-11-19,8,104,454,558
94881,2021-11-19,9,83,336,419
94882,2021-11-19,10,110,223,333
94883,2021-11-19,11,96,254,350
94884,2021-11-19,12,122,329,451
94885,2021-11-19,13,118,332,450
94886,2021-11-19,14,121,397,518
94887,2021-11-19,15,155,415,570
94888,2021-11-19,16,171,504,675
94889,2021-11-19,17,143,569,712
94890,2021-11-19,18,141,518,659
94891,2021-11-19,19,98,355,453
94892,2021-11-19,20,64,208,272
94893,2021-11-19,21,57,160,217
94894,2021-11-19,22,48,158,206
94895,2021-11-19,23,60,124,184
94896,2021-11-20,0,48,114,162
94897,2021-11-20,1,55,70,125
94898,2021-11-20,2,28,49,77
94899,2021-11-20,3,16,18,34
94900,2021-11-20,4,6,15,21
94901,2021-11-20,5,3,13,16
94902,2021-11-20,6,12,40,52
94903,2021-11-20,7,21,75,96
94904,2021-11-20,8,52,147,199
94905,2021-11-20,9,105,302,407
94906,2021-11-20,10,149,361,510
94907,2021-11-20,11,234,489,723
94908,2021-11-20,12,249,507,756
94909,2021-11-20,13,303,410,713
94910,2021-11-20,14,291,463,754
94911,2021-11-20,15,279,473,752
94912,2021-11-20,16,206,410,616
94913,2021-11-20,17,105,309,414
94914,2021-11-20,18,90,301,391
94915,2021-11-20,19,83,207,290
94916,2021-11-20,20,66,187,253
94917,2021-11-20,21,70,153,223
94918,2021-11-20,22,66,167,233
94919,2021-11-20,23,52,130,182
94920,2021-11-21,0,40,93,133
94921,2021-11-21,1,50,52,102
94922,2021-11-21,2,42,59,101
94923,2021-11-21,3,35,21,56
94924,2021-11-21,4,10,23,33
94925,2021-11-21,5,12,14,26
94926,2021-11-21,6,15,41,56
94927,2021-11-21,7,13,44,57
94928,2021-11-21,8,45,138,183
94929,2021-11-21,9,99,223,322
94930,2021-11-21,10,177,324,501
94931,2021-11-21,11,199,395,594
94932,2021-11-21,12,241,422,663
94933,2021-11-21,13,209,445,654
94934,2021-11-21,14,257,371,628
94935,2021-11-21,15,271,422,693
94936,2021-11-21,16,190,409,599
94937,2021-11-21,17,131,309,440
94938,2021-11-21,18,97,276,373
94939,2021-11-21,19,98,200,298
94940,2021-11-21,20,65,141,206
94941,2021-11-21,21,43,101,144
94942,2021-11-21,22,39,73,112
94943,2021-11-21,23,29,67,96
94944,2021-11-22,0,14,18,32
94945,2021-11-22,1,8,9,17
94946,2021-11-22,2,5,9,14
94947,2021-11-22,3,0,5,5
94948,2021-11-22,4,4,9,13
94949,2021-11-22,5,14,29,43
94950,2021-11-22,6,20,109,129
94951,2021-11-22,7,35,260,295
94952,2021-11-22,8,60,437,497
94953,2021-11-22,9,79,282,361
94954,2021-11-22,10,110,236,346
94955,2021-11-22,11,132,234,366
94956,2021-11-22,12,137,265,402
94957,2021-11-22,13,163,275,438
94958,2021-11-22,14,189,316,505
94959,2021-11-22,15,176,396,572
94960,2021-11-22,16,168,402,570
94961,2021-11-22,17,146,518,664
94962,2021-11-22,18,109,420,529
94963,2021-11-22,19,62,305,367
94964,2021-11-22,20,43,179,222
94965,2021-11-22,21,55,159,214
94966,2021-11-22,22,27,91,118
94967,2021-11-22,23,19,56,75
94968,2021-11-23,0,16,26,42
94969,2021-11-23,1,4,10,14
94970,2021-11-23,2,3,4,7
94971,2021-11-23,3,7,5,12
94972,2021-11-23,4,6,13,19
94973,2021-11-23,5,9,33,42
94974,2021-11-23,6,24,108,132
94975,2021-11-23,7,49,266,315
94976,2021-11-23,8,74,389,463
94977,2021-11-23,9,77,258,335
94978,2021-11-23,10,95,216,311
94979,2021-11-23,11,91,202,293
94980,2021-11-23,12,147,300,447
94981,2021-11-23,13,122,252,374
94982,2021-11-23,14,140,281,421
94983,2021-11-23,15,124,323,447
94984,2021-11-23,16,141,407,548
94985,2021-11-23,17,129,448,577
94986,2021-11-23,18,95,368,463
94987,2021-11-23,19,63,215,278
94988,2021-11-23,20,36,164,200
94989,2021-11-23,21,37,112,149
94990,2021-11-23,22,30,81,111
94991,2021-11-23,23,17,39,56
94992,2021-11-24,0,10,22,32
94993,2021-11-24,1,18,16,34
94994,2021-11-24,2,6,7,13
94995,2021-11-24,3,2,3,5
94996,2021-11-24,4,8,11,19
94997,2021-11-24,5,11,25,36
94998,2021-11-24,6,18,69,87
94999,2021-11-24,7,29,142,171
95000,2021-11-24,8,52,212,264
95001,2021-11-24,9,53,219,272
95002,2021-11-24,10,64,206,270
95003,2021-11-24,11,120,231,351
95004,2021-11-24,12,149,303,452
95005,2021-11-24,13,183,297,480
95006,2021-11-24,14,181,357,538
95007,2021-11-24,15,237,353,590
95008,2021-11-24,16,184,367,551
95009,2021-11-24,17,124,311,435
95010,2021-11-24,18,72,224,296
95011,2021-11-24,19,63,211,274
95012,2021-11-24,20,38,119,157
95013,2021-11-24,21,47,95,142
95014,2021-11-24,22,46,87,133
95015,2021-11-24,23,44,47,91
95016,2021-11-25,0,28,41,69
95017,2021-11-25,1,29,31,60
95018,2021-11-25,2,25,19,44
95019,2021-11-25,3,17,16,33
95020,2021-11-25,4,3,3,6
95021,2021-11-25,5,6,8,14
95022,2021-11-25,6,9,30,39
95023,2021-11-25,7,16,62,78
95024,2021-11-25,8,38,100,138
95025,2021-11-25,9,61,134,195
95026,2021-11-25,10,123,171,294
95027,2021-11-25,11,158,204,362
95028,2021-11-25,12,212,206,418
95029,2021-11-25,13,223,179,402
95030,2021-11-25,14,207,222,429
95031,2021-11-25,15,214,199,413
95032,2021-11-25,16,190,217,407
95033,2021-11-25,17,96,119,215
95034,2021-11-25,18,53,83,136
95035,2021-11-25,19,42,59,101
95036,2021-11-25,20,40,80,120
95037,2021-11-25,21,59,61,120
95038,2021-11-25,22,37,67,104
95039,2021-11-25,23,18,47,65
95040,2021-11-26,0,6,11,17
95041,2021-11-26,1,2,6,8
95042,2021-11-26,2,0,3,3
95043,2021-11-26,3,5,2,7
95044,2021-11-26,4,3,5,8
95045,2021-11-26,5,3,5,8
95046,2021-11-26,6,7,29,36
95047,2021-11-26,7,17,56,73
95048,2021-11-26,8,38,91,129
95049,2021-11-26,9,73,142,215
95050,2021-11-26,10,112,143,255
95051,2021-11-26,11,135,162,297
95052,2021-11-26,12,141,196,337
95053,2021-11-26,13,186,209,395
95054,2021-11-26,14,155,265,420
95055,2021-11-26,15,133,208,341
95056,2021-11-26,16,109,196,305
95057,2021-11-26,17,82,158,240
95058,2021-11-26,18,49,137,186
95059,2021-11-26,19,41,110,151
95060,2021-11-26,20,51,69,120
95061,2021-11-26,21,26,62,88
95062,2021-11-26,22,43,60,103
95063,2021-11-26,23,29,47,76
95064,2021-11-27,0,22,49,71
95065,2021-11-27,1,26,30,56
95066,2021-11-27,2,21,21,42
95067,2021-11-27,3,16,11,27
95068,2021-11-27,4,4,7,11
95069,2021-11-27,5,4,10,14
95070,2021-11-27,6,9,23,32
95071,2021-11-27,7,10,45,55
95072,2021-11-27,8,26,82,108
95073,2021-11-27,9,73,145,218
95074,2021-11-27,10,100,163,263
95075,2021-11-27,11,128,206,334
95076,2021-11-27,12,177,229,406
95077,2021-11-27,13,165,208,373
95078,2021-11-27,14,152,255,407
95079,2021-11-27,15,186,289,475
95080,2021-11-27,16,156,297,453
95081,2021-11-27,17,103,198,301
95082,2021-11-27,18,77,166,243
95083,2021-11-27,19,63,149,212
95084,2021-11-27,20,53,114,167
95085,2021-11-27,21,52,88,140
95086,2021-11-27,22,53,96,149
95087,2021-11-27,23,43,77,120
95088,2021-11-28,0,31,48,79
95089,2021-11-28,1,32,34,66
95090,2021-11-28,2,25,32,57
95091,2021-11-28,3,13,17,30
95092,2021-11-28,4,6,8,14
95093,2021-11-28,5,4,12,16
95094,2021-11-28,6,10,23,33
95095,2021-11-28,7,16,42,58
95096,2021-11-28,8,33,86,119
95097,2021-11-28,9,96,147,243
95098,2021-11-28,10,143,207,350
95099,2021-11-28,11,163,328,491
95100,2021-11-28,12,224,353,577
95101,2021-11-28,13,241,360,601
95102,2021-11-28,14,306,407,713
95103,2021-11-28,15,216,382,598
95104,2021-11-28,16,210,395,605
95105,2021-11-28,17,129,271,400
95106,2021-11-28,18,90,218,308
95107,2021-11-28,19,59,170,229
95108,2021-11-28,20,35,112,147
95109,2021-11-28,21,49,94,143
95110,2021-11-28,22,40,75,115
95111,2021-11-28,23,22,45,67
95112,2021-11-29,0,8,18,26
95113,2021-11-29,1,12,5,17
95114,2021-11-29,2,1,8,9
95115,2021-11-29,3,1,5,6
95116,2021-11-29,4,5,6,11
95117,2021-11-29,5,12,26,38
95118,2021-11-29,6,15,103,118
95119,2021-11-29,7,65,305,370
95120,2021-11-29,8,80,411,491
95121,2021-11-29,9,78,262,340
95122,2021-11-29,10,46,183,229
95123,2021-11-29,11,75,182,257
95124,2021-11-29,12,78,231,309
95125,2021-11-29,13,60,224,284
95126,2021-11-29,14,73,214,287
95127,2021-11-29,15,130,297,427
95128,2021-11-29,16,106,397,503
95129,2021-11-29,17,123,485,608
95130,2021-11-29,18,107,424,531
95131,2021-11-29,19,87,269,356
95132,2021-11-29,20,46,182,228
95133,2021-11-29,21,34,131,165
95134,2021-11-29,22,25,54,79
95135,2021-11-29,23,21,36,57
95136,2021-11-30,0,10,18,28
95137,2021-11-30,1,4,6,10
95138,2021-11-30,2,2,9,11
95139,2021-11-30,3,0,1,1
95140,2021-11-30,4,5,10,15
95141,2021-11-30,5,16,42,58
95142,2021-11-30,6,25,136,161
95143,2021-11-30,7,67,336,403
95144,2021-11-30,8,81,504,585
95145,2021-11-30,9,61,289,350
95146,2021-11-30,10,53,178,231
95147,2021-11-30,11,63,207,270
95148,2021-11-30,12,78,275,353
95149,2021-11-30,13,95,245,340
95150,2021-11-30,14,102,257,359
95151,2021-11-30,15,109,324,433
95152,2021-11-30,16,113,438,551
95153,2021-11-30,17,149,629,778
95154,2021-11-30,18,123,518,641
95155,2021-11-30,19,114,343,457
95156,2021-11-30,20,53,249,302
95157,2021-11-30,21,46,180,226
95158,2021-11-30,22,59,116,175
95159,2021-11-30,23,40,65,105
95160,2021-12-01,0,9,31,40
95161,2021-12-01,1,8,12,20
95162,2021-12-01,2,2,1,3
95163,2021-12-01,3,2,5,7
95164,2021-12-01,4,2,8,10
95165,2021-12-01,5,12,32,44
95166,2021-12-01,6,23,115,138
95167,2021-12-01,7,68,333,401
95168,2021-12-01,8,140,527,667
95169,2021-12-01,9,76,337,413
95170,2021-12-01,10,76,245,321
95171,2021-12-01,11,86,225,311
95172,2021-12-01,12,121,308,429
95173,2021-12-01,13,129,302,431
95174,2021-12-01,14,114,325,439
95175,2021-12-01,15,139,358,497
95176,2021-12-01,16,146,489,635
95177,2021-12-01,17,199,650,849
95178,2021-12-01,18,178,554,732
95179,2021-12-01,19,102,402,504
95180,2021-12-01,20,76,255,331
95181,2021-12-01,21,84,208,292
95182,2021-12-01,22,62,118,180
95183,2021-12-01,23,28,64,92
95184,2021-12-02,0,17,39,56
95185,2021-12-02,1,7,16,23
95186,2021-12-02,2,8,6,14
95187,2021-12-02,3,2,2,4
95188,2021-12-02,4,8,6,14
95189,2021-12-02,5,14,38,52
95190,2021-12-02,6,36,112,148
95191,2021-12-02,7,77,315,392
95192,2021-12-02,8,127,559,686
95193,2021-12-02,9,117,338,455
95194,2021-12-02,10,108,212,320
95195,2021-12-02,11,96,242,338
95196,2021-12-02,12,142,331,473
95197,2021-12-02,13,163,314,477
95198,2021-12-02,14,171,328,499
95199,2021-12-02,15,219,426,645
95200,2021-12-02,16,220,547,767
95201,2021-12-02,17,231,687,918
95202,2021-12-02,18,238,603,841
95203,2021-12-02,19,129,442,571
95204,2021-12-02,20,98,255,353
95205,2021-12-02,21,93,251,344
95206,2021-12-02,22,116,199,315
95207,2021-12-02,23,81,112,193
95208,2021-12-03,0,25,50,75
95209,2021-12-03,1,17,29,46
95210,2021-12-03,2,10,10,20
95211,2021-12-03,3,5,15,20
95212,2021-12-03,4,8,20,28
95213,2021-12-03,5,11,35,46
95214,2021-12-03,6,42,125,167
95215,2021-12-03,7,83,307,390
95216,2021-12-03,8,105,480,585
95217,2021-12-03,9,129,371,500
95218,2021-12-03,10,137,246,383
95219,2021-12-03,11,150,255,405
95220,2021-12-03,12,136,287,423
95221,2021-12-03,13,152,313,465
95222,2021-12-03,14,154,328,482
95223,2021-12-03,15,176,402,578
95224,2021-12-03,16,203,451,654
95225,2021-12-03,17,203,565,768
95226,2021-12-03,18,189,509,698
95227,2021-12-03,19,150,352,502
95228,2021-12-03,20,124,271,395
95229,2021-12-03,21,116,199,315
95230,2021-12-03,22,119,161,280
95231,2021-12-03,23,105,177,282
95232,2021-12-04,0,84,142,226
95233,2021-12-04,1,66,94,160
95234,2021-12-04,2,51,57,108
95235,2021-12-04,3,20,17,37
95236,2021-12-04,4,7,17,24
95237,2021-12-04,5,5,11,16
95238,2021-12-04,6,22,32,54
95239,2021-12-04,7,33,77,110
95240,2021-12-04,8,62,189,251
95241,2021-12-04,9,142,332,474
95242,2021-12-04,10,248,372,620
95243,2021-12-04,11,275,443,718
95244,2021-12-04,12,360,444,804
95245,2021-12-04,13,389,450,839
95246,2021-12-04,14,439,496,935
95247,2021-12-04,15,433,559,992
95248,2021-12-04,16,385,449,834
95249,2021-12-04,17,252,362,614
95250,2021-12-04,18,177,354,531
95251,2021-12-04,19,194,301,495
95252,2021-12-04,20,177,218,395
95253,2021-12-04,21,124,171,295
95254,2021-12-04,22,111,195,306
95255,2021-12-04,23,97,160,257
95256,2021-12-05,0,76,123,199
95257,2021-12-05,1,72,97,169
95258,2021-12-05,2,41,58,99
95259,2021-12-05,3,42,24,66
95260,2021-12-05,4,7,7,14
95261,2021-12-05,5,7,12,19
95262,2021-12-05,6,15,26,41
95263,2021-12-05,7,18,54,72
95264,2021-12-05,8,51,130,181
95265,2021-12-05,9,104,216,320
95266,2021-12-05,10,160,287,447
95267,2021-12-05,11,226,376,602
95268,2021-12-05,12,265,404,669
95269,2021-12-05,13,243,372,615
95270,2021-12-05,14,268,369,637
95271,2021-12-05,15,238,394,632
95272,2021-12-05,16,223,392,615
95273,2021-12-05,17,168,298,466
95274,2021-12-05,18,100,221,321
95275,2021-12-05,19,100,170,270
95276,2021-12-05,20,68,130,198
95277,2021-12-05,21,72,114,186
95278,2021-12-05,22,49,95,144
95279,2021-12-05,23,36,42,78
95280,2021-12-06,0,16,24,40
95281,2021-12-06,1,10,12,22
95282,2021-12-06,2,1,6,7
95283,2021-12-06,3,5,5,10
95284,2021-12-06,4,8,7,15
95285,2021-12-06,5,15,38,53
95286,2021-12-06,6,22,122,144
95287,2021-12-06,7,60,317,377
95288,2021-12-06,8,104,469,573
95289,2021-12-06,9,95,296,391
95290,2021-12-06,10,74,188,262
95291,2021-12-06,11,94,203,297
95292,2021-12-06,12,134,260,394
95293,2021-12-06,13,122,250,372
95294,2021-12-06,14,134,269,403
95295,2021-12-06,15,141,343,484
95296,2021-12-06,16,176,446,622
95297,2021-12-06,17,189,652,841
95298,2021-12-06,18,160,543,703
95299,2021-12-06,19,108,363,471
95300,2021-12-06,20,70,195,265
95301,2021-12-06,21,54,143,197
95302,2021-12-06,22,48,96,144
95303,2021-12-06,23,26,62,88
95304,2021-12-07,0,11,12,23
95305,2021-12-07,1,3,3,6
95306,2021-12-07,2,1,5,6
95307,2021-12-07,3,1,4,5
95308,2021-12-07,4,2,10,12
95309,2021-12-07,5,15,41,56
95310,2021-12-07,6,23,113,136
95311,2021-12-07,7,65,327,392
95312,2021-12-07,8,108,506,614
95313,2021-12-07,9,90,314,404
95314,2021-12-07,10,71,189,260
95315,2021-12-07,11,63,213,276
95316,2021-12-07,12,100,262,362
95317,2021-12-07,13,98,273,371
95318,2021-12-07,14,105,262,367
95319,2021-12-07,15,120,289,409
95320,2021-12-07,16,108,408,516
95321,2021-12-07,17,131,555,686
95322,2021-12-07,18,109,403,512
95323,2021-12-07,19,100,318,418
95324,2021-12-07,20,83,206,289
95325,2021-12-07,21,54,153,207
95326,2021-12-07,22,52,108,160
95327,2021-12-07,23,26,47,73
95328,2021-12-08,0,11,19,30
95329,2021-12-08,1,7,13,20
95330,2021-12-08,2,2,6,8
95331,2021-12-08,3,4,4,8
95332,2021-12-08,4,4,4,8
95333,2021-12-08,5,6,32,38
95334,2021-12-08,6,23,100,123
95335,2021-12-08,7,67,278,345
95336,2021-12-08,8,121,462,583
95337,2021-12-08,9,75,298,373
95338,2021-12-08,10,51,192,243
95339,2021-12-08,11,74,185,259
95340,2021-12-08,12,62,225,287
95341,2021-12-08,13,88,234,322
95342,2021-12-08,14,87,204,291
95343,2021-12-08,15,111,258,369
95344,2021-12-08,16,135,362,497
95345,2021-12-08,17,167,523,690
95346,2021-12-08,18,122,453,575
95347,2021-12-08,19,121,294,415
95348,2021-12-08,20,70,203,273
95349,2021-12-08,21,80,141,221
95350,2021-12-08,22,57,130,187
95351,2021-12-08,23,27,61,88
95352,2021-12-09,0,12,24,36
95353,2021-12-09,1,2,9,11
95354,2021-12-09,2,4,12,16
95355,2021-12-09,3,2,7,9
95356,2021-12-09,4,4,7,11
95357,2021-12-09,5,8,30,38
95358,2021-12-09,6,25,108,133
95359,2021-12-09,7,70,263,333
95360,2021-12-09,8,96,458,554
95361,2021-12-09,9,78,294,372
95362,2021-12-09,10,71,161,232
95363,2021-12-09,11,82,197,279
95364,2021-12-09,12,112,271,383
95365,2021-12-09,13,114,251,365
95366,2021-12-09,14,116,209,325
95367,2021-12-09,15,122,281,403
95368,2021-12-09,16,116,371,487
95369,2021-12-09,17,161,588,749
95370,2021-12-09,18,164,478,642
95371,2021-12-09,19,78,287,365
95372,2021-12-09,20,78,196,274
95373,2021-12-09,21,72,175,247
95374,2021-12-09,22,71,118,189
95375,2021-12-09,23,52,104,156
95376,2021-12-10,0,16,45,61
95377,2021-12-10,1,12,18,30
95378,2021-12-10,2,9,10,19
95379,2021-12-10,3,1,4,5
95380,2021-12-10,4,5,9,14
95381,2021-12-10,5,12,32,44
95382,2021-12-10,6,33,104,137
95383,2021-12-10,7,53,249,302
95384,2021-12-10,8,110,414,524
95385,2021-12-10,9,108,308,416
95386,2021-12-10,10,117,200,317
95387,2021-12-10,11,140,253,393
95388,2021-12-10,12,151,284,435
95389,2021-12-10,13,182,298,480
95390,2021-12-10,14,219,352,571
95391,2021-12-10,15,241,387,628
95392,2021-12-10,16,239,463,702
95393,2021-12-10,17,230,527,757
95394,2021-12-10,18,180,468,648
95395,2021-12-10,19,170,321,491
95396,2021-12-10,20,95,207,302
95397,2021-12-10,21,98,187,285
95398,2021-12-10,22,126,169,295
95399,2021-12-10,23,102,143,245
95400,2021-12-11,0,90,132,222
95401,2021-12-11,1,72,55,127
95402,2021-12-11,2,65,50,115
95403,2021-12-11,3,19,31,50
95404,2021-12-11,4,11,7,18
95405,2021-12-11,5,17,14,31
95406,2021-12-11,6,12,35,47
95407,2021-12-11,7,31,54,85
95408,2021-12-11,8,56,159,215
95409,2021-12-11,9,132,208,340
95410,2021-12-11,10,201,302,503
95411,2021-12-11,11,265,375,640
95412,2021-12-11,12,307,406,713
95413,2021-12-11,13,318,410,728
95414,2021-12-11,14,370,417,787
95415,2021-12-11,15,331,427,758
95416,2021-12-11,16,292,425,717
95417,2021-12-11,17,219,335,554
95418,2021-12-11,18,145,239,384
95419,2021-12-11,19,66,129,195
95420,2021-12-11,20,43,95,138
95421,2021-12-11,21,38,81,119
95422,2021-12-11,22,86,115,201
95423,2021-12-11,23,70,121,191
95424,2021-12-12,0,94,105,199
95425,2021-12-12,1,60,91,151
95426,2021-12-12,2,36,37,73
95427,2021-12-12,3,23,21,44
95428,2021-12-12,4,8,10,18
95429,2021-12-12,5,2,9,11
95430,2021-12-12,6,17,17,34
95431,2021-12-12,7,25,45,70
95432,2021-12-12,8,43,106,149
95433,2021-12-12,9,87,186,273
95434,2021-12-12,10,161,264,425
95435,2021-12-12,11,209,342,551
95436,2021-12-12,12,240,420,660
95437,2021-12-12,13,280,372,652
95438,2021-12-12,14,273,351,624
95439,2021-12-12,15,231,385,616
95440,2021-12-12,16,226,406,632
95441,2021-12-12,17,166,340,506
95442,2021-12-12,18,135,238,373
95443,2021-12-12,19,62,149,211
95444,2021-12-12,20,71,132,203
95445,2021-12-12,21,38,100,138
95446,2021-12-12,22,41,78,119
95447,2021-12-12,23,28,54,82
95448,2021-12-13,0,12,17,29
95449,2021-12-13,1,9,11,20
95450,2021-12-13,2,5,10,15
95451,2021-12-13,3,6,1,7
95452,2021-12-13,4,5,8,13
95453,2021-12-13,5,9,31,40
95454,2021-12-13,6,24,117,141
95455,2021-12-13,7,51,243,294
95456,2021-12-13,8,103,424,527
95457,2021-12-13,9,56,251,307
95458,2021-12-13,10,64,160,224
95459,2021-12-13,11,113,163,276
95460,2021-12-13,12,112,225,337
95461,2021-12-13,13,125,244,369
95462,2021-12-13,14,132,233,365
95463,2021-12-13,15,145,290,435
95464,2021-12-13,16,160,406,566
95465,2021-12-13,17,175,491,666
95466,2021-12-13,18,136,438,574
95467,2021-12-13,19,92,308,400
95468,2021-12-13,20,79,190,269
95469,2021-12-13,21,68,137,205
95470,2021-12-13,22,42,99,141
95471,2021-12-13,23,30,59,89
95472,2021-12-14,0,14,15,29
95473,2021-12-14,1,5,15,20
95474,2021-12-14,2,4,5,9
95475,2021-12-14,3,5,4,9
95476,2021-12-14,4,2,10,12
95477,2021-12-14,5,7,38,45
95478,2021-12-14,6,31,121,152
95479,2021-12-14,7,66,296,362
95480,2021-12-14,8,130,484,614
95481,2021-12-14,9,85,286,371
95482,2021-12-14,10,85,226,311
95483,2021-12-14,11,105,216,321
95484,2021-12-14,12,124,263,387
95485,2021-12-14,13,137,246,383
95486,2021-12-14,14,144,261,405
95487,2021-12-14,15,188,321,509
95488,2021-12-14,16,181,433,614
95489,2021-12-14,17,207,578,785
95490,2021-12-14,18,194,541,735
95491,2021-12-14,19,125,323,448
95492,2021-12-14,20,89,270,359
95493,2021-12-14,21,66,146,212
95494,2021-12-14,22,56,130,186
95495,2021-12-14,23,29,66,95
95496,2021-12-15,0,9,20,29
95497,2021-12-15,1,9,14,23
95498,2021-12-15,2,11,8,19
95499,2021-12-15,3,1,6,7
95500,2021-12-15,4,3,15,18
95501,2021-12-15,5,7,40,47
95502,2021-12-15,6,23,123,146
95503,2021-12-15,7,64,306,370
95504,2021-12-15,8,118,467,585
95505,2021-12-15,9,88,280,368
95506,2021-12-15,10,104,183,287
95507,2021-12-15,11,101,203,304
95508,2021-12-15,12,108,263,371
95509,2021-12-15,13,108,271,379
95510,2021-12-15,14,131,276,407
95511,2021-12-15,15,153,303,456
95512,2021-12-15,16,173,411,584
95513,2021-12-15,17,192,537,729
95514,2021-12-15,18,179,485,664
95515,2021-12-15,19,126,331,457
95516,2021-12-15,20,99,218,317
95517,2021-12-15,21,82,178,260
95518,2021-12-15,22,60,133,193
95519,2021-12-15,23,30,75,105
95520,2021-12-16,0,26,15,41
95521,2021-12-16,1,5,21,26
95522,2021-12-16,2,12,12,24
95523,2021-12-16,3,6,9,15
95524,2021-12-16,4,6,10,16
95525,2021-12-16,5,4,36,40
95526,2021-12-16,6,26,118,144
95527,2021-12-16,7,62,277,339
95528,2021-12-16,8,139,450,589
95529,2021-12-16,9,110,331,441
95530,2021-12-16,10,86,224,310
95531,2021-12-16,11,138,222,360
95532,2021-12-16,12,141,293,434
95533,2021-12-16,13,167,266,433
95534,2021-12-16,14,204,312,516
95535,2021-12-16,15,220,359,579
95536,2021-12-16,16,239,491,730
95537,2021-12-16,17,239,567,806
95538,2021-12-16,18,212,523,735
95539,2021-12-16,19,137,329,466
95540,2021-12-16,20,111,248,359
95541,2021-12-16,21,103,168,271
95542,2021-12-16,22,106,155,261
95543,2021-12-16,23,72,117,189
95544,2021-12-17,0,23,56,79
95545,2021-12-17,1,19,33,52
95546,2021-12-17,2,16,9,25
95547,2021-12-17,3,6,7,13
95548,2021-12-17,4,10,13,23
95549,2021-12-17,5,15,27,42
95550,2021-12-17,6,34,108,142
95551,2021-12-17,7,75,248,323
95552,2021-12-17,8,92,394,486
95553,2021-12-17,9,92,314,406
95554,2021-12-17,10,95,229,324
95555,2021-12-17,11,149,301,450
95556,2021-12-17,12,194,297,491
95557,2021-12-17,13,182,344,526
95558,2021-12-17,14,220,385,605
95559,2021-12-17,15,214,385,599
95560,2021-12-17,16,227,455,682
95561,2021-12-17,17,195,463,658
95562,2021-12-17,18,152,393,545
95563,2021-12-17,19,141,261,402
95564,2021-12-17,20,114,174,288
95565,2021-12-17,21,86,152,238
95566,2021-12-17,22,68,127,195
95567,2021-12-17,23,61,133,194
95568,2021-12-18,0,53,50,103
95569,2021-12-18,1,33,58,91
95570,2021-12-18,2,26,45,71
95571,2021-12-18,3,27,21,48
95572,2021-12-18,4,13,15,28
95573,2021-12-18,5,8,7,15
95574,2021-12-18,6,14,34,48
95575,2021-12-18,7,28,90,118
95576,2021-12-18,8,60,149,209
95577,2021-12-18,9,141,254,395
95578,2021-12-18,10,201,293,494
95579,2021-12-18,11,251,340,591
95580,2021-12-18,12,261,356,617
95581,2021-12-18,13,324,334,658
95582,2021-12-18,14,253,326,579
95583,2021-12-18,15,177,335,512
95584,2021-12-18,16,149,248,397
95585,2021-12-18,17,140,243,383
95586,2021-12-18,18,124,201,325
95587,2021-12-18,19,120,169,289
95588,2021-12-18,20,81,153,234
95589,2021-12-18,21,90,103,193
95590,2021-12-18,22,73,107,180
95591,2021-12-18,23,70,99,169
95592,2021-12-19,0,74,63,137
95593,2021-12-19,1,33,42,75
95594,2021-12-19,2,34,34,68
95595,2021-12-19,3,22,25,47
95596,2021-12-19,4,14,6,20
95597,2021-12-19,5,10,13,23
95598,2021-12-19,6,16,28,44
95599,2021-12-19,7,14,34,48
95600,2021-12-19,8,33,81,114
95601,2021-12-19,9,47,129,176
95602,2021-12-19,10,136,185,321
95603,2021-12-19,11,122,253,375
95604,2021-12-19,12,175,300,475
95605,2021-12-19,13,182,279,461
95606,2021-12-19,14,153,290,443
95607,2021-12-19,15,164,272,436
95608,2021-12-19,16,141,268,409
95609,2021-12-19,17,122,201,323
95610,2021-12-19,18,72,142,214
95611,2021-12-19,19,65,109,174
95612,2021-12-19,20,39,80,119
95613,2021-12-19,21,37,71,108
95614,2021-12-19,22,45,62,107
95615,2021-12-19,23,19,33,52
95616,2021-12-20,0,6,12,18
95617,2021-12-20,1,6,8,14
95618,2021-12-20,2,1,7,8
95619,2021-12-20,3,1,3,4
95620,2021-12-20,4,1,8,9
95621,2021-12-20,5,9,20,29
95622,2021-12-20,6,16,84,100
95623,2021-12-20,7,32,160,192
95624,2021-12-20,8,57,246,303
95625,2021-12-20,9,41,211,252
95626,2021-12-20,10,58,176,234
95627,2021-12-20,11,112,176,288
95628,2021-12-20,12,114,228,342
95629,2021-12-20,13,124,197,321
95630,2021-12-20,14,141,234,375
95631,2021-12-20,15,139,271,410
95632,2021-12-20,16,118,310,428
95633,2021-12-20,17,104,315,419
95634,2021-12-20,18,77,259,336
95635,2021-12-20,19,81,166,247
95636,2021-12-20,20,53,95,148
95637,2021-12-20,21,28,70,98
95638,2021-12-20,22,23,40,63
95639,2021-12-20,23,18,20,38
95640,2021-12-21,0,10,9,19
95641,2021-12-21,1,3,5,8
95642,2021-12-21,2,5,2,7
95643,2021-12-21,3,0,2,2
95644,2021-12-21,4,2,11,13
95645,2021-12-21,5,5,22,27
95646,2021-12-21,6,24,71,95
95647,2021-12-21,7,36,176,212
95648,2021-12-21,8,52,215,267
95649,2021-12-21,9,53,184,237
95650,2021-12-21,10,68,175,243
95651,2021-12-21,11,106,198,304
95652,2021-12-21,12,103,203,306
95653,2021-12-21,13,98,179,277
95654,2021-12-21,14,118,205,323
95655,2021-12-21,15,140,236,376
95656,2021-12-21,16,101,275,376
95657,2021-12-21,17,100,309,409
95658,2021-12-21,18,80,252,332
95659,2021-12-21,19,37,138,175
95660,2021-12-21,20,35,64,99
95661,2021-12-21,21,11,61,72
95662,2021-12-21,22,18,48,66
95663,2021-12-21,23,4,21,25
95664,2021-12-22,0,1,12,13
95665,2021-12-22,1,3,2,5
95666,2021-12-22,2,12,6,18
95667,2021-12-22,3,4,1,5
95668,2021-12-22,4,4,7,11
95669,2021-12-22,5,6,15,21
95670,2021-12-22,6,19,61,80
95671,2021-12-22,7,34,132,166
95672,2021-12-22,8,42,161,203
95673,2021-12-22,9,58,167,225
95674,2021-12-22,10,84,175,259
95675,2021-12-22,11,107,194,301
95676,2021-12-22,12,99,206,305
95677,2021-12-22,13,123,233,356
95678,2021-12-22,14,147,235,382
95679,2021-12-22,15,150,253,403
95680,2021-12-22,16,126,277,403
95681,2021-12-22,17,88,239,327
95682,2021-12-22,18,45,209,254
95683,2021-12-22,19,32,144,176
95684,2021-12-22,20,33,83,116
95685,2021-12-22,21,36,64,100
95686,2021-12-22,22,27,55,82
95687,2021-12-22,23,13,27,40
95688,2021-12-23,0,11,13,24
95689,2021-12-23,1,8,7,15
95690,2021-12-23,2,4,11,15
95691,2021-12-23,3,3,2,5
95692,2021-12-23,4,5,9,14
95693,2021-12-23,5,4,12,16
95694,2021-12-23,6,14,48,62
95695,2021-12-23,7,22,92,114
95696,2021-12-23,8,33,89,122
95697,2021-12-23,9,55,131,186
95698,2021-12-23,10,72,137,209
95699,2021-12-23,11,74,151,225
95700,2021-12-23,12,104,179,283
95701,2021-12-23,13,93,216,309
95702,2021-12-23,14,137,228,365
95703,2021-12-23,15,141,239,380
95704,2021-12-23,16,120,238,358
95705,2021-12-23,17,74,194,268
95706,2021-12-23,18,49,160,209
95707,2021-12-23,19,48,118,166
95708,2021-12-23,20,41,67,108
95709,2021-12-23,21,25,55,80
95710,2021-12-23,22,26,46,72
95711,2021-12-23,23,26,29,55
95712,2021-12-24,0,14,16,30
95713,2021-12-24,1,6,11,17
95714,2021-12-24,2,9,6,15
95715,2021-12-24,3,1,1,2
95716,2021-12-24,4,6,3,9
95717,2021-12-24,5,2,12,14
95718,2021-12-24,6,15,29,44
95719,2021-12-24,7,9,41,50
95720,2021-12-24,8,17,61,78
95721,2021-12-24,9,32,106,138
95722,2021-12-24,10,86,124,210
95723,2021-12-24,11,95,181,276
95724,2021-12-24,12,142,178,320
95725,2021-12-24,13,137,204,341
95726,2021-12-24,14,183,240,423
95727,2021-12-24,15,181,188,369
95728,2021-12-24,16,116,144,260
95729,2021-12-24,17,77,125,202
95730,2021-12-24,18,60,107,167
95731,2021-12-24,19,31,69,100
95732,2021-12-24,20,27,54,81
95733,2021-12-24,21,23,53,76
95734,2021-12-24,22,20,27,47
95735,2021-12-24,23,21,26,47
95736,2021-12-25,0,13,18,31
95737,2021-12-25,1,12,8,20
95738,2021-12-25,2,6,9,15
95739,2021-12-25,3,2,2,4
95740,2021-12-25,4,3,5,8
95741,2021-12-25,5,3,7,10
95742,2021-12-25,6,3,15,18
95743,2021-12-25,7,9,21,30
95744,2021-12-25,8,18,34,52
95745,2021-12-25,9,33,48,81
95746,2021-12-25,10,64,66,130
95747,2021-12-25,11,129,86,215
95748,2021-12-25,12,186,107,293
95749,2021-12-25,13,221,142,363
95750,2021-12-25,14,294,186,480
95751,2021-12-25,15,291,134,425
95752,2021-12-25,16,201,135,336
95753,2021-12-25,17,148,109,257
95754,2021-12-25,18,82,51,133
95755,2021-12-25,19,61,39,100
95756,2021-12-25,20,33,19,52
95757,2021-12-25,21,21,25,46
95758,2021-12-25,22,17,23,40
95759,2021-12-25,23,25,19,44
95760,2021-12-26,0,19,12,31
95761,2021-12-26,1,6,5,11
95762,2021-12-26,2,4,5,9
95763,2021-12-26,3,7,6,13
95764,2021-12-26,4,1,4,5
95765,2021-12-26,5,5,8,13
95766,2021-12-26,6,9,19,28
95767,2021-12-26,7,19,20,39
95768,2021-12-26,8,42,48,90
95769,2021-12-26,9,95,106,201
95770,2021-12-26,10,134,101,235
95771,2021-12-26,11,198,155,353
95772,2021-12-26,12,246,205,451
95773,2021-12-26,13,296,194,490
95774,2021-12-26,14,288,221,509
95775,2021-12-26,15,295,212,507
95776,2021-12-26,16,266,212,478
95777,2021-12-26,17,163,158,321
95778,2021-12-26,18,90,118,208
95779,2021-12-26,19,71,102,173
95780,2021-12-26,20,73,48,121
95781,2021-12-26,21,37,48,85
95782,2021-12-26,22,40,31,71
95783,2021-12-26,23,31,32,63
95784,2021-12-27,0,14,11,25
95785,2021-12-27,1,6,6,12
95786,2021-12-27,2,12,5,17
95787,2021-12-27,3,3,2,5
95788,2021-12-27,4,3,2,5
95789,2021-12-27,5,6,17,23
95790,2021-12-27,6,11,39,50
95791,2021-12-27,7,24,76,100
95792,2021-12-27,8,34,103,137
95793,2021-12-27,9,37,84,121
95794,2021-12-27,10,74,98,172
95795,2021-12-27,11,115,123,238
95796,2021-12-27,12,91,128,219
95797,2021-12-27,13,81,119,200
95798,2021-12-27,14,113,163,276
95799,2021-12-27,15,121,126,247
95800,2021-12-27,16,99,177,276
95801,2021-12-27,17,98,202,300
95802,2021-12-27,18,79,144,223
95803,2021-12-27,19,48,120,168
95804,2021-12-27,20,51,59,110
95805,2021-12-27,21,28,56,84
95806,2021-12-27,22,27,40,67
95807,2021-12-27,23,14,33,47
95808,2021-12-28,0,7,7,14
95809,2021-12-28,1,5,5,10
95810,2021-12-28,2,1,2,3
95811,2021-12-28,3,3,0,3
95812,2021-12-28,4,2,6,8
95813,2021-12-28,5,11,14,25
95814,2021-12-28,6,15,60,75
95815,2021-12-28,7,11,89,100
95816,2021-12-28,8,53,139,192
95817,2021-12-28,9,78,107,185
95818,2021-12-28,10,132,164,296
95819,2021-12-28,11,198,179,377
95820,2021-12-28,12,204,184,388
95821,2021-12-28,13,258,209,467
95822,2021-12-28,14,243,218,461
95823,2021-12-28,15,311,249,560
95824,2021-12-28,16,273,230,503
95825,2021-12-28,17,158,243,401
95826,2021-12-28,18,135,174,309
95827,2021-12-28,19,83,125,208
95828,2021-12-28,20,70,79,149
95829,2021-12-28,21,55,43,98
95830,2021-12-28,22,44,46,90
95831,2021-12-28,23,37,33,70
95832,2021-12-29,0,8,12,20
95833,2021-12-29,1,5,7,12
95834,2021-12-29,2,7,8,15
95835,2021-12-29,3,1,0,1
95836,2021-12-29,4,4,12,16
95837,2021-12-29,5,8,13,21
95838,2021-12-29,6,16,54,70
95839,2021-12-29,7,28,93,121
95840,2021-12-29,8,56,119,175
95841,2021-12-29,9,81,111,192
95842,2021-12-29,10,152,136,288
95843,2021-12-29,11,172,178,350
95844,2021-12-29,12,214,240,454
95845,2021-12-29,13,204,201,405
95846,2021-12-29,14,242,239,481
95847,2021-12-29,15,259,259,518
95848,2021-12-29,16,185,263,448
95849,2021-12-29,17,141,200,341
95850,2021-12-29,18,60,132,192
95851,2021-12-29,19,26,56,82
95852,2021-12-29,20,22,46,68
95853,2021-12-29,21,29,42,71
95854,2021-12-29,22,28,40,68
95855,2021-12-29,23,26,36,62
95856,2021-12-30,0,6,5,11
95857,2021-12-30,1,6,6,12
95858,2021-12-30,2,7,5,12
95859,2021-12-30,3,3,5,8
95860,2021-12-30,4,6,7,13
95861,2021-12-30,5,6,15,21
95862,2021-12-30,6,9,46,55
95863,2021-12-30,7,25,68,93
95864,2021-12-30,8,25,79,104
95865,2021-12-30,9,68,83,151
95866,2021-12-30,10,115,136,251
95867,2021-12-30,11,153,158,311
95868,2021-12-30,12,172,199,371
95869,2021-12-30,13,200,230,430
95870,2021-12-30,14,251,232,483
95871,2021-12-30,15,257,247,504
95872,2021-12-30,16,201,295,496
95873,2021-12-30,17,178,227,405
95874,2021-12-30,18,104,198,302
95875,2021-12-30,19,60,122,182
95876,2021-12-30,20,63,101,164
95877,2021-12-30,21,59,86,145
95878,2021-12-30,22,55,58,113
95879,2021-12-30,23,44,43,87
95880,2021-12-31,0,19,29,48
95881,2021-12-31,1,17,20,37
95882,2021-12-31,2,17,7,24
95883,2021-12-31,3,7,2,9
95884,2021-12-31,4,12,9,21
95885,2021-12-31,5,5,12,17
95886,2021-12-31,6,15,34,49
95887,2021-12-31,7,22,52,74
95888,2021-12-31,8,31,69,100
95889,2021-12-31,9,67,129,196
95890,2021-12-31,10,127,175,302
95891,2021-12-31,11,225,257,482
95892,2021-12-31,12,243,295,538
95893,2021-12-31,13,307,300,607
95894,2021-12-31,14,315,317,632
95895,2021-12-31,15,327,326,653
95896,2021-12-31,16,291,246,537
95897,2021-12-31,17,181,177,358
95898,2021-12-31,18,144,133,277
95899,2021-12-31,19,112,117,229
95900,2021-12-31,20,67,72,139
95901,2021-12-31,21,49,65,114
95902,2021-12-31,22,71,55,126
95903,2021-12-31,23,72,46,118
95904,2022-01-01,0,125,63,188
95905,2022-01-01,1,122,79,201
95906,2022-01-01,2,98,58,156
95907,2022-01-01,3,28,22,50
95908,2022-01-01,4,23,9,32
95909,2022-01-01,5,14,16,30
95910,2022-01-01,6,11,22,33
95911,2022-01-01,7,6,11,17
95912,2022-01-01,8,9,18,27
95913,2022-01-01,9,5,25,30
95914,2022-01-01,10,18,34,52
95915,2022-01-01,11,23,37,60
95916,2022-01-01,12,35,69,104
95917,2022-01-01,13,82,98,180
95918,2022-01-01,14,168,138,306
95919,2022-01-01,15,244,196,440
95920,2022-01-01,16,212,194,406
95921,2022-01-01,17,143,148,291
95922,2022-01-01,18,119,127,246
95923,2022-01-01,19,114,104,218
95924,2022-01-01,20,67,71,138
95925,2022-01-01,21,45,55,100
95926,2022-01-01,22,28,32,60
95927,2022-01-01,23,49,38,87
95928,2022-01-02,0,34,29,63
95929,2022-01-02,1,9,13,22
95930,2022-01-02,2,9,9,18
95931,2022-01-02,3,2,7,9
95932,2022-01-02,4,2,6,8
95933,2022-01-02,5,6,8,14
95934,2022-01-02,6,13,5,18
95935,2022-01-02,7,16,34,50
95936,2022-01-02,8,28,65,93
95937,2022-01-02,9,62,139,201
95938,2022-01-02,10,134,187,321
95939,2022-01-02,11,184,275,459
95940,2022-01-02,12,259,331,590
95941,2022-01-02,13,253,315,568
95942,2022-01-02,14,291,299,590
95943,2022-01-02,15,309,332,641
95944,2022-01-02,16,227,283,510
95945,2022-01-02,17,187,229,416
95946,2022-01-02,18,129,171,300
95947,2022-01-02,19,79,103,182
95948,2022-01-02,20,51,66,117
95949,2022-01-02,21,49,64,113
95950,2022-01-02,22,40,39,79
95951,2022-01-02,23,16,21,37
95952,2022-01-03,0,12,6,18
95953,2022-01-03,1,2,8,10
95954,2022-01-03,2,2,6,8
95955,2022-01-03,3,2,2,4
95956,2022-01-03,4,3,4,7
95957,2022-01-03,5,5,11,16
95958,2022-01-03,6,10,34,44
95959,2022-01-03,7,4,26,30
95960,2022-01-03,8,6,19,25
95961,2022-01-03,9,4,18,22
95962,2022-01-03,10,7,2,9
95963,2022-01-03,11,5,8,13
95964,2022-01-03,12,9,13,22
95965,2022-01-03,13,10,11,21
95966,2022-01-03,14,9,8,17
95967,2022-01-03,15,16,23,39
95968,2022-01-03,16,15,26,41
95969,2022-01-03,17,9,25,34
95970,2022-01-03,18,11,21,32
95971,2022-01-03,19,6,12,18
95972,2022-01-03,20,8,9,17
95973,2022-01-03,21,10,17,27
95974,2022-01-03,22,5,7,12
95975,2022-01-03,23,4,7,11
95976,2022-01-04,0,5,3,8
95977,2022-01-04,1,4,0,4
95978,2022-01-04,3,2,2,4
95979,2022-01-04,4,0,5,5
95980,2022-01-04,5,4,2,6
95981,2022-01-04,6,4,18,22
95982,2022-01-04,7,3,24,27
95983,2022-01-04,8,12,25,37
95984,2022-01-04,9,8,38,46
95985,2022-01-04,10,13,20,33
95986,2022-01-04,11,19,39,58
95987,2022-01-04,12,19,60,79
95988,2022-01-04,13,33,69,102
95989,2022-01-04,14,43,49,92
95990,2022-01-04,15,28,72,100
95991,2022-01-04,16,35,83,118
95992,2022-01-04,17,39,118,157
95993,2022-01-04,18,38,91,129
95994,2022-01-04,19,20,60,80
95995,2022-01-04,20,11,41,52
95996,2022-01-04,21,7,19,26
95997,2022-01-04,22,13,35,48
95998,2022-01-04,23,9,15,24
95999,2022-01-05,0,5,6,11
96000,2022-01-05,1,4,0,4
96001,2022-01-05,2,2,0,2
96002,2022-01-05,3,3,1,4
96003,2022-01-05,4,2,6,8
96004,2022-01-05,5,7,14,21
96005,2022-01-05,6,8,30,38
96006,2022-01-05,7,13,50,63
96007,2022-01-05,8,17,80,97
96008,2022-01-05,9,31,70,101
96009,2022-01-05,10,25,77,102
96010,2022-01-05,11,23,71,94
96011,2022-01-05,12,29,76,105
96012,2022-01-05,13,37,97,134
96013,2022-01-05,14,48,107,155
96014,2022-01-05,15,56,124,180
96015,2022-01-05,16,50,137,187
96016,2022-01-05,17,54,186,240
96017,2022-01-05,18,45,158,203
96018,2022-01-05,19,38,146,184
96019,2022-01-05,20,37,74,111
96020,2022-01-05,21,31,65,96
96021,2022-01-05,22,23,55,78
96022,2022-01-05,23,22,25,47
96023,2022-01-06,0,12,8,20
96024,2022-01-06,1,2,8,10
96025,2022-01-06,2,2,7,9
96026,2022-01-06,3,0,5,5
96027,2022-01-06,4,5,5,10
96028,2022-01-06,5,2,19,21
96029,2022-01-06,6,19,62,81
96030,2022-01-06,7,27,126,153
96031,2022-01-06,8,50,160,210
96032,2022-01-06,9,36,142,178
96033,2022-01-06,10,34,94,128
96034,2022-01-06,11,65,139,204
96035,2022-01-06,12,84,165,249
96036,2022-01-06,13,83,156,239
96037,2022-01-06,14,84,187,271
96038,2022-01-06,15,96,202,298
96039,2022-01-06,16,86,243,329
96040,2022-01-06,17,120,278,398
96041,2022-01-06,18,85,253,338
96042,2022-01-06,19,44,161,205
96043,2022-01-06,20,49,91,140
96044,2022-01-06,21,27,71,98
96045,2022-01-06,22,29,73,102
96046,2022-01-06,23,14,37,51
96047,2022-01-07,0,15,19,34
96048,2022-01-07,1,7,6,13
96049,2022-01-07,2,5,2,7
96050,2022-01-07,3,6,5,11
96051,2022-01-07,4,1,3,4
96052,2022-01-07,5,5,11,16
96053,2022-01-07,6,10,26,36
96054,2022-01-07,7,10,40,50
96055,2022-01-07,8,17,59,76
96056,2022-01-07,9,11,52,63
96057,2022-01-07,10,25,56,81
96058,2022-01-07,11,38,78,116
96059,2022-01-07,12,48,81,129
96060,2022-01-07,13,58,109,167
96061,2022-01-07,14,40,116,156
96062,2022-01-07,15,52,135,187
96063,2022-01-07,16,54,167,221
96064,2022-01-07,17,61,167,228
96065,2022-01-07,18,57,149,206
96066,2022-01-07,19,44,109,153
96067,2022-01-07,20,27,48,75
96068,2022-01-07,21,28,46,74
96069,2022-01-07,22,17,65,82
96070,2022-01-07,23,15,35,50
96071,2022-01-08,0,16,36,52
96072,2022-01-08,1,12,8,20
96073,2022-01-08,2,12,11,23
96074,2022-01-08,3,12,21,33
96075,2022-01-08,4,4,5,9
96076,2022-01-08,5,2,7,9
96077,2022-01-08,6,8,20,28
96078,2022-01-08,7,8,30,38
96079,2022-01-08,8,13,48,61
96080,2022-01-08,9,33,116,149
96081,2022-01-08,10,52,158,210
96082,2022-01-08,11,70,193,263
96083,2022-01-08,12,83,182,265
96084,2022-01-08,13,85,208,293
96085,2022-01-08,14,113,226,339
96086,2022-01-08,15,119,222,341
96087,2022-01-08,16,111,183,294
96088,2022-01-08,17,72,163,235
96089,2022-01-08,18,60,151,211
96090,2022-01-08,19,42,105,147
96091,2022-01-08,20,19,74,93
96092,2022-01-08,21,21,37,58
96093,2022-01-08,22,26,56,82
96094,2022-01-08,23,31,34,65
96095,2022-01-09,0,20,35,55
96096,2022-01-09,1,20,24,44
96097,2022-01-09,2,10,18,28
96098,2022-01-09,3,7,13,20
96099,2022-01-09,4,3,13,16
96100,2022-01-09,5,8,6,14
96101,2022-01-09,6,14,12,26
96102,2022-01-09,7,9,37,46
96103,2022-01-09,8,23,83,106
96104,2022-01-09,9,25,121,146
96105,2022-01-09,10,67,197,264
96106,2022-01-09,11,41,125,166
96107,2022-01-09,12,36,99,135
96108,2022-01-09,13,22,67,89
96109,2022-01-09,14,10,45,55
96110,2022-01-09,15,12,48,60
96111,2022-01-09,16,18,60,78
96112,2022-01-09,17,10,47,57
96113,2022-01-09,18,18,53,71
96114,2022-01-09,19,14,43,57
96115,2022-01-09,20,14,47,61
96116,2022-01-09,21,27,44,71
96117,2022-01-09,22,25,35,60
96118,2022-01-09,23,9,30,39
96119,2022-01-10,0,8,20,28
96120,2022-01-10,1,3,3,6
96121,2022-01-10,2,2,7,9
96122,2022-01-10,3,3,1,4
96123,2022-01-10,4,2,9,11
96124,2022-01-10,5,7,21,28
96125,2022-01-10,6,18,65,83
96126,2022-01-10,7,38,152,190
96127,2022-01-10,8,55,207,262
96128,2022-01-10,9,49,137,186
96129,2022-01-10,10,40,110,150
96130,2022-01-10,11,49,148,197
96131,2022-01-10,12,63,184,247
96132,2022-01-10,13,59,153,212
96133,2022-01-10,14,65,137,202
96134,2022-01-10,15,113,214,327
96135,2022-01-10,16,100,264,364
96136,2022-01-10,17,103,304,407
96137,2022-01-10,18,61,249,310
96138,2022-01-10,19,70,184,254
96139,2022-01-10,20,33,116,149
96140,2022-01-10,21,28,77,105
96141,2022-01-10,22,28,58,86
96142,2022-01-10,23,17,28,45
96143,2022-01-11,0,9,21,30
96144,2022-01-11,1,4,6,10
96145,2022-01-11,2,3,3,6
96146,2022-01-11,3,1,2,3
96147,2022-01-11,4,0,10,10
96148,2022-01-11,5,12,23,35
96149,2022-01-11,6,13,74,87
96150,2022-01-11,7,41,169,210
96151,2022-01-11,8,55,215,270
96152,2022-01-11,9,30,148,178
96153,2022-01-11,10,34,102,136
96154,2022-01-11,11,36,113,149
96155,2022-01-11,12,47,128,175
96156,2022-01-11,13,49,139,188
96157,2022-01-11,14,54,147,201
96158,2022-01-11,15,65,146,211
96159,2022-01-11,16,63,196,259
96160,2022-01-11,17,86,277,363
96161,2022-01-11,18,58,222,280
96162,2022-01-11,19,44,165,209
96163,2022-01-11,20,35,92,127
96164,2022-01-11,21,22,77,99
96165,2022-01-11,22,17,53,70
96166,2022-01-11,23,6,25,31
96167,2022-01-12,0,4,7,11
96168,2022-01-12,1,5,11,16
96169,2022-01-12,2,0,2,2
96170,2022-01-12,3,2,0,2
96171,2022-01-12,4,3,4,7
96172,2022-01-12,5,10,32,42
96173,2022-01-12,6,16,83,99
96174,2022-01-12,7,35,194,229
96175,2022-01-12,8,60,241,301
96176,2022-01-12,9,47,141,188
96177,2022-01-12,10,37,115,152
96178,2022-01-12,11,60,115,175
96179,2022-01-12,12,77,174,251
96180,2022-01-12,13,88,161,249
96181,2022-01-12,14,84,199,283
96182,2022-01-12,15,87,251,338
96183,2022-01-12,16,94,271,365
96184,2022-01-12,17,104,358,462
96185,2022-01-12,18,114,323,437
96186,2022-01-12,19,82,228,310
96187,2022-01-12,20,61,167,228
96188,2022-01-12,21,49,89,138
96189,2022-01-12,22,39,75,114
96190,2022-01-12,23,17,35,52
96191,2022-01-13,0,9,11,20
96192,2022-01-13,1,4,8,12
96193,2022-01-13,2,2,5,7
96194,2022-01-13,3,0,2,2
96195,2022-01-13,4,2,10,12
96196,2022-01-13,5,13,23,36
96197,2022-01-13,6,23,83,106
96198,2022-01-13,7,49,166,215
96199,2022-01-13,8,66,290,356
96200,2022-01-13,9,63,180,243
96201,2022-01-13,10,57,143,200
96202,2022-01-13,11,60,152,212
96203,2022-01-13,12,104,236,340
96204,2022-01-13,13,98,205,303
96205,2022-01-13,14,120,219,339
96206,2022-01-13,15,125,276,401
96207,2022-01-13,16,111,292,403
96208,2022-01-13,17,135,353,488
96209,2022-01-13,18,111,336,447
96210,2022-01-13,19,78,225,303
96211,2022-01-13,20,50,123,173
96212,2022-01-13,21,55,118,173
96213,2022-01-13,22,52,77,129
96214,2022-01-13,23,37,45,82
96215,2022-01-14,0,14,31,45
96216,2022-01-14,1,11,18,29
96217,2022-01-14,2,7,4,11
96218,2022-01-14,3,5,5,10
96219,2022-01-14,4,2,12,14
96220,2022-01-14,5,11,14,25
96221,2022-01-14,6,21,92,113
96222,2022-01-14,7,46,178,224
96223,2022-01-14,8,62,236,298
96224,2022-01-14,9,66,172,238
96225,2022-01-14,10,59,135,194
96226,2022-01-14,11,78,162,240
96227,2022-01-14,12,112,233,345
96228,2022-01-14,13,115,210,325
96229,2022-01-14,14,119,227,346
96230,2022-01-14,15,137,270,407
96231,2022-01-14,16,132,309,441
96232,2022-01-14,17,140,367,507
96233,2022-01-14,18,95,294,389
96234,2022-01-14,19,93,201,294
96235,2022-01-14,20,51,113,164
96236,2022-01-14,21,44,79,123
96237,2022-01-14,22,49,80,129
96238,2022-01-14,23,36,62,98
96239,2022-01-15,0,18,39,57
96240,2022-01-15,1,20,33,53
96241,2022-01-15,2,13,22,35
96242,2022-01-15,3,2,12,14
96243,2022-01-15,4,4,8,12
96244,2022-01-15,5,8,5,13
96245,2022-01-15,6,9,22,31
96246,2022-01-15,7,15,49,64
96247,2022-01-15,8,15,90,105
96248,2022-01-15,9,42,116,158
96249,2022-01-15,10,76,164,240
96250,2022-01-15,11,94,206,300
96251,2022-01-15,12,104,218,322
96252,2022-01-15,13,101,213,314
96253,2022-01-15,14,88,190,278
96254,2022-01-15,15,111,231,342
96255,2022-01-15,16,115,183,298
96256,2022-01-15,17,70,158,228
96257,2022-01-15,18,43,127,170
96258,2022-01-15,19,51,102,153
96259,2022-01-15,20,30,71,101
96260,2022-01-15,21,15,41,56
96261,2022-01-15,22,37,43,80
96262,2022-01-15,23,21,55,76
96263,2022-01-16,0,16,32,48
96264,2022-01-16,1,12,27,39
96265,2022-01-16,2,10,11,21
96266,2022-01-16,3,4,9,13
96267,2022-01-16,4,4,5,9
96268,2022-01-16,5,3,7,10
96269,2022-01-16,6,6,7,13
96270,2022-01-16,7,6,29,35
96271,2022-01-16,8,13,59,72
96272,2022-01-16,9,26,111,137
96273,2022-01-16,10,36,130,166
96274,2022-01-16,11,57,167,224
96275,2022-01-16,12,67,195,262
96276,2022-01-16,13,55,186,241
96277,2022-01-16,14,36,71,107
96278,2022-01-16,15,10,51,61
96279,2022-01-16,16,12,28,40
96280,2022-01-16,17,11,22,33
96281,2022-01-16,18,4,14,18
96282,2022-01-16,19,5,12,17
96283,2022-01-16,20,6,9,15
96284,2022-01-16,21,3,8,11
96285,2022-01-16,22,3,5,8
96286,2022-01-16,23,7,6,13
96287,2022-01-17,0,4,7,11
96288,2022-01-17,1,3,5,8
96289,2022-01-17,2,1,3,4
96290,2022-01-17,3,2,1,3
96291,2022-01-17,4,0,2,2
96292,2022-01-17,5,2,5,7
96293,2022-01-17,6,3,15,18
96294,2022-01-17,7,6,29,35
96295,2022-01-17,8,9,48,57
96296,2022-01-17,9,26,78,104
96297,2022-01-17,10,26,79,105
96298,2022-01-17,11,67,126,193
96299,2022-01-17,12,65,175,240
96300,2022-01-17,13,60,159,219
96301,2022-01-17,14,65,171,236
96302,2022-01-17,15,63,171,234
96303,2022-01-17,16,60,200,260
96304,2022-01-17,17,39,197,236
96305,2022-01-17,18,44,164,208
96306,2022-01-17,19,26,121,147
96307,2022-01-17,20,27,73,100
96308,2022-01-17,21,17,50,67
96309,2022-01-17,22,15,42,57
96310,2022-01-17,23,13,19,32
96311,2022-01-18,0,4,9,13
96312,2022-01-18,1,2,11,13
96313,2022-01-18,2,2,1,3
96314,2022-01-18,3,1,2,3
96315,2022-01-18,4,1,8,9
96316,2022-01-18,5,9,30,39
96317,2022-01-18,6,18,95,113
96318,2022-01-18,7,43,175,218
96319,2022-01-18,8,63,294,357
96320,2022-01-18,9,43,177,220
96321,2022-01-18,10,40,130,170
96322,2022-01-18,11,48,136,184
96323,2022-01-18,12,50,149,199
96324,2022-01-18,13,32,148,180
96325,2022-01-18,14,64,170,234
96326,2022-01-18,15,76,219,295
96327,2022-01-18,16,79,255,334
96328,2022-01-18,17,89,338,427
96329,2022-01-18,18,83,335,418
96330,2022-01-18,19,62,207,269
96331,2022-01-18,20,31,125,156
96332,2022-01-18,21,34,109,143
96333,2022-01-18,22,32,52,84
96334,2022-01-18,23,16,31,47
96335,2022-01-19,0,9,17,26
96336,2022-01-19,1,4,15,19
96337,2022-01-19,2,5,4,9
96338,2022-01-19,3,4,4,8
96339,2022-01-19,4,3,3,6
96340,2022-01-19,5,11,28,39
96341,2022-01-19,6,25,103,128
96342,2022-01-19,7,44,205,249
96343,2022-01-19,8,74,318,392
96344,2022-01-19,9,46,177,223
96345,2022-01-19,10,32,149,181
96346,2022-01-19,11,50,140,190
96347,2022-01-19,12,67,230,297
96348,2022-01-19,13,74,180,254
96349,2022-01-19,14,83,203,286
96350,2022-01-19,15,105,306,411
96351,2022-01-19,16,111,285,396
96352,2022-01-19,17,131,437,568
96353,2022-01-19,18,118,420,538
96354,2022-01-19,19,84,255,339
96355,2022-01-19,20,70,167,237
96356,2022-01-19,21,72,138,210
96357,2022-01-19,22,41,75,116
96358,2022-01-19,23,8,43,51
96359,2022-01-20,0,5,6,11
96360,2022-01-20,1,4,11,15
96361,2022-01-20,2,0,12,12
96362,2022-01-20,3,1,3,4
96363,2022-01-20,4,4,7,11
96364,2022-01-20,5,3,11,14
96365,2022-01-20,6,5,49,54
96366,2022-01-20,7,9,40,49
96367,2022-01-20,8,20,94,114
96368,2022-01-20,9,22,87,109
96369,2022-01-20,10,17,80,97
96370,2022-01-20,11,33,96,129
96371,2022-01-20,12,58,125,183
96372,2022-01-20,13,50,114,164
96373,2022-01-20,14,50,145,195
96374,2022-01-20,15,73,176,249
96375,2022-01-20,16,85,221,306
96376,2022-01-20,17,96,307,403
96377,2022-01-20,18,88,314,402
96378,2022-01-20,19,78,211,289
96379,2022-01-20,20,46,113,159
96380,2022-01-20,21,42,115,157
96381,2022-01-20,22,39,58,97
96382,2022-01-20,23,17,49,66
96383,2022-01-21,0,7,22,29
96384,2022-01-21,1,5,18,23
96385,2022-01-21,2,2,8,10
96386,2022-01-21,3,2,1,3
96387,2022-01-21,4,4,7,11
96388,2022-01-21,5,14,25,39
96389,2022-01-21,6,20,100,120
96390,2022-01-21,7,39,145,184
96391,2022-01-21,8,31,225,256
96392,2022-01-21,9,35,133,168
96393,2022-01-21,10,29,114,143
96394,2022-01-21,11,36,107,143
96395,2022-01-21,12,61,138,199
96396,2022-01-21,13,56,161,217
96397,2022-01-21,14,53,179,232
96398,2022-01-21,15,85,217,302
96399,2022-01-21,16,68,227,295
96400,2022-01-21,17,72,273,345
96401,2022-01-21,18,82,210,292
96402,2022-01-21,19,57,182,239
96403,2022-01-21,20,38,104,142
96404,2022-01-21,21,29,53,82
96405,2022-01-21,22,27,73,100
96406,2022-01-21,23,29,55,84
96407,2022-01-22,0,19,28,47
96408,2022-01-22,1,4,29,33
96409,2022-01-22,2,13,24,37
96410,2022-01-22,3,6,15,21
96411,2022-01-22,4,4,5,9
96412,2022-01-22,5,6,10,16
96413,2022-01-22,6,12,19,31
96414,2022-01-22,7,4,34,38
96415,2022-01-22,8,23,88,111
96416,2022-01-22,9,44,120,164
96417,2022-01-22,10,77,165,242
96418,2022-01-22,11,93,226,319
96419,2022-01-22,12,137,238,375
96420,2022-01-22,13,125,233,358
96421,2022-01-22,14,133,259,392
96422,2022-01-22,15,134,285,419
96423,2022-01-22,16,135,272,407
96424,2022-01-22,17,128,193,321
96425,2022-01-22,18,68,164,232
96426,2022-01-22,19,39,128,167
96427,2022-01-22,20,44,87,131
96428,2022-01-22,21,38,67,105
96429,2022-01-22,22,28,47,75
96430,2022-01-22,23,31,68,99
96431,2022-01-23,0,21,49,70
96432,2022-01-23,1,28,32,60
96433,2022-01-23,2,9,34,43
96434,2022-01-23,3,9,7,16
96435,2022-01-23,4,4,6,10
96436,2022-01-23,5,3,7,10
96437,2022-01-23,6,9,16,25
96438,2022-01-23,7,14,26,40
96439,2022-01-23,8,26,80,106
96440,2022-01-23,9,46,120,166
96441,2022-01-23,10,104,182,286
96442,2022-01-23,11,107,235,342
96443,2022-01-23,12,138,229,367
96444,2022-01-23,13,118,246,364
96445,2022-01-23,14,154,254,408
96446,2022-01-23,15,111,260,371
96447,2022-01-23,16,94,188,282
96448,2022-01-23,17,78,199,277
96449,2022-01-23,18,60,164,224
96450,2022-01-23,19,43,122,165
96451,2022-01-23,20,42,72,114
96452,2022-01-23,21,33,58,91
96453,2022-01-23,22,29,61,90
96454,2022-01-23,23,14,27,41
96455,2022-01-24,0,7,13,20
96456,2022-01-24,1,2,6,8
96457,2022-01-24,2,4,4,8
96458,2022-01-24,3,2,1,3
96459,2022-01-24,4,3,8,11
96460,2022-01-24,5,12,26,38
96461,2022-01-24,6,18,93,111
96462,2022-01-24,7,49,204,253
96463,2022-01-24,8,57,306,363
96464,2022-01-24,9,42,199,241
96465,2022-01-24,10,35,94,129
96466,2022-01-24,11,64,138,202
96467,2022-01-24,12,67,175,242
96468,2022-01-24,13,76,173,249
96469,2022-01-24,14,77,191,268
96470,2022-01-24,15,61,198,259
96471,2022-01-24,16,86,291,377
96472,2022-01-24,17,111,394,505
96473,2022-01-24,18,111,339,450
96474,2022-01-24,19,71,200,271
96475,2022-01-24,20,39,132,171
96476,2022-01-24,21,29,101,130
96477,2022-01-24,22,25,67,92
96478,2022-01-24,23,13,24,37
96479,2022-01-25,0,10,9,19
96480,2022-01-25,1,8,5,13
96481,2022-01-25,2,3,2,5
96482,2022-01-25,3,0,1,1
96483,2022-01-25,4,3,11,14
96484,2022-01-25,5,9,47,56
96485,2022-01-25,6,28,108,136
96486,2022-01-25,7,48,226,274
96487,2022-01-25,8,77,359,436
96488,2022-01-25,9,52,185,237
96489,2022-01-25,10,47,159,206
96490,2022-01-25,11,55,150,205
96491,2022-01-25,12,63,195,258
96492,2022-01-25,13,76,173,249
96493,2022-01-25,14,91,205,296
96494,2022-01-25,15,88,247,335
96495,2022-01-25,16,119,316,435
96496,2022-01-25,17,123,416,539
96497,2022-01-25,18,93,360,453
96498,2022-01-25,19,81,224,305
96499,2022-01-25,20,42,162,204
96500,2022-01-25,21,46,96,142
96501,2022-01-25,22,33,78,111
96502,2022-01-25,23,13,34,47
96503,2022-01-26,0,8,13,21
96504,2022-01-26,1,6,3,9
96505,2022-01-26,2,1,2,3
96506,2022-01-26,3,2,4,6
96507,2022-01-26,4,2,7,9
96508,2022-01-26,5,11,33,44
96509,2022-01-26,6,26,85,111
96510,2022-01-26,7,41,183,224
96511,2022-01-26,8,67,315,382
96512,2022-01-26,9,58,178,236
96513,2022-01-26,10,46,122,168
96514,2022-01-26,11,55,123,178
96515,2022-01-26,12,64,183,247
96516,2022-01-26,13,59,147,206
96517,2022-01-26,14,57,141,198
96518,2022-01-26,15,75,219,294
96519,2022-01-26,16,81,220,301
96520,2022-01-26,17,89,358,447
96521,2022-01-26,18,100,324,424
96522,2022-01-26,19,72,194,266
96523,2022-01-26,20,48,122,170
96524,2022-01-26,21,51,130,181
96525,2022-01-26,22,25,80,105
96526,2022-01-26,23,9,37,46
96527,2022-01-27,0,13,18,31
96528,2022-01-27,1,2,8,10
96529,2022-01-27,2,2,5,7
96530,2022-01-27,3,2,4,6
96531,2022-01-27,4,4,11,15
96532,2022-01-27,5,8,25,33
96533,2022-01-27,6,19,96,115
96534,2022-01-27,7,50,176,226
96535,2022-01-27,8,64,318,382
96536,2022-01-27,9,53,185,238
96537,2022-01-27,10,32,145,177
96538,2022-01-27,11,55,169,224
96539,2022-01-27,12,67,186,253
96540,2022-01-27,13,57,178,235
96541,2022-01-27,14,49,175,224
96542,2022-01-27,15,67,213,280
96543,2022-01-27,16,98,274,372
96544,2022-01-27,17,114,367,481
96545,2022-01-27,18,97,350,447
96546,2022-01-27,19,62,222,284
96547,2022-01-27,20,65,151,216
96548,2022-01-27,21,37,129,166
96549,2022-01-27,22,27,75,102
96550,2022-01-27,23,23,54,77
96551,2022-01-28,0,18,20,38
96552,2022-01-28,1,5,12,17
96553,2022-01-28,2,7,4,11
96554,2022-01-28,3,3,6,9
96555,2022-01-28,4,4,9,13
96556,2022-01-28,5,8,32,40
96557,2022-01-28,6,22,94,116
96558,2022-01-28,7,36,209,245
96559,2022-01-28,8,46,279,325
96560,2022-01-28,9,52,189,241
96561,2022-01-28,10,41,166,207
96562,2022-01-28,11,64,178,242
96563,2022-01-28,12,67,221,288
96564,2022-01-28,13,77,252,329
96565,2022-01-28,14,71,186,257
96566,2022-01-28,15,50,183,233
96567,2022-01-28,16,38,155,193
96568,2022-01-28,17,38,187,225
96569,2022-01-28,18,20,134,154
96570,2022-01-28,19,33,110,143
96571,2022-01-28,20,15,54,69
96572,2022-01-28,21,20,48,68
96573,2022-01-28,22,25,41,66
96574,2022-01-28,23,16,37,53
96575,2022-01-29,0,17,26,43
96576,2022-01-29,1,9,24,33
96577,2022-01-29,2,18,20,38
96578,2022-01-29,3,5,9,14
96579,2022-01-29,4,2,7,9
96580,2022-01-29,5,6,5,11
96581,2022-01-29,6,6,10,16
96582,2022-01-29,7,8,19,27
96583,2022-01-29,8,9,59,68
96584,2022-01-29,9,25,89,114
96585,2022-01-29,10,53,122,175
96586,2022-01-29,11,52,154,206
96587,2022-01-29,12,53,173,226
96588,2022-01-29,13,74,149,223
96589,2022-01-29,14,72,155,227
96590,2022-01-29,15,68,170,238
96591,2022-01-29,16,62,200,262
96592,2022-01-29,17,49,165,214
96593,2022-01-29,18,41,118,159
96594,2022-01-29,19,41,117,158
96595,2022-01-29,20,20,57,77
96596,2022-01-29,21,12,46,58
96597,2022-01-29,22,19,40,59
96598,2022-01-29,23,22,43,65
96599,2022-01-30,0,24,44,68
96600,2022-01-30,1,11,28,39
96601,2022-01-30,2,10,21,31
96602,2022-01-30,3,9,11,20
96603,2022-01-30,4,5,5,10
96604,2022-01-30,5,3,8,11
96605,2022-01-30,6,3,15,18
96606,2022-01-30,7,5,23,28
96607,2022-01-30,8,15,52,67
96608,2022-01-30,9,35,77,112
96609,2022-01-30,10,45,159,204
96610,2022-01-30,11,48,160,208
96611,2022-01-30,12,66,214,280
96612,2022-01-30,13,88,200,288
96613,2022-01-30,14,79,225,304
96614,2022-01-30,15,109,219,328
96615,2022-01-30,16,81,159,240
96616,2022-01-30,17,61,140,201
96617,2022-01-30,18,58,159,217
96618,2022-01-30,19,30,87,117
96619,2022-01-30,20,21,77,98
96620,2022-01-30,21,26,68,94
96621,2022-01-30,22,16,58,74
96622,2022-01-30,23,11,10,21
96623,2022-01-31,0,8,10,18
96624,2022-01-31,1,1,10,11
96625,2022-01-31,2,2,3,5
96626,2022-01-31,3,6,2,8
96627,2022-01-31,4,3,7,10
96628,2022-01-31,5,10,32,42
96629,2022-01-31,6,15,88,103
96630,2022-01-31,7,33,186,219
96631,2022-01-31,8,58,303,361
96632,2022-01-31,9,32,209,241
96633,2022-01-31,10,45,128,173
96634,2022-01-31,11,43,142,185
96635,2022-01-31,12,58,163,221
96636,2022-01-31,13,39,177,216
96637,2022-01-31,14,58,189,247
96638,2022-01-31,15,78,225,303
96639,2022-01-31,16,75,236,311
96640,2022-01-31,17,93,394,487
96641,2022-01-31,18,62,320,382
96642,2022-01-31,19,51,217,268
96643,2022-01-31,20,23,151,174
96644,2022-01-31,21,37,119,156
96645,2022-01-31,22,25,65,90
96646,2022-01-31,23,16,21,37
96647,2022-02-01,0,5,12,17
96648,2022-02-01,1,8,4,12
96649,2022-02-01,2,1,2,3
96650,2022-02-01,3,1,2,3
96651,2022-02-01,4,3,9,12
96652,2022-02-01,5,10,42,52
96653,2022-02-01,6,23,115,138
96654,2022-02-01,7,42,232,274
96655,2022-02-01,8,67,360,427
96656,2022-02-01,9,49,208,257
96657,2022-02-01,10,37,157,194
96658,2022-02-01,11,54,159,213
96659,2022-02-01,12,81,207,288
96660,2022-02-01,13,66,216,282
96661,2022-02-01,14,63,181,244
96662,2022-02-01,15,77,266,343
96663,2022-02-01,16,103,293,396
96664,2022-02-01,17,146,489,635
96665,2022-02-01,18,105,382,487
96666,2022-02-01,19,76,279,355
96667,2022-02-01,20,40,162,202
96668,2022-02-01,21,43,125,168
96669,2022-02-01,22,30,84,114
96670,2022-02-01,23,16,41,57
96671,2022-02-02,0,6,11,17
96672,2022-02-02,1,4,2,6
96673,2022-02-02,2,1,6,7
96674,2022-02-02,3,1,3,4
96675,2022-02-02,4,4,5,9
96676,2022-02-02,5,15,42,57
96677,2022-02-02,6,25,102,127
96678,2022-02-02,7,46,215,261
96679,2022-02-02,8,78,392,470
96680,2022-02-02,9,54,264,318
96681,2022-02-02,10,55,143,198
96682,2022-02-02,11,59,170,229
96683,2022-02-02,12,94,206,300
96684,2022-02-02,13,75,213,288
96685,2022-02-02,14,86,194,280
96686,2022-02-02,15,129,252,381
96687,2022-02-02,16,139,342,481
96688,2022-02-02,17,148,514,662
96689,2022-02-02,18,125,436,561
96690,2022-02-02,19,96,296,392
96691,2022-02-02,20,60,219,279
96692,2022-02-02,21,60,173,233
96693,2022-02-02,22,60,112,172
96694,2022-02-02,23,19,56,75
96695,2022-02-03,0,9,23,32
96696,2022-02-03,1,4,3,7
96697,2022-02-03,2,2,10,12
96698,2022-02-03,3,0,6,6
96699,2022-02-03,4,2,6,8
96700,2022-02-03,5,8,23,31
96701,2022-02-03,6,12,55,67
96702,2022-02-03,7,22,88,110
96703,2022-02-03,8,35,160,195
96704,2022-02-03,9,23,113,136
96705,2022-02-03,10,18,100,118
96706,2022-02-03,11,16,67,83
96707,2022-02-03,12,17,55,72
96708,2022-02-03,13,25,64,89
96709,2022-02-03,14,33,90,123
96710,2022-02-03,15,58,158,216
96711,2022-02-03,16,63,174,237
96712,2022-02-03,17,88,342,430
96713,2022-02-03,18,81,301,382
96714,2022-02-03,19,45,163,208
96715,2022-02-03,20,44,139,183
96716,2022-02-03,21,44,107,151
96717,2022-02-03,22,53,90,143
96718,2022-02-03,23,66,112,178
96719,2022-02-04,0,23,29,52
96720,2022-02-04,1,12,15,27
96721,2022-02-04,2,5,12,17
96722,2022-02-04,3,7,9,16
96723,2022-02-04,4,8,14,22
96724,2022-02-04,5,11,22,33
96725,2022-02-04,6,12,52,64
96726,2022-02-04,7,8,76,84
96727,2022-02-04,8,16,101,117
96728,2022-02-04,9,24,72,96
96729,2022-02-04,10,25,98,123
96730,2022-02-04,11,22,77,99
96731,2022-02-04,12,13,42,55
96732,2022-02-04,13,24,51,75
96733,2022-02-04,14,18,81,99
96734,2022-02-04,15,34,97,131
96735,2022-02-04,16,34,124,158
96736,2022-02-04,17,35,118,153
96737,2022-02-04,18,74,250,324
96738,2022-02-04,19,56,182,238
96739,2022-02-04,20,52,132,184
96740,2022-02-04,21,33,94,127
96741,2022-02-04,22,44,77,121
96742,2022-02-04,23,47,79,126
96743,2022-02-05,0,44,76,120
96744,2022-02-05,1,20,54,74
96745,2022-02-05,2,22,26,48
96746,2022-02-05,3,13,17,30
96747,2022-02-05,4,6,8,14
96748,2022-02-05,5,3,14,17
96749,2022-02-05,6,9,22,31
96750,2022-02-05,7,12,40,52
96751,2022-02-05,8,21,101,122
96752,2022-02-05,9,54,149,203
96753,2022-02-05,10,93,191,284
96754,2022-02-05,11,101,248,349
96755,2022-02-05,12,107,258,365
96756,2022-02-05,13,114,259,373
96757,2022-02-05,14,108,264,372
96758,2022-02-05,15,118,239,357
96759,2022-02-05,16,104,270,374
96760,2022-02-05,17,83,252,335
96761,2022-02-05,18,71,143,214
96762,2022-02-05,19,51,154,205
96763,2022-02-05,20,46,102,148
96764,2022-02-05,21,40,93,133
96765,2022-02-05,22,31,71,102
96766,2022-02-05,23,44,75,119
96767,2022-02-06,0,41,64,105
96768,2022-02-06,1,21,64,85
96769,2022-02-06,2,19,46,65
96770,2022-02-06,3,10,13,23
96771,2022-02-06,4,2,11,13
96772,2022-02-06,5,4,5,9
96773,2022-02-06,6,7,18,25
96774,2022-02-06,7,20,37,57
96775,2022-02-06,8,14,65,79
96776,2022-02-06,9,39,107,146
96777,2022-02-06,10,74,189,263
96778,2022-02-06,11,91,224,315
96779,2022-02-06,12,109,254,363
96780,2022-02-06,13,129,280,409
96781,2022-02-06,14,144,280,424
96782,2022-02-06,15,144,287,431
96783,2022-02-06,16,111,273,384
96784,2022-02-06,17,77,225,302
96785,2022-02-06,18,49,183,232
96786,2022-02-06,19,42,125,167
96787,2022-02-06,20,29,85,114
96788,2022-02-06,21,25,57,82
96789,2022-02-06,22,22,46,68
96790,2022-02-06,23,13,32,45
96791,2022-02-07,0,4,20,24
96792,2022-02-07,1,2,8,10
96793,2022-02-07,2,2,4,6
96794,2022-02-07,3,1,3,4
96795,2022-02-07,4,2,8,10
96796,2022-02-07,5,12,31,43
96797,2022-02-07,6,16,116,132
96798,2022-02-07,7,41,207,248
96799,2022-02-07,8,66,352,418
96800,2022-02-07,9,53,229,282
96801,2022-02-07,10,41,144,185
96802,2022-02-07,11,33,185,218
96803,2022-02-07,12,59,209,268
96804,2022-02-07,13,42,226,268
96805,2022-02-07,14,43,161,204
96806,2022-02-07,15,71,173,244
96807,2022-02-07,16,55,236,291
96808,2022-02-07,17,60,278,338
96809,2022-02-07,18,48,205,253
96810,2022-02-07,19,36,157,193
96811,2022-02-07,20,21,106,127
96812,2022-02-07,21,28,96,124
96813,2022-02-07,22,22,47,69
96814,2022-02-07,23,10,37,47
96815,2022-02-08,0,11,17,28
96816,2022-02-08,1,2,11,13
96817,2022-02-08,2,2,5,7
96818,2022-02-08,3,1,2,3
96819,2022-02-08,4,1,8,9
96820,2022-02-08,5,16,40,56
96821,2022-02-08,6,20,107,127
96822,2022-02-08,7,44,257,301
96823,2022-02-08,8,77,401,478
96824,2022-02-08,9,56,257,313
96825,2022-02-08,10,58,160,218
96826,2022-02-08,11,58,171,229
96827,2022-02-08,12,74,223,297
96828,2022-02-08,13,70,216,286
96829,2022-02-08,14,83,175,258
96830,2022-02-08,15,92,250,342
96831,2022-02-08,16,91,337,428
96832,2022-02-08,17,118,484,602
96833,2022-02-08,18,124,392,516
96834,2022-02-08,19,77,300,377
96835,2022-02-08,20,37,173,210
96836,2022-02-08,21,54,148,202
96837,2022-02-08,22,36,114,150
96838,2022-02-08,23,18,33,51
96839,2022-02-09,0,11,16,27
96840,2022-02-09,1,10,9,19
96841,2022-02-09,2,1,5,6
96842,2022-02-09,3,2,2,4
96843,2022-02-09,4,3,7,10
96844,2022-02-09,5,15,35,50
96845,2022-02-09,6,20,92,112
96846,2022-02-09,7,48,266,314
96847,2022-02-09,8,90,409,499
96848,2022-02-09,9,68,235,303
96849,2022-02-09,10,60,186,246
96850,2022-02-09,11,54,189,243
96851,2022-02-09,12,86,238,324
96852,2022-02-09,13,101,245,346
96853,2022-02-09,14,88,252,340
96854,2022-02-09,15,117,273,390
96855,2022-02-09,16,137,405,542
96856,2022-02-09,17,190,583,773
96857,2022-02-09,18,141,491,632
96858,2022-02-09,19,109,324,433
96859,2022-02-09,20,79,206,285
96860,2022-02-09,21,61,137,198
96861,2022-02-09,22,51,133,184
96862,2022-02-09,23,23,67,90
96863,2022-02-10,0,20,27,47
96864,2022-02-10,1,2,21,23
96865,2022-02-10,2,3,17,20
96866,2022-02-10,3,0,10,10
96867,2022-02-10,4,7,13,20
96868,2022-02-10,5,12,30,42
96869,2022-02-10,6,23,101,124
96870,2022-02-10,7,62,229,291
96871,2022-02-10,8,100,406,506
96872,2022-02-10,9,84,289,373
96873,2022-02-10,10,77,167,244
96874,2022-02-10,11,95,212,307
96875,2022-02-10,12,116,250,366
96876,2022-02-10,13,94,265,359
96877,2022-02-10,14,109,218,327
96878,2022-02-10,15,136,248,384
96879,2022-02-10,16,206,369,575
96880,2022-02-10,17,252,569,821
96881,2022-02-10,18,172,461,633
96882,2022-02-10,19,100,332,432
96883,2022-02-10,20,81,196,277
96884,2022-02-10,21,77,157,234
96885,2022-02-10,22,55,134,189
96886,2022-02-10,23,53,78,131
96887,2022-02-11,0,17,32,49
96888,2022-02-11,1,15,26,41
96889,2022-02-11,2,10,7,17
96890,2022-02-11,3,6,8,14
96891,2022-02-11,4,7,7,14
96892,2022-02-11,5,14,30,44
96893,2022-02-11,6,17,100,117
96894,2022-02-11,7,47,232,279
96895,2022-02-11,8,91,348,439
96896,2022-02-11,9,68,195,263
96897,2022-02-11,10,77,180,257
96898,2022-02-11,11,110,200,310
96899,2022-02-11,12,135,283,418
96900,2022-02-11,13,189,317,506
96901,2022-02-11,14,200,341,541
96902,2022-02-11,15,276,410,686
96903,2022-02-11,16,283,483,766
96904,2022-02-11,17,329,591,920
96905,2022-02-11,18,236,465,701
96906,2022-02-11,19,178,323,501
96907,2022-02-11,20,125,185,310
96908,2022-02-11,21,107,136,243
96909,2022-02-11,22,94,147,241
96910,2022-02-11,23,75,119,194
96911,2022-02-12,0,62,117,179
96912,2022-02-12,1,66,86,152
96913,2022-02-12,2,39,31,70
96914,2022-02-12,3,21,25,46
96915,2022-02-12,4,3,7,10
96916,2022-02-12,5,6,14,20
96917,2022-02-12,6,18,26,44
96918,2022-02-12,7,29,64,93
96919,2022-02-12,8,68,136,204
96920,2022-02-12,9,152,267,419
96921,2022-02-12,10,244,357,601
96922,2022-02-12,11,351,395,746
96923,2022-02-12,12,351,453,804
96924,2022-02-12,13,372,381,753
96925,2022-02-12,14,401,417,818
96926,2022-02-12,15,435,408,843
96927,2022-02-12,16,394,391,785
96928,2022-02-12,17,278,358,636
96929,2022-02-12,18,157,242,399
96930,2022-02-12,19,121,200,321
96931,2022-02-12,20,114,138,252
96932,2022-02-12,21,68,116,184
96933,2022-02-12,22,60,92,152
96934,2022-02-12,23,59,68,127
96935,2022-02-13,0,40,61,101
96936,2022-02-13,1,28,37,65
96937,2022-02-13,2,13,21,34
96938,2022-02-13,3,6,18,24
96939,2022-02-13,4,4,5,9
96940,2022-02-13,5,4,9,13
96941,2022-02-13,6,3,16,19
96942,2022-02-13,7,3,14,17
96943,2022-02-13,8,18,41,59
96944,2022-02-13,9,29,57,86
96945,2022-02-13,10,42,100,142
96946,2022-02-13,11,58,123,181
96947,2022-02-13,12,51,111,162
96948,2022-02-13,13,40,145,185
96949,2022-02-13,14,55,118,173
96950,2022-02-13,15,63,161,224
96951,2022-02-13,16,64,178,242
96952,2022-02-13,17,102,201,303
96953,2022-02-13,18,61,194,255
96954,2022-02-13,19,40,98,138
96955,2022-02-13,20,17,70,87
96956,2022-02-13,21,19,42,61
96957,2022-02-13,22,90,173,263
96958,2022-02-13,23,21,47,68
96959,2022-02-14,0,5,18,23
96960,2022-02-14,1,2,12,14
96961,2022-02-14,2,0,5,5
96962,2022-02-14,3,2,6,8
96963,2022-02-14,4,3,6,9
96964,2022-02-14,5,8,30,38
96965,2022-02-14,6,18,90,108
96966,2022-02-14,7,34,186,220
96967,2022-02-14,8,66,313,379
96968,2022-02-14,9,40,175,215
96969,2022-02-14,10,39,120,159
96970,2022-02-14,11,41,123,164
96971,2022-02-14,12,48,148,196
96972,2022-02-14,13,33,198,231
96973,2022-02-14,14,56,143,199
96974,2022-02-14,15,70,203,273
96975,2022-02-14,16,59,256,315
96976,2022-02-14,17,88,370,458
96977,2022-02-14,18,70,309,379
96978,2022-02-14,19,62,175,237
96979,2022-02-14,20,31,151,182
96980,2022-02-14,21,33,91,124
96981,2022-02-14,22,31,54,85
96982,2022-02-14,23,20,41,61
96983,2022-02-15,0,17,23,40
96984,2022-02-15,1,2,12,14
96985,2022-02-15,2,1,6,7
96986,2022-02-15,3,1,2,3
96987,2022-02-15,4,1,10,11
96988,2022-02-15,5,8,38,46
96989,2022-02-15,6,18,103,121
96990,2022-02-15,7,41,214,255
96991,2022-02-15,8,86,367,453
96992,2022-02-15,9,58,220,278
96993,2022-02-15,10,57,137,194
96994,2022-02-15,11,41,147,188
96995,2022-02-15,12,92,179,271
96996,2022-02-15,13,75,154,229
96997,2022-02-15,14,93,180,273
96998,2022-02-15,15,93,237,330
96999,2022-02-15,16,95,281,376
97000,2022-02-15,17,132,442,574
97001,2022-02-15,18,97,364,461
97002,2022-02-15,19,83,245,328
97003,2022-02-15,20,56,164,220
97004,2022-02-15,21,54,127,181
97005,2022-02-15,22,26,96,122
97006,2022-02-15,23,15,40,55
97007,2022-02-16,0,6,12,18
97008,2022-02-16,1,5,3,8
97009,2022-02-16,2,1,6,7
97010,2022-02-16,3,2,3,5
97011,2022-02-16,4,4,6,10
97012,2022-02-16,5,9,36,45
97013,2022-02-16,6,19,97,116
97014,2022-02-16,7,46,251,297
97015,2022-02-16,8,95,424,519
97016,2022-02-16,9,59,250,309
97017,2022-02-16,10,66,159,225
97018,2022-02-16,11,44,173,217
97019,2022-02-16,12,85,251,336
97020,2022-02-16,13,91,198,289
97021,2022-02-16,14,89,225,314
97022,2022-02-16,15,130,291,421
97023,2022-02-16,16,114,352,466
97024,2022-02-16,17,184,530,714
97025,2022-02-16,18,158,448,606
97026,2022-02-16,19,119,317,436
97027,2022-02-16,20,85,220,305
97028,2022-02-16,21,72,171,243
97029,2022-02-16,22,56,130,186
97030,2022-02-16,23,29,61,90
97031,2022-02-17,0,15,15,30
97032,2022-02-17,1,8,11,19
97033,2022-02-17,2,2,9,11
97034,2022-02-17,3,0,8,8
97035,2022-02-17,4,5,3,8
97036,2022-02-17,5,12,45,57
97037,2022-02-17,6,34,110,144
97038,2022-02-17,7,70,273,343
97039,2022-02-17,8,95,446,541
97040,2022-02-17,9,79,252,331
97041,2022-02-17,10,75,233,308
97042,2022-02-17,11,76,198,274
97043,2022-02-17,12,99,266,365
97044,2022-02-17,13,120,243,363
97045,2022-02-17,14,119,209,328
97046,2022-02-17,15,124,315,439
97047,2022-02-17,16,171,407,578
97048,2022-02-17,17,268,649,917
97049,2022-02-17,18,191,496,687
97050,2022-02-17,19,127,383,510
97051,2022-02-17,20,99,303,402
97052,2022-02-17,21,101,221,322
97053,2022-02-17,22,67,134,201
97054,2022-02-17,23,40,72,112
97055,2022-02-18,0,27,41,68
97056,2022-02-18,1,22,30,52
97057,2022-02-18,2,11,12,23
97058,2022-02-18,3,5,7,12
97059,2022-02-18,4,7,7,14
97060,2022-02-18,5,13,24,37
97061,2022-02-18,6,22,72,94
97062,2022-02-18,7,35,202,237
97063,2022-02-18,8,63,285,348
97064,2022-02-18,9,83,225,308
97065,2022-02-18,10,59,165,224
97066,2022-02-18,11,73,174,247
97067,2022-02-18,12,105,204,309
97068,2022-02-18,13,104,239,343
97069,2022-02-18,14,98,238,336
97070,2022-02-18,15,177,297,474
97071,2022-02-18,16,145,302,447
97072,2022-02-18,17,155,363,518
97073,2022-02-18,18,93,331,424
97074,2022-02-18,19,105,218,323
97075,2022-02-18,20,59,164,223
97076,2022-02-18,21,46,85,131
97077,2022-02-18,22,34,105,139
97078,2022-02-18,23,39,90,129
97079,2022-02-19,0,42,77,119
97080,2022-02-19,1,39,48,87
97081,2022-02-19,2,23,40,63
97082,2022-02-19,3,11,13,24
97083,2022-02-19,4,5,12,17
97084,2022-02-19,5,6,10,16
97085,2022-02-19,6,9,26,35
97086,2022-02-19,7,14,58,72
97087,2022-02-19,8,31,96,127
97088,2022-02-19,9,70,181,251
97089,2022-02-19,10,121,212,333
97090,2022-02-19,11,189,272,461
97091,2022-02-19,12,212,305,517
97092,2022-02-19,13,215,289,504
97093,2022-02-19,14,203,219,422
97094,2022-02-19,15,158,269,427
97095,2022-02-19,16,155,239,394
97096,2022-02-19,17,107,188,295
97097,2022-02-19,18,84,161,245
97098,2022-02-19,19,63,141,204
97099,2022-02-19,20,31,94,125
97100,2022-02-19,21,32,82,114
97101,2022-02-19,22,22,62,84
97102,2022-02-19,23,43,76,119
97103,2022-02-20,0,33,64,97
97104,2022-02-20,1,22,26,48
97105,2022-02-20,2,18,38,56
97106,2022-02-20,3,12,11,23
97107,2022-02-20,4,0,9,9
97108,2022-02-20,5,3,9,12
97109,2022-02-20,6,9,18,27
97110,2022-02-20,7,13,40,53
97111,2022-02-20,8,34,75,109
97112,2022-02-20,9,52,119,171
97113,2022-02-20,10,110,146,256
97114,2022-02-20,11,137,198,335
97115,2022-02-20,12,168,253,421
97116,2022-02-20,13,206,253,459
97117,2022-02-20,14,222,262,484
97118,2022-02-20,15,234,222,456
97119,2022-02-20,16,219,244,463
97120,2022-02-20,17,148,261,409
97121,2022-02-20,18,93,207,300
97122,2022-02-20,19,71,138,209
97123,2022-02-20,20,47,101,148
97124,2022-02-20,21,40,78,118
97125,2022-02-20,22,42,76,118
97126,2022-02-20,23,35,39,74
97127,2022-02-21,0,23,33,56
97128,2022-02-21,1,12,14,26
97129,2022-02-21,2,8,7,15
97130,2022-02-21,3,5,12,17
97131,2022-02-21,4,3,9,12
97132,2022-02-21,5,5,16,21
97133,2022-02-21,6,16,36,52
97134,2022-02-21,7,22,82,104
97135,2022-02-21,8,47,103,150
97136,2022-02-21,9,81,175,256
97137,2022-02-21,10,165,180,345
97138,2022-02-21,11,265,247,512
97139,2022-02-21,12,328,317,645
97140,2022-02-21,13,389,385,774
97141,2022-02-21,14,455,471,926
97142,2022-02-21,15,448,487,935
97143,2022-02-21,16,406,490,896
97144,2022-02-21,17,358,474,832
97145,2022-02-21,18,175,323,498
97146,2022-02-21,19,104,198,302
97147,2022-02-21,20,72,154,226
97148,2022-02-21,21,52,108,160
97149,2022-02-21,22,44,92,136
97150,2022-02-21,23,26,44,70
97151,2022-02-22,0,14,12,26
97152,2022-02-22,1,9,6,15
97153,2022-02-22,2,2,2,4
97154,2022-02-22,3,3,2,5
97155,2022-02-22,4,3,8,11
97156,2022-02-22,5,5,40,45
97157,2022-02-22,6,32,111,143
97158,2022-02-22,7,58,252,310
97159,2022-02-22,8,114,425,539
97160,2022-02-22,9,89,256,345
97161,2022-02-22,10,37,113,150
97162,2022-02-22,11,55,114,169
97163,2022-02-22,12,85,173,258
97164,2022-02-22,13,71,155,226
97165,2022-02-22,14,53,103,156
97166,2022-02-22,15,96,171,267
97167,2022-02-22,16,82,229,311
97168,2022-02-22,17,126,428,554
97169,2022-02-22,18,115,399,514
97170,2022-02-22,19,87,261,348
97171,2022-02-22,20,70,204,274
97172,2022-02-22,21,69,148,217
97173,2022-02-22,22,52,98,150
97174,2022-02-22,23,39,63,102
97175,2022-02-23,0,14,18,32
97176,2022-02-23,1,9,13,22
97177,2022-02-23,2,4,11,15
97178,2022-02-23,3,2,4,6
97179,2022-02-23,4,4,13,17
97180,2022-02-23,5,6,42,48
97181,2022-02-23,6,35,111,146
97182,2022-02-23,7,62,253,315
97183,2022-02-23,8,105,455,560
97184,2022-02-23,9,97,263,360
97185,2022-02-23,10,85,185,270
97186,2022-02-23,11,128,227,355
97187,2022-02-23,12,156,299,455
97188,2022-02-23,13,148,263,411
97189,2022-02-23,14,170,276,446
97190,2022-02-23,15,201,371,572
97191,2022-02-23,16,272,475,747
97192,2022-02-23,17,401,689,1090
97193,2022-02-23,18,288,596,884
97194,2022-02-23,19,145,340,485
97195,2022-02-23,20,96,240,336
97196,2022-02-23,21,77,163,240
97197,2022-02-23,22,51,102,153
97198,2022-02-23,23,34,68,102
97199,2022-02-24,0,14,22,36
97200,2022-02-24,1,6,15,21
97201,2022-02-24,2,5,4,9
97202,2022-02-24,3,4,5,9
97203,2022-02-24,4,4,11,15
97204,2022-02-24,5,10,29,39
97205,2022-02-24,6,42,96,138
97206,2022-02-24,7,47,210,257
97207,2022-02-24,8,83,364,447
97208,2022-02-24,9,61,195,256
97209,2022-02-24,10,21,100,121
97210,2022-02-24,11,16,76,92
97211,2022-02-24,12,23,107,130
97212,2022-02-24,13,27,79,106
97213,2022-02-24,14,29,101,130
97214,2022-02-24,15,51,173,224
97215,2022-02-24,16,63,192,255
97216,2022-02-24,17,53,234,287
97217,2022-02-24,18,61,226,287
97218,2022-02-24,19,51,168,219
97219,2022-02-24,20,37,86,123
97220,2022-02-24,21,27,91,118
97221,2022-02-24,22,18,67,85
97222,2022-02-24,23,8,18,26
97223,2022-02-25,0,3,6,9
97224,2022-02-25,1,4,9,13
97225,2022-02-25,2,3,9,12
97226,2022-02-25,3,2,5,7
97227,2022-02-25,4,5,4,9
97228,2022-02-25,5,7,23,30
97229,2022-02-25,6,17,67,84
97230,2022-02-25,7,34,117,151
97231,2022-02-25,8,43,193,236
97232,2022-02-25,9,56,181,237
97233,2022-02-25,10,36,110,146
97234,2022-02-25,11,64,150,214
97235,2022-02-25,12,75,217,292
97236,2022-02-25,13,146,229,375
97237,2022-02-25,14,183,277,460
97238,2022-02-25,15,184,342,526
97239,2022-02-25,16,176,411,587
97240,2022-02-25,17,171,463,634
97241,2022-02-25,18,133,359,492
97242,2022-02-25,19,120,283,403
97243,2022-02-25,20,73,182,255
97244,2022-02-25,21,59,109,168
97245,2022-02-25,22,56,126,182
97246,2022-02-25,23,47,84,131
97247,2022-02-26,0,42,58,100
97248,2022-02-26,1,35,50,85
97249,2022-02-26,2,20,32,52
97250,2022-02-26,3,13,16,29
97251,2022-02-26,4,2,7,9
97252,2022-02-26,5,7,10,17
97253,2022-02-26,6,12,34,46
97254,2022-02-26,7,10,43,53
97255,2022-02-26,8,36,126,162
97256,2022-02-26,9,88,175,263
97257,2022-02-26,10,145,248,393
97258,2022-02-26,11,154,268,422
97259,2022-02-26,12,201,286,487
97260,2022-02-26,13,255,317,572
97261,2022-02-26,14,283,329,612
97262,2022-02-26,15,258,289,547
97263,2022-02-26,16,294,348,642
97264,2022-02-26,17,238,263,501
97265,2022-02-26,18,125,226,351
97266,2022-02-26,19,95,214,309
97267,2022-02-26,20,75,116,191
97268,2022-02-26,21,59,90,149
97269,2022-02-26,22,63,89,152
97270,2022-02-26,23,50,110,160
97271,2022-02-27,0,43,81,124
97272,2022-02-27,1,34,64,98
97273,2022-02-27,2,24,34,58
97274,2022-02-27,3,14,23,37
97275,2022-02-27,4,8,6,14
97276,2022-02-27,5,5,9,14
97277,2022-02-27,6,8,19,27
97278,2022-02-27,7,19,31,50
97279,2022-02-27,8,26,96,122
97280,2022-02-27,9,101,164,265
97281,2022-02-27,10,189,209,398
97282,2022-02-27,11,209,297,506
97283,2022-02-27,12,253,344,597
97284,2022-02-27,13,283,337,620
97285,2022-02-27,14,326,380,706
97286,2022-02-27,15,310,408,718
97287,2022-02-27,16,299,382,681
97288,2022-02-27,17,226,320,546
97289,2022-02-27,18,108,239,347
97290,2022-02-27,19,61,131,192
97291,2022-02-27,20,48,88,136
97292,2022-02-27,21,43,70,113
97293,2022-02-27,22,45,86,131
97294,2022-02-27,23,22,42,64
97295,2022-02-28,0,13,23,36
97296,2022-02-28,1,5,11,16
97297,2022-02-28,2,0,5,5
97298,2022-02-28,3,2,5,7
97299,2022-02-28,4,2,4,6
97300,2022-02-28,5,9,37,46
97301,2022-02-28,6,17,108,125
97302,2022-02-28,7,62,263,325
97303,2022-02-28,8,81,399,480
97304,2022-02-28,9,64,210,274
97305,2022-02-28,10,74,147,221
97306,2022-02-28,11,79,146,225
97307,2022-02-28,12,98,209,307
97308,2022-02-28,13,104,202,306
97309,2022-02-28,14,99,191,290
97310,2022-02-28,15,128,275,403
97311,2022-02-28,16,151,356,507
97312,2022-02-28,17,149,534,683
97313,2022-02-28,18,112,429,541
97314,2022-02-28,19,67,269,336
97315,2022-02-28,20,51,207,258
97316,2022-02-28,21,35,147,182
97317,2022-02-28,22,47,77,124
97318,2022-02-28,23,31,46,77
97319,2022-03-01,0,4,10,14
97320,2022-03-01,1,6,6,12
97321,2022-03-01,2,3,7,10
97322,2022-03-01,3,2,1,3
97323,2022-03-01,4,3,4,7
97324,2022-03-01,5,5,41,46
97325,2022-03-01,6,25,115,140
97326,2022-03-01,7,65,288,353
97327,2022-03-01,8,121,486,607
97328,2022-03-01,9,80,306,386
97329,2022-03-01,10,85,189,274
97330,2022-03-01,11,78,169,247
97331,2022-03-01,12,74,208,282
97332,2022-03-01,13,86,219,305
97333,2022-03-01,14,107,213,320
97334,2022-03-01,15,137,318,455
97335,2022-03-01,16,171,351,522
97336,2022-03-01,17,215,601,816
97337,2022-03-01,18,181,516,697
97338,2022-03-01,19,159,368,527
97339,2022-03-01,20,90,242,332
97340,2022-03-01,21,64,194,258
97341,2022-03-01,22,79,117,196
97342,2022-03-01,23,42,77,119
97343,2022-03-02,0,22,33,55
97344,2022-03-02,1,7,16,23
97345,2022-03-02,2,1,7,8
97346,2022-03-02,3,2,2,4
97347,2022-03-02,4,4,3,7
97348,2022-03-02,5,11,39,50
97349,2022-03-02,6,21,124,145
97350,2022-03-02,7,72,302,374
97351,2022-03-02,8,162,513,675
97352,2022-03-02,9,101,268,369
97353,2022-03-02,10,109,188,297
97354,2022-03-02,11,100,230,330
97355,2022-03-02,12,128,285,413
97356,2022-03-02,13,148,259,407
97357,2022-03-02,14,166,226,392
97358,2022-03-02,15,179,339,518
97359,2022-03-02,16,216,389,605
97360,2022-03-02,17,327,658,985
97361,2022-03-02,18,263,545,808
97362,2022-03-02,19,138,350,488
97363,2022-03-02,20,99,234,333
97364,2022-03-02,21,84,154,238
97365,2022-03-02,22,80,124,204
97366,2022-03-02,23,66,94,160
97367,2022-03-03,0,25,43,68
97368,2022-03-03,1,16,16,32
97369,2022-03-03,2,2,7,9
97370,2022-03-03,3,2,7,9
97371,2022-03-03,4,7,8,15
97372,2022-03-03,5,11,39,50
97373,2022-03-03,6,34,127,161
97374,2022-03-03,7,77,278,355
97375,2022-03-03,8,128,483,611
97376,2022-03-03,9,74,311,385
97377,2022-03-03,10,81,161,242
97378,2022-03-03,11,87,206,293
97379,2022-03-03,12,131,265,396
97380,2022-03-03,13,124,249,373
97381,2022-03-03,14,151,225,376
97382,2022-03-03,15,153,280,433
97383,2022-03-03,16,182,353,535
97384,2022-03-03,17,245,583,828
97385,2022-03-03,18,201,483,684
97386,2022-03-03,19,110,289,399
97387,2022-03-03,20,61,232,293
97388,2022-03-03,21,64,160,224
97389,2022-03-03,22,65,110,175
97390,2022-03-03,23,44,65,109
97391,2022-03-04,0,19,25,44
97392,2022-03-04,1,11,18,29
97393,2022-03-04,2,5,4,9
97394,2022-03-04,3,0,3,3
97395,2022-03-04,4,9,3,12
97396,2022-03-04,5,7,22,29
97397,2022-03-04,6,25,112,137
97398,2022-03-04,7,54,222,276
97399,2022-03-04,8,95,376,471
97400,2022-03-04,9,85,225,310
97401,2022-03-04,10,85,166,251
97402,2022-03-04,11,134,211,345
97403,2022-03-04,12,130,236,366
97404,2022-03-04,13,137,227,364
97405,2022-03-04,14,171,253,424
97406,2022-03-04,15,178,313,491
97407,2022-03-04,16,210,376,586
97408,2022-03-04,17,234,507,741
97409,2022-03-04,18,193,423,616
97410,2022-03-04,19,118,296,414
97411,2022-03-04,20,89,141,230
97412,2022-03-04,21,87,146,233
97413,2022-03-04,22,61,107,168
97414,2022-03-04,23,57,111,168
97415,2022-03-05,0,39,78,117
97416,2022-03-05,1,54,58,112
97417,2022-03-05,2,12,35,47
97418,2022-03-05,3,11,19,30
97419,2022-03-05,4,1,4,5
97420,2022-03-05,5,6,10,16
97421,2022-03-05,6,13,37,50
97422,2022-03-05,7,16,64,80
97423,2022-03-05,8,49,154,203
97424,2022-03-05,9,110,238,348
97425,2022-03-05,10,208,353,561
97426,2022-03-05,11,343,334,677
97427,2022-03-05,12,412,419,831
97428,2022-03-05,13,559,442,1001
97429,2022-03-05,14,548,479,1027
97430,2022-03-05,15,611,460,1071
97431,2022-03-05,16,456,430,886
97432,2022-03-05,17,408,417,825
97433,2022-03-05,18,210,298,508
97434,2022-03-05,19,147,210,357
97435,2022-03-05,20,113,147,260
97436,2022-03-05,21,86,158,244
97437,2022-03-05,22,103,131,234
97438,2022-03-05,23,103,98,201
97439,2022-03-06,0,65,100,165
97440,2022-03-06,1,55,62,117
97441,2022-03-06,2,52,38,90
97442,2022-03-06,3,32,16,48
97443,2022-03-06,4,12,7,19
97444,2022-03-06,5,5,8,13
97445,2022-03-06,6,16,24,40
97446,2022-03-06,7,23,47,70
97447,2022-03-06,8,44,117,161
97448,2022-03-06,9,96,180,276
97449,2022-03-06,10,184,209,393
97450,2022-03-06,11,277,310,587
97451,2022-03-06,12,433,383,816
97452,2022-03-06,13,536,461,997
97453,2022-03-06,14,588,460,1048
97454,2022-03-06,15,577,540,1117
97455,2022-03-06,16,451,473,924
97456,2022-03-06,17,395,385,780
97457,2022-03-06,18,260,295,555
97458,2022-03-06,19,140,205,345
97459,2022-03-06,20,142,145,287
97460,2022-03-06,21,114,140,254
97461,2022-03-06,22,65,79,144
97462,2022-03-06,23,42,50,92
97463,2022-03-07,0,22,27,49
97464,2022-03-07,1,14,15,29
97465,2022-03-07,2,8,10,18
97466,2022-03-07,3,6,4,10
97467,2022-03-07,4,6,8,14
97468,2022-03-07,5,11,40,51
97469,2022-03-07,6,33,135,168
97470,2022-03-07,7,70,308,378
97471,2022-03-07,8,138,502,640
97472,2022-03-07,9,122,293,415
97473,2022-03-07,10,138,180,318
97474,2022-03-07,11,148,217,365
97475,2022-03-07,12,207,246,453
97476,2022-03-07,13,195,268,463
97477,2022-03-07,14,205,219,424
97478,2022-03-07,15,229,311,540
97479,2022-03-07,16,111,219,330
97480,2022-03-07,17,153,403,556
97481,2022-03-07,18,160,384,544
97482,2022-03-07,19,50,169,219
97483,2022-03-07,20,59,130,189
97484,2022-03-07,21,65,145,210
97485,2022-03-07,22,62,115,177
97486,2022-03-07,23,38,51,89
97487,2022-03-08,0,18,12,30
97488,2022-03-08,1,4,11,15
97489,2022-03-08,2,3,2,5
97490,2022-03-08,3,1,3,4
97491,2022-03-08,4,5,4,9
97492,2022-03-08,5,7,45,52
97493,2022-03-08,6,28,145,173
97494,2022-03-08,7,76,297,373
97495,2022-03-08,8,135,474,609
97496,2022-03-08,9,99,278,377
97497,2022-03-08,10,78,176,254
97498,2022-03-08,11,138,199,337
97499,2022-03-08,12,145,232,377
97500,2022-03-08,13,154,241,395
97501,2022-03-08,14,210,217,427
97502,2022-03-08,15,202,289,491
97503,2022-03-08,16,232,382,614
97504,2022-03-08,17,287,628,915
97505,2022-03-08,18,216,567,783
97506,2022-03-08,19,114,366,480
97507,2022-03-08,20,98,225,323
97508,2022-03-08,21,81,203,284
97509,2022-03-08,22,64,115,179
97510,2022-03-08,23,39,53,92
97511,2022-03-09,0,13,18,31
97512,2022-03-09,1,4,6,10
97513,2022-03-09,2,0,4,4
97514,2022-03-09,3,0,4,4
97515,2022-03-09,4,3,3,6
97516,2022-03-09,5,1,11,12
97517,2022-03-09,6,10,58,68
97518,2022-03-09,7,15,71,86
97519,2022-03-09,8,44,152,196
97520,2022-03-09,9,29,140,169
97521,2022-03-09,10,31,87,118
97522,2022-03-09,11,21,75,96
97523,2022-03-09,12,24,66,90
97524,2022-03-09,13,24,79,103
97525,2022-03-09,14,54,82,136
97526,2022-03-09,15,63,148,211
97527,2022-03-09,16,88,229,317
97528,2022-03-09,17,134,439,573
97529,2022-03-09,18,121,439,560
97530,2022-03-09,19,107,281,388
97531,2022-03-09,20,73,183,256
97532,2022-03-09,21,46,159,205
97533,2022-03-09,22,44,115,159
97534,2022-03-09,23,44,49,93
97535,2022-03-10,0,15,20,35
97536,2022-03-10,1,8,14,22
97537,2022-03-10,2,2,4,6
97538,2022-03-10,3,0,4,4
97539,2022-03-10,4,7,9,16
97540,2022-03-10,5,14,25,39
97541,2022-03-10,6,25,106,131
97542,2022-03-10,7,55,253,308
97543,2022-03-10,8,128,465,593
97544,2022-03-10,9,111,304,415
97545,2022-03-10,10,119,193,312
97546,2022-03-10,11,119,218,337
97547,2022-03-10,12,126,304,430
97548,2022-03-10,13,144,235,379
97549,2022-03-10,14,187,250,437
97550,2022-03-10,15,195,329,524
97551,2022-03-10,16,240,335,575
97552,2022-03-10,17,255,574,829
97553,2022-03-10,18,208,517,725
97554,2022-03-10,19,127,394,521
97555,2022-03-10,20,106,244,350
97556,2022-03-10,21,79,186,265
97557,2022-03-10,22,69,124,193
97558,2022-03-10,23,43,88,131
97559,2022-03-11,0,27,39,66
97560,2022-03-11,1,8,22,30
97561,2022-03-11,2,15,8,23
97562,2022-03-11,3,1,7,8
97563,2022-03-11,4,5,6,11
97564,2022-03-11,5,3,18,21
97565,2022-03-11,6,29,114,143
97566,2022-03-11,7,63,205,268
97567,2022-03-11,8,118,370,488
97568,2022-03-11,9,124,254,378
97569,2022-03-11,10,187,213,400
97570,2022-03-11,11,202,253,455
97571,2022-03-11,12,299,319,618
97572,2022-03-11,13,315,321,636
97573,2022-03-11,14,297,320,617
97574,2022-03-11,15,381,424,805
97575,2022-03-11,16,365,503,868
97576,2022-03-11,17,473,621,1094
97577,2022-03-11,18,312,505,817
97578,2022-03-11,19,153,350,503
97579,2022-03-11,20,119,201,320
97580,2022-03-11,21,87,147,234
97581,2022-03-11,22,81,133,214
97582,2022-03-11,23,93,126,219
97583,2022-03-12,0,65,112,177
97584,2022-03-12,1,58,50,108
97585,2022-03-12,2,45,46,91
97586,2022-03-12,3,21,21,42
97587,2022-03-12,4,12,8,20
97588,2022-03-12,5,1,5,6
97589,2022-03-12,6,4,6,10
97590,2022-03-12,7,5,15,20
97591,2022-03-12,8,8,26,34
97592,2022-03-12,9,12,35,47
97593,2022-03-12,10,22,40,62
97594,2022-03-12,11,25,68,93
97595,2022-03-12,12,29,89,118
97596,2022-03-12,13,18,89,107
97597,2022-03-12,14,29,72,101
97598,2022-03-12,15,38,91,129
97599,2022-03-12,16,39,130,169
97600,2022-03-12,17,45,147,192
97601,2022-03-12,18,32,130,162
97602,2022-03-12,19,28,102,130
97603,2022-03-12,20,21,54,75
97604,2022-03-12,21,30,55,85
97605,2022-03-12,22,12,61,73
97606,2022-03-12,23,27,41,68
97607,2022-03-13,0,24,52,76
97608,2022-03-13,1,17,31,48
97609,2022-03-13,3,18,17,35
97610,2022-03-13,4,4,10,14
97611,2022-03-13,5,5,7,12
97612,2022-03-13,6,8,11,19
97613,2022-03-13,7,10,36,46
97614,2022-03-13,8,19,47,66
97615,2022-03-13,9,29,93,122
97616,2022-03-13,10,70,156,226
97617,2022-03-13,11,113,172,285
97618,2022-03-13,12,143,211,354
97619,2022-03-13,13,126,248,374
97620,2022-03-13,14,175,226,401
97621,2022-03-13,15,143,248,391
97622,2022-03-13,16,170,265,435
97623,2022-03-13,17,175,243,418
97624,2022-03-13,18,128,186,314
97625,2022-03-13,19,81,162,243
97626,2022-03-13,20,54,118,172
97627,2022-03-13,21,31,67,98
97628,2022-03-13,22,44,63,107
97629,2022-03-13,23,22,32,54
97630,2022-03-14,0,13,20,33
97631,2022-03-14,1,4,11,15
97632,2022-03-14,2,4,8,12
97633,2022-03-14,3,0,5,5
97634,2022-03-14,4,5,4,9
97635,2022-03-14,5,12,22,34
97636,2022-03-14,6,24,95,119
97637,2022-03-14,7,58,217,275
97638,2022-03-14,8,103,368,471
97639,2022-03-14,9,89,243,332
97640,2022-03-14,10,117,142,259
97641,2022-03-14,11,129,186,315
97642,2022-03-14,12,177,220,397
97643,2022-03-14,13,231,239,470
97644,2022-03-14,14,217,230,447
97645,2022-03-14,15,303,325,628
97646,2022-03-14,16,341,410,751
97647,2022-03-14,17,416,630,1046
97648,2022-03-14,18,329,566,895
97649,2022-03-14,19,197,392,589
97650,2022-03-14,20,130,263,393
97651,2022-03-14,21,80,166,246
97652,2022-03-14,22,81,97,178
97653,2022-03-14,23,35,53,88
97654,2022-03-15,0,17,19,36
97655,2022-03-15,1,4,7,11
97656,2022-03-15,2,2,10,12
97657,2022-03-15,3,3,8,11
97658,2022-03-15,4,1,6,7
97659,2022-03-15,5,11,39,50
97660,2022-03-15,6,31,143,174
97661,2022-03-15,7,56,313,369
97662,2022-03-15,8,184,521,705
97663,2022-03-15,9,104,311,415
97664,2022-03-15,10,186,194,380
97665,2022-03-15,11,232,213,445
97666,2022-03-15,12,290,277,567
97667,2022-03-15,13,268,288,556
97668,2022-03-15,14,317,272,589
97669,2022-03-15,15,335,354,689
97670,2022-03-15,16,414,466,880
97671,2022-03-15,17,538,733,1271
97672,2022-03-15,18,485,707,1192
97673,2022-03-15,19,330,446,776
97674,2022-03-15,20,179,310,489
97675,2022-03-15,21,141,202,343
97676,2022-03-15,22,150,163,313
97677,2022-03-15,23,60,79,139
97678,2022-03-16,0,36,28,64
97679,2022-03-16,1,8,12,20
97680,2022-03-16,2,10,5,15
97681,2022-03-16,3,4,3,7
97682,2022-03-16,4,8,7,15
97683,2022-03-16,5,12,35,47
97684,2022-03-16,6,31,142,173
97685,2022-03-16,7,87,318,405
97686,2022-03-16,8,180,604,784
97687,2022-03-16,9,193,322,515
97688,2022-03-16,10,177,217,394
97689,2022-03-16,11,251,231,482
97690,2022-03-16,12,240,263,503
97691,2022-03-16,13,348,290,638
97692,2022-03-16,14,344,269,613
97693,2022-03-16,15,429,371,800
97694,2022-03-16,16,428,483,911
97695,2022-03-16,17,516,806,1322
97696,2022-03-16,18,494,726,1220
97697,2022-03-16,19,322,479,801
97698,2022-03-16,20,171,293,464
97699,2022-03-16,21,168,259,427
97700,2022-03-16,22,115,160,275
97701,2022-03-16,23,67,90,157
97702,2022-03-17,0,40,31,71
97703,2022-03-17,1,10,12,22
97704,2022-03-17,2,6,12,18
97705,2022-03-17,3,4,1,5
97706,2022-03-17,4,2,8,10
97707,2022-03-17,5,15,26,41
97708,2022-03-17,6,22,96,118
97709,2022-03-17,7,61,227,288
97710,2022-03-17,8,108,452,560
97711,2022-03-17,9,104,282,386
97712,2022-03-17,10,87,161,248
97713,2022-03-17,11,92,135,227
97714,2022-03-17,12,29,92,121
97715,2022-03-17,13,23,62,85
97716,2022-03-17,14,32,53,85
97717,2022-03-17,15,70,156,226
97718,2022-03-17,16,112,247,359
97719,2022-03-17,17,186,410,596
97720,2022-03-17,18,188,445,633
97721,2022-03-17,19,141,295,436
97722,2022-03-17,20,123,244,367
97723,2022-03-17,21,127,165,292
97724,2022-03-17,22,88,121,209
97725,2022-03-17,23,85,115,200
97726,2022-03-18,0,40,40,80
97727,2022-03-18,1,21,32,53
97728,2022-03-18,2,9,7,16
97729,2022-03-18,3,5,9,14
97730,2022-03-18,4,2,7,9
97731,2022-03-18,5,13,36,49
97732,2022-03-18,6,31,116,147
97733,2022-03-18,7,67,266,333
97734,2022-03-18,8,122,410,532
97735,2022-03-18,9,159,293,452
97736,2022-03-18,10,177,211,388
97737,2022-03-18,11,301,258,559
97738,2022-03-18,12,383,315,698
97739,2022-03-18,13,396,293,689
97740,2022-03-18,14,462,359,821
97741,2022-03-18,15,519,411,930
97742,2022-03-18,16,581,531,1112
97743,2022-03-18,17,636,657,1293
97744,2022-03-18,18,475,574,1049
97745,2022-03-18,19,340,415,755
97746,2022-03-18,20,214,294,508
97747,2022-03-18,21,182,178,360
97748,2022-03-18,22,158,188,346
97749,2022-03-18,23,123,128,251
97750,2022-03-19,0,101,106,207
97751,2022-03-19,1,56,77,133
97752,2022-03-19,2,54,60,114
97753,2022-03-19,3,24,20,44
97754,2022-03-19,4,9,18,27
97755,2022-03-19,5,10,8,18
97756,2022-03-19,6,24,36,60
97757,2022-03-19,7,59,92,151
97758,2022-03-19,8,119,156,275
97759,2022-03-19,9,248,298,546
97760,2022-03-19,10,458,351,809
97761,2022-03-19,11,568,467,1035
97762,2022-03-19,12,613,468,1081
97763,2022-03-19,13,722,476,1198
97764,2022-03-19,14,763,470,1233
97765,2022-03-19,15,758,490,1248
97766,2022-03-19,16,780,471,1251
97767,2022-03-19,17,732,439,1171
97768,2022-03-19,18,608,429,1037
97769,2022-03-19,19,469,362,831
97770,2022-03-19,20,320,217,537
97771,2022-03-19,21,233,186,419
97772,2022-03-19,22,194,140,334
97773,2022-03-19,23,150,119,269
97774,2022-03-20,0,109,105,214
97775,2022-03-20,1,84,82,166
97776,2022-03-20,2,58,60,118
97777,2022-03-20,3,30,20,50
97778,2022-03-20,4,4,6,10
97779,2022-03-20,5,10,7,17
97780,2022-03-20,6,15,26,41
97781,2022-03-20,7,31,46,77
97782,2022-03-20,8,114,131,245
97783,2022-03-20,9,242,219,461
97784,2022-03-20,10,337,305,642
97785,2022-03-20,11,449,304,753
97786,2022-03-20,12,483,389,872
97787,2022-03-20,13,519,388,907
97788,2022-03-20,14,478,426,904
97789,2022-03-20,15,390,386,776
97790,2022-03-20,16,400,351,751
97791,2022-03-20,17,282,318,600
97792,2022-03-20,18,204,258,462
97793,2022-03-20,19,148,194,342
97794,2022-03-20,20,108,141,249
97795,2022-03-20,21,47,89,136
97796,2022-03-20,22,49,80,129
97797,2022-03-20,23,38,39,77
97798,2022-03-21,0,17,14,31
97799,2022-03-21,1,12,17,29
97800,2022-03-21,2,1,11,12
97801,2022-03-21,3,3,7,10
97802,2022-03-21,4,3,10,13
97803,2022-03-21,5,14,36,50
97804,2022-03-21,6,42,127,169
97805,2022-03-21,7,92,263,355
97806,2022-03-21,8,132,502,634
97807,2022-03-21,9,142,308,450
97808,2022-03-21,10,189,194,383
97809,2022-03-21,11,237,213,450
97810,2022-03-21,12,280,279,559
97811,2022-03-21,13,365,311,676
97812,2022-03-21,14,332,268,600
97813,2022-03-21,15,358,405,763
97814,2022-03-21,16,417,532,949
97815,2022-03-21,17,639,813,1452
97816,2022-03-21,18,653,704,1357
97817,2022-03-21,19,394,537,931
97818,2022-03-21,20,182,305,487
97819,2022-03-21,21,159,200,359
97820,2022-03-21,22,90,100,190
97821,2022-03-21,23,60,60,120
97822,2022-03-22,0,13,23,36
97823,2022-03-22,1,10,11,21
97824,2022-03-22,2,6,3,9
97825,2022-03-22,3,3,6,9
97826,2022-03-22,4,5,10,15
97827,2022-03-22,5,13,58,71
97828,2022-03-22,6,103,174,277
97829,2022-03-22,7,133,423,556
97830,2022-03-22,8,217,662,879
97831,2022-03-22,9,164,418,582
97832,2022-03-22,10,188,241,429
97833,2022-03-22,11,232,253,485
97834,2022-03-22,12,275,338,613
97835,2022-03-22,13,287,295,582
97836,2022-03-22,14,343,280,623
97837,2022-03-22,15,451,407,858
97838,2022-03-22,16,472,502,974
97839,2022-03-22,17,807,988,1795
97840,2022-03-22,18,731,847,1578
97841,2022-03-22,19,477,567,1044
97842,2022-03-22,20,201,334,535
97843,2022-03-22,21,174,235,409
97844,2022-03-22,22,100,135,235
97845,2022-03-22,23,54,72,126
97846,2022-03-23,0,13,34,47
97847,2022-03-23,1,10,7,17
97848,2022-03-23,2,7,5,12
97849,2022-03-23,3,2,7,9
97850,2022-03-23,4,5,8,13
97851,2022-03-23,5,15,57,72
97852,2022-03-23,6,62,148,210
97853,2022-03-23,7,145,390,535
97854,2022-03-23,8,217,626,843
97855,2022-03-23,9,210,349,559
97856,2022-03-23,10,132,219,351
97857,2022-03-23,11,116,226,342
97858,2022-03-23,12,69,127,196
97859,2022-03-23,13,47,123,170
97860,2022-03-23,14,52,116,168
97861,2022-03-23,15,115,197,312
97862,2022-03-23,16,136,352,488
97863,2022-03-23,17,175,490,665
97864,2022-03-23,18,80,293,373
97865,2022-03-23,19,42,147,189
97866,2022-03-23,20,30,82,112
97867,2022-03-23,21,27,54,81
97868,2022-03-23,22,27,70,97
97869,2022-03-23,23,11,33,44
97870,2022-03-24,0,9,13,22
97871,2022-03-24,1,3,0,3
97872,2022-03-24,2,2,6,8
97873,2022-03-24,3,3,2,5
97874,2022-03-24,4,5,11,16
97875,2022-03-24,5,7,40,47
97876,2022-03-24,6,25,107,132
97877,2022-03-24,7,54,233,287
97878,2022-03-24,8,113,409,522
97879,2022-03-24,9,122,282,404
97880,2022-03-24,10,94,189,283
97881,2022-03-24,11,166,205,371
97882,2022-03-24,12,157,297,454
97883,2022-03-24,13,217,274,491
97884,2022-03-24,14,206,211,417
97885,2022-03-24,15,249,297,546
97886,2022-03-24,16,276,374,650
97887,2022-03-24,17,384,618,1002
97888,2022-03-24,18,292,525,817
97889,2022-03-24,19,131,334,465
97890,2022-03-24,20,78,174,252
97891,2022-03-24,21,76,156,232
97892,2022-03-24,22,64,129,193
97893,2022-03-24,23,42,70,112
97894,2022-03-25,0,37,56,93
97895,2022-03-25,1,22,20,42
97896,2022-03-25,2,13,14,27
97897,2022-03-25,3,5,10,15
97898,2022-03-25,4,7,15,22
97899,2022-03-25,5,18,43,61
97900,2022-03-25,6,78,135,213
97901,2022-03-25,7,99,279,378
97902,2022-03-25,8,173,458,631
97903,2022-03-25,9,278,301,579
97904,2022-03-25,10,326,229,555
97905,2022-03-25,11,434,268,702
97906,2022-03-25,12,406,372,778
97907,2022-03-25,13,505,396,901
97908,2022-03-25,14,507,361,868
97909,2022-03-25,15,547,426,973
97910,2022-03-25,16,569,514,1083
97911,2022-03-25,17,654,645,1299
97912,2022-03-25,18,609,653,1262
97913,2022-03-25,19,414,475,889
97914,2022-03-25,20,214,260,474
97915,2022-03-25,21,129,184,313
97916,2022-03-25,22,99,158,257
97917,2022-03-25,23,113,137,250
97918,2022-03-26,0,117,120,237
97919,2022-03-26,1,66,95,161
97920,2022-03-26,2,37,45,82
97921,2022-03-26,3,13,23,36
97922,2022-03-26,4,5,8,13
97923,2022-03-26,5,15,10,25
97924,2022-03-26,6,61,56,117
97925,2022-03-26,7,183,172,355
97926,2022-03-26,8,218,216,434
97927,2022-03-26,9,373,273,646
97928,2022-03-26,10,493,378,871
97929,2022-03-26,11,624,410,1034
97930,2022-03-26,12,672,396,1068
97931,2022-03-26,13,566,336,902
97932,2022-03-26,14,617,374,991
97933,2022-03-26,15,550,336,886
97934,2022-03-26,16,502,321,823
97935,2022-03-26,17,488,320,808
97936,2022-03-26,18,379,336,715
97937,2022-03-26,19,204,256,460
97938,2022-03-26,20,115,160,275
97939,2022-03-26,21,78,117,195
97940,2022-03-26,22,86,113,199
97941,2022-03-26,23,73,115,188
97942,2022-03-27,0,64,62,126
97943,2022-03-27,1,46,51,97
97944,2022-03-27,2,48,57,105
97945,2022-03-27,3,10,18,28
97946,2022-03-27,4,10,8,18
97947,2022-03-27,5,10,10,20
97948,2022-03-27,6,27,27,54
97949,2022-03-27,7,38,49,87
97950,2022-03-27,8,111,120,231
97951,2022-03-27,9,187,153,340
97952,2022-03-27,10,201,254,455
97953,2022-03-27,11,219,269,488
97954,2022-03-27,12,221,253,474
97955,2022-03-27,13,249,273,522
97956,2022-03-27,14,197,223,420
97957,2022-03-27,15,256,261,517
97958,2022-03-27,16,199,257,456
97959,2022-03-27,17,163,246,409
97960,2022-03-27,18,123,188,311
97961,2022-03-27,19,98,139,237
97962,2022-03-27,20,49,104,153
97963,2022-03-27,21,35,75,110
97964,2022-03-27,22,37,70,107
97965,2022-03-27,23,24,45,69
97966,2022-03-28,0,12,10,22
97967,2022-03-28,1,3,11,14
97968,2022-03-28,2,2,4,6
97969,2022-03-28,3,4,3,7
97970,2022-03-28,4,5,5,10
97971,2022-03-28,5,12,25,37
97972,2022-03-28,6,32,121,153
97973,2022-03-28,7,58,205,263
97974,2022-03-28,8,105,383,488
97975,2022-03-28,9,94,218,312
97976,2022-03-28,10,85,140,225
97977,2022-03-28,11,74,140,214
97978,2022-03-28,12,92,197,289
97979,2022-03-28,13,89,160,249
97980,2022-03-28,14,69,161,230
97981,2022-03-28,15,105,240,345
97982,2022-03-28,16,106,276,382
97983,2022-03-28,17,143,386,529
97984,2022-03-28,18,99,315,414
97985,2022-03-28,19,68,273,341
97986,2022-03-28,20,44,154,198
97987,2022-03-28,21,36,112,148
97988,2022-03-28,22,30,65,95
97989,2022-03-28,23,4,30,34
97990,2022-03-29,0,3,9,12
97991,2022-03-29,1,2,3,5
97992,2022-03-29,2,0,1,1
97993,2022-03-29,3,1,2,3
97994,2022-03-29,4,2,12,14
97995,2022-03-29,5,7,37,44
97996,2022-03-29,6,29,122,151
97997,2022-03-29,7,52,255,307
97998,2022-03-29,8,117,405,522
97999,2022-03-29,9,90,273,363
98000,2022-03-29,10,77,143,220
98001,2022-03-29,11,99,151,250
98002,2022-03-29,12,83,214,297
98003,2022-03-29,13,122,212,334
98004,2022-03-29,14,125,194,319
98005,2022-03-29,15,142,249,391
98006,2022-03-29,16,177,344,521
98007,2022-03-29,17,249,546,795
98008,2022-03-29,18,234,491,725
98009,2022-03-29,19,127,381,508
98010,2022-03-29,20,97,204,301
98011,2022-03-29,21,88,190,278
98012,2022-03-29,22,68,121,189
98013,2022-03-29,23,45,50,95
98014,2022-03-30,0,22,19,41
98015,2022-03-30,1,4,3,7
98016,2022-03-30,2,1,5,6
98017,2022-03-30,3,0,4,4
98018,2022-03-30,4,7,8,15
98019,2022-03-30,5,7,41,48
98020,2022-03-30,6,27,110,137
98021,2022-03-30,7,49,205,254
98022,2022-03-30,8,101,494,595
98023,2022-03-30,9,104,302,406
98024,2022-03-30,10,124,188,312
98025,2022-03-30,11,122,198,320
98026,2022-03-30,12,160,235,395
98027,2022-03-30,13,196,264,460
98028,2022-03-30,14,231,249,480
98029,2022-03-30,15,235,323,558
98030,2022-03-30,16,261,432,693
98031,2022-03-30,17,387,696,1083
98032,2022-03-30,18,337,636,973
98033,2022-03-30,19,200,445,645
98034,2022-03-30,20,165,269,434
98035,2022-03-30,21,107,234,341
98036,2022-03-30,22,121,152,273
98037,2022-03-30,23,49,87,136
98038,2022-03-31,0,22,20,42
98039,2022-03-31,1,9,18,27
98040,2022-03-31,2,7,12,19
98041,2022-03-31,3,6,9,15
98042,2022-03-31,4,3,18,21
98043,2022-03-31,5,13,59,72
98044,2022-03-31,6,38,124,162
98045,2022-03-31,7,74,323,397
98046,2022-03-31,8,140,493,633
98047,2022-03-31,9,133,328,461
98048,2022-03-31,10,129,209,338
98049,2022-03-31,11,125,208,333
98050,2022-03-31,12,166,267,433
98051,2022-03-31,13,140,250,390
98052,2022-03-31,14,85,159,244
98053,2022-03-31,15,163,250,413
98054,2022-03-31,16,202,379,581
98055,2022-03-31,17,254,607,861
98056,2022-03-31,18,266,575,841
98057,2022-03-31,19,216,457,673
98058,2022-03-31,20,144,239,383
98059,2022-03-31,21,90,181,271
98060,2022-03-31,22,80,132,212
98061,2022-03-31,23,68,99,167
98062,2022-04-01,0,37,61,98
98063,2022-04-01,1,17,21,38
98064,2022-04-01,2,9,13,22
98065,2022-04-01,3,2,7,9
98066,2022-04-01,4,11,10,21
98067,2022-04-01,5,8,34,42
98068,2022-04-01,6,25,113,138
98069,2022-04-01,7,61,235,296
98070,2022-04-01,8,138,417,555
98071,2022-04-01,9,129,267,396
98072,2022-04-01,10,191,220,411
98073,2022-04-01,11,186,251,437
98074,2022-04-01,12,148,242,390
98075,2022-04-01,13,240,267,507
98076,2022-04-01,14,270,305,575
98077,2022-04-01,15,307,378,685
98078,2022-04-01,16,350,433,783
98079,2022-04-01,17,424,625,1049
98080,2022-04-01,18,337,527,864
98081,2022-04-01,19,236,411,647
98082,2022-04-01,20,118,226,344
98083,2022-04-01,21,119,191,310
98084,2022-04-01,22,98,154,252
98085,2022-04-01,23,67,130,197
98086,2022-04-02,0,75,95,170
98087,2022-04-02,1,50,61,111
98088,2022-04-02,2,33,49,82
98089,2022-04-02,3,10,21,31
98090,2022-04-02,4,11,11,22
98091,2022-04-02,5,5,12,17
98092,2022-04-02,6,21,33,54
98093,2022-04-02,7,29,81,110
98094,2022-04-02,8,101,162,263
98095,2022-04-02,9,207,294,501
98096,2022-04-02,10,382,362,744
98097,2022-04-02,11,531,412,943
98098,2022-04-02,12,706,441,1147
98099,2022-04-02,13,767,465,1232
98100,2022-04-02,14,795,453,1248
98101,2022-04-02,15,801,464,1265
98102,2022-04-02,16,787,470,1257
98103,2022-04-02,17,781,476,1257
98104,2022-04-02,18,564,437,1001
98105,2022-04-02,19,430,328,758
98106,2022-04-02,20,234,212,446
98107,2022-04-02,21,146,192,338
98108,2022-04-02,22,152,160,312
98109,2022-04-02,23,168,188,356
98110,2022-04-03,0,92,111,203
98111,2022-04-03,1,70,61,131
98112,2022-04-03,2,49,56,105
98113,2022-04-03,3,21,25,46
98114,2022-04-03,4,7,8,15
98115,2022-04-03,5,13,18,31
98116,2022-04-03,6,235,174,409
98117,2022-04-03,7,152,115,267
98118,2022-04-03,8,151,180,331
98119,2022-04-03,9,288,241,529
98120,2022-04-03,10,487,403,890
98121,2022-04-03,11,468,445,913
98122,2022-04-03,12,510,400,910
98123,2022-04-03,13,572,440,1012
98124,2022-04-03,14,582,373,955
98125,2022-04-03,15,480,370,850
98126,2022-04-03,16,381,355,736
98127,2022-04-03,17,267,280,547
98128,2022-04-03,18,235,262,497
98129,2022-04-03,19,119,189,308
98130,2022-04-03,20,88,127,215
98131,2022-04-03,21,71,112,183
98132,2022-04-03,22,62,86,148
98133,2022-04-03,23,24,43,67
98134,2022-04-04,0,19,19,38
98135,2022-04-04,1,12,11,23
98136,2022-04-04,2,5,11,16
98137,2022-04-04,3,1,4,5
98138,2022-04-04,4,12,10,22
98139,2022-04-04,5,15,33,48
98140,2022-04-04,6,18,125,143
98141,2022-04-04,7,85,267,352
98142,2022-04-04,8,156,454,610
98143,2022-04-04,9,133,285,418
98144,2022-04-04,10,178,179,357
98145,2022-04-04,11,215,207,422
98146,2022-04-04,12,221,248,469
98147,2022-04-04,13,273,233,506
98148,2022-04-04,14,315,249,564
98149,2022-04-04,15,296,307,603
98150,2022-04-04,16,266,387,653
98151,2022-04-04,17,376,614,990
98152,2022-04-04,18,302,566,868
98153,2022-04-04,19,204,374,578
98154,2022-04-04,20,142,290,432
98155,2022-04-04,21,108,173,281
98156,2022-04-04,22,65,88,153
98157,2022-04-04,23,63,90,153
98158,2022-04-05,0,38,25,63
98159,2022-04-05,1,12,9,21
98160,2022-04-05,2,1,4,5
98161,2022-04-05,3,2,7,9
98162,2022-04-05,4,6,9,15
98163,2022-04-05,5,17,50,67
98164,2022-04-05,6,48,160,208
98165,2022-04-05,7,83,342,425
98166,2022-04-05,8,115,386,501
98167,2022-04-05,9,71,217,288
98168,2022-04-05,10,39,102,141
98169,2022-04-05,11,30,79,109
98170,2022-04-05,12,28,97,125
98171,2022-04-05,13,45,112,157
98172,2022-04-05,14,59,135,194
98173,2022-04-05,15,111,214,325
98174,2022-04-05,16,150,327,477
98175,2022-04-05,17,213,587,800
98176,2022-04-05,18,189,537,726
98177,2022-04-05,19,100,230,330
98178,2022-04-05,20,46,110,156
98179,2022-04-05,21,24,61,85
98180,2022-04-05,22,15,36,51
98181,2022-04-05,23,8,22,30
98182,2022-04-06,0,3,13,16
98183,2022-04-06,1,0,5,5
98184,2022-04-06,2,0,3,3
98185,2022-04-06,3,2,4,6
98186,2022-04-06,4,8,5,13
98187,2022-04-06,5,8,33,41
98188,2022-04-06,6,35,107,142
98189,2022-04-06,7,62,250,312
98190,2022-04-06,8,84,330,414
98191,2022-04-06,9,69,184,253
98192,2022-04-06,10,72,167,239
98193,2022-04-06,11,102,171,273
98194,2022-04-06,12,115,249,364
98195,2022-04-06,13,149,287,436
98196,2022-04-06,14,142,266,408
98197,2022-04-06,15,193,369,562
98198,2022-04-06,16,207,406,613
98199,2022-04-06,17,326,732,1058
98200,2022-04-06,18,295,674,969
98201,2022-04-06,19,231,491,722
98202,2022-04-06,20,172,270,442
98203,2022-04-06,21,120,231,351
98204,2022-04-06,22,78,194,272
98205,2022-04-06,23,44,96,140
98206,2022-04-07,0,21,29,50
98207,2022-04-07,1,7,15,22
98208,2022-04-07,2,2,14,16
98209,2022-04-07,3,2,5,7
98210,2022-04-07,4,4,8,12
98211,2022-04-07,5,17,39,56
98212,2022-04-07,6,14,65,79
98213,2022-04-07,7,30,95,125
98214,2022-04-07,8,57,261,318
98215,2022-04-07,9,54,185,239
98216,2022-04-07,10,29,93,122
98217,2022-04-07,11,42,122,164
98218,2022-04-07,12,58,167,225
98219,2022-04-07,13,32,141,173
98220,2022-04-07,14,59,137,196
98221,2022-04-07,15,101,201,302
98222,2022-04-07,16,107,260,367
98223,2022-04-07,17,106,354,460
98224,2022-04-07,18,60,239,299
98225,2022-04-07,19,95,239,334
98226,2022-04-07,20,73,213,286
98227,2022-04-07,21,60,169,229
98228,2022-04-07,22,83,171,254
98229,2022-04-07,23,49,101,150
98230,2022-04-08,0,49,68,117
98231,2022-04-08,1,16,33,49
98232,2022-04-08,2,12,15,27
98233,2022-04-08,3,6,13,19
98234,2022-04-08,4,5,13,18
98235,2022-04-08,5,13,30,43
98236,2022-04-08,6,41,129,170
98237,2022-04-08,7,68,253,321
98238,2022-04-08,8,151,478,629
98239,2022-04-08,9,175,303,478
98240,2022-04-08,10,189,223,412
98241,2022-04-08,11,219,305,524
98242,2022-04-08,12,321,321,642
98243,2022-04-08,13,313,360,673
98244,2022-04-08,14,377,355,732
98245,2022-04-08,15,454,427,881
98246,2022-04-08,16,398,495,893
98247,2022-04-08,17,488,609,1097
98248,2022-04-08,18,404,576,980
98249,2022-04-08,19,302,466,768
98250,2022-04-08,20,152,289,441
98251,2022-04-08,21,128,199,327
98252,2022-04-08,22,99,154,253
98253,2022-04-08,23,70,110,180
98254,2022-04-09,0,56,89,145
98255,2022-04-09,1,40,55,95
98256,2022-04-09,2,34,52,86
98257,2022-04-09,3,16,12,28
98258,2022-04-09,4,8,7,15
98259,2022-04-09,5,7,14,21
98260,2022-04-09,6,20,35,55
98261,2022-04-09,7,50,103,153
98262,2022-04-09,8,118,173,291
98263,2022-04-09,9,245,276,521
98264,2022-04-09,10,416,357,773
98265,2022-04-09,11,458,407,865
98266,2022-04-09,12,579,429,1008
98267,2022-04-09,13,652,441,1093
98268,2022-04-09,14,693,436,1129
98269,2022-04-09,15,599,428,1027
98270,2022-04-09,16,545,356,901
98271,2022-04-09,17,526,394,920
98272,2022-04-09,18,356,335,691
98273,2022-04-09,19,274,300,574
98274,2022-04-09,20,145,192,337
98275,2022-04-09,21,124,152,276
98276,2022-04-09,22,123,153,276
98277,2022-04-09,23,111,157,268
98278,2022-04-10,0,81,110,191
98279,2022-04-10,1,55,72,127
98280,2022-04-10,2,57,39,96
98281,2022-04-10,3,24,24,48
98282,2022-04-10,4,8,4,12
98283,2022-04-10,5,6,10,16
98284,2022-04-10,6,24,49,73
98285,2022-04-10,7,31,61,92
98286,2022-04-10,8,83,106,189
98287,2022-04-10,9,194,183,377
98288,2022-04-10,10,272,265,537
98289,2022-04-10,11,305,288,593
98290,2022-04-10,12,319,334,653
98291,2022-04-10,13,341,326,667
98292,2022-04-10,14,285,341,626
98293,2022-04-10,15,366,333,699
98294,2022-04-10,16,337,343,680
98295,2022-04-10,17,347,319,666
98296,2022-04-10,18,261,325,586
98297,2022-04-10,19,183,281,464
98298,2022-04-10,20,119,167,286
98299,2022-04-10,21,82,108,190
98300,2022-04-10,22,68,83,151
98301,2022-04-10,23,32,52,84
98302,2022-04-11,0,11,18,29
98303,2022-04-11,1,8,9,17
98304,2022-04-11,2,1,14,15
98305,2022-04-11,3,4,6,10
98306,2022-04-11,4,6,11,17
98307,2022-04-11,5,10,34,44
98308,2022-04-11,6,29,133,162
98309,2022-04-11,7,59,260,319
98310,2022-04-11,8,127,452,579
98311,2022-04-11,9,140,266,406
98312,2022-04-11,10,186,204,390
98313,2022-04-11,11,226,211,437
98314,2022-04-11,12,273,301,574
98315,2022-04-11,13,269,269,538
98316,2022-04-11,14,329,283,612
98317,2022-04-11,15,342,314,656
98318,2022-04-11,16,324,423,747
98319,2022-04-11,17,449,680,1129
98320,2022-04-11,18,357,617,974
98321,2022-04-11,19,306,445,751
98322,2022-04-11,20,194,286,480
98323,2022-04-11,21,108,174,282
98324,2022-04-11,22,73,112,185
98325,2022-04-11,23,48,62,110
98326,2022-04-12,0,27,19,46
98327,2022-04-12,1,4,7,11
98328,2022-04-12,2,1,2,3
98329,2022-04-12,3,2,4,6
98330,2022-04-12,4,7,17,24
98331,2022-04-12,5,13,44,57
98332,2022-04-12,6,33,136,169
98333,2022-04-12,7,76,319,395
98334,2022-04-12,8,170,465,635
98335,2022-04-12,9,168,366,534
98336,2022-04-12,10,195,240,435
98337,2022-04-12,11,261,240,501
98338,2022-04-12,12,330,307,637
98339,2022-04-12,13,282,296,578
98340,2022-04-12,14,332,281,613
98341,2022-04-12,15,342,354,696
98342,2022-04-12,16,423,487,910
98343,2022-04-12,17,635,822,1457
98344,2022-04-12,18,523,829,1352
98345,2022-04-12,19,442,565,1007
98346,2022-04-12,20,255,347,602
98347,2022-04-12,21,191,289,480
98348,2022-04-12,22,128,215,343
98349,2022-04-12,23,73,85,158
98350,2022-04-13,0,33,42,75
98351,2022-04-13,1,17,9,26
98352,2022-04-13,2,5,5,10
98353,2022-04-13,3,4,7,11
98354,2022-04-13,4,4,9,13
98355,2022-04-13,5,17,43,60
98356,2022-04-13,6,50,150,200
98357,2022-04-13,7,102,368,470
98358,2022-04-13,8,221,592,813
98359,2022-04-13,9,214,390,604
98360,2022-04-13,10,283,279,562
98361,2022-04-13,11,290,273,563
98362,2022-04-13,12,320,291,611
98363,2022-04-13,13,379,327,706
98364,2022-04-13,14,323,314,637
98365,2022-04-13,15,360,367,727
98366,2022-04-13,16,383,526,909
98367,2022-04-13,17,556,839,1395
98368,2022-04-13,18,556,796,1352
98369,2022-04-13,19,443,519,962
98370,2022-04-13,20,285,360,645
98371,2022-04-13,21,181,296,477
98372,2022-04-13,22,195,212,407
98373,2022-04-13,23,94,119,213
98374,2022-04-14,0,39,45,84
98375,2022-04-14,1,31,14,45
98376,2022-04-14,2,12,8,20
98377,2022-04-14,3,3,8,11
98378,2022-04-14,4,3,15,18
98379,2022-04-14,5,9,42,51
98380,2022-04-14,6,40,136,176
98381,2022-04-14,7,96,333,429
98382,2022-04-14,8,199,561,760
98383,2022-04-14,9,208,364,572
98384,2022-04-14,10,265,249,514
98385,2022-04-14,11,279,267,546
98386,2022-04-14,12,312,324,636
98387,2022-04-14,13,285,309,594
98388,2022-04-14,14,319,286,605
98389,2022-04-14,15,331,328,659
98390,2022-04-14,16,242,318,560
98391,2022-04-14,17,463,671,1134
98392,2022-04-14,18,399,672,1071
98393,2022-04-14,19,285,380,665
98394,2022-04-14,20,170,306,476
98395,2022-04-14,21,156,201,357
98396,2022-04-14,22,153,187,340
98397,2022-04-14,23,83,97,180
98398,2022-04-15,0,38,59,97
98399,2022-04-15,1,27,27,54
98400,2022-04-15,2,11,19,30
98401,2022-04-15,3,5,12,17
98402,2022-04-15,4,6,14,20
98403,2022-04-15,5,14,40,54
98404,2022-04-15,6,34,103,137
98405,2022-04-15,7,87,234,321
98406,2022-04-15,8,151,375,526
98407,2022-04-15,9,242,263,505
98408,2022-04-15,10,422,277,699
98409,2022-04-15,11,526,311,837
98410,2022-04-15,12,575,402,977
98411,2022-04-15,13,561,377,938
98412,2022-04-15,14,609,398,1007
98413,2022-04-15,15,650,443,1093
98414,2022-04-15,16,679,581,1260
98415,2022-04-15,17,699,600,1299
98416,2022-04-15,18,564,554,1118
98417,2022-04-15,19,422,398,820
98418,2022-04-15,20,258,276,534
98419,2022-04-15,21,207,180,387
98420,2022-04-15,22,141,179,320
98421,2022-04-15,23,132,142,274
98422,2022-04-16,0,80,116,196
98423,2022-04-16,1,58,76,134
98424,2022-04-16,2,70,55,125
98425,2022-04-16,3,17,34,51
98426,2022-04-16,4,9,15,24
98427,2022-04-16,5,6,18,24
98428,2022-04-16,6,29,34,63
98429,2022-04-16,7,54,117,171
98430,2022-04-16,8,129,188,317
98431,2022-04-16,9,301,322,623
98432,2022-04-16,10,541,356,897
98433,2022-04-16,11,689,405,1094
98434,2022-04-16,12,846,423,1269
98435,2022-04-16,13,938,427,1365
98436,2022-04-16,14,898,489,1387
98437,2022-04-16,15,892,454,1346
98438,2022-04-16,16,873,446,1319
98439,2022-04-16,17,804,428,1232
98440,2022-04-16,18,410,323,733
98441,2022-04-16,19,281,243,524
98442,2022-04-16,20,171,173,344
98443,2022-04-16,21,138,155,293
98444,2022-04-16,22,226,182,408
98445,2022-04-16,23,141,154,295
98446,2022-04-17,0,99,100,199
98447,2022-04-17,1,60,70,130
98448,2022-04-17,2,41,38,79
98449,2022-04-17,3,49,24,73
98450,2022-04-17,4,8,6,14
98451,2022-04-17,5,28,8,36
98452,2022-04-17,6,40,35,75
98453,2022-04-17,7,32,72,104
98454,2022-04-17,8,119,132,251
98455,2022-04-17,9,243,202,445
98456,2022-04-17,10,393,301,694
98457,2022-04-17,11,476,295,771
98458,2022-04-17,12,507,383,890
98459,2022-04-17,13,528,341,869
98460,2022-04-17,14,518,296,814
98461,2022-04-17,15,511,358,869
98462,2022-04-17,16,499,318,817
98463,2022-04-17,17,440,347,787
98464,2022-04-17,18,380,283,663
98465,2022-04-17,19,282,243,525
98466,2022-04-17,20,123,186,309
98467,2022-04-17,21,111,113,224
98468,2022-04-17,22,88,85,173
98469,2022-04-17,23,32,43,75
98470,2022-04-18,0,13,44,57
98471,2022-04-18,1,4,15,19
98472,2022-04-18,2,3,12,15
98473,2022-04-18,3,1,5,6
98474,2022-04-18,4,5,20,25
98475,2022-04-18,5,11,51,62
98476,2022-04-18,6,26,123,149
98477,2022-04-18,7,66,267,333
98478,2022-04-18,8,123,388,511
98479,2022-04-18,9,75,195,270
98480,2022-04-18,10,105,132,237
98481,2022-04-18,11,88,131,219
98482,2022-04-18,12,74,141,215
98483,2022-04-18,13,31,107,138
98484,2022-04-18,14,38,82,120
98485,2022-04-18,15,35,76,111
98486,2022-04-18,16,33,87,120
98487,2022-04-18,17,63,237,300
98488,2022-04-18,18,71,247,318
98489,2022-04-18,19,20,60,80
98490,2022-04-18,20,11,50,61
98491,2022-04-18,21,6,43,49
98492,2022-04-18,22,14,28,42
98493,2022-04-18,23,3,24,27
98494,2022-04-19,0,2,12,14
98495,2022-04-19,1,0,8,8
98496,2022-04-19,2,1,3,4
98497,2022-04-19,3,1,3,4
98498,2022-04-19,4,4,15,19
98499,2022-04-19,5,10,47,57
98500,2022-04-19,6,24,147,171
98501,2022-04-19,7,87,353,440
98502,2022-04-19,8,158,539,697
98503,2022-04-19,9,144,327,471
98504,2022-04-19,10,119,188,307
98505,2022-04-19,11,141,185,326
98506,2022-04-19,12,159,254,413
98507,2022-04-19,13,134,264,398
98508,2022-04-19,14,121,203,324
98509,2022-04-19,15,219,312,531
98510,2022-04-19,16,215,384,599
98511,2022-04-19,17,304,696,1000
98512,2022-04-19,18,280,561,841
98513,2022-04-19,19,146,439,585
98514,2022-04-19,20,115,247,362
98515,2022-04-19,21,93,206,299
98516,2022-04-19,22,66,127,193
98517,2022-04-19,23,58,60,118
98518,2022-04-20,0,20,30,50
98519,2022-04-20,1,3,8,11
98520,2022-04-20,2,6,1,7
98521,2022-04-20,3,2,3,5
98522,2022-04-20,4,3,11,14
98523,2022-04-20,5,10,39,49
98524,2022-04-20,6,40,151,191
98525,2022-04-20,7,92,357,449
98526,2022-04-20,8,165,654,819
98527,2022-04-20,9,168,347,515
98528,2022-04-20,10,198,227,425
98529,2022-04-20,11,240,215,455
98530,2022-04-20,12,211,300,511
98531,2022-04-20,13,263,263,526
98532,2022-04-20,14,303,264,567
98533,2022-04-20,15,316,375,691
98534,2022-04-20,16,330,492,822
98535,2022-04-20,17,498,820,1318
98536,2022-04-20,18,441,791,1232
98537,2022-04-20,19,308,534,842
98538,2022-04-20,20,198,306,504
98539,2022-04-20,21,146,266,412
98540,2022-04-20,22,93,199,292
98541,2022-04-20,23,53,78,131
98542,2022-04-21,0,14,35,49
98543,2022-04-21,1,11,13,24
98544,2022-04-21,2,2,9,11
98545,2022-04-21,3,4,14,18
98546,2022-04-21,4,2,14,16
98547,2022-04-21,5,18,44,62
98548,2022-04-21,6,32,140,172
98549,2022-04-21,7,88,352,440
98550,2022-04-21,8,213,615,828
98551,2022-04-21,9,174,348,522
98552,2022-04-21,10,198,215,413
98553,2022-04-21,11,208,230,438
98554,2022-04-21,12,234,284,518
98555,2022-04-21,13,277,306,583
98556,2022-04-21,14,264,257,521
98557,2022-04-21,15,301,340,641
98558,2022-04-21,16,357,480,837
98559,2022-04-21,17,425,753,1178
98560,2022-04-21,18,395,645,1040
98561,2022-04-21,19,313,497,810
98562,2022-04-21,20,223,354,577
98563,2022-04-21,21,153,280,433
98564,2022-04-21,22,174,220,394
98565,2022-04-21,23,100,125,225
98566,2022-04-22,0,35,55,90
98567,2022-04-22,1,31,35,66
98568,2022-04-22,2,22,20,42
98569,2022-04-22,3,3,17,20
98570,2022-04-22,4,8,11,19
98571,2022-04-22,5,14,45,59
98572,2022-04-22,6,42,138,180
98573,2022-04-22,7,102,308,410
98574,2022-04-22,8,187,482,669
98575,2022-04-22,9,220,351,571
98576,2022-04-22,10,244,222,466
98577,2022-04-22,11,313,302,615
98578,2022-04-22,12,354,355,709
98579,2022-04-22,13,402,365,767
98580,2022-04-22,14,421,374,795
98581,2022-04-22,15,509,461,970
98582,2022-04-22,16,582,578,1160
98583,2022-04-22,17,607,750,1357
98584,2022-04-22,18,571,645,1216
98585,2022-04-22,19,401,481,882
98586,2022-04-22,20,264,320,584
98587,2022-04-22,21,219,245,464
98588,2022-04-22,22,213,221,434
98589,2022-04-22,23,184,186,370
98590,2022-04-23,0,116,133,249
98591,2022-04-23,1,93,106,199
98592,2022-04-23,2,56,61,117
98593,2022-04-23,3,19,29,48
98594,2022-04-23,4,11,16,27
98595,2022-04-23,5,17,14,31
98596,2022-04-23,6,33,71,104
98597,2022-04-23,7,57,134,191
98598,2022-04-23,8,133,216,349
98599,2022-04-23,9,325,291,616
98600,2022-04-23,10,438,364,802
98601,2022-04-23,11,528,449,977
98602,2022-04-23,12,621,514,1135
98603,2022-04-23,13,697,481,1178
98604,2022-04-23,14,691,467,1158
98605,2022-04-23,15,740,450,1190
98606,2022-04-23,16,729,519,1248
98607,2022-04-23,17,746,506,1252
98608,2022-04-23,18,620,471,1091
98609,2022-04-23,19,485,426,911
98610,2022-04-23,20,329,293,622
98611,2022-04-23,21,309,237,546
98612,2022-04-23,22,253,223,476
98613,2022-04-23,23,189,194,383
98614,2022-04-24,0,148,116,264
98615,2022-04-24,1,122,110,232
98616,2022-04-24,2,72,43,115
98617,2022-04-24,3,38,32,70
98618,2022-04-24,4,13,9,22
98619,2022-04-24,5,12,13,25
98620,2022-04-24,6,20,39,59
98621,2022-04-24,7,48,84,132
98622,2022-04-24,8,120,174,294
98623,2022-04-24,9,280,278,558
98624,2022-04-24,10,454,388,842
98625,2022-04-24,11,596,471,1067
98626,2022-04-24,12,687,519,1206
98627,2022-04-24,13,694,515,1209
98628,2022-04-24,14,749,517,1266
98629,2022-04-24,15,673,449,1122
98630,2022-04-24,16,638,424,1062
98631,2022-04-24,17,609,499,1108
98632,2022-04-24,18,558,453,1011
98633,2022-04-24,19,418,343,761
98634,2022-04-24,20,239,258,497
98635,2022-04-24,21,164,146,310
98636,2022-04-24,22,159,143,302
98637,2022-04-24,23,67,59,126
98638,2022-04-25,0,36,42,78
98639,2022-04-25,1,12,19,31
98640,2022-04-25,2,11,20,31
98641,2022-04-25,3,4,4,8
98642,2022-04-25,4,8,18,26
98643,2022-04-25,5,17,50,67
98644,2022-04-25,6,32,171,203
98645,2022-04-25,7,82,345,427
98646,2022-04-25,8,205,536,741
98647,2022-04-25,9,156,302,458
98648,2022-04-25,10,164,199,363
98649,2022-04-25,11,212,243,455
98650,2022-04-25,12,207,300,507
98651,2022-04-25,13,245,266,511
98652,2022-04-25,14,243,284,527
98653,2022-04-25,15,275,332,607
98654,2022-04-25,16,335,514,849
98655,2022-04-25,17,446,749,1195
98656,2022-04-25,18,440,692,1132
98657,2022-04-25,19,366,498,864
98658,2022-04-25,20,192,347,539
98659,2022-04-25,21,138,248,386
98660,2022-04-25,22,81,125,206
98661,2022-04-25,23,55,74,129
98662,2022-04-26,0,19,32,51
98663,2022-04-26,1,6,11,17
98664,2022-04-26,2,5,9,14
98665,2022-04-26,3,3,2,5
98666,2022-04-26,4,4,17,21
98667,2022-04-26,5,12,74,86
98668,2022-04-26,6,49,176,225
98669,2022-04-26,7,108,442,550
98670,2022-04-26,8,230,687,917
98671,2022-04-26,9,188,380,568
98672,2022-04-26,10,201,236,437
98673,2022-04-26,11,172,234,406
98674,2022-04-26,12,192,334,526
98675,2022-04-26,13,187,305,492
98676,2022-04-26,14,161,196,357
98677,2022-04-26,15,123,242,365
98678,2022-04-26,16,114,282,396
98679,2022-04-26,17,202,508,710
98680,2022-04-26,18,214,494,708
98681,2022-04-26,19,119,309,428
98682,2022-04-26,20,75,225,300
98683,2022-04-26,21,99,187,286
98684,2022-04-26,22,112,143,255
98685,2022-04-26,23,55,91,146
98686,2022-04-27,0,22,38,60
98687,2022-04-27,1,10,6,16
98688,2022-04-27,2,10,3,13
98689,2022-04-27,3,1,2,3
98690,2022-04-27,4,8,17,25
98691,2022-04-27,5,15,52,67
98692,2022-04-27,6,42,171,213
98693,2022-04-27,7,97,398,495
98694,2022-04-27,8,208,677,885
98695,2022-04-27,9,156,390,546
98696,2022-04-27,10,150,218,368
98697,2022-04-27,11,172,231,403
98698,2022-04-27,12,185,302,487
98699,2022-04-27,13,168,286,454
98700,2022-04-27,14,195,280,475
98701,2022-04-27,15,194,366,560
98702,2022-04-27,16,306,449,755
98703,2022-04-27,17,436,769,1205
98704,2022-04-27,18,425,703,1128
98705,2022-04-27,19,274,544,818
98706,2022-04-27,20,202,300,502
98707,2022-04-27,21,134,268,402
98708,2022-04-27,22,91,150,241
98709,2022-04-27,23,46,83,129
98710,2022-04-28,0,21,29,50
98711,2022-04-28,1,7,16,23
98712,2022-04-28,2,10,8,18
98713,2022-04-28,3,1,4,5
98714,2022-04-28,4,2,15,17
98715,2022-04-28,5,10,38,48
98716,2022-04-28,6,29,130,159
98717,2022-04-28,7,80,358,438
98718,2022-04-28,8,168,518,686
98719,2022-04-28,9,130,316,446
98720,2022-04-28,10,131,204,335
98721,2022-04-28,11,147,206,353
98722,2022-04-28,12,169,293,462
98723,2022-04-28,13,206,281,487
98724,2022-04-28,14,201,276,477
98725,2022-04-28,15,223,343,566
98726,2022-04-28,16,314,464,778
98727,2022-04-28,17,401,793,1194
98728,2022-04-28,18,425,726,1151
98729,2022-04-28,19,297,496,793
98730,2022-04-28,20,176,341,517
98731,2022-04-28,21,155,241,396
98732,2022-04-28,22,134,182,316
98733,2022-04-28,23,75,108,183
98734,2022-04-29,0,50,42,92
98735,2022-04-29,1,18,44,62
98736,2022-04-29,2,18,14,32
98737,2022-04-29,3,7,16,23
98738,2022-04-29,4,7,20,27
98739,2022-04-29,5,15,41,56
98740,2022-04-29,6,39,127,166
98741,2022-04-29,7,84,282,366
98742,2022-04-29,8,159,460,619
98743,2022-04-29,9,168,305,473
98744,2022-04-29,10,207,252,459
98745,2022-04-29,11,288,271,559
98746,2022-04-29,12,275,313,588
98747,2022-04-29,13,316,343,659
98748,2022-04-29,14,342,384,726
98749,2022-04-29,15,408,447,855
98750,2022-04-29,16,429,520,949
98751,2022-04-29,17,586,658,1244
98752,2022-04-29,18,497,595,1092
98753,2022-04-29,19,430,472,902
98754,2022-04-29,20,258,300,558
98755,2022-04-29,21,201,169,370
98756,2022-04-29,22,179,193,372
98757,2022-04-29,23,125,127,252
98758,2022-04-30,0,104,84,188
98759,2022-04-30,1,78,81,159
98760,2022-04-30,2,67,41,108
98761,2022-04-30,3,17,18,35
98762,2022-04-30,4,11,7,18
98763,2022-04-30,5,10,20,30
98764,2022-04-30,6,27,55,82
98765,2022-04-30,7,47,87,134
98766,2022-04-30,8,137,144,281
98767,2022-04-30,9,250,295,545
98768,2022-04-30,10,459,409,868
98769,2022-04-30,11,530,392,922
98770,2022-04-30,12,615,439,1054
98771,2022-04-30,13,693,458,1151
98772,2022-04-30,14,727,474,1201
98773,2022-04-30,15,742,476,1218
98774,2022-04-30,16,709,530,1239
98775,2022-04-30,17,573,518,1091
98776,2022-04-30,18,562,427,989
98777,2022-04-30,19,410,397,807
98778,2022-04-30,20,312,288,600
98779,2022-04-30,21,238,206,444
98780,2022-04-30,22,192,211,403
98781,2022-04-30,23,244,199,443
98782,2022-05-01,0,137,119,256
98783,2022-05-01,1,68,85,153
98784,2022-05-01,2,66,61,127
98785,2022-05-01,3,42,24,66
98786,2022-05-01,4,6,8,14
98787,2022-05-01,5,21,23,44
98788,2022-05-01,6,61,59,120
98789,2022-05-01,7,67,98,165
98790,2022-05-01,8,152,186,338
98791,2022-05-01,9,224,271,495
98792,2022-05-01,10,378,343,721
98793,2022-05-01,11,384,408,792
98794,2022-05-01,12,474,455,929
98795,2022-05-01,13,484,394,878
98796,2022-05-01,14,144,163,307
98797,2022-05-01,15,118,183,301
98798,2022-05-01,16,176,225,401
98799,2022-05-01,17,230,255,485
98800,2022-05-01,18,194,282,476
98801,2022-05-01,19,165,285,450
98802,2022-05-01,20,140,161,301
98803,2022-05-01,21,91,110,201
98804,2022-05-01,22,83,103,186
98805,2022-05-01,23,126,54,180
98806,2022-05-02,0,49,43,92
98807,2022-05-02,1,18,12,30
98808,2022-05-02,2,5,8,13
98809,2022-05-02,3,9,9,18
98810,2022-05-02,4,7,11,18
98811,2022-05-02,5,27,36,63
98812,2022-05-02,6,47,144,191
98813,2022-05-02,7,95,334,429
98814,2022-05-02,8,187,526,713
98815,2022-05-02,9,191,312,503
98816,2022-05-02,10,219,203,422
98817,2022-05-02,11,240,241,481
98818,2022-05-02,12,267,320,587
98819,2022-05-02,13,279,281,560
98820,2022-05-02,14,296,313,609
98821,2022-05-02,15,330,389,719
98822,2022-05-02,16,405,507,912
98823,2022-05-02,17,493,759,1252
98824,2022-05-02,18,495,710,1205
98825,2022-05-02,19,432,531,963
98826,2022-05-02,20,240,364,604
98827,2022-05-02,21,197,270,467
98828,2022-05-02,22,143,151,294
98829,2022-05-02,23,87,108,195
98830,2022-05-03,0,40,49,89
98831,2022-05-03,1,48,21,69
98832,2022-05-03,2,10,14,24
98833,2022-05-03,3,6,5,11
98834,2022-05-03,4,4,11,15
98835,2022-05-03,5,28,64,92
98836,2022-05-03,6,52,160,212
98837,2022-05-03,7,123,382,505
98838,2022-05-03,8,244,631,875
98839,2022-05-03,9,168,400,568
98840,2022-05-03,10,181,209,390
98841,2022-05-03,11,178,227,405
98842,2022-05-03,12,207,300,507
98843,2022-05-03,13,239,281,520
98844,2022-05-03,14,259,276,535
98845,2022-05-03,15,281,348,629
98846,2022-05-03,16,371,495,866
98847,2022-05-03,17,562,900,1462
98848,2022-05-03,18,531,813,1344
98849,2022-05-03,19,430,631,1061
98850,2022-05-03,20,274,434,708
98851,2022-05-03,21,180,285,465
98852,2022-05-03,22,132,176,308
98853,2022-05-03,23,50,97,147
98854,2022-05-04,0,45,30,75
98855,2022-05-04,1,2,5,7
98856,2022-05-04,2,1,4,5
98857,2022-05-04,3,1,6,7
98858,2022-05-04,4,2,5,7
98859,2022-05-04,5,7,45,52
98860,2022-05-04,6,50,156,206
98861,2022-05-04,7,78,348,426
98862,2022-05-04,8,190,648,838
98863,2022-05-04,9,156,361,517
98864,2022-05-04,10,173,211,384
98865,2022-05-04,11,168,256,424
98866,2022-05-04,12,185,272,457
98867,2022-05-04,13,213,275,488
98868,2022-05-04,14,226,280,506
98869,2022-05-04,15,307,371,678
98870,2022-05-04,16,333,459,792
98871,2022-05-04,17,467,829,1296
98872,2022-05-04,18,451,767,1218
98873,2022-05-04,19,340,543,883
98874,2022-05-04,20,206,384,590
98875,2022-05-04,21,161,283,444
98876,2022-05-04,22,144,192,336
98877,2022-05-04,23,84,123,207
98878,2022-05-05,0,51,40,91
98879,2022-05-05,1,22,21,43
98880,2022-05-05,2,6,10,16
98881,2022-05-05,3,3,11,14
98882,2022-05-05,4,5,14,19
98883,2022-05-05,5,11,44,55
98884,2022-05-05,6,49,162,211
98885,2022-05-05,7,109,385,494
98886,2022-05-05,8,221,620,841
98887,2022-05-05,9,211,370,581
98888,2022-05-05,10,227,214,441
98889,2022-05-05,11,187,249,436
98890,2022-05-05,12,252,293,545
98891,2022-05-05,13,270,281,551
98892,2022-05-05,14,273,257,530
98893,2022-05-05,15,325,356,681
98894,2022-05-05,16,318,496,814
98895,2022-05-05,17,489,788,1277
98896,2022-05-05,18,473,688,1161
98897,2022-05-05,19,281,514,795
98898,2022-05-05,20,250,345,595
98899,2022-05-05,21,174,278,452
98900,2022-05-05,22,143,202,345
98901,2022-05-05,23,111,143,254
98902,2022-05-06,0,79,92,171
98903,2022-05-06,1,69,51,120
98904,2022-05-06,2,27,21,48
98905,2022-05-06,3,7,18,25
98906,2022-05-06,4,9,14,23
98907,2022-05-06,5,14,42,56
98908,2022-05-06,6,28,110,138
98909,2022-05-06,7,55,173,228
98910,2022-05-06,8,40,233,273
98911,2022-05-06,9,31,81,112
98912,2022-05-06,10,25,56,81
98913,2022-05-06,11,39,102,141
98914,2022-05-06,12,32,90,122
98915,2022-05-06,13,71,154,225
98916,2022-05-06,14,86,110,196
98917,2022-05-06,15,106,201,307
98918,2022-05-06,16,130,320,450
98919,2022-05-06,17,176,346,522
98920,2022-05-06,18,83,221,304
98921,2022-05-06,19,39,111,150
98922,2022-05-06,20,48,100,148
98923,2022-05-06,21,32,88,120
98924,2022-05-06,22,26,56,82
98925,2022-05-06,23,49,77,126
98926,2022-05-07,0,21,45,66
98927,2022-05-07,1,9,19,28
98928,2022-05-07,2,7,19,26
98929,2022-05-07,3,7,13,20
98930,2022-05-07,4,4,14,18
98931,2022-05-07,5,9,11,20
98932,2022-05-07,6,9,36,45
98933,2022-05-07,7,8,48,56
98934,2022-05-07,8,17,44,61
98935,2022-05-07,9,23,68,91
98936,2022-05-07,10,68,160,228
98937,2022-05-07,11,57,139,196
98938,2022-05-07,12,67,144,211
98939,2022-05-07,13,48,151,199
98940,2022-05-07,14,76,133,209
98941,2022-05-07,15,63,137,200
98942,2022-05-07,16,59,100,159
98943,2022-05-07,17,47,123,170
98944,2022-05-07,18,56,117,173
98945,2022-05-07,19,50,154,204
98946,2022-05-07,20,41,82,123
98947,2022-05-07,21,31,79,110
98948,2022-05-07,22,45,59,104
98949,2022-05-07,23,59,63,122
98950,2022-05-08,0,40,70,110
98951,2022-05-08,1,47,43,90
98952,2022-05-08,2,25,32,57
98953,2022-05-08,3,19,18,37
98954,2022-05-08,4,5,11,16
98955,2022-05-08,5,4,12,16
98956,2022-05-08,6,16,27,43
98957,2022-05-08,7,26,64,90
98958,2022-05-08,8,43,126,169
98959,2022-05-08,9,93,170,263
98960,2022-05-08,10,173,254,427
98961,2022-05-08,11,200,306,506
98962,2022-05-08,12,196,310,506
98963,2022-05-08,13,276,316,592
98964,2022-05-08,14,306,329,635
98965,2022-05-08,15,274,345,619
98966,2022-05-08,16,279,363,642
98967,2022-05-08,17,282,326,608
98968,2022-05-08,18,220,305,525
98969,2022-05-08,19,140,242,382
98970,2022-05-08,20,124,200,324
98971,2022-05-08,21,109,104,213
98972,2022-05-08,22,82,77,159
98973,2022-05-08,23,43,51,94
98974,2022-05-09,0,35,28,63
98975,2022-05-09,1,14,19,33
98976,2022-05-09,2,5,7,12
98977,2022-05-09,3,5,5,10
98978,2022-05-09,4,6,17,23
98979,2022-05-09,5,11,37,48
98980,2022-05-09,6,38,142,180
98981,2022-05-09,7,87,323,410
98982,2022-05-09,8,159,525,684
98983,2022-05-09,9,140,269,409
98984,2022-05-09,10,145,220,365
98985,2022-05-09,11,180,227,407
98986,2022-05-09,12,221,276,497
98987,2022-05-09,13,269,283,552
98988,2022-05-09,14,258,295,553
98989,2022-05-09,15,277,380,657
98990,2022-05-09,16,312,475,787
98991,2022-05-09,17,440,815,1255
98992,2022-05-09,18,453,765,1218
98993,2022-05-09,19,284,538,822
98994,2022-05-09,20,198,338,536
98995,2022-05-09,21,139,204,343
98996,2022-05-09,22,113,159,272
98997,2022-05-09,23,79,82,161
98998,2022-05-10,0,22,40,62
98999,2022-05-10,1,8,18,26
99000,2022-05-10,2,2,7,9
99001,2022-05-10,3,0,5,5
99002,2022-05-10,4,2,11,13
99003,2022-05-10,5,16,49,65
99004,2022-05-10,6,47,181,228
99005,2022-05-10,7,108,416,524
99006,2022-05-10,8,193,645,838
99007,2022-05-10,9,176,381,557
99008,2022-05-10,10,177,230,407
99009,2022-05-10,11,194,243,437
99010,2022-05-10,12,220,332,552
99011,2022-05-10,13,255,314,569
99012,2022-05-10,14,278,311,589
99013,2022-05-10,15,334,406,740
99014,2022-05-10,16,372,502,874
99015,2022-05-10,17,518,917,1435
99016,2022-05-10,18,557,873,1430
99017,2022-05-10,19,395,502,897
99018,2022-05-10,20,257,413,670
99019,2022-05-10,21,239,254,493
99020,2022-05-10,22,140,217,357
99021,2022-05-10,23,79,106,185
99022,2022-05-11,0,24,35,59
99023,2022-05-11,1,13,14,27
99024,2022-05-11,2,5,5,10
99025,2022-05-11,3,2,4,6
99026,2022-05-11,4,5,12,17
99027,2022-05-11,5,20,66,86
99028,2022-05-11,6,57,177,234
99029,2022-05-11,7,131,421,552
99030,2022-05-11,8,219,729,948
99031,2022-05-11,9,206,387,593
99032,2022-05-11,10,199,226,425
99033,2022-05-11,11,220,258,478
99034,2022-05-11,12,217,326,543
99035,2022-05-11,13,242,305,547
99036,2022-05-11,14,306,297,603
99037,2022-05-11,15,296,392,688
99038,2022-05-11,16,319,532,851
99039,2022-05-11,17,518,895,1413
99040,2022-05-11,18,500,766,1266
99041,2022-05-11,19,398,508,906
99042,2022-05-11,20,213,382,595
99043,2022-05-11,21,195,263,458
99044,2022-05-11,22,176,228,404
99045,2022-05-11,23,95,95,190
99046,2022-05-12,0,43,51,94
99047,2022-05-12,1,17,13,30
99048,2022-05-12,2,8,19,27
99049,2022-05-12,3,4,8,12
99050,2022-05-12,4,3,15,18
99051,2022-05-12,5,15,49,64
99052,2022-05-12,6,52,166,218
99053,2022-05-12,7,140,383,523
99054,2022-05-12,8,215,621,836
99055,2022-05-12,9,153,353,506
99056,2022-05-12,10,147,206,353
99057,2022-05-12,11,218,294,512
99058,2022-05-12,12,265,280,545
99059,2022-05-12,13,224,298,522
99060,2022-05-12,14,317,293,610
99061,2022-05-12,15,323,362,685
99062,2022-05-12,16,335,505,840
99063,2022-05-12,17,532,764,1296
99064,2022-05-12,18,470,696,1166
99065,2022-05-12,19,308,488,796
99066,2022-05-12,20,277,347,624
99067,2022-05-12,21,231,261,492
99068,2022-05-12,22,150,200,350
99069,2022-05-12,23,136,138,274
99070,2022-05-13,0,36,60,96
99071,2022-05-13,1,26,44,70
99072,2022-05-13,2,25,28,53
99073,2022-05-13,3,6,16,22
99074,2022-05-13,4,6,22,28
99075,2022-05-13,5,7,18,25
99076,2022-05-13,6,33,97,130
99077,2022-05-13,7,53,218,271
99078,2022-05-13,8,96,330,426
99079,2022-05-13,9,121,237,358
99080,2022-05-13,10,167,195,362
99081,2022-05-13,11,237,230,467
99082,2022-05-13,12,260,254,514
99083,2022-05-13,13,296,296,592
99084,2022-05-13,14,341,296,637
99085,2022-05-13,15,386,361,747
99086,2022-05-13,16,447,443,890
99087,2022-05-13,17,452,632,1084
99088,2022-05-13,18,419,545,964
99089,2022-05-13,19,386,410,796
99090,2022-05-13,20,265,285,550
99091,2022-05-13,21,193,232,425
99092,2022-05-13,22,216,224,440
99093,2022-05-13,23,252,192,444
99094,2022-05-14,0,136,145,281
99095,2022-05-14,1,104,90,194
99096,2022-05-14,2,76,65,141
99097,2022-05-14,3,35,30,65
99098,2022-05-14,4,10,10,20
99099,2022-05-14,5,10,11,21
99100,2022-05-14,6,29,46,75
99101,2022-05-14,7,55,115,170
99102,2022-05-14,8,111,217,328
99103,2022-05-14,9,254,351,605
99104,2022-05-14,10,402,373,775
99105,2022-05-14,11,436,433,869
99106,2022-05-14,12,532,446,978
99107,2022-05-14,13,654,456,1110
99108,2022-05-14,14,560,426,986
99109,2022-05-14,15,506,368,874
99110,2022-05-14,16,530,366,896
99111,2022-05-14,17,441,365,806
99112,2022-05-14,18,337,377,714
99113,2022-05-14,19,307,321,628
99114,2022-05-14,20,239,229,468
99115,2022-05-14,21,247,214,461
99116,2022-05-14,22,227,182,409
99117,2022-05-14,23,207,189,396
99118,2022-05-15,0,131,116,247
99119,2022-05-15,1,106,79,185
99120,2022-05-15,2,80,80,160
99121,2022-05-15,3,38,31,69
99122,2022-05-15,4,20,15,35
99123,2022-05-15,5,7,17,24
99124,2022-05-15,6,31,39,70
99125,2022-05-15,7,50,112,162
99126,2022-05-15,8,131,177,308
99127,2022-05-15,9,277,242,519
99128,2022-05-15,10,321,330,651
99129,2022-05-15,11,482,399,881
99130,2022-05-15,12,582,486,1068
99131,2022-05-15,13,638,526,1164
99132,2022-05-15,14,650,506,1156
99133,2022-05-15,15,737,497,1234
99134,2022-05-15,16,667,511,1178
99135,2022-05-15,17,519,468,987
99136,2022-05-15,18,448,442,890
99137,2022-05-15,19,176,209,385
99138,2022-05-15,20,85,129,214
99139,2022-05-15,21,113,133,246
99140,2022-05-15,22,105,107,212
99141,2022-05-15,23,58,49,107
99142,2022-05-16,0,32,41,73
99143,2022-05-16,1,13,10,23
99144,2022-05-16,2,13,18,31
99145,2022-05-16,3,4,5,9
99146,2022-05-16,4,15,13,28
99147,2022-05-16,5,19,64,83
99148,2022-05-16,6,55,156,211
99149,2022-05-16,7,111,351,462
99150,2022-05-16,8,182,554,736
99151,2022-05-16,9,158,305,463
99152,2022-05-16,10,146,155,301
99153,2022-05-16,11,84,126,210
99154,2022-05-16,12,87,115,202
99155,2022-05-16,13,171,206,377
99156,2022-05-16,14,218,241,459
99157,2022-05-16,15,255,303,558
99158,2022-05-16,16,173,339,512
99159,2022-05-16,17,223,478,701
99160,2022-05-16,18,311,576,887
99161,2022-05-16,19,387,454,841
99162,2022-05-16,20,235,331,566
99163,2022-05-16,21,153,246,399
99164,2022-05-16,22,98,129,227
99165,2022-05-16,23,69,79,148
99166,2022-05-17,0,29,43,72
99167,2022-05-17,1,10,11,21
99168,2022-05-17,2,9,22,31
99169,2022-05-17,3,8,5,13
99170,2022-05-17,4,10,22,32
99171,2022-05-17,5,34,59,93
99172,2022-05-17,6,52,183,235
99173,2022-05-17,7,132,430,562
99174,2022-05-17,8,249,714,963
99175,2022-05-17,9,208,422,630
99176,2022-05-17,10,195,253,448
99177,2022-05-17,11,248,255,503
99178,2022-05-17,12,254,361,615
99179,2022-05-17,13,253,367,620
99180,2022-05-17,14,275,300,575
99181,2022-05-17,15,322,426,748
99182,2022-05-17,16,400,540,940
99183,2022-05-17,17,544,903,1447
99184,2022-05-17,18,525,825,1350
99185,2022-05-17,19,438,606,1044
99186,2022-05-17,20,318,436,754
99187,2022-05-17,21,222,251,473
99188,2022-05-17,22,172,211,383
99189,2022-05-17,23,72,102,174
99190,2022-05-18,0,33,43,76
99191,2022-05-18,1,16,12,28
99192,2022-05-18,2,10,8,18
99193,2022-05-18,3,6,11,17
99194,2022-05-18,4,10,17,27
99195,2022-05-18,5,20,67,87
99196,2022-05-18,6,62,163,225
99197,2022-05-18,7,155,398,553
99198,2022-05-18,8,227,692,919
99199,2022-05-18,9,243,416,659
99200,2022-05-18,10,211,241,452
99201,2022-05-18,11,214,275,489
99202,2022-05-18,12,269,278,547
99203,2022-05-18,13,280,286,566
99204,2022-05-18,14,284,295,579
99205,2022-05-18,15,321,408,729
99206,2022-05-18,16,386,530,916
99207,2022-05-18,17,495,867,1362
99208,2022-05-18,18,575,756,1331
99209,2022-05-18,19,422,528,950
99210,2022-05-18,20,256,359,615
99211,2022-05-18,21,177,313,490
99212,2022-05-18,22,140,186,326
99213,2022-05-18,23,72,109,181
99214,2022-05-19,0,24,31,55
99215,2022-05-19,1,5,12,17
99216,2022-05-19,2,3,10,13
99217,2022-05-19,3,1,13,14
99218,2022-05-19,4,5,15,20
99219,2022-05-19,5,13,46,59
99220,2022-05-19,6,44,160,204
99221,2022-05-19,7,114,368,482
99222,2022-05-19,8,231,621,852
99223,2022-05-19,9,189,317,506
99224,2022-05-19,10,191,204,395
99225,2022-05-19,11,232,256,488
99226,2022-05-19,12,260,291,551
99227,2022-05-19,13,259,289,548
99228,2022-05-19,14,275,301,576
99229,2022-05-19,15,323,379,702
99230,2022-05-19,16,402,488,890
99231,2022-05-19,17,541,817,1358
99232,2022-05-19,18,536,754,1290
99233,2022-05-19,19,459,602,1061
99234,2022-05-19,20,364,440,804
99235,2022-05-19,21,239,277,516
99236,2022-05-19,22,140,205,345
99237,2022-05-19,23,112,107,219
99238,2022-05-20,0,53,62,115
99239,2022-05-20,1,27,42,69
99240,2022-05-20,2,19,13,32
99241,2022-05-20,3,6,11,17
99242,2022-05-20,4,7,19,26
99243,2022-05-20,5,21,52,73
99244,2022-05-20,6,60,157,217
99245,2022-05-20,7,147,433,580
99246,2022-05-20,8,235,552,787
99247,2022-05-20,9,230,353,583
99248,2022-05-20,10,320,289,609
99249,2022-05-20,11,310,286,596
99250,2022-05-20,12,415,340,755
99251,2022-05-20,13,336,343,679
99252,2022-05-20,14,359,335,694
99253,2022-05-20,15,456,438,894
99254,2022-05-20,16,439,469,908
99255,2022-05-20,17,585,582,1167
99256,2022-05-20,18,441,550,991
99257,2022-05-20,19,387,440,827
99258,2022-05-20,20,288,322,610
99259,2022-05-20,21,237,247,484
99260,2022-05-20,22,166,241,407
99261,2022-05-20,23,163,169,332
99262,2022-05-21,0,160,111,271
99263,2022-05-21,1,124,56,180
99264,2022-05-21,2,74,43,117
99265,2022-05-21,3,41,35,76
99266,2022-05-21,4,17,19,36
99267,2022-05-21,5,37,23,60
99268,2022-05-21,6,71,89,160
99269,2022-05-21,7,71,155,226
99270,2022-05-21,8,187,247,434
99271,2022-05-21,9,337,348,685
99272,2022-05-21,10,420,378,798
99273,2022-05-21,11,516,439,955
99274,2022-05-21,12,535,423,958
99275,2022-05-21,13,546,376,922
99276,2022-05-21,14,511,363,874
99277,2022-05-21,15,509,382,891
99278,2022-05-21,16,534,411,945
99279,2022-05-21,17,469,374,843
99280,2022-05-21,18,398,386,784
99281,2022-05-21,19,408,324,732
99282,2022-05-21,20,352,282,634
99283,2022-05-21,21,296,254,550
99284,2022-05-21,22,243,246,489
99285,2022-05-21,23,239,167,406
99286,2022-05-22,0,131,113,244
99287,2022-05-22,1,109,93,202
99288,2022-05-22,2,75,58,133
99289,2022-05-22,3,67,35,102
99290,2022-05-22,4,14,12,26
99291,2022-05-22,5,20,22,42
99292,2022-05-22,6,44,79,123
99293,2022-05-22,7,69,135,204
99294,2022-05-22,8,165,175,340
99295,2022-05-22,9,280,291,571
99296,2022-05-22,10,418,369,787
99297,2022-05-22,11,526,387,913
99298,2022-05-22,12,500,410,910
99299,2022-05-22,13,515,436,951
99300,2022-05-22,14,538,368,906
99301,2022-05-22,15,497,391,888
99302,2022-05-22,16,453,397,850
99303,2022-05-22,17,316,296,612
99304,2022-05-22,18,171,169,340
99305,2022-05-22,19,128,180,308
99306,2022-05-22,20,19,29,48
99307,2022-05-22,21,15,22,37
99308,2022-05-22,22,46,69,115
99309,2022-05-22,23,42,53,95
99310,2022-05-23,0,22,34,56
99311,2022-05-23,1,10,9,19
99312,2022-05-23,2,9,8,17
99313,2022-05-23,3,7,5,12
99314,2022-05-23,4,9,14,23
99315,2022-05-23,5,25,52,77
99316,2022-05-23,6,53,187,240
99317,2022-05-23,7,118,394,512
99318,2022-05-23,8,202,562,764
99319,2022-05-23,9,219,325,544
99320,2022-05-23,10,251,221,472
99321,2022-05-23,11,288,234,522
99322,2022-05-23,12,293,282,575
99323,2022-05-23,13,326,296,622
99324,2022-05-23,14,360,269,629
99325,2022-05-23,15,410,416,826
99326,2022-05-23,16,408,541,949
99327,2022-05-23,17,490,701,1191
99328,2022-05-23,18,355,601,956
99329,2022-05-23,19,240,398,638
99330,2022-05-23,20,148,226,374
99331,2022-05-23,21,88,143,231
99332,2022-05-23,22,88,104,192
99333,2022-05-23,23,51,73,124
99334,2022-05-24,0,25,24,49
99335,2022-05-24,1,13,8,21
99336,2022-05-24,2,3,1,4
99337,2022-05-24,3,1,2,3
99338,2022-05-24,4,1,8,9
99339,2022-05-24,5,7,33,40
99340,2022-05-24,6,24,109,133
99341,2022-05-24,7,42,250,292
99342,2022-05-24,8,131,459,590
99343,2022-05-24,9,149,304,453
99344,2022-05-24,10,119,186,305
99345,2022-05-24,11,72,157,229
99346,2022-05-24,12,100,173,273
99347,2022-05-24,13,70,152,222
99348,2022-05-24,14,168,237,405
99349,2022-05-24,15,234,353,587
99350,2022-05-24,16,261,434,695
99351,2022-05-24,17,421,849,1270
99352,2022-05-24,18,399,711,1110
99353,2022-05-24,19,283,554,837
99354,2022-05-24,20,198,323,521
99355,2022-05-24,21,152,222,374
99356,2022-05-24,22,128,166,294
99357,2022-05-24,23,61,101,162
99358,2022-05-25,0,40,36,76
99359,2022-05-25,1,10,16,26
99360,2022-05-25,2,6,7,13
99361,2022-05-25,3,2,7,9
99362,2022-05-25,4,6,12,18
99363,2022-05-25,5,33,61,94
99364,2022-05-25,6,50,192,242
99365,2022-05-25,7,126,425,551
99366,2022-05-25,8,240,689,929
99367,2022-05-25,9,190,382,572
99368,2022-05-25,10,165,270,435
99369,2022-05-25,11,208,250,458
99370,2022-05-25,12,244,325,569
99371,2022-05-25,13,290,340,630
99372,2022-05-25,14,276,343,619
99373,2022-05-25,15,335,427,762
99374,2022-05-25,16,402,509,911
99375,2022-05-25,17,502,828,1330
99376,2022-05-25,18,447,806,1253
99377,2022-05-25,19,371,552,923
99378,2022-05-25,20,290,409,699
99379,2022-05-25,21,176,257,433
99380,2022-05-25,22,145,152,297
99381,2022-05-25,23,79,119,198
99382,2022-05-26,0,36,37,73
99383,2022-05-26,1,18,18,36
99384,2022-05-26,2,8,11,19
99385,2022-05-26,3,2,5,7
99386,2022-05-26,4,8,16,24
99387,2022-05-26,5,16,45,61
99388,2022-05-26,6,51,155,206
99389,2022-05-26,7,108,374,482
99390,2022-05-26,8,197,582,779
99391,2022-05-26,9,193,365,558
99392,2022-05-26,10,210,214,424
99393,2022-05-26,11,231,249,480
99394,2022-05-26,12,245,300,545
99395,2022-05-26,13,296,310,606
99396,2022-05-26,14,320,280,600
99397,2022-05-26,15,355,399,754
99398,2022-05-26,16,350,476,826
99399,2022-05-26,17,457,885,1342
99400,2022-05-26,18,427,668,1095
99401,2022-05-26,19,386,510,896
99402,2022-05-26,20,258,344,602
99403,2022-05-26,21,222,266,488
99404,2022-05-26,22,183,213,396
99405,2022-05-26,23,87,91,178
99406,2022-05-27,0,44,59,103
99407,2022-05-27,1,15,25,40
99408,2022-05-27,2,18,10,28
99409,2022-05-27,3,7,12,19
99410,2022-05-27,4,12,12,24
99411,2022-05-27,5,33,45,78
99412,2022-05-27,6,53,125,178
99413,2022-05-27,7,106,263,369
99414,2022-05-27,8,166,410,576
99415,2022-05-27,9,179,290,469
99416,2022-05-27,10,185,247,432
99417,2022-05-27,11,209,256,465
99418,2022-05-27,12,120,167,287
99419,2022-05-27,13,96,130,226
99420,2022-05-27,14,189,242,431
99421,2022-05-27,15,307,403,710
99422,2022-05-27,16,310,432,742
99423,2022-05-27,17,356,471,827
99424,2022-05-27,18,323,456,779
99425,2022-05-27,19,317,356,673
99426,2022-05-27,20,214,206,420
99427,2022-05-27,21,63,99,162
99428,2022-05-27,22,55,81,136
99429,2022-05-27,23,82,93,175
99430,2022-05-28,0,83,73,156
99431,2022-05-28,1,58,50,108
99432,2022-05-28,2,34,40,74
99433,2022-05-28,3,27,17,44
99434,2022-05-28,4,11,7,18
99435,2022-05-28,5,16,15,31
99436,2022-05-28,6,35,61,96
99437,2022-05-28,7,66,102,168
99438,2022-05-28,8,155,239,394
99439,2022-05-28,9,291,327,618
99440,2022-05-28,10,457,411,868
99441,2022-05-28,11,692,473,1165
99442,2022-05-28,12,707,462,1169
99443,2022-05-28,13,740,493,1233
99444,2022-05-28,14,774,469,1243
99445,2022-05-28,15,768,419,1187
99446,2022-05-28,16,662,401,1063
99447,2022-05-28,17,709,363,1072
99448,2022-05-28,18,544,422,966
99449,2022-05-28,19,480,366,846
99450,2022-05-28,20,380,235,615
99451,2022-05-28,21,332,202,534
99452,2022-05-28,22,247,160,407
99453,2022-05-28,23,153,139,292
99454,2022-05-29,0,127,104,231
99455,2022-05-29,1,99,78,177
99456,2022-05-29,2,57,50,107
99457,2022-05-29,3,41,19,60
99458,2022-05-29,4,18,12,30
99459,2022-05-29,5,27,12,39
99460,2022-05-29,6,38,44,82
99461,2022-05-29,7,68,126,194
99462,2022-05-29,8,174,165,339
99463,2022-05-29,9,374,249,623
99464,2022-05-29,10,511,355,866
99465,2022-05-29,11,686,373,1059
99466,2022-05-29,12,817,421,1238
99467,2022-05-29,13,952,455,1407
99468,2022-05-29,14,859,436,1295
99469,2022-05-29,15,821,398,1219
99470,2022-05-29,16,750,417,1167
99471,2022-05-29,17,740,416,1156
99472,2022-05-29,18,671,387,1058
99473,2022-05-29,19,533,342,875
99474,2022-05-29,20,431,284,715
99475,2022-05-29,21,277,239,516
99476,2022-05-29,22,193,157,350
99477,2022-05-29,23,153,140,293
99478,2022-05-30,0,138,72,210
99479,2022-05-30,1,76,60,136
99480,2022-05-30,2,44,18,62
99481,2022-05-30,3,25,22,47
99482,2022-05-30,4,22,11,33
99483,2022-05-30,5,26,12,38
99484,2022-05-30,6,40,64,104
99485,2022-05-30,7,72,114,186
99486,2022-05-30,8,150,185,335
99487,2022-05-30,9,308,275,583
99488,2022-05-30,10,533,331,864
99489,2022-05-30,11,585,346,931
99490,2022-05-30,12,588,417,1005
99491,2022-05-30,13,607,494,1101
99492,2022-05-30,14,606,416,1022
99493,2022-05-30,15,555,421,976
99494,2022-05-30,16,558,428,986
99495,2022-05-30,17,512,388,900
99496,2022-05-30,18,491,380,871
99497,2022-05-30,19,371,344,715
99498,2022-05-30,20,280,259,539
99499,2022-05-30,21,211,205,416
99500,2022-05-30,22,127,114,241
99501,2022-05-30,23,62,72,134
99502,2022-05-31,0,44,19,63
99503,2022-05-31,1,13,11,24
99504,2022-05-31,2,7,3,10
99505,2022-05-31,3,8,11,19
99506,2022-05-31,4,12,12,24
99507,2022-05-31,5,24,48,72
99508,2022-05-31,6,63,152,215
99509,2022-05-31,7,137,414,551
99510,2022-05-31,8,188,616,804
99511,2022-05-31,9,206,378,584
99512,2022-05-31,10,197,234,431
99513,2022-05-31,11,223,228,451
99514,2022-05-31,12,193,283,476
99515,2022-05-31,13,211,283,494
99516,2022-05-31,14,236,248,484
99517,2022-05-31,15,254,345,599
99518,2022-05-31,16,229,427,656
99519,2022-05-31,17,422,706,1128
99520,2022-05-31,18,446,751,1197
99521,2022-05-31,19,369,568,937
99522,2022-05-31,20,253,412,665
99523,2022-05-31,21,232,267,499
99524,2022-05-31,22,155,182,337
99525,2022-05-31,23,83,88,171
99526,2022-06-01,0,41,25,66
99527,2022-06-01,1,11,15,26
99528,2022-06-01,2,8,11,19
99529,2022-06-01,3,4,4,8
99530,2022-06-01,4,7,21,28
99531,2022-06-01,5,27,70,97
99532,2022-06-01,6,78,223,301
99533,2022-06-01,7,150,474,624
99534,2022-06-01,8,237,706,943
99535,2022-06-01,9,212,360,572
99536,2022-06-01,10,173,215,388
99537,2022-06-01,11,191,209,400
99538,2022-06-01,12,207,287,494
99539,2022-06-01,13,210,254,464
99540,2022-06-01,14,223,242,465
99541,2022-06-01,15,232,369,601
99542,2022-06-01,16,285,465,750
99543,2022-06-01,17,455,790,1245
99544,2022-06-01,18,522,725,1247
99545,2022-06-01,19,374,549,923
99546,2022-06-01,20,336,410,746
99547,2022-06-01,21,188,266,454
99548,2022-06-01,22,153,179,332
99549,2022-06-01,23,71,104,175
99550,2022-06-02,0,44,55,99
99551,2022-06-02,1,15,13,28
99552,2022-06-02,2,5,11,16
99553,2022-06-02,3,7,12,19
99554,2022-06-02,4,7,13,20
99555,2022-06-02,5,22,64,86
99556,2022-06-02,6,60,185,245
99557,2022-06-02,7,133,431,564
99558,2022-06-02,8,268,702,970
99559,2022-06-02,9,219,393,612
99560,2022-06-02,10,218,221,439
99561,2022-06-02,11,219,240,459
99562,2022-06-02,12,242,311,553
99563,2022-06-02,13,248,230,478
99564,2022-06-02,14,154,190,344
99565,2022-06-02,15,124,192,316
99566,2022-06-02,16,183,316,499
99567,2022-06-02,17,117,318,435
99568,2022-06-02,18,161,373,534
99569,2022-06-02,19,252,403,655
99570,2022-06-02,20,188,340,528
99571,2022-06-02,21,108,182,290
99572,2022-06-02,22,88,131,219
99573,2022-06-02,23,42,51,93
99574,2022-06-03,0,39,36,75
99575,2022-06-03,1,15,15,30
99576,2022-06-03,2,9,4,13
99577,2022-06-03,3,4,11,15
99578,2022-06-03,4,9,11,20
99579,2022-06-03,5,27,54,81
99580,2022-06-03,6,69,175,244
99581,2022-06-03,7,118,396,514
99582,2022-06-03,8,226,560,786
99583,2022-06-03,9,189,339,528
99584,2022-06-03,10,261,255,516
99585,2022-06-03,11,268,295,563
99586,2022-06-03,12,326,357,683
99587,2022-06-03,13,365,346,711
99588,2022-06-03,14,394,402,796
99589,2022-06-03,15,434,482,916
99590,2022-06-03,16,507,568,1075
99591,2022-06-03,17,625,797,1422
99592,2022-06-03,18,567,691,1258
99593,2022-06-03,19,505,510,1015
99594,2022-06-03,20,448,379,827
99595,2022-06-03,21,300,257,557
99596,2022-06-03,22,224,230,454
99597,2022-06-03,23,180,199,379
99598,2022-06-04,0,144,142,286
99599,2022-06-04,1,110,85,195
99600,2022-06-04,2,60,59,119
99601,2022-06-04,3,38,23,61
99602,2022-06-04,4,10,6,16
99603,2022-06-04,5,26,21,47
99604,2022-06-04,6,26,61,87
99605,2022-06-04,7,79,149,228
99606,2022-06-04,8,207,209,416
99607,2022-06-04,9,350,380,730
99608,2022-06-04,10,500,516,1016
99609,2022-06-04,11,645,564,1209
99610,2022-06-04,12,678,519,1197
99611,2022-06-04,13,692,526,1218
99612,2022-06-04,14,757,538,1295
99613,2022-06-04,15,673,570,1243
99614,2022-06-04,16,641,530,1171
99615,2022-06-04,17,645,471,1116
99616,2022-06-04,18,589,450,1039
99617,2022-06-04,19,552,398,950
99618,2022-06-04,20,432,341,773
99619,2022-06-04,21,344,267,611
99620,2022-06-04,22,275,210,485
99621,2022-06-04,23,196,202,398
99622,2022-06-05,0,174,118,292
99623,2022-06-05,1,123,83,206
99624,2022-06-05,2,59,62,121
99625,2022-06-05,3,36,27,63
99626,2022-06-05,4,8,11,19
99627,2022-06-05,5,14,17,31
99628,2022-06-05,6,16,57,73
99629,2022-06-05,7,60,111,171
99630,2022-06-05,8,124,190,314
99631,2022-06-05,9,286,283,569
99632,2022-06-05,10,442,420,862
99633,2022-06-05,11,512,479,991
99634,2022-06-05,12,567,513,1080
99635,2022-06-05,13,692,526,1218
99636,2022-06-05,14,642,541,1183
99637,2022-06-05,15,624,530,1154
99638,2022-06-05,16,587,514,1101
99639,2022-06-05,17,570,505,1075
99640,2022-06-05,18,540,431,971
99641,2022-06-05,19,482,428,910
99642,2022-06-05,20,341,318,659
99643,2022-06-05,21,198,187,385
99644,2022-06-05,22,164,169,333
99645,2022-06-05,23,70,75,145
99646,2022-06-06,0,32,21,53
99647,2022-06-06,1,11,17,28
99648,2022-06-06,2,3,10,13
99649,2022-06-06,3,4,4,8
99650,2022-06-06,4,11,20,31
99651,2022-06-06,5,33,55,88
99652,2022-06-06,6,55,178,233
99653,2022-06-06,7,145,422,567
99654,2022-06-06,8,231,641,872
99655,2022-06-06,9,230,339,569
99656,2022-06-06,10,220,240,460
99657,2022-06-06,11,213,278,491
99658,2022-06-06,12,324,321,645
99659,2022-06-06,13,331,268,599
99660,2022-06-06,14,336,299,635
99661,2022-06-06,15,336,388,724
99662,2022-06-06,16,401,490,891
99663,2022-06-06,17,531,863,1394
99664,2022-06-06,18,571,806,1377
99665,2022-06-06,19,451,540,991
99666,2022-06-06,20,338,435,773
99667,2022-06-06,21,233,257,490
99668,2022-06-06,22,149,167,316
99669,2022-06-06,23,79,81,160
99670,2022-06-07,0,20,36,56
99671,2022-06-07,1,7,11,18
99672,2022-06-07,2,2,9,11
99673,2022-06-07,3,2,8,10
99674,2022-06-07,4,8,12,20
99675,2022-06-07,5,28,60,88
99676,2022-06-07,6,87,207,294
99677,2022-06-07,7,183,478,661
99678,2022-06-07,8,296,802,1098
99679,2022-06-07,9,201,403,604
99680,2022-06-07,10,217,257,474
99681,2022-06-07,11,253,269,522
99682,2022-06-07,12,277,316,593
99683,2022-06-07,13,281,283,564
99684,2022-06-07,14,289,297,586
99685,2022-06-07,15,186,266,452
99686,2022-06-07,16,174,236,410
99687,2022-06-07,17,259,454,713
99688,2022-06-07,18,306,619,925
99689,2022-06-07,19,162,318,480
99690,2022-06-07,20,127,229,356
99691,2022-06-07,21,88,155,243
99692,2022-06-07,22,84,145,229
99693,2022-06-07,23,40,79,119
99694,2022-06-08,0,19,31,50
99695,2022-06-08,1,10,4,14
99696,2022-06-08,2,6,6,12
99697,2022-06-08,3,2,3,5
99698,2022-06-08,4,8,15,23
99699,2022-06-08,5,22,77,99
99700,2022-06-08,6,68,211,279
99701,2022-06-08,7,163,491,654
99702,2022-06-08,8,296,795,1091
99703,2022-06-08,9,225,393,618
99704,2022-06-08,10,232,247,479
99705,2022-06-08,11,270,269,539
99706,2022-06-08,12,308,302,610
99707,2022-06-08,13,270,305,575
99708,2022-06-08,14,273,259,532
99709,2022-06-08,15,306,393,699
99710,2022-06-08,16,366,529,895
99711,2022-06-08,17,503,863,1366
99712,2022-06-08,18,405,761,1166
99713,2022-06-08,19,167,352,519
99714,2022-06-08,20,175,300,475
99715,2022-06-08,21,143,268,411
99716,2022-06-08,22,120,165,285
99717,2022-06-08,23,147,139,286
99718,2022-06-09,0,55,56,111
99719,2022-06-09,1,25,14,39
99720,2022-06-09,2,4,1,5
99721,2022-06-09,3,1,4,5
99722,2022-06-09,4,6,18,24
99723,2022-06-09,5,20,53,73
99724,2022-06-09,6,56,210,266
99725,2022-06-09,7,137,437,574
99726,2022-06-09,8,277,732,1009
99727,2022-06-09,9,233,438,671
99728,2022-06-09,10,222,264,486
99729,2022-06-09,11,259,249,508
99730,2022-06-09,12,302,333,635
99731,2022-06-09,13,321,286,607
99732,2022-06-09,14,278,321,599
99733,2022-06-09,15,292,372,664
99734,2022-06-09,16,419,508,927
99735,2022-06-09,17,623,907,1530
99736,2022-06-09,18,614,863,1477
99737,2022-06-09,19,487,676,1163
99738,2022-06-09,20,386,479,865
99739,2022-06-09,21,287,346,633
99740,2022-06-09,22,207,263,470
99741,2022-06-09,23,137,149,286
99742,2022-06-10,0,65,78,143
99743,2022-06-10,1,36,32,68
99744,2022-06-10,2,19,14,33
99745,2022-06-10,3,4,11,15
99746,2022-06-10,4,12,12,24
99747,2022-06-10,5,22,55,77
99748,2022-06-10,6,66,169,235
99749,2022-06-10,7,125,345,470
99750,2022-06-10,8,247,603,850
99751,2022-06-10,9,229,375,604
99752,2022-06-10,10,315,286,601
99753,2022-06-10,11,363,354,717
99754,2022-06-10,12,363,383,746
99755,2022-06-10,13,408,397,805
99756,2022-06-10,14,416,396,812
99757,2022-06-10,15,502,496,998
99758,2022-06-10,16,551,638,1189
99759,2022-06-10,17,719,812,1531
99760,2022-06-10,18,669,684,1353
99761,2022-06-10,19,521,543,1064
99762,2022-06-10,20,410,410,820
99763,2022-06-10,21,339,297,636
99764,2022-06-10,22,268,273,541
99765,2022-06-10,23,205,218,423
99766,2022-06-11,0,155,163,318
99767,2022-06-11,1,119,118,237
99768,2022-06-11,2,84,58,142
99769,2022-06-11,3,39,37,76
99770,2022-06-11,4,13,25,38
99771,2022-06-11,5,10,19,29
99772,2022-06-11,6,26,56,82
99773,2022-06-11,7,40,70,110
99774,2022-06-11,8,65,122,187
99775,2022-06-11,9,140,170,310
99776,2022-06-11,10,216,279,495
99777,2022-06-11,11,392,378,770
99778,2022-06-11,12,422,433,855
99779,2022-06-11,13,532,484,1016
99780,2022-06-11,14,628,481,1109
99781,2022-06-11,15,668,474,1142
99782,2022-06-11,16,562,422,984
99783,2022-06-11,17,619,491,1110
99784,2022-06-11,18,529,472,1001
99785,2022-06-11,19,575,416,991
99786,2022-06-11,20,387,334,721
99787,2022-06-11,21,319,312,631
99788,2022-06-11,22,300,203,503
99789,2022-06-11,23,261,203,464
99790,2022-06-12,0,176,132,308
99791,2022-06-12,1,139,99,238
99792,2022-06-12,2,77,84,161
99793,2022-06-12,3,56,32,88
99794,2022-06-12,4,15,17,32
99795,2022-06-12,5,8,17,25
99796,2022-06-12,6,36,27,63
99797,2022-06-12,7,45,65,110
99798,2022-06-12,8,77,132,209
99799,2022-06-12,9,149,189,338
99800,2022-06-12,10,292,257,549
99801,2022-06-12,11,308,382,690
99802,2022-06-12,12,569,425,994
99803,2022-06-12,13,606,532,1138
99804,2022-06-12,14,668,540,1208
99805,2022-06-12,15,628,545,1173
99806,2022-06-12,16,654,519,1173
99807,2022-06-12,17,602,535,1137
99808,2022-06-12,18,571,485,1056
99809,2022-06-12,19,464,422,886
99810,2022-06-12,20,344,327,671
99811,2022-06-12,21,226,265,491
99812,2022-06-12,22,136,137,273
99813,2022-06-12,23,69,109,178
99814,2022-06-13,0,32,37,69
99815,2022-06-13,1,25,15,40
99816,2022-06-13,2,16,10,26
99817,2022-06-13,3,2,7,9
99818,2022-06-13,4,3,18,21
99819,2022-06-13,5,29,50,79
99820,2022-06-13,6,83,206,289
99821,2022-06-13,7,129,412,541
99822,2022-06-13,8,217,639,856
99823,2022-06-13,9,204,359,563
99824,2022-06-13,10,240,223,463
99825,2022-06-13,11,242,259,501
99826,2022-06-13,12,291,304,595
99827,2022-06-13,13,291,310,601
99828,2022-06-13,14,288,282,570
99829,2022-06-13,15,311,362,673
99830,2022-06-13,16,376,461,837
99831,2022-06-13,17,501,831,1332
99832,2022-06-13,18,463,858,1321
99833,2022-06-13,19,235,402,637
99834,2022-06-13,20,188,342,530
99835,2022-06-13,21,142,232,374
99836,2022-06-13,22,126,168,294
99837,2022-06-13,23,95,115,210
99838,2022-06-14,0,25,39,64
99839,2022-06-14,1,10,11,21
99840,2022-06-14,2,6,4,10
99841,2022-06-14,3,2,7,9
99842,2022-06-14,4,5,9,14
99843,2022-06-14,5,25,45,70
99844,2022-06-14,6,59,195,254
99845,2022-06-14,7,165,462,627
99846,2022-06-14,8,262,710,972
99847,2022-06-14,9,208,402,610
99848,2022-06-14,10,204,203,407
99849,2022-06-14,11,257,224,481
99850,2022-06-14,12,217,325,542
99851,2022-06-14,13,221,277,498
99852,2022-06-14,14,222,205,427
99853,2022-06-14,15,285,394,679
99854,2022-06-14,16,369,525,894
99855,2022-06-14,17,548,929,1477
99856,2022-06-14,18,536,873,1409
99857,2022-06-14,19,437,667,1104
99858,2022-06-14,20,305,481,786
99859,2022-06-14,21,244,408,652
99860,2022-06-14,22,242,291,533
99861,2022-06-14,23,115,138,253
99862,2022-06-15,0,40,36,76
99863,2022-06-15,1,9,9,18
99864,2022-06-15,2,7,8,15
99865,2022-06-15,3,2,6,8
99866,2022-06-15,4,13,15,28
99867,2022-06-15,5,32,71,103
99868,2022-06-15,6,71,225,296
99869,2022-06-15,7,153,446,599
99870,2022-06-15,8,320,821,1141
99871,2022-06-15,9,229,426,655
99872,2022-06-15,10,254,252,506
99873,2022-06-15,11,251,293,544
99874,2022-06-15,12,266,341,607
99875,2022-06-15,13,242,299,541
99876,2022-06-15,14,281,315,596
99877,2022-06-15,15,291,388,679
99878,2022-06-15,16,358,500,858
99879,2022-06-15,17,518,887,1405
99880,2022-06-15,18,569,876,1445
99881,2022-06-15,19,490,599,1089
99882,2022-06-15,20,385,472,857
99883,2022-06-15,21,340,347,687
99884,2022-06-15,22,210,225,435
99885,2022-06-15,23,109,129,238
99886,2022-06-16,0,51,57,108
99887,2022-06-16,1,29,25,54
99888,2022-06-16,2,13,4,17
99889,2022-06-16,3,11,9,20
99890,2022-06-16,4,8,23,31
99891,2022-06-16,5,30,54,84
99892,2022-06-16,6,49,168,217
99893,2022-06-16,7,142,372,514
99894,2022-06-16,8,291,762,1053
99895,2022-06-16,9,203,428,631
99896,2022-06-16,10,252,276,528
99897,2022-06-16,11,252,283,535
99898,2022-06-16,12,267,314,581
99899,2022-06-16,13,299,299,598
99900,2022-06-16,14,333,330,663
99901,2022-06-16,15,344,384,728
99902,2022-06-16,16,385,584,969
99903,2022-06-16,17,454,701,1155
99904,2022-06-16,18,439,673,1112
99905,2022-06-16,19,431,562,993
99906,2022-06-16,20,340,466,806
99907,2022-06-16,21,295,338,633
99908,2022-06-16,22,229,209,438
99909,2022-06-16,23,154,170,324
99910,2022-06-17,0,85,90,175
99911,2022-06-17,1,30,45,75
99912,2022-06-17,2,22,17,39
99913,2022-06-17,3,7,5,12
99914,2022-06-17,4,12,19,31
99915,2022-06-17,5,22,57,79
99916,2022-06-17,6,73,194,267
99917,2022-06-17,7,125,337,462
99918,2022-06-17,8,226,513,739
99919,2022-06-17,9,261,350,611
99920,2022-06-17,10,294,282,576
99921,2022-06-17,11,292,305,597
99922,2022-06-17,12,308,364,672
99923,2022-06-17,13,304,343,647
99924,2022-06-17,14,284,372,656
99925,2022-06-17,15,384,404,788
99926,2022-06-17,16,459,526,985
99927,2022-06-17,17,527,679,1206
99928,2022-06-17,18,484,584,1068
99929,2022-06-17,19,427,445,872
99930,2022-06-17,20,357,393,750
99931,2022-06-17,21,324,319,643
99932,2022-06-17,22,312,212,524
99933,2022-06-17,23,340,197,537
99934,2022-06-18,0,306,181,487
99935,2022-06-18,1,132,93,225
99936,2022-06-18,2,96,48,144
99937,2022-06-18,3,36,34,70
99938,2022-06-18,4,20,14,34
99939,2022-06-18,5,24,23,47
99940,2022-06-18,6,46,71,117
99941,2022-06-18,7,77,134,211
99942,2022-06-18,8,187,255,442
99943,2022-06-18,9,294,392,686
99944,2022-06-18,10,484,419,903
99945,2022-06-18,11,597,533,1130
99946,2022-06-18,12,726,545,1271
99947,2022-06-18,13,777,508,1285
99948,2022-06-18,14,798,534,1332
99949,2022-06-18,15,879,533,1412
99950,2022-06-18,16,783,493,1276
99951,2022-06-18,17,751,458,1209
99952,2022-06-18,18,580,475,1055
99953,2022-06-18,19,536,408,944
99954,2022-06-18,20,477,348,825
99955,2022-06-18,21,374,288,662
99956,2022-06-18,22,295,209,504
99957,2022-06-18,23,261,222,483
99958,2022-06-19,0,265,172,437
99959,2022-06-19,1,133,91,224
99960,2022-06-19,2,102,70,172
99961,2022-06-19,3,29,24,53
99962,2022-06-19,4,20,7,27
99963,2022-06-19,5,16,20,36
99964,2022-06-19,6,27,36,63
99965,2022-06-19,7,76,85,161
99966,2022-06-19,8,131,186,317
99967,2022-06-19,9,272,296,568
99968,2022-06-19,10,485,369,854
99969,2022-06-19,11,608,427,1035
99970,2022-06-19,12,705,483,1188
99971,2022-06-19,13,771,515,1286
99972,2022-06-19,14,746,453,1199
99973,2022-06-19,15,800,511,1311
99974,2022-06-19,16,784,426,1210
99975,2022-06-19,17,734,484,1218
99976,2022-06-19,18,566,421,987
99977,2022-06-19,19,491,368,859
99978,2022-06-19,20,451,254,705
99979,2022-06-19,21,296,221,517
99980,2022-06-19,22,244,167,411
99981,2022-06-19,23,214,135,349
99982,2022-06-20,0,199,92,291
99983,2022-06-20,1,54,28,82
99984,2022-06-20,2,27,13,40
99985,2022-06-20,3,8,8,16
99986,2022-06-20,4,7,18,25
99987,2022-06-20,5,29,34,63
99988,2022-06-20,6,57,93,150
99989,2022-06-20,7,71,179,250
99990,2022-06-20,8,174,256,430
99991,2022-06-20,9,241,284,525
99992,2022-06-20,10,346,322,668
99993,2022-06-20,11,510,418,928
99994,2022-06-20,12,491,480,971
99995,2022-06-20,13,589,424,1013
99996,2022-06-20,14,604,476,1080
99997,2022-06-20,15,661,492,1153
99998,2022-06-20,16,619,543,1162
99999,2022-06-20,17,586,631,1217
100000,2022-06-20,18,534,589,1123
100001,2022-06-20,19,460,447,907
100002,2022-06-20,20,374,363,737
100003,2022-06-20,21,234,262,496
100004,2022-06-20,22,156,142,298
100005,2022-06-20,23,85,80,165
100006,2022-06-21,0,29,19,48
100007,2022-06-21,1,20,6,26
100008,2022-06-21,2,9,9,18
100009,2022-06-21,3,7,8,15
100010,2022-06-21,4,15,20,35
100011,2022-06-21,5,29,66,95
100012,2022-06-21,6,53,198,251
100013,2022-06-21,7,177,446,623
100014,2022-06-21,8,263,724,987
100015,2022-06-21,9,215,367,582
100016,2022-06-21,10,199,204,403
100017,2022-06-21,11,236,252,488
100018,2022-06-21,12,275,306,581
100019,2022-06-21,13,273,275,548
100020,2022-06-21,14,287,282,569
100021,2022-06-21,15,352,378,730
100022,2022-06-21,16,367,473,840
100023,2022-06-21,17,627,840,1467
100024,2022-06-21,18,617,810,1427
100025,2022-06-21,19,471,613,1084
100026,2022-06-21,20,389,487,876
100027,2022-06-21,21,251,324,575
100028,2022-06-21,22,215,223,438
100029,2022-06-21,23,99,85,184
100030,2022-06-22,0,51,24,75
100031,2022-06-22,1,19,17,36
100032,2022-06-22,2,5,7,12
100033,2022-06-22,3,3,4,7
100034,2022-06-22,4,8,14,22
100035,2022-06-22,5,30,71,101
100036,2022-06-22,6,79,228,307
100037,2022-06-22,7,190,451,641
100038,2022-06-22,8,284,806,1090
100039,2022-06-22,9,244,429,673
100040,2022-06-22,10,233,253,486
100041,2022-06-22,11,293,275,568
100042,2022-06-22,12,255,294,549
100043,2022-06-22,13,223,269,492
100044,2022-06-22,14,219,245,464
100045,2022-06-22,15,277,348,625
100046,2022-06-22,16,224,330,554
100047,2022-06-22,17,314,583,897
100048,2022-06-22,18,383,686,1069
100049,2022-06-22,19,332,509,841
100050,2022-06-22,20,127,219,346
100051,2022-06-22,21,35,62,97
100052,2022-06-22,22,46,69,115
100053,2022-06-22,23,27,44,71
100054,2022-06-23,0,9,19,28
100055,2022-06-23,1,6,10,16
100056,2022-06-23,2,4,7,11
100057,2022-06-23,3,5,8,13
100058,2022-06-23,4,8,11,19
100059,2022-06-23,5,20,47,67
100060,2022-06-23,6,51,156,207
100061,2022-06-23,7,117,316,433
100062,2022-06-23,8,139,390,529
100063,2022-06-23,9,102,220,322
100064,2022-06-23,10,70,128,198
100065,2022-06-23,11,124,167,291
100066,2022-06-23,12,160,246,406
100067,2022-06-23,13,171,271,442
100068,2022-06-23,14,191,257,448
100069,2022-06-23,15,241,284,525
100070,2022-06-23,16,323,482,805
100071,2022-06-23,17,498,791,1289
100072,2022-06-23,18,529,722,1251
100073,2022-06-23,19,488,612,1100
100074,2022-06-23,20,334,450,784
100075,2022-06-23,21,278,301,579
100076,2022-06-23,22,215,226,441
100077,2022-06-23,23,108,142,250
100078,2022-06-24,0,45,71,116
100079,2022-06-24,1,48,37,85
100080,2022-06-24,2,15,12,27
100081,2022-06-24,3,3,13,16
100082,2022-06-24,4,4,15,19
100083,2022-06-24,5,35,50,85
100084,2022-06-24,6,58,169,227
100085,2022-06-24,7,146,341,487
100086,2022-06-24,8,241,592,833
100087,2022-06-24,9,238,365,603
100088,2022-06-24,10,317,287,604
100089,2022-06-24,11,372,313,685
100090,2022-06-24,12,397,407,804
100091,2022-06-24,13,468,395,863
100092,2022-06-24,14,499,384,883
100093,2022-06-24,15,468,514,982
100094,2022-06-24,16,525,628,1153
100095,2022-06-24,17,768,846,1614
100096,2022-06-24,18,580,746,1326
100097,2022-06-24,19,586,590,1176
100098,2022-06-24,20,503,441,944
100099,2022-06-24,21,365,307,672
100100,2022-06-24,22,298,288,586
100101,2022-06-24,23,241,217,458
100102,2022-06-25,0,126,157,283
100103,2022-06-25,1,149,98,247
100104,2022-06-25,2,78,62,140
100105,2022-06-25,3,29,23,52
100106,2022-06-25,4,8,16,24
100107,2022-06-25,5,16,31,47
100108,2022-06-25,6,32,54,86
100109,2022-06-25,7,86,146,232
100110,2022-06-25,8,212,229,441
100111,2022-06-25,9,344,319,663
100112,2022-06-25,10,509,410,919
100113,2022-06-25,11,551,471,1022
100114,2022-06-25,12,631,492,1123
100115,2022-06-25,13,694,483,1177
100116,2022-06-25,14,675,524,1199
100117,2022-06-25,15,678,527,1205
100118,2022-06-25,16,670,525,1195
100119,2022-06-25,17,637,447,1084
100120,2022-06-25,18,557,469,1026
100121,2022-06-25,19,559,485,1044
100122,2022-06-25,20,566,414,980
100123,2022-06-25,21,441,288,729
100124,2022-06-25,22,311,225,536
100125,2022-06-25,23,276,259,535
100126,2022-06-26,0,224,168,392
100127,2022-06-26,1,118,102,220
100128,2022-06-26,2,99,75,174
100129,2022-06-26,3,44,47,91
100130,2022-06-26,4,12,14,26
100131,2022-06-26,5,15,16,31
100132,2022-06-26,6,36,36,72
100133,2022-06-26,7,67,78,145
100134,2022-06-26,8,155,176,331
100135,2022-06-26,9,315,296,611
100136,2022-06-26,10,452,380,832
100137,2022-06-26,11,535,445,980
100138,2022-06-26,12,543,484,1027
100139,2022-06-26,13,522,511,1033
100140,2022-06-26,14,541,466,1007
100141,2022-06-26,15,477,444,921
100142,2022-06-26,16,525,429,954
100143,2022-06-26,17,501,421,922
100144,2022-06-26,18,430,439,869
100145,2022-06-26,19,368,289,657
100146,2022-06-26,20,234,207,441
100147,2022-06-26,21,202,187,389
100148,2022-06-26,22,141,151,292
100149,2022-06-26,23,96,61,157
100150,2022-06-27,0,45,36,81
100151,2022-06-27,1,27,26,53
100152,2022-06-27,2,14,7,21
100153,2022-06-27,3,11,8,19
100154,2022-06-27,4,12,13,25
100155,2022-06-27,5,25,47,72
100156,2022-06-27,6,48,160,208
100157,2022-06-27,7,110,361,471
100158,2022-06-27,8,230,585,815
100159,2022-06-27,9,209,364,573
100160,2022-06-27,10,183,141,324
100161,2022-06-27,11,223,226,449
100162,2022-06-27,12,155,162,317
100163,2022-06-27,13,86,98,184
100164,2022-06-27,14,203,234,437
100165,2022-06-27,15,321,335,656
100166,2022-06-27,16,373,442,815
100167,2022-06-27,17,511,785,1296
100168,2022-06-27,18,562,796,1358
100169,2022-06-27,19,428,568,996
100170,2022-06-27,20,372,426,798
100171,2022-06-27,21,255,301,556
100172,2022-06-27,22,199,245,444
100173,2022-06-27,23,107,116,223
100174,2022-06-28,0,40,34,74
100175,2022-06-28,1,10,9,19
100176,2022-06-28,2,12,6,18
100177,2022-06-28,3,7,4,11
100178,2022-06-28,4,5,13,18
100179,2022-06-28,5,22,69,91
100180,2022-06-28,6,79,177,256
100181,2022-06-28,7,165,458,623
100182,2022-06-28,8,296,760,1056
100183,2022-06-28,9,212,443,655
100184,2022-06-28,10,229,240,469
100185,2022-06-28,11,247,258,505
100186,2022-06-28,12,286,337,623
100187,2022-06-28,13,349,344,693
100188,2022-06-28,14,301,290,591
100189,2022-06-28,15,375,381,756
100190,2022-06-28,16,472,531,1003
100191,2022-06-28,17,653,938,1591
100192,2022-06-28,18,649,893,1542
100193,2022-06-28,19,472,639,1111
100194,2022-06-28,20,422,463,885
100195,2022-06-28,21,277,331,608
100196,2022-06-28,22,203,270,473
100197,2022-06-28,23,104,129,233
100198,2022-06-29,0,29,50,79
100199,2022-06-29,1,15,11,26
100200,2022-06-29,2,10,8,18
100201,2022-06-29,3,3,8,11
100202,2022-06-29,4,7,13,20
100203,2022-06-29,5,35,70,105
100204,2022-06-29,6,92,205,297
100205,2022-06-29,7,169,450,619
100206,2022-06-29,8,284,747,1031
100207,2022-06-29,9,261,457,718
100208,2022-06-29,10,208,269,477
100209,2022-06-29,11,228,286,514
100210,2022-06-29,12,260,351,611
100211,2022-06-29,13,235,309,544
100212,2022-06-29,14,292,291,583
100213,2022-06-29,15,326,354,680
100214,2022-06-29,16,367,517,884
100215,2022-06-29,17,593,933,1526
100216,2022-06-29,18,618,793,1411
100217,2022-06-29,19,564,621,1185
100218,2022-06-29,20,385,479,864
100219,2022-06-29,21,271,345,616
100220,2022-06-29,22,211,227,438
100221,2022-06-29,23,108,120,228
100222,2022-06-30,0,52,57,109
100223,2022-06-30,1,25,18,43
100224,2022-06-30,2,12,8,20
100225,2022-06-30,3,6,8,14
100226,2022-06-30,4,6,19,25
100227,2022-06-30,5,21,58,79
100228,2022-06-30,6,69,181,250
100229,2022-06-30,7,128,379,507
100230,2022-06-30,8,280,698,978
100231,2022-06-30,9,243,420,663
100232,2022-06-30,10,214,245,459
100233,2022-06-30,11,229,272,501
100234,2022-06-30,12,266,327,593
100235,2022-06-30,13,239,267,506
100236,2022-06-30,14,274,306,580
100237,2022-06-30,15,319,374,693
100238,2022-06-30,16,365,450,815
100239,2022-06-30,17,499,813,1312
100240,2022-06-30,18,565,751,1316
100241,2022-06-30,19,444,645,1089
100242,2022-06-30,20,412,499,911
100243,2022-06-30,21,304,349,653
100244,2022-06-30,22,213,267,480
100245,2022-06-30,23,124,142,266
100246,2022-07-01,0,72,87,159
100247,2022-07-01,1,29,39,68
100248,2022-07-01,2,13,26,39
100249,2022-07-01,3,12,9,21
100250,2022-07-01,4,19,14,33
100251,2022-07-01,5,28,47,75
100252,2022-07-01,6,59,143,202
100253,2022-07-01,7,133,275,408
100254,2022-07-01,8,214,467,681
100255,2022-07-01,9,248,351,599
100256,2022-07-01,10,306,271,577
100257,2022-07-01,11,315,316,631
100258,2022-07-01,12,318,366,684
100259,2022-07-01,13,347,405,752
100260,2022-07-01,14,372,464,836
100261,2022-07-01,15,415,504,919
100262,2022-07-01,16,456,549,1005
100263,2022-07-01,17,508,644,1152
100264,2022-07-01,18,405,478,883
100265,2022-07-01,19,356,383,739
100266,2022-07-01,20,333,333,666
100267,2022-07-01,21,242,285,527
100268,2022-07-01,22,247,233,480
100269,2022-07-01,23,196,175,371
100270,2022-07-02,0,122,136,258
100271,2022-07-02,1,90,87,177
100272,2022-07-02,2,77,58,135
100273,2022-07-02,3,35,17,52
100274,2022-07-02,4,13,19,32
100275,2022-07-02,5,11,23,34
100276,2022-07-02,6,52,61,113
100277,2022-07-02,7,79,159,238
100278,2022-07-02,8,192,256,448
100279,2022-07-02,9,311,335,646
100280,2022-07-02,10,481,406,887
100281,2022-07-02,11,591,461,1052
100282,2022-07-02,12,541,437,978
100283,2022-07-02,13,610,422,1032
100284,2022-07-02,14,598,424,1022
100285,2022-07-02,15,591,412,1003
100286,2022-07-02,16,556,365,921
100287,2022-07-02,17,502,378,880
100288,2022-07-02,18,378,371,749
100289,2022-07-02,19,503,322,825
100290,2022-07-02,20,266,212,478
100291,2022-07-02,21,56,55,111
100292,2022-07-02,22,142,123,265
100293,2022-07-02,23,94,111,205
100294,2022-07-03,0,73,69,142
100295,2022-07-03,1,70,48,118
100296,2022-07-03,2,43,26,69
100297,2022-07-03,3,29,17,46
100298,2022-07-03,4,5,9,14
100299,2022-07-03,5,13,15,28
100300,2022-07-03,6,25,37,62
100301,2022-07-03,7,72,60,132
100302,2022-07-03,8,165,155,320
100303,2022-07-03,9,307,216,523
100304,2022-07-03,10,436,319,755
100305,2022-07-03,11,601,425,1026
100306,2022-07-03,12,697,382,1079
100307,2022-07-03,13,773,402,1175
100308,2022-07-03,14,685,430,1115
100309,2022-07-03,15,764,389,1153
100310,2022-07-03,16,746,441,1187
100311,2022-07-03,17,786,390,1176
100312,2022-07-03,18,719,441,1160
100313,2022-07-03,19,592,364,956
100314,2022-07-03,20,508,298,806
100315,2022-07-03,21,417,260,677
100316,2022-07-03,22,301,215,516
100317,2022-07-03,23,220,172,392
100318,2022-07-04,0,136,89,225
100319,2022-07-04,1,117,60,177
100320,2022-07-04,2,49,43,92
100321,2022-07-04,3,27,17,44
100322,2022-07-04,4,18,18,36
100323,2022-07-04,5,21,28,49
100324,2022-07-04,6,35,71,106
100325,2022-07-04,7,70,108,178
100326,2022-07-04,8,207,180,387
100327,2022-07-04,9,395,302,697
100328,2022-07-04,10,597,378,975
100329,2022-07-04,11,714,411,1125
100330,2022-07-04,12,719,401,1120
100331,2022-07-04,13,852,497,1349
100332,2022-07-04,14,935,466,1401
100333,2022-07-04,15,828,382,1210
100334,2022-07-04,16,865,453,1318
100335,2022-07-04,17,916,414,1330
100336,2022-07-04,18,1029,418,1447
100337,2022-07-04,19,1083,445,1528
100338,2022-07-04,20,1048,424,1472
100339,2022-07-04,21,1041,487,1528
100340,2022-07-04,22,788,407,1195
100341,2022-07-04,23,346,192,538
100342,2022-07-05,0,106,76,182
100343,2022-07-05,1,47,27,74
100344,2022-07-05,2,19,15,34
100345,2022-07-05,3,13,13,26
100346,2022-07-05,4,11,14,25
100347,2022-07-05,5,26,48,74
100348,2022-07-05,6,66,146,212
100349,2022-07-05,7,148,332,480
100350,2022-07-05,8,254,596,850
100351,2022-07-05,9,278,414,692
100352,2022-07-05,10,251,252,503
100353,2022-07-05,11,328,274,602
100354,2022-07-05,12,356,322,678
100355,2022-07-05,13,163,183,346
100356,2022-07-05,14,233,223,456
100357,2022-07-05,15,304,312,616
100358,2022-07-05,16,380,438,818
100359,2022-07-05,17,536,738,1274
100360,2022-07-05,18,492,693,1185
100361,2022-07-05,19,404,513,917
100362,2022-07-05,20,269,338,607
100363,2022-07-05,21,235,253,488
100364,2022-07-05,22,164,154,318
100365,2022-07-05,23,70,102,172
100366,2022-07-06,0,30,36,66
100367,2022-07-06,1,10,16,26
100368,2022-07-06,2,3,12,15
100369,2022-07-06,3,2,6,8
100370,2022-07-06,4,9,18,27
100371,2022-07-06,5,36,66,102
100372,2022-07-06,6,77,208,285
100373,2022-07-06,7,171,412,583
100374,2022-07-06,8,341,755,1096
100375,2022-07-06,9,294,396,690
100376,2022-07-06,10,234,245,479
100377,2022-07-06,11,236,270,506
100378,2022-07-06,12,327,303,630
100379,2022-07-06,13,330,267,597
100380,2022-07-06,14,331,270,601
100381,2022-07-06,15,316,357,673
100382,2022-07-06,16,355,508,863
100383,2022-07-06,17,566,846,1412
100384,2022-07-06,18,550,758,1308
100385,2022-07-06,19,391,546,937
100386,2022-07-06,20,191,304,495
100387,2022-07-06,21,157,223,380
100388,2022-07-06,22,109,159,268
100389,2022-07-06,23,54,100,154
100390,2022-07-07,0,32,32,64
100391,2022-07-07,1,17,4,21
100392,2022-07-07,2,4,7,11
100393,2022-07-07,3,5,6,11
100394,2022-07-07,4,3,18,21
100395,2022-07-07,5,21,53,74
100396,2022-07-07,6,51,170,221
100397,2022-07-07,7,106,284,390
100398,2022-07-07,8,218,603,821
100399,2022-07-07,9,244,417,661
100400,2022-07-07,10,204,253,457
100401,2022-07-07,11,249,245,494
100402,2022-07-07,12,321,300,621
100403,2022-07-07,13,277,243,520
100404,2022-07-07,14,321,280,601
100405,2022-07-07,15,336,357,693
100406,2022-07-07,16,396,494,890
100407,2022-07-07,17,580,822,1402
100408,2022-07-07,18,561,756,1317
100409,2022-07-07,19,452,567,1019
100410,2022-07-07,20,379,410,789
100411,2022-07-07,21,264,313,577
100412,2022-07-07,22,184,235,419
100413,2022-07-07,23,131,114,245
100414,2022-07-08,0,58,59,117
100415,2022-07-08,1,30,14,44
100416,2022-07-08,2,15,13,28
100417,2022-07-08,3,7,9,16
100418,2022-07-08,4,3,16,19
100419,2022-07-08,5,25,46,71
100420,2022-07-08,6,57,164,221
100421,2022-07-08,7,136,336,472
100422,2022-07-08,8,229,497,726
100423,2022-07-08,9,233,393,626
100424,2022-07-08,10,234,263,497
100425,2022-07-08,11,324,248,572
100426,2022-07-08,12,328,341,669
100427,2022-07-08,13,357,341,698
100428,2022-07-08,14,387,335,722
100429,2022-07-08,15,403,421,824
100430,2022-07-08,16,466,493,959
100431,2022-07-08,17,576,788,1364
100432,2022-07-08,18,541,672,1213
100433,2022-07-08,19,450,499,949
100434,2022-07-08,20,401,400,801
100435,2022-07-08,21,273,313,586
100436,2022-07-08,22,196,230,426
100437,2022-07-08,23,174,158,332
100438,2022-07-09,0,83,93,176
100439,2022-07-09,1,33,33,66
100440,2022-07-09,2,16,15,31
100441,2022-07-09,3,5,10,15
100442,2022-07-09,4,1,4,5
100443,2022-07-09,5,7,7,14
100444,2022-07-09,6,18,34,52
100445,2022-07-09,7,40,84,124
100446,2022-07-09,8,74,155,229
100447,2022-07-09,9,88,157,245
100448,2022-07-09,10,159,204,363
100449,2022-07-09,11,193,289,482
100450,2022-07-09,12,180,237,417
100451,2022-07-09,13,90,112,202
100452,2022-07-09,14,109,180,289
100453,2022-07-09,15,222,273,495
100454,2022-07-09,16,348,313,661
100455,2022-07-09,17,406,409,815
100456,2022-07-09,18,310,349,659
100457,2022-07-09,19,337,365,702
100458,2022-07-09,20,274,285,559
100459,2022-07-09,21,206,216,422
100460,2022-07-09,22,218,175,393
100461,2022-07-09,23,188,157,345
100462,2022-07-10,0,144,122,266
100463,2022-07-10,1,127,94,221
100464,2022-07-10,2,83,72,155
100465,2022-07-10,3,45,44,89
100466,2022-07-10,4,18,11,29
100467,2022-07-10,5,29,18,47
100468,2022-07-10,6,29,46,75
100469,2022-07-10,7,58,86,144
100470,2022-07-10,8,153,204,357
100471,2022-07-10,9,259,306,565
100472,2022-07-10,10,481,419,900
100473,2022-07-10,11,573,462,1035
100474,2022-07-10,12,673,490,1163
100475,2022-07-10,13,698,547,1245
100476,2022-07-10,14,687,517,1204
100477,2022-07-10,15,662,506,1168
100478,2022-07-10,16,595,539,1134
100479,2022-07-10,17,606,546,1152
100480,2022-07-10,18,471,462,933
100481,2022-07-10,19,486,362,848
100482,2022-07-10,20,382,269,651
100483,2022-07-10,21,276,217,493
100484,2022-07-10,22,150,173,323
100485,2022-07-10,23,80,75,155
100486,2022-07-11,0,48,32,80
100487,2022-07-11,1,23,12,35
100488,2022-07-11,2,4,13,17
100489,2022-07-11,3,6,7,13
100490,2022-07-11,4,8,23,31
100491,2022-07-11,5,30,68,98
100492,2022-07-11,6,75,176,251
100493,2022-07-11,7,132,385,517
100494,2022-07-11,8,247,621,868
100495,2022-07-11,9,253,390,643
100496,2022-07-11,10,250,224,474
100497,2022-07-11,11,282,231,513
100498,2022-07-11,12,331,316,647
100499,2022-07-11,13,324,342,666
100500,2022-07-11,14,295,294,589
100501,2022-07-11,15,385,372,757
100502,2022-07-11,16,375,440,815
100503,2022-07-11,17,621,838,1459
100504,2022-07-11,18,536,809,1345
100505,2022-07-11,19,496,616,1112
100506,2022-07-11,20,390,456,846
100507,2022-07-11,21,267,319,586
100508,2022-07-11,22,157,175,332
100509,2022-07-11,23,89,96,185
100510,2022-07-12,0,46,39,85
100511,2022-07-12,1,11,18,29
100512,2022-07-12,2,4,9,13
100513,2022-07-12,3,2,15,17
100514,2022-07-12,4,9,10,19
100515,2022-07-12,5,36,60,96
100516,2022-07-12,6,68,203,271
100517,2022-07-12,7,184,447,631
100518,2022-07-12,8,335,829,1164
100519,2022-07-12,9,218,438,656
100520,2022-07-12,10,227,224,451
100521,2022-07-12,11,249,271,520
100522,2022-07-12,12,263,292,555
100523,2022-07-12,13,273,310,583
100524,2022-07-12,14,301,295,596
100525,2022-07-12,15,289,369,658
100526,2022-07-12,16,336,515,851
100527,2022-07-12,17,495,843,1338
100528,2022-07-12,18,119,255,374
100529,2022-07-12,19,129,266,395
100530,2022-07-12,20,78,189,267
100531,2022-07-12,21,103,144,247
100532,2022-07-12,22,94,140,234
100533,2022-07-12,23,72,84,156
100534,2022-07-13,0,35,35,70
100535,2022-07-13,1,15,18,33
100536,2022-07-13,2,8,5,13
100537,2022-07-13,3,4,9,13
100538,2022-07-13,4,10,18,28
100539,2022-07-13,5,27,72,99
100540,2022-07-13,6,77,222,299
100541,2022-07-13,7,192,489,681
100542,2022-07-13,8,343,823,1166
100543,2022-07-13,9,274,437,711
100544,2022-07-13,10,255,253,508
100545,2022-07-13,11,244,287,531
100546,2022-07-13,12,278,297,575
100547,2022-07-13,13,275,292,567
100548,2022-07-13,14,308,284,592
100549,2022-07-13,15,324,368,692
100550,2022-07-13,16,377,561,938
100551,2022-07-13,17,608,879,1487
100552,2022-07-13,18,658,898,1556
100553,2022-07-13,19,531,654,1185
100554,2022-07-13,20,381,510,891
100555,2022-07-13,21,313,387,700
100556,2022-07-13,22,264,274,538
100557,2022-07-13,23,90,117,207
100558,2022-07-14,0,43,43,86
100559,2022-07-14,1,18,13,31
100560,2022-07-14,2,13,20,33
100561,2022-07-14,3,5,14,19
100562,2022-07-14,4,7,14,21
100563,2022-07-14,5,29,56,85
100564,2022-07-14,6,89,179,268
100565,2022-07-14,7,178,464,642
100566,2022-07-14,8,313,741,1054
100567,2022-07-14,9,234,405,639
100568,2022-07-14,10,245,258,503
100569,2022-07-14,11,257,262,519
100570,2022-07-14,12,265,311,576
100571,2022-07-14,13,310,302,612
100572,2022-07-14,14,315,293,608
100573,2022-07-14,15,360,391,751
100574,2022-07-14,16,451,567,1018
100575,2022-07-14,17,665,887,1552
100576,2022-07-14,18,606,831,1437
100577,2022-07-14,19,470,570,1040
100578,2022-07-14,20,408,405,813
100579,2022-07-14,21,334,305,639
100580,2022-07-14,22,272,278,550
100581,2022-07-14,23,137,166,303
100582,2022-07-15,0,56,55,111
100583,2022-07-15,1,32,29,61
100584,2022-07-15,2,18,16,34
100585,2022-07-15,3,18,7,25
100586,2022-07-15,4,8,20,28
100587,2022-07-15,5,26,50,76
100588,2022-07-15,6,59,186,245
100589,2022-07-15,7,135,361,496
100590,2022-07-15,8,240,532,772
100591,2022-07-15,9,238,383,621
100592,2022-07-15,10,324,250,574
100593,2022-07-15,11,330,296,626
100594,2022-07-15,12,375,339,714
100595,2022-07-15,13,427,380,807
100596,2022-07-15,14,440,375,815
100597,2022-07-15,15,439,448,887
100598,2022-07-15,16,469,555,1024
100599,2022-07-15,17,597,751,1348
100600,2022-07-15,18,583,675,1258
100601,2022-07-15,19,472,513,985
100602,2022-07-15,20,411,398,809
100603,2022-07-15,21,329,294,623
100604,2022-07-15,22,293,247,540
100605,2022-07-15,23,196,211,407
100606,2022-07-16,0,157,158,315
100607,2022-07-16,1,133,89,222
100608,2022-07-16,2,89,61,150
100609,2022-07-16,3,56,22,78
100610,2022-07-16,4,11,19,30
100611,2022-07-16,5,27,35,62
100612,2022-07-16,6,47,88,135
100613,2022-07-16,7,96,151,247
100614,2022-07-16,8,193,243,436
100615,2022-07-16,9,347,364,711
100616,2022-07-16,10,521,431,952
100617,2022-07-16,11,595,508,1103
100618,2022-07-16,12,695,504,1199
100619,2022-07-16,13,623,416,1039
100620,2022-07-16,14,551,401,952
100621,2022-07-16,15,609,525,1134
100622,2022-07-16,16,618,482,1100
100623,2022-07-16,17,612,401,1013
100624,2022-07-16,18,254,234,488
100625,2022-07-16,19,242,237,479
100626,2022-07-16,20,346,287,633
100627,2022-07-16,21,253,200,453
100628,2022-07-16,22,230,187,417
100629,2022-07-16,23,170,196,366
100630,2022-07-17,0,134,107,241
100631,2022-07-17,1,99,104,203
100632,2022-07-17,2,79,46,125
100633,2022-07-17,3,43,26,69
100634,2022-07-17,4,15,9,24
100635,2022-07-17,5,21,15,36
100636,2022-07-17,6,34,46,80
100637,2022-07-17,7,62,72,134
100638,2022-07-17,8,167,165,332
100639,2022-07-17,9,326,260,586
100640,2022-07-17,10,499,365,864
100641,2022-07-17,11,562,476,1038
100642,2022-07-17,12,555,458,1013
100643,2022-07-17,13,588,510,1098
100644,2022-07-17,14,616,454,1070
100645,2022-07-17,15,614,469,1083
100646,2022-07-17,16,649,473,1122
100647,2022-07-17,17,526,478,1004
100648,2022-07-17,18,311,399,710
100649,2022-07-17,19,354,330,684
100650,2022-07-17,20,320,305,625
100651,2022-07-17,21,240,197,437
100652,2022-07-17,22,143,131,274
100653,2022-07-17,23,66,89,155
100654,2022-07-18,0,43,33,76
100655,2022-07-18,1,14,18,32
100656,2022-07-18,2,13,8,21
100657,2022-07-18,3,10,6,16
100658,2022-07-18,4,8,22,30
100659,2022-07-18,5,29,59,88
100660,2022-07-18,6,75,188,263
100661,2022-07-18,7,138,352,490
100662,2022-07-18,8,246,641,887
100663,2022-07-18,9,240,372,612
100664,2022-07-18,10,291,238,529
100665,2022-07-18,11,278,237,515
100666,2022-07-18,12,307,323,630
100667,2022-07-18,13,286,281,567
100668,2022-07-18,14,316,299,615
100669,2022-07-18,15,342,387,729
100670,2022-07-18,16,329,514,843
100671,2022-07-18,17,336,625,961
100672,2022-07-18,18,319,584,903
100673,2022-07-18,19,342,522,864
100674,2022-07-18,20,268,400,668
100675,2022-07-18,21,198,280,478
100676,2022-07-18,22,126,159,285
100677,2022-07-18,23,48,97,145
100678,2022-07-19,0,23,36,59
100679,2022-07-19,1,7,18,25
100680,2022-07-19,2,8,5,13
100681,2022-07-19,3,10,10,20
100682,2022-07-19,4,13,19,32
100683,2022-07-19,5,27,63,90
100684,2022-07-19,6,62,225,287
100685,2022-07-19,7,171,481,652
100686,2022-07-19,8,289,839,1128
100687,2022-07-19,9,255,432,687
100688,2022-07-19,10,214,298,512
100689,2022-07-19,11,245,292,537
100690,2022-07-19,12,301,288,589
100691,2022-07-19,13,278,313,591
100692,2022-07-19,14,271,322,593
100693,2022-07-19,15,292,390,682
100694,2022-07-19,16,368,490,858
100695,2022-07-19,17,550,958,1508
100696,2022-07-19,18,571,890,1461
100697,2022-07-19,19,548,639,1187
100698,2022-07-19,20,382,495,877
100699,2022-07-19,21,287,300,587
100700,2022-07-19,22,161,201,362
100701,2022-07-19,23,115,103,218
100702,2022-07-20,0,48,47,95
100703,2022-07-20,1,21,18,39
100704,2022-07-20,2,11,7,18
100705,2022-07-20,3,10,13,23
100706,2022-07-20,4,8,13,21
100707,2022-07-20,5,39,63,102
100708,2022-07-20,6,86,221,307
100709,2022-07-20,7,182,491,673
100710,2022-07-20,8,313,816,1129
100711,2022-07-20,9,213,451,664
100712,2022-07-20,10,247,275,522
100713,2022-07-20,11,258,239,497
100714,2022-07-20,12,268,316,584
100715,2022-07-20,13,226,287,513
100716,2022-07-20,14,286,267,553
100717,2022-07-20,15,325,387,712
100718,2022-07-20,16,363,503,866
100719,2022-07-20,17,601,869,1470
100720,2022-07-20,18,573,809,1382
100721,2022-07-20,19,466,687,1153
100722,2022-07-20,20,389,486,875
100723,2022-07-20,21,282,309,591
100724,2022-07-20,22,230,273,503
100725,2022-07-20,23,109,127,236
100726,2022-07-21,0,43,37,80
100727,2022-07-21,1,35,19,54
100728,2022-07-21,2,10,8,18
100729,2022-07-21,3,7,4,11
100730,2022-07-21,4,9,21,30
100731,2022-07-21,5,33,57,90
100732,2022-07-21,6,67,172,239
100733,2022-07-21,7,141,433,574
100734,2022-07-21,8,269,665,934
100735,2022-07-21,9,228,458,686
100736,2022-07-21,10,213,246,459
100737,2022-07-21,11,230,268,498
100738,2022-07-21,12,224,295,519
100739,2022-07-21,13,204,259,463
100740,2022-07-21,14,265,290,555
100741,2022-07-21,15,282,335,617
100742,2022-07-21,16,254,354,608
100743,2022-07-21,17,400,673,1073
100744,2022-07-21,18,495,713,1208
100745,2022-07-21,19,458,552,1010
100746,2022-07-21,20,396,394,790
100747,2022-07-21,21,326,278,604
100748,2022-07-21,22,229,243,472
100749,2022-07-21,23,141,138,279
100750,2022-07-22,0,83,81,164
100751,2022-07-22,1,32,29,61
100752,2022-07-22,2,15,14,29
100753,2022-07-22,3,10,6,16
100754,2022-07-22,4,16,19,35
100755,2022-07-22,5,30,45,75
100756,2022-07-22,6,62,160,222
100757,2022-07-22,7,120,343,463
100758,2022-07-22,8,202,535,737
100759,2022-07-22,9,216,402,618
100760,2022-07-22,10,252,264,516
100761,2022-07-22,11,271,280,551
100762,2022-07-22,12,294,321,615
100763,2022-07-22,13,341,299,640
100764,2022-07-22,14,324,333,657
100765,2022-07-22,15,380,396,776
100766,2022-07-22,16,447,522,969
100767,2022-07-22,17,473,628,1101
100768,2022-07-22,18,498,612,1110
100769,2022-07-22,19,417,524,941
100770,2022-07-22,20,407,415,822
100771,2022-07-22,21,309,276,585
100772,2022-07-22,22,265,220,485
100773,2022-07-22,23,219,220,439
100774,2022-07-23,0,134,150,284
100775,2022-07-23,1,133,121,254
100776,2022-07-23,2,71,66,137
100777,2022-07-23,3,37,27,64
100778,2022-07-23,4,15,12,27
100779,2022-07-23,5,19,18,37
100780,2022-07-23,6,48,88,136
100781,2022-07-23,7,86,124,210
100782,2022-07-23,8,191,241,432
100783,2022-07-23,9,366,336,702
100784,2022-07-23,10,508,394,902
100785,2022-07-23,11,468,395,863
100786,2022-07-23,12,497,401,898
100787,2022-07-23,13,483,384,867
100788,2022-07-23,14,459,396,855
100789,2022-07-23,15,486,349,835
100790,2022-07-23,16,461,351,812
100791,2022-07-23,17,450,377,827
100792,2022-07-23,18,414,387,801
100793,2022-07-23,19,413,368,781
100794,2022-07-23,20,352,309,661
100795,2022-07-23,21,260,224,484
100796,2022-07-23,22,269,186,455
100797,2022-07-23,23,219,161,380
100798,2022-07-24,0,148,142,290
100799,2022-07-24,1,132,103,235
100800,2022-07-24,2,113,72,185
100801,2022-07-24,3,38,23,61
100802,2022-07-24,4,20,12,32
100803,2022-07-24,5,28,13,41
100804,2022-07-24,6,43,55,98
100805,2022-07-24,7,76,107,183
100806,2022-07-24,8,174,200,374
100807,2022-07-24,9,279,251,530
100808,2022-07-24,10,412,330,742
100809,2022-07-24,11,462,350,812
100810,2022-07-24,12,441,377,818
100811,2022-07-24,13,407,388,795
100812,2022-07-24,14,396,358,754
100813,2022-07-24,15,386,360,746
100814,2022-07-24,16,359,349,708
100815,2022-07-24,17,395,369,764
100816,2022-07-24,18,360,353,713
100817,2022-07-24,19,362,300,662
100818,2022-07-24,20,343,274,617
100819,2022-07-24,21,220,192,412
100820,2022-07-24,22,178,129,307
100821,2022-07-24,23,77,69,146
100822,2022-07-25,0,42,33,75
100823,2022-07-25,1,13,20,33
100824,2022-07-25,2,16,14,30
100825,2022-07-25,3,5,12,17
100826,2022-07-25,4,4,16,20
100827,2022-07-25,5,22,63,85
100828,2022-07-25,6,68,177,245
100829,2022-07-25,7,151,386,537
100830,2022-07-25,8,231,591,822
100831,2022-07-25,9,207,388,595
100832,2022-07-25,10,224,247,471
100833,2022-07-25,11,226,246,472
100834,2022-07-25,12,272,265,537
100835,2022-07-25,13,263,273,536
100836,2022-07-25,14,265,271,536
100837,2022-07-25,15,235,326,561
100838,2022-07-25,16,92,125,217
100839,2022-07-25,17,345,579,924
100840,2022-07-25,18,366,620,986
100841,2022-07-25,19,352,497,849
100842,2022-07-25,20,226,368,594
100843,2022-07-25,21,163,248,411
100844,2022-07-25,22,82,166,248
100845,2022-07-25,23,53,86,139
100846,2022-07-26,0,23,32,55
100847,2022-07-26,1,13,12,25
100848,2022-07-26,2,6,10,16
100849,2022-07-26,3,1,5,6
100850,2022-07-26,4,9,15,24
100851,2022-07-26,5,28,84,112
100852,2022-07-26,6,74,207,281
100853,2022-07-26,7,158,446,604
100854,2022-07-26,8,282,777,1059
100855,2022-07-26,9,242,426,668
100856,2022-07-26,10,230,218,448
100857,2022-07-26,11,265,254,519
100858,2022-07-26,12,231,309,540
100859,2022-07-26,13,231,238,469
100860,2022-07-26,14,241,250,491
100861,2022-07-26,15,319,368,687
100862,2022-07-26,16,346,464,810
100863,2022-07-26,17,520,871,1391
100864,2022-07-26,18,535,780,1315
100865,2022-07-26,19,379,565,944
100866,2022-07-26,20,281,415,696
100867,2022-07-26,21,201,273,474
100868,2022-07-26,22,144,190,334
100869,2022-07-26,23,89,106,195
100870,2022-07-27,0,26,39,65
100871,2022-07-27,1,12,12,24
100872,2022-07-27,2,10,6,16
100873,2022-07-27,3,2,9,11
100874,2022-07-27,4,8,13,21
100875,2022-07-27,5,39,79,118
100876,2022-07-27,6,82,231,313
100877,2022-07-27,7,174,453,627
100878,2022-07-27,8,288,748,1036
100879,2022-07-27,9,246,427,673
100880,2022-07-27,10,220,243,463
100881,2022-07-27,11,289,291,580
100882,2022-07-27,12,324,329,653
100883,2022-07-27,13,281,313,594
100884,2022-07-27,14,282,311,593
100885,2022-07-27,15,338,367,705
100886,2022-07-27,16,376,471,847
100887,2022-07-27,17,515,843,1358
100888,2022-07-27,18,569,878,1447
100889,2022-07-27,19,420,595,1015
100890,2022-07-27,20,349,464,813
100891,2022-07-27,21,246,339,585
100892,2022-07-27,22,231,207,438
100893,2022-07-27,23,87,126,213
100894,2022-07-28,0,48,48,96
100895,2022-07-28,1,18,20,38
100896,2022-07-28,2,11,12,23
100897,2022-07-28,3,5,11,16
100898,2022-07-28,4,13,15,28
100899,2022-07-28,5,34,53,87
100900,2022-07-28,6,72,198,270
100901,2022-07-28,7,152,428,580
100902,2022-07-28,8,281,701,982
100903,2022-07-28,9,243,397,640
100904,2022-07-28,10,215,223,438
100905,2022-07-28,11,289,225,514
100906,2022-07-28,12,267,317,584
100907,2022-07-28,13,267,325,592
100908,2022-07-28,14,282,280,562
100909,2022-07-28,15,332,304,636
100910,2022-07-28,16,381,445,826
100911,2022-07-28,17,599,826,1425
100912,2022-07-28,18,621,776,1397
100913,2022-07-28,19,426,597,1023
100914,2022-07-28,20,211,269,480
100915,2022-07-28,21,217,284,501
100916,2022-07-28,22,214,236,450
100917,2022-07-28,23,123,152,275
100918,2022-07-29,0,70,62,132
100919,2022-07-29,1,26,28,54
100920,2022-07-29,2,24,12,36
100921,2022-07-29,3,9,7,16
100922,2022-07-29,4,6,17,23
100923,2022-07-29,5,46,48,94
100924,2022-07-29,6,62,182,244
100925,2022-07-29,7,121,280,401
100926,2022-07-29,8,226,534,760
100927,2022-07-29,9,223,371,594
100928,2022-07-29,10,237,248,485
100929,2022-07-29,11,316,286,602
100930,2022-07-29,12,339,320,659
100931,2022-07-29,13,354,329,683
100932,2022-07-29,14,352,332,684
100933,2022-07-29,15,401,415,816
100934,2022-07-29,16,354,431,785
100935,2022-07-29,17,368,510,878
100936,2022-07-29,18,412,539,951
100937,2022-07-29,19,356,466,822
100938,2022-07-29,20,215,237,452
100939,2022-07-29,21,193,189,382
100940,2022-07-29,22,171,179,350
100941,2022-07-29,23,105,126,231
100942,2022-07-30,0,76,126,202
100943,2022-07-30,1,91,75,166
100944,2022-07-30,2,64,73,137
100945,2022-07-30,3,44,21,65
100946,2022-07-30,4,13,15,28
100947,2022-07-30,5,19,30,49
100948,2022-07-30,6,33,65,98
100949,2022-07-30,7,75,139,214
100950,2022-07-30,8,216,212,428
100951,2022-07-30,9,367,363,730
100952,2022-07-30,10,566,469,1035
100953,2022-07-30,11,626,487,1113
100954,2022-07-30,12,743,435,1178
100955,2022-07-30,13,756,483,1239
100956,2022-07-30,14,745,453,1198
100957,2022-07-30,15,684,486,1170
100958,2022-07-30,16,678,451,1129
100959,2022-07-30,17,666,437,1103
100960,2022-07-30,18,559,425,984
100961,2022-07-30,19,522,387,909
100962,2022-07-30,20,391,320,711
100963,2022-07-30,21,324,270,594
100964,2022-07-30,22,278,217,495
100965,2022-07-30,23,250,205,455
100966,2022-07-31,0,163,170,333
100967,2022-07-31,1,164,119,283
100968,2022-07-31,2,77,68,145
100969,2022-07-31,3,63,36,99
100970,2022-07-31,4,8,16,24
100971,2022-07-31,5,23,19,42
100972,2022-07-31,6,50,55,105
100973,2022-07-31,7,97,87,184
100974,2022-07-31,8,142,190,332
100975,2022-07-31,9,337,315,652
100976,2022-07-31,10,491,356,847
100977,2022-07-31,11,563,454,1017
100978,2022-07-31,12,673,490,1163
100979,2022-07-31,13,621,477,1098
100980,2022-07-31,14,462,425,887
100981,2022-07-31,15,435,402,837
100982,2022-07-31,16,462,416,878
100983,2022-07-31,17,282,244,526
100984,2022-07-31,18,155,187,342
100985,2022-07-31,19,82,108,190
100986,2022-07-31,20,80,116,196
100987,2022-07-31,21,101,144,245
100988,2022-07-31,22,88,100,188
100989,2022-07-31,23,61,55,116
100990,2022-08-01,0,28,27,55
100991,2022-08-01,1,14,13,27
100992,2022-08-01,2,8,13,21
100993,2022-08-01,3,7,8,15
100994,2022-08-01,4,7,16,23
100995,2022-08-01,5,35,56,91
100996,2022-08-01,6,67,186,253
100997,2022-08-01,7,128,386,514
100998,2022-08-01,8,209,624,833
100999,2022-08-01,9,232,337,569
101000,2022-08-01,10,259,246,505
101001,2022-08-01,11,252,248,500
101002,2022-08-01,12,314,308,622
101003,2022-08-01,13,318,302,620
101004,2022-08-01,14,267,320,587
101005,2022-08-01,15,357,405,762
101006,2022-08-01,16,400,447,847
101007,2022-08-01,17,573,769,1342
101008,2022-08-01,18,580,756,1336
101009,2022-08-01,19,422,557,979
101010,2022-08-01,20,320,436,756
101011,2022-08-01,21,249,313,562
101012,2022-08-01,22,182,192,374
101013,2022-08-01,23,69,81,150
101014,2022-08-02,0,10,21,31
101015,2022-08-02,1,14,14,28
101016,2022-08-02,2,3,3,6
101017,2022-08-02,3,3,8,11
101018,2022-08-02,4,6,13,19
101019,2022-08-02,5,27,65,92
101020,2022-08-02,6,67,189,256
101021,2022-08-02,7,142,416,558
101022,2022-08-02,8,235,751,986
101023,2022-08-02,9,203,421,624
101024,2022-08-02,10,213,281,494
101025,2022-08-02,11,279,282,561
101026,2022-08-02,12,292,333,625
101027,2022-08-02,13,275,288,563
101028,2022-08-02,14,253,280,533
101029,2022-08-02,15,266,348,614
101030,2022-08-02,16,346,511,857
101031,2022-08-02,17,554,902,1456
101032,2022-08-02,18,541,909,1450
101033,2022-08-02,19,489,618,1107
101034,2022-08-02,20,342,465,807
101035,2022-08-02,21,261,309,570
101036,2022-08-02,22,228,259,487
101037,2022-08-02,23,107,146,253
101038,2022-08-03,0,48,44,92
101039,2022-08-03,1,14,18,32
101040,2022-08-03,2,12,11,23
101041,2022-08-03,3,3,8,11
101042,2022-08-03,4,15,14,29
101043,2022-08-03,5,35,63,98
101044,2022-08-03,6,72,208,280
101045,2022-08-03,7,170,458,628
101046,2022-08-03,8,276,717,993
101047,2022-08-03,9,224,469,693
101048,2022-08-03,10,258,223,481
101049,2022-08-03,11,272,264,536
101050,2022-08-03,12,268,320,588
101051,2022-08-03,13,300,287,587
101052,2022-08-03,14,286,335,621
101053,2022-08-03,15,327,374,701
101054,2022-08-03,16,327,517,844
101055,2022-08-03,17,538,828,1366
101056,2022-08-03,18,497,846,1343
101057,2022-08-03,19,528,593,1121
101058,2022-08-03,20,399,433,832
101059,2022-08-03,21,253,306,559
101060,2022-08-03,22,192,227,419
101061,2022-08-03,23,124,120,244
101062,2022-08-04,0,42,46,88
101063,2022-08-04,1,14,27,41
101064,2022-08-04,2,13,27,40
101065,2022-08-04,3,0,4,4
101066,2022-08-04,4,9,13,22
101067,2022-08-04,5,38,54,92
101068,2022-08-04,6,73,156,229
101069,2022-08-04,7,156,393,549
101070,2022-08-04,8,279,694,973
101071,2022-08-04,9,244,360,604
101072,2022-08-04,10,233,226,459
101073,2022-08-04,11,265,255,520
101074,2022-08-04,12,295,297,592
101075,2022-08-04,13,237,265,502
101076,2022-08-04,14,258,267,525
101077,2022-08-04,15,235,339,574
101078,2022-08-04,16,322,473,795
101079,2022-08-04,17,480,717,1197
101080,2022-08-04,18,264,487,751
101081,2022-08-04,19,163,270,433
101082,2022-08-04,20,165,249,414
101083,2022-08-04,21,88,149,237
101084,2022-08-04,22,34,61,95
101085,2022-08-04,23,41,73,114
101086,2022-08-05,0,24,33,57
101087,2022-08-05,1,10,18,28
101088,2022-08-05,2,12,8,20
101089,2022-08-05,3,8,14,22
101090,2022-08-05,4,9,17,26
101091,2022-08-05,5,32,41,73
101092,2022-08-05,6,62,148,210
101093,2022-08-05,7,132,322,454
101094,2022-08-05,8,225,463,688
101095,2022-08-05,9,238,327,565
101096,2022-08-05,10,275,283,558
101097,2022-08-05,11,335,289,624
101098,2022-08-05,12,342,296,638
101099,2022-08-05,13,334,371,705
101100,2022-08-05,14,364,337,701
101101,2022-08-05,15,347,390,737
101102,2022-08-05,16,256,345,601
101103,2022-08-05,17,149,232,381
101104,2022-08-05,18,180,254,434
101105,2022-08-05,19,199,293,492
101106,2022-08-05,20,218,237,455
101107,2022-08-05,21,171,192,363
101108,2022-08-05,22,161,182,343
101109,2022-08-05,23,114,148,262
101110,2022-08-06,0,119,123,242
101111,2022-08-06,1,108,100,208
101112,2022-08-06,2,80,56,136
101113,2022-08-06,3,48,37,85
101114,2022-08-06,4,16,16,32
101115,2022-08-06,5,21,31,52
101116,2022-08-06,6,55,64,119
101117,2022-08-06,7,108,154,262
101118,2022-08-06,8,205,265,470
101119,2022-08-06,9,357,317,674
101120,2022-08-06,10,556,400,956
101121,2022-08-06,11,537,482,1019
101122,2022-08-06,12,691,527,1218
101123,2022-08-06,13,625,485,1110
101124,2022-08-06,14,637,515,1152
101125,2022-08-06,15,613,473,1086
101126,2022-08-06,16,556,425,981
101127,2022-08-06,17,626,432,1058
101128,2022-08-06,18,486,442,928
101129,2022-08-06,19,518,356,874
101130,2022-08-06,20,346,284,630
101131,2022-08-06,21,300,215,515
101132,2022-08-06,22,255,226,481
101133,2022-08-06,23,213,182,395
101134,2022-08-07,0,148,110,258
101135,2022-08-07,1,96,108,204
101136,2022-08-07,2,98,51,149
101137,2022-08-07,3,35,29,64
101138,2022-08-07,4,21,8,29
101139,2022-08-07,5,16,11,27
101140,2022-08-07,6,49,46,95
101141,2022-08-07,7,72,95,167
101142,2022-08-07,8,154,201,355
101143,2022-08-07,9,324,264,588
101144,2022-08-07,10,452,335,787
101145,2022-08-07,11,482,382,864
101146,2022-08-07,12,512,431,943
101147,2022-08-07,13,566,408,974
101148,2022-08-07,14,498,383,881
101149,2022-08-07,15,482,374,856
101150,2022-08-07,16,479,395,874
101151,2022-08-07,17,450,403,853
101152,2022-08-07,18,397,376,773
101153,2022-08-07,19,400,321,721
101154,2022-08-07,20,299,282,581
101155,2022-08-07,21,225,164,389
101156,2022-08-07,22,161,159,320
101157,2022-08-07,23,90,56,146
101158,2022-08-08,0,47,32,79
101159,2022-08-08,1,29,23,52
101160,2022-08-08,2,6,14,20
101161,2022-08-08,3,5,12,17
101162,2022-08-08,4,13,12,25
101163,2022-08-08,5,26,60,86
101164,2022-08-08,6,74,157,231
101165,2022-08-08,7,128,361,489
101166,2022-08-08,8,210,532,742
101167,2022-08-08,9,216,307,523
101168,2022-08-08,10,246,215,461
101169,2022-08-08,11,235,232,467
101170,2022-08-08,12,266,273,539
101171,2022-08-08,13,249,274,523
101172,2022-08-08,14,291,280,571
101173,2022-08-08,15,308,363,671
101174,2022-08-08,16,291,399,690
101175,2022-08-08,17,400,680,1080
101176,2022-08-08,18,383,631,1014
101177,2022-08-08,19,363,458,821
101178,2022-08-08,20,263,351,614
101179,2022-08-08,21,164,264,428
101180,2022-08-08,22,133,168,301
101181,2022-08-08,23,225,213,438
101182,2022-08-09,0,114,75,189
101183,2022-08-09,1,19,22,41
101184,2022-08-09,2,7,7,14
101185,2022-08-09,3,3,21,24
101186,2022-08-09,4,9,14,23
101187,2022-08-09,5,32,51,83
101188,2022-08-09,6,76,194,270
101189,2022-08-09,7,131,414,545
101190,2022-08-09,8,264,694,958
101191,2022-08-09,9,203,376,579
101192,2022-08-09,10,270,222,492
101193,2022-08-09,11,278,239,517
101194,2022-08-09,12,289,314,603
101195,2022-08-09,13,255,247,502
101196,2022-08-09,14,233,222,455
101197,2022-08-09,15,274,276,550
101198,2022-08-09,16,333,446,779
101199,2022-08-09,17,452,756,1208
101200,2022-08-09,18,460,778,1238
101201,2022-08-09,19,409,545,954
101202,2022-08-09,20,309,421,730
101203,2022-08-09,21,179,219,398
101204,2022-08-09,22,141,186,327
101205,2022-08-09,23,55,100,155
101206,2022-08-10,0,28,24,52
101207,2022-08-10,1,14,13,27
101208,2022-08-10,2,11,10,21
101209,2022-08-10,3,2,6,8
101210,2022-08-10,4,6,12,18
101211,2022-08-10,5,25,69,94
101212,2022-08-10,6,82,191,273
101213,2022-08-10,7,149,438,587
101214,2022-08-10,8,261,728,989
101215,2022-08-10,9,202,394,596
101216,2022-08-10,10,202,227,429
101217,2022-08-10,11,276,275,551
101218,2022-08-10,12,251,282,533
101219,2022-08-10,13,218,318,536
101220,2022-08-10,14,239,305,544
101221,2022-08-10,15,295,365,660
101222,2022-08-10,16,189,286,475
101223,2022-08-10,17,69,154,223
101224,2022-08-10,18,64,185,249
101225,2022-08-10,19,46,100,146
101226,2022-08-10,20,32,111,143
101227,2022-08-10,21,70,156,226
101228,2022-08-10,22,94,148,242
101229,2022-08-10,23,62,87,149
101230,2022-08-11,0,25,26,51
101231,2022-08-11,1,19,8,27
101232,2022-08-11,2,2,5,7
101233,2022-08-11,3,6,6,12
101234,2022-08-11,4,6,13,19
101235,2022-08-11,5,26,65,91
101236,2022-08-11,6,98,166,264
101237,2022-08-11,7,134,402,536
101238,2022-08-11,8,257,605,862
101239,2022-08-11,9,226,383,609
101240,2022-08-11,10,258,252,510
101241,2022-08-11,11,270,294,564
101242,2022-08-11,12,318,319,637
101243,2022-08-11,13,298,322,620
101244,2022-08-11,14,286,324,610
101245,2022-08-11,15,292,385,677
101246,2022-08-11,16,416,541,957
101247,2022-08-11,17,570,838,1408
101248,2022-08-11,18,609,811,1420
101249,2022-08-11,19,488,658,1146
101250,2022-08-11,20,383,406,789
101251,2022-08-11,21,267,299,566
101252,2022-08-11,22,170,254,424
101253,2022-08-11,23,98,139,237
101254,2022-08-12,0,73,94,167
101255,2022-08-12,1,41,28,69
101256,2022-08-12,2,24,13,37
101257,2022-08-12,3,6,10,16
101258,2022-08-12,4,15,8,23
101259,2022-08-12,5,30,42,72
101260,2022-08-12,6,54,159,213
101261,2022-08-12,7,130,330,460
101262,2022-08-12,8,221,490,711
101263,2022-08-12,9,196,362,558
101264,2022-08-12,10,272,239,511
101265,2022-08-12,11,290,309,599
101266,2022-08-12,12,328,377,705
101267,2022-08-12,13,361,370,731
101268,2022-08-12,14,389,343,732
101269,2022-08-12,15,451,422,873
101270,2022-08-12,16,498,531,1029
101271,2022-08-12,17,639,732,1371
101272,2022-08-12,18,537,627,1164
101273,2022-08-12,19,494,539,1033
101274,2022-08-12,20,335,380,715
101275,2022-08-12,21,285,281,566
101276,2022-08-12,22,255,254,509
101277,2022-08-12,23,250,238,488
101278,2022-08-13,0,149,132,281
101279,2022-08-13,1,106,83,189
101280,2022-08-13,2,97,54,151
101281,2022-08-13,3,51,28,79
101282,2022-08-13,4,20,16,36
101283,2022-08-13,5,23,28,51
101284,2022-08-13,6,38,54,92
101285,2022-08-13,7,83,160,243
101286,2022-08-13,8,165,219,384
101287,2022-08-13,9,296,365,661
101288,2022-08-13,10,477,380,857
101289,2022-08-13,11,567,448,1015
101290,2022-08-13,12,667,504,1171
101291,2022-08-13,13,722,452,1174
101292,2022-08-13,14,678,529,1207
101293,2022-08-13,15,706,503,1209
101294,2022-08-13,16,699,468,1167
101295,2022-08-13,17,616,494,1110
101296,2022-08-13,18,519,438,957
101297,2022-08-13,19,439,356,795
101298,2022-08-13,20,344,305,649
101299,2022-08-13,21,279,204,483
101300,2022-08-13,22,290,231,521
101301,2022-08-13,23,198,175,373
101302,2022-08-14,0,132,110,242
101303,2022-08-14,1,106,83,189
101304,2022-08-14,2,66,51,117
101305,2022-08-14,3,37,23,60
101306,2022-08-14,4,7,12,19
101307,2022-08-14,5,21,13,34
101308,2022-08-14,6,35,43,78
101309,2022-08-14,7,90,106,196
101310,2022-08-14,8,167,184,351
101311,2022-08-14,9,278,291,569
101312,2022-08-14,10,458,440,898
101313,2022-08-14,11,590,463,1053
101314,2022-08-14,12,586,452,1038
101315,2022-08-14,13,650,460,1110
101316,2022-08-14,14,632,416,1048
101317,2022-08-14,15,676,410,1086
101318,2022-08-14,16,593,437,1030
101319,2022-08-14,17,496,452,948
101320,2022-08-14,18,241,249,490
101321,2022-08-14,19,248,235,483
101322,2022-08-14,20,114,144,258
101323,2022-08-14,21,116,108,224
101324,2022-08-14,22,60,70,130
101325,2022-08-14,23,26,40,66
101326,2022-08-15,0,10,11,21
101327,2022-08-15,1,6,10,16
101328,2022-08-15,2,4,10,14
101329,2022-08-15,3,6,10,16
101330,2022-08-15,4,10,16,26
101331,2022-08-15,5,22,48,70
101332,2022-08-15,6,60,159,219
101333,2022-08-15,7,109,330,439
101334,2022-08-15,8,211,539,750
101335,2022-08-15,9,169,346,515
101336,2022-08-15,10,223,218,441
101337,2022-08-15,11,277,295,572
101338,2022-08-15,12,297,294,591
101339,2022-08-15,13,288,303,591
101340,2022-08-15,14,290,268,558
101341,2022-08-15,15,320,319,639
101342,2022-08-15,16,283,408,691
101343,2022-08-15,17,450,743,1193
101344,2022-08-15,18,513,710,1223
101345,2022-08-15,19,322,472,794
101346,2022-08-15,20,255,336,591
101347,2022-08-15,21,164,223,387
101348,2022-08-15,22,180,180,360
101349,2022-08-15,23,69,72,141
101350,2022-08-16,0,29,35,64
101351,2022-08-16,1,4,7,11
101352,2022-08-16,2,6,8,14
101353,2022-08-16,3,6,12,18
101354,2022-08-16,4,7,19,26
101355,2022-08-16,5,30,66,96
101356,2022-08-16,6,65,207,272
101357,2022-08-16,7,163,421,584
101358,2022-08-16,8,257,715,972
101359,2022-08-16,9,225,432,657
101360,2022-08-16,10,236,277,513
101361,2022-08-16,11,273,294,567
101362,2022-08-16,12,304,324,628
101363,2022-08-16,13,291,301,592
101364,2022-08-16,14,321,317,638
101365,2022-08-16,15,339,399,738
101366,2022-08-16,16,434,532,966
101367,2022-08-16,17,626,935,1561
101368,2022-08-16,18,613,891,1504
101369,2022-08-16,19,515,573,1088
101370,2022-08-16,20,356,424,780
101371,2022-08-16,21,238,301,539
101372,2022-08-16,22,181,208,389
101373,2022-08-16,23,115,136,251
101374,2022-08-17,0,45,52,97
101375,2022-08-17,1,16,17,33
101376,2022-08-17,2,3,13,16
101377,2022-08-17,3,7,11,18
101378,2022-08-17,4,10,11,21
101379,2022-08-17,5,26,61,87
101380,2022-08-17,6,75,196,271
101381,2022-08-17,7,153,438,591
101382,2022-08-17,8,284,755,1039
101383,2022-08-17,9,264,447,711
101384,2022-08-17,10,248,300,548
101385,2022-08-17,11,266,309,575
101386,2022-08-17,12,297,389,686
101387,2022-08-17,13,355,344,699
101388,2022-08-17,14,295,313,608
101389,2022-08-17,15,344,401,745
101390,2022-08-17,16,424,508,932
101391,2022-08-17,17,521,822,1343
101392,2022-08-17,18,489,747,1236
101393,2022-08-17,19,423,575,998
101394,2022-08-17,20,222,326,548
101395,2022-08-17,21,214,265,479
101396,2022-08-17,22,164,192,356
101397,2022-08-17,23,80,105,185
101398,2022-08-18,0,48,41,89
101399,2022-08-18,1,22,19,41
101400,2022-08-18,2,18,7,25
101401,2022-08-18,3,2,13,15
101402,2022-08-18,4,15,14,29
101403,2022-08-18,5,19,48,67
101404,2022-08-18,6,72,190,262
101405,2022-08-18,7,121,425,546
101406,2022-08-18,8,266,687,953
101407,2022-08-18,9,247,392,639
101408,2022-08-18,10,242,262,504
101409,2022-08-18,11,290,288,578
101410,2022-08-18,12,294,335,629
101411,2022-08-18,13,309,297,606
101412,2022-08-18,14,395,322,717
101413,2022-08-18,15,382,397,779
101414,2022-08-18,16,484,526,1010
101415,2022-08-18,17,595,899,1494
101416,2022-08-18,18,556,871,1427
101417,2022-08-18,19,471,621,1092
101418,2022-08-18,20,350,447,797
101419,2022-08-18,21,264,331,595
101420,2022-08-18,22,228,236,464
101421,2022-08-18,23,93,115,208
101422,2022-08-19,0,59,63,122
101423,2022-08-19,1,24,47,71
101424,2022-08-19,2,17,21,38
101425,2022-08-19,3,8,8,16
101426,2022-08-19,4,8,13,21
101427,2022-08-19,5,22,56,78
101428,2022-08-19,6,63,162,225
101429,2022-08-19,7,129,333,462
101430,2022-08-19,8,200,553,753
101431,2022-08-19,9,231,360,591
101432,2022-08-19,10,234,274,508
101433,2022-08-19,11,329,275,604
101434,2022-08-19,12,366,358,724
101435,2022-08-19,13,344,372,716
101436,2022-08-19,14,360,396,756
101437,2022-08-19,15,397,471,868
101438,2022-08-19,16,448,504,952
101439,2022-08-19,17,506,654,1160
101440,2022-08-19,18,451,669,1120
101441,2022-08-19,19,437,537,974
101442,2022-08-19,20,339,343,682
101443,2022-08-19,21,238,256,494
101444,2022-08-19,22,235,202,437
101445,2022-08-19,23,169,197,366
101446,2022-08-20,0,139,138,277
101447,2022-08-20,1,104,100,204
101448,2022-08-20,2,69,57,126
101449,2022-08-20,3,35,24,59
101450,2022-08-20,4,19,19,38
101451,2022-08-20,5,18,23,41
101452,2022-08-20,6,35,58,93
101453,2022-08-20,7,89,146,235
101454,2022-08-20,8,166,233,399
101455,2022-08-20,9,295,371,666
101456,2022-08-20,10,422,404,826
101457,2022-08-20,11,566,489,1055
101458,2022-08-20,12,580,477,1057
101459,2022-08-20,13,641,491,1132
101460,2022-08-20,14,630,450,1080
101461,2022-08-20,15,621,404,1025
101462,2022-08-20,16,604,445,1049
101463,2022-08-20,17,552,486,1038
101464,2022-08-20,18,492,480,972
101465,2022-08-20,19,522,429,951
101466,2022-08-20,20,267,309,576
101467,2022-08-20,21,284,263,547
101468,2022-08-20,22,216,217,433
101469,2022-08-20,23,162,173,335
101470,2022-08-21,0,157,123,280
101471,2022-08-21,1,105,96,201
101472,2022-08-21,2,61,71,132
101473,2022-08-21,3,36,30,66
101474,2022-08-21,4,11,15,26
101475,2022-08-21,5,23,10,33
101476,2022-08-21,6,29,46,75
101477,2022-08-21,7,57,132,189
101478,2022-08-21,8,133,207,340
101479,2022-08-21,9,244,299,543
101480,2022-08-21,10,435,367,802
101481,2022-08-21,11,485,439,924
101482,2022-08-21,12,448,433,881
101483,2022-08-21,13,314,321,635
101484,2022-08-21,14,309,255,564
101485,2022-08-21,15,370,360,730
101486,2022-08-21,16,379,334,713
101487,2022-08-21,17,380,429,809
101488,2022-08-21,18,307,412,719
101489,2022-08-21,19,185,238,423
101490,2022-08-21,20,108,159,267
101491,2022-08-21,21,112,112,224
101492,2022-08-21,22,73,83,156
101493,2022-08-21,23,53,51,104
101494,2022-08-22,0,20,20,40
101495,2022-08-22,1,14,10,24
101496,2022-08-22,2,15,11,26
101497,2022-08-22,3,3,7,10
101498,2022-08-22,4,8,10,18
101499,2022-08-22,5,20,59,79
101500,2022-08-22,6,48,148,196
101501,2022-08-22,7,87,392,479
101502,2022-08-22,8,182,541,723
101503,2022-08-22,9,173,334,507
101504,2022-08-22,10,197,228,425
101505,2022-08-22,11,197,209,406
101506,2022-08-22,12,296,315,611
101507,2022-08-22,13,292,320,612
101508,2022-08-22,14,281,281,562
101509,2022-08-22,15,324,402,726
101510,2022-08-22,16,376,488,864
101511,2022-08-22,17,458,790,1248
101512,2022-08-22,18,401,732,1133
101513,2022-08-22,19,147,294,441
101514,2022-08-22,20,168,253,421
101515,2022-08-22,21,98,180,278
101516,2022-08-22,22,65,120,185
101517,2022-08-22,23,50,74,124
101518,2022-08-23,0,19,28,47
101519,2022-08-23,1,16,18,34
101520,2022-08-23,2,7,6,13
101521,2022-08-23,3,3,8,11
101522,2022-08-23,4,3,13,16
101523,2022-08-23,5,25,62,87
101524,2022-08-23,6,76,196,272
101525,2022-08-23,7,154,512,666
101526,2022-08-23,8,269,769,1038
101527,2022-08-23,9,233,411,644
101528,2022-08-23,10,206,282,488
101529,2022-08-23,11,225,293,518
101530,2022-08-23,12,266,362,628
101531,2022-08-23,13,256,313,569
101532,2022-08-23,14,300,282,582
101533,2022-08-23,15,277,378,655
101534,2022-08-23,16,367,567,934
101535,2022-08-23,17,565,930,1495
101536,2022-08-23,18,543,882,1425
101537,2022-08-23,19,443,649,1092
101538,2022-08-23,20,311,464,775
101539,2022-08-23,21,204,286,490
101540,2022-08-23,22,152,204,356
101541,2022-08-23,23,174,127,301
101542,2022-08-24,0,53,43,96
101543,2022-08-24,1,12,13,25
101544,2022-08-24,2,10,11,21
101545,2022-08-24,3,5,11,16
101546,2022-08-24,4,8,11,19
101547,2022-08-24,5,19,73,92
101548,2022-08-24,6,68,168,236
101549,2022-08-24,7,136,529,665
101550,2022-08-24,8,286,783,1069
101551,2022-08-24,9,221,462,683
101552,2022-08-24,10,240,249,489
101553,2022-08-24,11,195,265,460
101554,2022-08-24,12,256,317,573
101555,2022-08-24,13,242,296,538
101556,2022-08-24,14,243,302,545
101557,2022-08-24,15,316,389,705
101558,2022-08-24,16,356,555,911
101559,2022-08-24,17,565,926,1491
101560,2022-08-24,18,559,880,1439
101561,2022-08-24,19,440,659,1099
101562,2022-08-24,20,303,416,719
101563,2022-08-24,21,238,292,530
101564,2022-08-24,22,141,215,356
101565,2022-08-24,23,90,124,214
101566,2022-08-25,0,47,48,95
101567,2022-08-25,1,13,23,36
101568,2022-08-25,2,17,14,31
101569,2022-08-25,3,6,10,16
101570,2022-08-25,4,5,16,21
101571,2022-08-25,5,28,56,84
101572,2022-08-25,6,64,190,254
101573,2022-08-25,7,149,459,608
101574,2022-08-25,8,250,699,949
101575,2022-08-25,9,226,460,686
101576,2022-08-25,10,214,243,457
101577,2022-08-25,11,235,257,492
101578,2022-08-25,12,230,341,571
101579,2022-08-25,13,234,333,567
101580,2022-08-25,14,253,297,550
101581,2022-08-25,15,275,318,593
101582,2022-08-25,16,327,499,826
101583,2022-08-25,17,531,831,1362
101584,2022-08-25,18,525,791,1316
101585,2022-08-25,19,394,612,1006
101586,2022-08-25,20,244,411,655
101587,2022-08-25,21,218,328,546
101588,2022-08-25,22,165,258,423
101589,2022-08-25,23,109,153,262
101590,2022-08-26,0,67,67,134
101591,2022-08-26,1,39,19,58
101592,2022-08-26,2,21,15,36
101593,2022-08-26,3,11,8,19
101594,2022-08-26,4,8,14,22
101595,2022-08-26,5,30,60,90
101596,2022-08-26,6,68,149,217
101597,2022-08-26,7,146,352,498
101598,2022-08-26,8,216,549,765
101599,2022-08-26,9,203,369,572
101600,2022-08-26,10,237,291,528
101601,2022-08-26,11,252,316,568
101602,2022-08-26,12,318,361,679
101603,2022-08-26,13,297,386,683
101604,2022-08-26,14,346,360,706
101605,2022-08-26,15,400,435,835
101606,2022-08-26,16,467,542,1009
101607,2022-08-26,17,505,696,1201
101608,2022-08-26,18,453,657,1110
101609,2022-08-26,19,396,558,954
101610,2022-08-26,20,305,353,658
101611,2022-08-26,21,266,305,571
101612,2022-08-26,22,200,257,457
101613,2022-08-26,23,194,190,384
101614,2022-08-27,0,162,150,312
101615,2022-08-27,1,117,113,230
101616,2022-08-27,2,68,52,120
101617,2022-08-27,3,43,27,70
101618,2022-08-27,4,9,18,27
101619,2022-08-27,5,15,10,25
101620,2022-08-27,6,33,69,102
101621,2022-08-27,7,82,172,254
101622,2022-08-27,8,163,308,471
101623,2022-08-27,9,253,398,651
101624,2022-08-27,10,468,452,920
101625,2022-08-27,11,532,479,1011
101626,2022-08-27,12,617,529,1146
101627,2022-08-27,13,599,489,1088
101628,2022-08-27,14,612,478,1090
101629,2022-08-27,15,559,484,1043
101630,2022-08-27,16,523,454,977
101631,2022-08-27,17,572,498,1070
101632,2022-08-27,18,507,502,1009
101633,2022-08-27,19,452,394,846
101634,2022-08-27,20,292,300,592
101635,2022-08-27,21,282,220,502
101636,2022-08-27,22,203,236,439
101637,2022-08-27,23,196,176,372
101638,2022-08-28,0,149,139,288
101639,2022-08-28,1,126,109,235
101640,2022-08-28,2,90,63,153
101641,2022-08-28,3,36,34,70
101642,2022-08-28,4,9,11,20
101643,2022-08-28,5,11,16,27
101644,2022-08-28,6,25,50,75
101645,2022-08-28,7,45,107,152
101646,2022-08-28,8,148,225,373
101647,2022-08-28,9,265,319,584
101648,2022-08-28,10,465,427,892
101649,2022-08-28,11,506,432,938
101650,2022-08-28,12,481,465,946
101651,2022-08-28,13,549,511,1060
101652,2022-08-28,14,468,442,910
101653,2022-08-28,15,475,465,940
101654,2022-08-28,16,448,463,911
101655,2022-08-28,17,425,449,874
101656,2022-08-28,18,386,442,828
101657,2022-08-28,19,324,399,723
101658,2022-08-28,20,229,275,504
101659,2022-08-28,21,145,197,342
101660,2022-08-28,22,93,139,232
101661,2022-08-28,23,57,76,133
101662,2022-08-29,0,29,26,55
101663,2022-08-29,1,9,10,19
101664,2022-08-29,2,9,6,15
101665,2022-08-29,3,7,6,13
101666,2022-08-29,4,8,10,18
101667,2022-08-29,5,25,65,90
101668,2022-08-29,6,66,185,251
101669,2022-08-29,7,137,453,590
101670,2022-08-29,8,203,659,862
101671,2022-08-29,9,164,421,585
101672,2022-08-29,10,177,260,437
101673,2022-08-29,11,187,278,465
101674,2022-08-29,12,228,349,577
101675,2022-08-29,13,232,305,537
101676,2022-08-29,14,183,260,443
101677,2022-08-29,15,246,403,649
101678,2022-08-29,16,327,515,842
101679,2022-08-29,17,399,834,1233
101680,2022-08-29,18,430,792,1222
101681,2022-08-29,19,373,591,964
101682,2022-08-29,20,181,412,593
101683,2022-08-29,21,137,247,384
101684,2022-08-29,22,115,168,283
101685,2022-08-29,23,60,82,142
101686,2022-08-30,0,31,26,57
101687,2022-08-30,1,11,8,19
101688,2022-08-30,2,6,9,15
101689,2022-08-30,3,4,7,11
101690,2022-08-30,4,8,14,22
101691,2022-08-30,5,35,59,94
101692,2022-08-30,6,80,212,292
101693,2022-08-30,7,186,531,717
101694,2022-08-30,8,275,786,1061
101695,2022-08-30,9,180,451,631
101696,2022-08-30,10,151,299,450
101697,2022-08-30,11,171,267,438
101698,2022-08-30,12,194,338,532
101699,2022-08-30,13,204,298,502
101700,2022-08-30,14,169,305,474
101701,2022-08-30,15,282,438,720
101702,2022-08-30,16,180,417,597
101703,2022-08-30,17,73,228,301
101704,2022-08-30,18,235,581,816
101705,2022-08-30,19,231,565,796
101706,2022-08-30,20,186,372,558
101707,2022-08-30,21,152,273,425
101708,2022-08-30,22,123,207,330
101709,2022-08-30,23,46,104,150
101710,2022-08-31,0,30,18,48
101711,2022-08-31,1,12,15,27
101712,2022-08-31,2,3,8,11
101713,2022-08-31,3,4,4,8
101714,2022-08-31,4,7,11,18
101715,2022-08-31,5,28,85,113
101716,2022-08-31,6,69,223,292
101717,2022-08-31,7,166,543,709
101718,2022-08-31,8,273,819,1092
101719,2022-08-31,9,182,452,634
101720,2022-08-31,10,190,283,473
101721,2022-08-31,11,182,322,504
101722,2022-08-31,12,188,399,587
101723,2022-08-31,13,221,322,543
101724,2022-08-31,14,227,344,571
101725,2022-08-31,15,293,405,698
101726,2022-08-31,16,339,573,912
101727,2022-08-31,17,526,1008,1534
101728,2022-08-31,18,539,914,1453
101729,2022-08-31,19,415,689,1104
101730,2022-08-31,20,299,451,750
101731,2022-08-31,21,241,332,573
101732,2022-08-31,22,167,249,416
101733,2022-08-31,23,77,118,195
101734,2022-09-01,0,29,58,87
101735,2022-09-01,1,16,21,37
101736,2022-09-01,2,4,6,10
101737,2022-09-01,3,2,6,8
101738,2022-09-01,4,4,16,20
101739,2022-09-01,5,27,61,88
101740,2022-09-01,6,44,186,230
101741,2022-09-01,7,163,466,629
101742,2022-09-01,8,237,727,964
101743,2022-09-01,9,189,443,632
101744,2022-09-01,10,177,302,479
101745,2022-09-01,11,198,345,543
101746,2022-09-01,12,217,353,570
101747,2022-09-01,13,242,354,596
101748,2022-09-01,14,248,371,619
101749,2022-09-01,15,309,399,708
101750,2022-09-01,16,372,576,948
101751,2022-09-01,17,518,915,1433
101752,2022-09-01,18,538,803,1341
101753,2022-09-01,19,394,603,997
101754,2022-09-01,20,272,435,707
101755,2022-09-01,21,203,339,542
101756,2022-09-01,22,140,227,367
101757,2022-09-01,23,89,134,223
101758,2022-09-02,0,69,87,156
101759,2022-09-02,1,46,35,81
101760,2022-09-02,2,24,13,37
101761,2022-09-02,3,9,8,17
101762,2022-09-02,4,9,14,23
101763,2022-09-02,5,19,38,57
101764,2022-09-02,6,55,137,192
101765,2022-09-02,7,103,339,442
101766,2022-09-02,8,209,456,665
101767,2022-09-02,9,264,363,627
101768,2022-09-02,10,211,274,485
101769,2022-09-02,11,267,337,604
101770,2022-09-02,12,316,402,718
101771,2022-09-02,13,380,408,788
101772,2022-09-02,14,426,434,860
101773,2022-09-02,15,439,473,912
101774,2022-09-02,16,443,582,1025
101775,2022-09-02,17,485,649,1134
101776,2022-09-02,18,485,650,1135
101777,2022-09-02,19,357,517,874
101778,2022-09-02,20,293,336,629
101779,2022-09-02,21,226,238,464
101780,2022-09-02,22,178,226,404
101781,2022-09-02,23,144,161,305
101782,2022-09-03,0,106,102,208
101783,2022-09-03,1,105,78,183
101784,2022-09-03,2,51,51,102
101785,2022-09-03,3,39,27,66
101786,2022-09-03,4,21,11,32
101787,2022-09-03,5,17,23,40
101788,2022-09-03,6,35,71,106
101789,2022-09-03,7,92,159,251
101790,2022-09-03,8,156,215,371
101791,2022-09-03,9,299,302,601
101792,2022-09-03,10,487,322,809
101793,2022-09-03,11,560,381,941
101794,2022-09-03,12,558,435,993
101795,2022-09-03,13,586,391,977
101796,2022-09-03,14,629,395,1024
101797,2022-09-03,15,533,423,956
101798,2022-09-03,16,567,403,970
101799,2022-09-03,17,608,412,1020
101800,2022-09-03,18,573,428,1001
101801,2022-09-03,19,446,405,851
101802,2022-09-03,20,301,245,546
101803,2022-09-03,21,310,224,534
101804,2022-09-03,22,223,175,398
101805,2022-09-03,23,174,128,302
101806,2022-09-04,0,134,100,234
101807,2022-09-04,1,107,82,189
101808,2022-09-04,2,71,57,128
101809,2022-09-04,3,33,29,62
101810,2022-09-04,4,8,12,20
101811,2022-09-04,5,10,17,27
101812,2022-09-04,6,25,37,62
101813,2022-09-04,7,62,89,151
101814,2022-09-04,8,159,188,347
101815,2022-09-04,9,325,278,603
101816,2022-09-04,10,482,353,835
101817,2022-09-04,11,579,397,976
101818,2022-09-04,12,560,402,962
101819,2022-09-04,13,662,391,1053
101820,2022-09-04,14,621,335,956
101821,2022-09-04,15,640,330,970
101822,2022-09-04,16,700,368,1068
101823,2022-09-04,17,592,399,991
101824,2022-09-04,18,527,429,956
101825,2022-09-04,19,472,356,828
101826,2022-09-04,20,336,248,584
101827,2022-09-04,21,330,230,560
101828,2022-09-04,22,254,183,437
101829,2022-09-04,23,141,139,280
101830,2022-09-05,0,72,71,143
101831,2022-09-05,1,64,49,113
101832,2022-09-05,2,46,36,82
101833,2022-09-05,3,23,17,40
101834,2022-09-05,4,15,13,28
101835,2022-09-05,5,21,25,46
101836,2022-09-05,6,39,52,91
101837,2022-09-05,7,50,111,161
101838,2022-09-05,8,147,194,341
101839,2022-09-05,9,271,319,590
101840,2022-09-05,10,406,377,783
101841,2022-09-05,11,539,401,940
101842,2022-09-05,12,583,455,1038
101843,2022-09-05,13,519,447,966
101844,2022-09-05,14,525,400,925
101845,2022-09-05,15,440,439,879
101846,2022-09-05,16,442,429,871
101847,2022-09-05,17,292,350,642
101848,2022-09-05,18,139,235,374
101849,2022-09-05,19,142,202,344
101850,2022-09-05,20,117,179,296
101851,2022-09-05,21,91,147,238
101852,2022-09-05,22,72,110,182
101853,2022-09-05,23,38,62,100
101854,2022-09-06,0,14,17,31
101855,2022-09-06,1,8,6,14
101856,2022-09-06,2,1,2,3
101857,2022-09-06,3,1,6,7
101858,2022-09-06,4,5,6,11
101859,2022-09-06,5,11,29,40
101860,2022-09-06,6,21,62,83
101861,2022-09-06,7,40,203,243
101862,2022-09-06,8,46,235,281
101863,2022-09-06,9,71,196,267
101864,2022-09-06,10,129,250,379
101865,2022-09-06,11,167,286,453
101866,2022-09-06,12,187,296,483
101867,2022-09-06,13,200,339,539
101868,2022-09-06,14,220,303,523
101869,2022-09-06,15,247,434,681
101870,2022-09-06,16,312,645,957
101871,2022-09-06,17,540,961,1501
101872,2022-09-06,18,389,734,1123
101873,2022-09-06,19,321,573,894
101874,2022-09-06,20,219,429,648
101875,2022-09-06,21,170,304,474
101876,2022-09-06,22,128,166,294
101877,2022-09-06,23,64,96,160
101878,2022-09-07,0,31,41,72
101879,2022-09-07,1,16,15,31
101880,2022-09-07,2,7,15,22
101881,2022-09-07,3,5,12,17
101882,2022-09-07,4,11,10,21
101883,2022-09-07,5,20,63,83
101884,2022-09-07,6,69,199,268
101885,2022-09-07,7,149,503,652
101886,2022-09-07,8,272,827,1099
101887,2022-09-07,9,183,468,651
101888,2022-09-07,10,182,271,453
101889,2022-09-07,11,146,267,413
101890,2022-09-07,12,155,317,472
101891,2022-09-07,13,171,289,460
101892,2022-09-07,14,206,331,537
101893,2022-09-07,15,255,414,669
101894,2022-09-07,16,318,534,852
101895,2022-09-07,17,403,906,1309
101896,2022-09-07,18,223,499,722
101897,2022-09-07,19,206,488,694
101898,2022-09-07,20,175,316,491
101899,2022-09-07,21,147,257,404
101900,2022-09-07,22,92,171,263
101901,2022-09-07,23,70,103,173
101902,2022-09-08,0,46,39,85
101903,2022-09-08,1,12,11,23
101904,2022-09-08,2,7,11,18
101905,2022-09-08,3,6,11,17
101906,2022-09-08,4,8,20,28
101907,2022-09-08,5,21,49,70
101908,2022-09-08,6,67,179,246
101909,2022-09-08,7,146,506,652
101910,2022-09-08,8,267,868,1135
101911,2022-09-08,9,223,489,712
101912,2022-09-08,10,200,296,496
101913,2022-09-08,11,182,323,505
101914,2022-09-08,12,236,360,596
101915,2022-09-08,13,241,350,591
101916,2022-09-08,14,245,343,588
101917,2022-09-08,15,347,417,764
101918,2022-09-08,16,373,590,963
101919,2022-09-08,17,573,990,1563
101920,2022-09-08,18,545,898,1443
101921,2022-09-08,19,392,637,1029
101922,2022-09-08,20,254,447,701
101923,2022-09-08,21,199,355,554
101924,2022-09-08,22,222,248,470
101925,2022-09-08,23,182,223,405
101926,2022-09-09,0,76,88,164
101927,2022-09-09,1,29,32,61
101928,2022-09-09,2,13,16,29
101929,2022-09-09,3,5,15,20
101930,2022-09-09,4,8,15,23
101931,2022-09-09,5,27,42,69
101932,2022-09-09,6,69,176,245
101933,2022-09-09,7,110,410,520
101934,2022-09-09,8,235,600,835
101935,2022-09-09,9,214,430,644
101936,2022-09-09,10,228,322,550
101937,2022-09-09,11,252,361,613
101938,2022-09-09,12,304,384,688
101939,2022-09-09,13,302,428,730
101940,2022-09-09,14,375,402,777
101941,2022-09-09,15,380,537,917
101942,2022-09-09,16,494,627,1121
101943,2022-09-09,17,590,816,1406
101944,2022-09-09,18,576,843,1419
101945,2022-09-09,19,483,625,1108
101946,2022-09-09,20,332,373,705
101947,2022-09-09,21,234,291,525
101948,2022-09-09,22,209,259,468
101949,2022-09-09,23,222,214,436
101950,2022-09-10,0,128,170,298
101951,2022-09-10,1,102,126,228
101952,2022-09-10,2,78,62,140
101953,2022-09-10,3,24,37,61
101954,2022-09-10,4,14,9,23
101955,2022-09-10,5,13,24,37
101956,2022-09-10,6,59,70,129
101957,2022-09-10,7,100,154,254
101958,2022-09-10,8,178,280,458
101959,2022-09-10,9,369,369,738
101960,2022-09-10,10,506,524,1030
101961,2022-09-10,11,625,608,1233
101962,2022-09-10,12,660,581,1241
101963,2022-09-10,13,743,496,1239
101964,2022-09-10,14,705,461,1166
101965,2022-09-10,15,730,580,1310
101966,2022-09-10,16,646,594,1240
101967,2022-09-10,17,540,497,1037
101968,2022-09-10,18,526,519,1045
101969,2022-09-10,19,434,458,892
101970,2022-09-10,20,274,293,567
101971,2022-09-10,21,221,237,458
101972,2022-09-10,22,214,240,454
101973,2022-09-10,23,169,201,370
101974,2022-09-11,0,146,144,290
101975,2022-09-11,1,116,101,217
101976,2022-09-11,2,87,61,148
101977,2022-09-11,3,37,41,78
101978,2022-09-11,4,15,14,29
101979,2022-09-11,5,6,17,23
101980,2022-09-11,6,15,11,26
101981,2022-09-11,7,9,17,26
101982,2022-09-11,8,23,62,85
101983,2022-09-11,9,34,72,106
101984,2022-09-11,10,101,183,284
101985,2022-09-11,11,143,237,380
101986,2022-09-11,12,259,351,610
101987,2022-09-11,13,252,354,606
101988,2022-09-11,14,326,389,715
101989,2022-09-11,15,385,482,867
101990,2022-09-11,16,394,498,892
101991,2022-09-11,17,377,511,888
101992,2022-09-11,18,314,485,799
101993,2022-09-11,19,230,362,592
101994,2022-09-11,20,148,256,404
101995,2022-09-11,21,135,166,301
101996,2022-09-11,22,94,153,247
101997,2022-09-11,23,50,89,139
101998,2022-09-12,0,37,44,81
101999,2022-09-12,1,15,16,31
102000,2022-09-12,2,8,13,21
102001,2022-09-12,3,4,11,15
102002,2022-09-12,4,10,22,32
102003,2022-09-12,5,20,67,87
102004,2022-09-12,6,66,178,244
102005,2022-09-12,7,116,470,586
102006,2022-09-12,8,258,720,978
102007,2022-09-12,9,189,435,624
102008,2022-09-12,10,206,235,441
102009,2022-09-12,11,236,298,534
102010,2022-09-12,12,255,348,603
102011,2022-09-12,13,197,374,571
102012,2022-09-12,14,252,315,567
102013,2022-09-12,15,275,439,714
102014,2022-09-12,16,256,469,725
102015,2022-09-12,17,232,509,741
102016,2022-09-12,18,113,273,386
102017,2022-09-12,19,142,425,567
102018,2022-09-12,20,137,317,454
102019,2022-09-12,21,88,220,308
102020,2022-09-12,22,67,168,235
102021,2022-09-12,23,92,122,214
102022,2022-09-13,0,26,23,49
102023,2022-09-13,1,8,15,23
102024,2022-09-13,2,4,6,10
102025,2022-09-13,3,7,8,15
102026,2022-09-13,4,8,12,20
102027,2022-09-13,5,21,63,84
102028,2022-09-13,6,67,218,285
102029,2022-09-13,7,163,587,750
102030,2022-09-13,8,316,870,1186
102031,2022-09-13,9,222,493,715
102032,2022-09-13,10,191,301,492
102033,2022-09-13,11,179,313,492
102034,2022-09-13,12,209,376,585
102035,2022-09-13,13,232,367,599
102036,2022-09-13,14,255,367,622
102037,2022-09-13,15,318,454,772
102038,2022-09-13,16,336,637,973
102039,2022-09-13,17,592,1124,1716
102040,2022-09-13,18,590,1018,1608
102041,2022-09-13,19,403,775,1178
102042,2022-09-13,20,260,440,700
102043,2022-09-13,21,229,380,609
102044,2022-09-13,22,165,274,439
102045,2022-09-13,23,69,116,185
102046,2022-09-14,0,34,49,83
102047,2022-09-14,1,19,10,29
102048,2022-09-14,2,7,7,14
102049,2022-09-14,3,2,7,9
102050,2022-09-14,4,10,12,22
102051,2022-09-14,5,29,77,106
102052,2022-09-14,6,80,228,308
102053,2022-09-14,7,195,559,754
102054,2022-09-14,8,344,975,1319
102055,2022-09-14,9,220,522,742
102056,2022-09-14,10,185,316,501
102057,2022-09-14,11,210,346,556
102058,2022-09-14,12,239,391,630
102059,2022-09-14,13,210,384,594
102060,2022-09-14,14,255,339,594
102061,2022-09-14,15,312,490,802
102062,2022-09-14,16,348,672,1020
102063,2022-09-14,17,613,1094,1707
102064,2022-09-14,18,616,988,1604
102065,2022-09-14,19,466,752,1218
102066,2022-09-14,20,233,462,695
102067,2022-09-14,21,200,380,580
102068,2022-09-14,22,177,289,466
102069,2022-09-14,23,121,140,261
102070,2022-09-15,0,35,59,94
102071,2022-09-15,1,13,12,25
102072,2022-09-15,2,9,4,13
102073,2022-09-15,3,3,10,13
102074,2022-09-15,4,6,14,20
102075,2022-09-15,5,28,53,81
102076,2022-09-15,6,84,211,295
102077,2022-09-15,7,158,528,686
102078,2022-09-15,8,282,866,1148
102079,2022-09-15,9,207,537,744
102080,2022-09-15,10,217,313,530
102081,2022-09-15,11,211,281,492
102082,2022-09-15,12,213,412,625
102083,2022-09-15,13,225,355,580
102084,2022-09-15,14,252,311,563
102085,2022-09-15,15,324,444,768
102086,2022-09-15,16,348,642,990
102087,2022-09-15,17,603,1046,1649
102088,2022-09-15,18,596,947,1543
102089,2022-09-15,19,375,692,1067
102090,2022-09-15,20,317,503,820
102091,2022-09-15,21,191,385,576
102092,2022-09-15,22,188,272,460
102093,2022-09-15,23,113,186,299
102094,2022-09-16,0,56,65,121
102095,2022-09-16,1,32,39,71
102096,2022-09-16,2,21,25,46
102097,2022-09-16,3,8,12,20
102098,2022-09-16,4,7,13,20
102099,2022-09-16,5,19,60,79
102100,2022-09-16,6,77,180,257
102101,2022-09-16,7,168,425,593
102102,2022-09-16,8,253,626,879
102103,2022-09-16,9,226,415,641
102104,2022-09-16,10,227,328,555
102105,2022-09-16,11,252,357,609
102106,2022-09-16,12,319,419,738
102107,2022-09-16,13,313,459,772
102108,2022-09-16,14,372,379,751
102109,2022-09-16,15,386,533,919
102110,2022-09-16,16,454,704,1158
102111,2022-09-16,17,644,850,1494
102112,2022-09-16,18,621,805,1426
102113,2022-09-16,19,486,592,1078
102114,2022-09-16,20,253,396,649
102115,2022-09-16,21,204,296,500
102116,2022-09-16,22,254,298,552
102117,2022-09-16,23,205,236,441
102118,2022-09-17,0,176,192,368
102119,2022-09-17,1,110,107,217
102120,2022-09-17,2,105,69,174
102121,2022-09-17,3,36,22,58
102122,2022-09-17,4,12,13,25
102123,2022-09-17,5,21,28,49
102124,2022-09-17,6,44,60,104
102125,2022-09-17,7,70,130,200
102126,2022-09-17,8,176,260,436
102127,2022-09-17,9,342,392,734
102128,2022-09-17,10,536,516,1052
102129,2022-09-17,11,595,550,1145
102130,2022-09-17,12,606,600,1206
102131,2022-09-17,13,696,588,1284
102132,2022-09-17,14,716,553,1269
102133,2022-09-17,15,698,634,1332
102134,2022-09-17,16,633,537,1170
102135,2022-09-17,17,657,498,1155
102136,2022-09-17,18,607,585,1192
102137,2022-09-17,19,502,505,1007
102138,2022-09-17,20,352,331,683
102139,2022-09-17,21,247,275,522
102140,2022-09-17,22,261,220,481
102141,2022-09-17,23,196,172,368
102142,2022-09-18,0,149,148,297
102143,2022-09-18,1,126,116,242
102144,2022-09-18,2,84,51,135
102145,2022-09-18,3,43,40,83
102146,2022-09-18,4,20,13,33
102147,2022-09-18,5,15,19,34
102148,2022-09-18,6,100,104,204
102149,2022-09-18,7,62,109,171
102150,2022-09-18,8,164,216,380
102151,2022-09-18,9,357,401,758
102152,2022-09-18,10,456,517,973
102153,2022-09-18,11,592,548,1140
102154,2022-09-18,12,591,563,1154
102155,2022-09-18,13,609,494,1103
102156,2022-09-18,14,598,557,1155
102157,2022-09-18,15,530,479,1009
102158,2022-09-18,16,587,540,1127
102159,2022-09-18,17,497,526,1023
102160,2022-09-18,18,476,468,944
102161,2022-09-18,19,373,448,821
102162,2022-09-18,20,183,275,458
102163,2022-09-18,21,157,221,378
102164,2022-09-18,22,107,165,272
102165,2022-09-18,23,70,98,168
102166,2022-09-19,0,23,34,57
102167,2022-09-19,1,17,16,33
102168,2022-09-19,2,6,7,13
102169,2022-09-19,3,11,7,18
102170,2022-09-19,4,8,16,24
102171,2022-09-19,5,19,65,84
102172,2022-09-19,6,71,206,277
102173,2022-09-19,7,129,482,611
102174,2022-09-19,8,245,691,936
102175,2022-09-19,9,195,409,604
102176,2022-09-19,10,185,265,450
102177,2022-09-19,11,198,289,487
102178,2022-09-19,12,231,366,597
102179,2022-09-19,13,220,335,555
102180,2022-09-19,14,257,328,585
102181,2022-09-19,15,272,438,710
102182,2022-09-19,16,344,629,973
102183,2022-09-19,17,486,938,1424
102184,2022-09-19,18,457,889,1346
102185,2022-09-19,19,341,617,958
102186,2022-09-19,20,231,402,633
102187,2022-09-19,21,170,298,468
102188,2022-09-19,22,109,164,273
102189,2022-09-19,23,57,106,163
102190,2022-09-20,0,25,27,52
102191,2022-09-20,1,11,14,25
102192,2022-09-20,2,4,6,10
102193,2022-09-20,3,4,3,7
102194,2022-09-20,4,8,16,24
102195,2022-09-20,5,24,77,101
102196,2022-09-20,6,80,230,310
102197,2022-09-20,7,186,568,754
102198,2022-09-20,8,337,913,1250
102199,2022-09-20,9,228,456,684
102200,2022-09-20,10,172,299,471
102201,2022-09-20,11,215,310,525
102202,2022-09-20,12,273,378,651
102203,2022-09-20,13,220,347,567
102204,2022-09-20,14,273,376,649
102205,2022-09-20,15,309,443,752
102206,2022-09-20,16,428,608,1036
102207,2022-09-20,17,632,1061,1693
102208,2022-09-20,18,626,1009,1635
102209,2022-09-20,19,456,724,1180
102210,2022-09-20,20,275,468,743
102211,2022-09-20,21,197,306,503
102212,2022-09-20,22,149,237,386
102213,2022-09-20,23,78,112,190
102214,2022-09-21,0,35,34,69
102215,2022-09-21,1,6,21,27
102216,2022-09-21,2,7,6,13
102217,2022-09-21,3,5,6,11
102218,2022-09-21,4,5,10,15
102219,2022-09-21,5,32,54,86
102220,2022-09-21,6,74,237,311
102221,2022-09-21,7,193,547,740
102222,2022-09-21,8,352,936,1288
102223,2022-09-21,9,225,464,689
102224,2022-09-21,10,189,305,494
102225,2022-09-21,11,185,372,557
102226,2022-09-21,12,206,420,626
102227,2022-09-21,13,193,331,524
102228,2022-09-21,14,254,339,593
102229,2022-09-21,15,273,467,740
102230,2022-09-21,16,348,592,940
102231,2022-09-21,17,594,1000,1594
102232,2022-09-21,18,556,1018,1574
102233,2022-09-21,19,438,752,1190
102234,2022-09-21,20,283,460,743
102235,2022-09-21,21,188,356,544
102236,2022-09-21,22,181,257,438
102237,2022-09-21,23,85,127,212
102238,2022-09-22,0,29,58,87
102239,2022-09-22,1,17,8,25
102240,2022-09-22,2,10,5,15
102241,2022-09-22,3,4,7,11
102242,2022-09-22,4,8,17,25
102243,2022-09-22,5,29,48,77
102244,2022-09-22,6,68,208,276
102245,2022-09-22,7,179,482,661
102246,2022-09-22,8,312,850,1162
102247,2022-09-22,9,194,486,680
102248,2022-09-22,10,139,280,419
102249,2022-09-22,11,112,251,363
102250,2022-09-22,12,97,187,284
102251,2022-09-22,13,144,291,435
102252,2022-09-22,14,209,292,501
102253,2022-09-22,15,265,480,745
102254,2022-09-22,16,355,603,958
102255,2022-09-22,17,586,1007,1593
102256,2022-09-22,18,502,933,1435
102257,2022-09-22,19,370,671,1041
102258,2022-09-22,20,190,449,639
102259,2022-09-22,21,180,320,500
102260,2022-09-22,22,110,218,328
102261,2022-09-22,23,78,121,199
102262,2022-09-23,0,58,64,122
102263,2022-09-23,1,22,26,48
102264,2022-09-23,2,9,13,22
102265,2022-09-23,3,7,6,13
102266,2022-09-23,4,8,19,27
102267,2022-09-23,5,26,56,82
102268,2022-09-23,6,45,184,229
102269,2022-09-23,7,127,373,500
102270,2022-09-23,8,215,609,824
102271,2022-09-23,9,166,426,592
102272,2022-09-23,10,259,352,611
102273,2022-09-23,11,266,356,622
102274,2022-09-23,12,293,425,718
102275,2022-09-23,13,336,446,782
102276,2022-09-23,14,329,434,763
102277,2022-09-23,15,393,552,945
102278,2022-09-23,16,479,647,1126
102279,2022-09-23,17,530,835,1365
102280,2022-09-23,18,557,752,1309
102281,2022-09-23,19,401,571,972
102282,2022-09-23,20,237,386,623
102283,2022-09-23,21,183,258,441
102284,2022-09-23,22,162,228,390
102285,2022-09-23,23,186,208,394
102286,2022-09-24,0,93,145,238
102287,2022-09-24,1,89,125,214
102288,2022-09-24,2,56,52,108
102289,2022-09-24,3,27,23,50
102290,2022-09-24,4,9,21,30
102291,2022-09-24,5,17,29,46
102292,2022-09-24,6,30,43,73
102293,2022-09-24,7,72,115,187
102294,2022-09-24,8,127,210,337
102295,2022-09-24,9,297,377,674
102296,2022-09-24,10,389,458,847
102297,2022-09-24,11,577,529,1106
102298,2022-09-24,12,579,525,1104
102299,2022-09-24,13,675,507,1182
102300,2022-09-24,14,632,543,1175
102301,2022-09-24,15,653,583,1236
102302,2022-09-24,16,604,533,1137
102303,2022-09-24,17,524,505,1029
102304,2022-09-24,18,548,530,1078
102305,2022-09-24,19,419,493,912
102306,2022-09-24,20,253,297,550
102307,2022-09-24,21,245,232,477
102308,2022-09-24,22,226,274,500
102309,2022-09-24,23,254,232,486
102310,2022-09-25,0,135,145,280
102311,2022-09-25,1,123,98,221
102312,2022-09-25,2,63,73,136
102313,2022-09-25,3,43,29,72
102314,2022-09-25,4,15,13,28
102315,2022-09-25,5,9,25,34
102316,2022-09-25,6,28,23,51
102317,2022-09-25,7,47,78,125
102318,2022-09-25,8,125,214,339
102319,2022-09-25,9,245,339,584
102320,2022-09-25,10,444,434,878
102321,2022-09-25,11,488,496,984
102322,2022-09-25,12,530,604,1134
102323,2022-09-25,13,507,514,1021
102324,2022-09-25,14,435,526,961
102325,2022-09-25,15,347,431,778
102326,2022-09-25,16,261,297,558
102327,2022-09-25,17,290,402,692
102328,2022-09-25,18,312,416,728
102329,2022-09-25,19,212,336,548
102330,2022-09-25,20,144,220,364
102331,2022-09-25,21,127,163,290
102332,2022-09-25,22,115,155,270
102333,2022-09-25,23,49,91,140
102334,2022-09-26,0,14,32,46
102335,2022-09-26,1,11,15,26
102336,2022-09-26,2,7,15,22
102337,2022-09-26,3,3,4,7
102338,2022-09-26,4,9,14,23
102339,2022-09-26,5,13,64,77
102340,2022-09-26,6,51,177,228
102341,2022-09-26,7,135,444,579
102342,2022-09-26,8,220,695,915
102343,2022-09-26,9,211,402,613
102344,2022-09-26,10,196,277,473
102345,2022-09-26,11,247,321,568
102346,2022-09-26,12,279,402,681
102347,2022-09-26,13,249,367,616
102348,2022-09-26,14,255,345,600
102349,2022-09-26,15,316,473,789
102350,2022-09-26,16,348,594,942
102351,2022-09-26,17,492,1003,1495
102352,2022-09-26,18,456,919,1375
102353,2022-09-26,19,303,572,875
102354,2022-09-26,20,201,389,590
102355,2022-09-26,21,165,277,442
102356,2022-09-26,22,142,207,349
102357,2022-09-26,23,82,118,200
102358,2022-09-27,0,20,32,52
102359,2022-09-27,1,14,10,24
102360,2022-09-27,2,7,5,12
102361,2022-09-27,3,4,9,13
102362,2022-09-27,4,6,14,20
102363,2022-09-27,5,31,63,94
102364,2022-09-27,6,63,202,265
102365,2022-09-27,7,156,555,711
102366,2022-09-27,8,320,897,1217
102367,2022-09-27,9,183,467,650
102368,2022-09-27,10,161,278,439
102369,2022-09-27,11,182,291,473
102370,2022-09-27,12,193,401,594
102371,2022-09-27,13,241,367,608
102372,2022-09-27,14,185,339,524
102373,2022-09-27,15,242,464,706
102374,2022-09-27,16,338,619,957
102375,2022-09-27,17,519,1095,1614
102376,2022-09-27,18,540,975,1515
102377,2022-09-27,19,323,662,985
102378,2022-09-27,20,192,391,583
102379,2022-09-27,21,168,294,462
102380,2022-09-27,22,133,266,399
102381,2022-09-27,23,99,120,219
102382,2022-09-28,0,27,28,55
102383,2022-09-28,1,14,21,35
102384,2022-09-28,2,2,10,12
102385,2022-09-28,3,7,6,13
102386,2022-09-28,4,6,16,22
102387,2022-09-28,5,22,68,90
102388,2022-09-28,6,62,190,252
102389,2022-09-28,7,187,541,728
102390,2022-09-28,8,295,957,1252
102391,2022-09-28,9,219,482,701
102392,2022-09-28,10,163,294,457
102393,2022-09-28,11,180,319,499
102394,2022-09-28,12,186,382,568
102395,2022-09-28,13,206,329,535
102396,2022-09-28,14,222,333,555
102397,2022-09-28,15,282,451,733
102398,2022-09-28,16,405,654,1059
102399,2022-09-28,17,546,1130,1676
102400,2022-09-28,18,529,991,1520
102401,2022-09-28,19,330,671,1001
102402,2022-09-28,20,217,473,690
102403,2022-09-28,21,172,329,501
102404,2022-09-28,22,136,216,352
102405,2022-09-28,23,69,104,173
102406,2022-09-29,0,31,37,68
102407,2022-09-29,1,11,17,28
102408,2022-09-29,2,11,8,19
102409,2022-09-29,3,4,6,10
102410,2022-09-29,4,5,14,19
102411,2022-09-29,5,19,57,76
102412,2022-09-29,6,62,195,257
102413,2022-09-29,7,151,472,623
102414,2022-09-29,8,262,820,1082
102415,2022-09-29,9,192,511,703
102416,2022-09-29,10,159,320,479
102417,2022-09-29,11,176,310,486
102418,2022-09-29,12,217,349,566
102419,2022-09-29,13,205,376,581
102420,2022-09-29,14,242,331,573
102421,2022-09-29,15,322,433,755
102422,2022-09-29,16,372,597,969
102423,2022-09-29,17,487,1101,1588
102424,2022-09-29,18,522,934,1456
102425,2022-09-29,19,352,620,972
102426,2022-09-29,20,219,418,637
102427,2022-09-29,21,155,348,503
102428,2022-09-29,22,146,213,359
102429,2022-09-29,23,150,199,349
102430,2022-09-30,0,63,70,133
102431,2022-09-30,1,29,33,62
102432,2022-09-30,2,24,23,47
102433,2022-09-30,3,5,12,17
102434,2022-09-30,4,4,13,17
102435,2022-09-30,5,23,46,69
102436,2022-09-30,6,64,149,213
102437,2022-09-30,7,147,412,559
102438,2022-09-30,8,210,579,789
102439,2022-09-30,9,202,425,627
102440,2022-09-30,10,189,289,478
102441,2022-09-30,11,243,392,635
102442,2022-09-30,12,245,394,639
102443,2022-09-30,13,256,405,661
102444,2022-09-30,14,275,405,680
102445,2022-09-30,15,242,423,665
102446,2022-09-30,16,180,370,550
102447,2022-09-30,17,147,326,473
102448,2022-09-30,18,147,351,498
102449,2022-09-30,19,126,286,412
102450,2022-09-30,20,99,156,255
102451,2022-09-30,21,55,106,161
102452,2022-09-30,22,33,63,96
102453,2022-09-30,23,27,68,95
102454,2022-10-01,0,26,59,85
102455,2022-10-01,1,34,36,70
102456,2022-10-01,2,10,21,31
102457,2022-10-01,3,6,12,18
102458,2022-10-01,4,5,5,10
102459,2022-10-01,5,10,10,20
102460,2022-10-01,6,16,26,42
102461,2022-10-01,7,44,69,113
102462,2022-10-01,8,72,149,221
102463,2022-10-01,9,89,180,269
102464,2022-10-01,10,99,234,333
102465,2022-10-01,11,184,292,476
102466,2022-10-01,12,125,279,404
102467,2022-10-01,13,160,300,460
102468,2022-10-01,14,217,341,558
102469,2022-10-01,15,263,346,609
102470,2022-10-01,16,288,328,616
102471,2022-10-01,17,263,344,607
102472,2022-10-01,18,209,290,499
102473,2022-10-01,19,139,253,392
102474,2022-10-01,20,86,162,248
102475,2022-10-01,21,87,159,246
102476,2022-10-01,22,67,158,225
102477,2022-10-01,23,67,107,174
102478,2022-10-02,0,59,89,148
102479,2022-10-02,1,54,86,140
102480,2022-10-02,2,50,55,105
102481,2022-10-02,3,27,17,44
102482,2022-10-02,4,7,7,14
102483,2022-10-02,5,6,13,19
102484,2022-10-02,6,17,16,33
102485,2022-10-02,7,7,29,36
102486,2022-10-02,8,26,90,116
102487,2022-10-02,9,51,150,201
102488,2022-10-02,10,95,199,294
102489,2022-10-02,11,93,201,294
102490,2022-10-02,12,80,162,242
102491,2022-10-02,13,105,242,347
102492,2022-10-02,14,73,169,242
102493,2022-10-02,15,87,176,263
102494,2022-10-02,16,61,114,175
102495,2022-10-02,17,51,150,201
102496,2022-10-02,18,41,126,167
102497,2022-10-02,19,56,145,201
102498,2022-10-02,20,37,117,154
102499,2022-10-02,21,37,103,140
102500,2022-10-02,22,27,69,96
102501,2022-10-02,23,14,45,59
102502,2022-10-03,0,4,9,13
102503,2022-10-03,1,5,5,10
102504,2022-10-03,2,1,5,6
102505,2022-10-03,3,5,1,6
102506,2022-10-03,4,4,6,10
102507,2022-10-03,5,20,43,63
102508,2022-10-03,6,40,108,148
102509,2022-10-03,7,73,334,407
102510,2022-10-03,8,159,589,748
102511,2022-10-03,9,109,334,443
102512,2022-10-03,10,76,174,250
102513,2022-10-03,11,90,201,291
102514,2022-10-03,12,106,292,398
102515,2022-10-03,13,143,277,420
102516,2022-10-03,14,113,252,365
102517,2022-10-03,15,64,160,224
102518,2022-10-03,16,79,221,300
102519,2022-10-03,17,123,360,483
102520,2022-10-03,18,66,243,309
102521,2022-10-03,19,33,160,193
102522,2022-10-03,20,34,99,133
102523,2022-10-03,21,29,104,133
102524,2022-10-03,22,40,81,121
102525,2022-10-03,23,17,56,73
102526,2022-10-04,0,7,13,20
102527,2022-10-04,1,0,5,5
102528,2022-10-04,2,2,4,6
102529,2022-10-04,3,2,4,6
102530,2022-10-04,4,1,12,13
102531,2022-10-04,5,15,41,56
102532,2022-10-04,6,38,124,162
102533,2022-10-04,7,88,388,476
102534,2022-10-04,8,195,645,840
102535,2022-10-04,9,120,419,539
102536,2022-10-04,10,75,183,258
102537,2022-10-04,11,80,210,290
102538,2022-10-04,12,99,242,341
102539,2022-10-04,13,123,286,409
102540,2022-10-04,14,107,244,351
102541,2022-10-04,15,151,342,493
102542,2022-10-04,16,173,495,668
102543,2022-10-04,17,231,709,940
102544,2022-10-04,18,131,463,594
102545,2022-10-04,19,83,279,362
102546,2022-10-04,20,67,210,277
102547,2022-10-04,21,48,126,174
102548,2022-10-04,22,42,114,156
102549,2022-10-04,23,31,65,96
102550,2022-10-05,0,19,27,46
102551,2022-10-05,1,6,6,12
102552,2022-10-05,2,2,5,7
102553,2022-10-05,3,3,4,7
102554,2022-10-05,4,2,5,7
102555,2022-10-05,5,13,38,51
102556,2022-10-05,6,24,111,135
102557,2022-10-05,7,77,283,360
102558,2022-10-05,8,102,415,517
102559,2022-10-05,9,103,381,484
102560,2022-10-05,10,83,200,283
102561,2022-10-05,11,90,220,310
102562,2022-10-05,12,100,278,378
102563,2022-10-05,13,138,302,440
102564,2022-10-05,14,152,343,495
102565,2022-10-05,15,209,401,610
102566,2022-10-05,16,287,556,843
102567,2022-10-05,17,418,883,1301
102568,2022-10-05,18,391,835,1226
102569,2022-10-05,19,242,597,839
102570,2022-10-05,20,138,354,492
102571,2022-10-05,21,138,284,422
102572,2022-10-05,22,107,190,297
102573,2022-10-05,23,67,109,176
102574,2022-10-06,0,29,31,60
102575,2022-10-06,1,7,13,20
102576,2022-10-06,2,6,13,19
102577,2022-10-06,3,3,10,13
102578,2022-10-06,4,0,14,14
102579,2022-10-06,5,19,60,79
102580,2022-10-06,6,68,175,243
102581,2022-10-06,7,133,469,602
102582,2022-10-06,8,245,776,1021
102583,2022-10-06,9,218,493,711
102584,2022-10-06,10,180,295,475
102585,2022-10-06,11,179,309,488
102586,2022-10-06,12,254,399,653
102587,2022-10-06,13,237,366,603
102588,2022-10-06,14,279,337,616
102589,2022-10-06,15,298,471,769
102590,2022-10-06,16,424,606,1030
102591,2022-10-06,17,615,977,1592
102592,2022-10-06,18,573,938,1511
102593,2022-10-06,19,389,572,961
102594,2022-10-06,20,231,455,686
102595,2022-10-06,21,160,324,484
102596,2022-10-06,22,177,249,426
102597,2022-10-06,23,92,166,258
102598,2022-10-07,0,46,111,157
102599,2022-10-07,1,39,33,72
102600,2022-10-07,2,18,17,35
102601,2022-10-07,3,5,9,14
102602,2022-10-07,4,2,20,22
102603,2022-10-07,5,20,44,64
102604,2022-10-07,6,50,150,200
102605,2022-10-07,7,115,340,455
102606,2022-10-07,8,212,506,718
102607,2022-10-07,9,217,375,592
102608,2022-10-07,10,248,286,534
102609,2022-10-07,11,256,319,575
102610,2022-10-07,12,291,405,696
102611,2022-10-07,13,362,464,826
102612,2022-10-07,14,413,477,890
102613,2022-10-07,15,516,525,1041
102614,2022-10-07,16,513,639,1152
102615,2022-10-07,17,611,845,1456
102616,2022-10-07,18,553,700,1253
102617,2022-10-07,19,342,533,875
102618,2022-10-07,20,244,317,561
102619,2022-10-07,21,193,230,423
102620,2022-10-07,22,140,206,346
102621,2022-10-07,23,118,183,301
102622,2022-10-08,0,123,135,258
102623,2022-10-08,1,66,99,165
102624,2022-10-08,2,58,54,112
102625,2022-10-08,3,27,22,49
102626,2022-10-08,4,11,15,26
102627,2022-10-08,5,13,24,37
102628,2022-10-08,6,47,43,90
102629,2022-10-08,7,56,114,170
102630,2022-10-08,8,147,213,360
102631,2022-10-08,9,274,328,602
102632,2022-10-08,10,400,399,799
102633,2022-10-08,11,527,488,1015
102634,2022-10-08,12,490,505,995
102635,2022-10-08,13,543,495,1038
102636,2022-10-08,14,519,442,961
102637,2022-10-08,15,553,453,1006
102638,2022-10-08,16,523,401,924
102639,2022-10-08,17,555,449,1004
102640,2022-10-08,18,385,420,805
102641,2022-10-08,19,222,308,530
102642,2022-10-08,20,183,206,389
102643,2022-10-08,21,131,197,328
102644,2022-10-08,22,129,184,313
102645,2022-10-08,23,98,170,268
102646,2022-10-09,0,78,127,205
102647,2022-10-09,1,93,99,192
102648,2022-10-09,2,61,50,111
102649,2022-10-09,3,22,34,56
102650,2022-10-09,4,10,18,28
102651,2022-10-09,5,19,10,29
102652,2022-10-09,6,28,41,69
102653,2022-10-09,7,49,74,123
102654,2022-10-09,8,109,171,280
102655,2022-10-09,9,218,253,471
102656,2022-10-09,10,380,387,767
102657,2022-10-09,11,500,457,957
102658,2022-10-09,12,515,477,992
102659,2022-10-09,13,551,529,1080
102660,2022-10-09,14,590,496,1086
102661,2022-10-09,15,567,472,1039
102662,2022-10-09,16,530,508,1038
102663,2022-10-09,17,518,481,999
102664,2022-10-09,18,416,445,861
102665,2022-10-09,19,201,305,506
102666,2022-10-09,20,153,203,356
102667,2022-10-09,21,120,163,283
102668,2022-10-09,22,130,169,299
102669,2022-10-09,23,60,94,154
102670,2022-10-10,0,35,41,76
102671,2022-10-10,1,20,33,53
102672,2022-10-10,2,7,14,21
102673,2022-10-10,3,6,11,17
102674,2022-10-10,4,6,10,16
102675,2022-10-10,5,11,38,49
102676,2022-10-10,6,28,87,115
102677,2022-10-10,7,76,168,244
102678,2022-10-10,8,124,319,443
102679,2022-10-10,9,178,288,466
102680,2022-10-10,10,227,320,547
102681,2022-10-10,11,281,392,673
102682,2022-10-10,12,299,408,707
102683,2022-10-10,13,406,451,857
102684,2022-10-10,14,443,465,908
102685,2022-10-10,15,393,495,888
102686,2022-10-10,16,391,561,952
102687,2022-10-10,17,511,726,1237
102688,2022-10-10,18,409,709,1118
102689,2022-10-10,19,260,426,686
102690,2022-10-10,20,165,290,455
102691,2022-10-10,21,107,204,311
102692,2022-10-10,22,111,145,256
102693,2022-10-10,23,70,111,181
102694,2022-10-11,0,27,35,62
102695,2022-10-11,1,12,9,21
102696,2022-10-11,2,7,3,10
102697,2022-10-11,3,5,13,18
102698,2022-10-11,4,9,8,17
102699,2022-10-11,5,19,59,78
102700,2022-10-11,6,46,168,214
102701,2022-10-11,7,124,472,596
102702,2022-10-11,8,233,841,1074
102703,2022-10-11,9,167,396,563
102704,2022-10-11,10,174,268,442
102705,2022-10-11,11,160,273,433
102706,2022-10-11,12,177,344,521
102707,2022-10-11,13,194,321,515
102708,2022-10-11,14,224,341,565
102709,2022-10-11,15,273,438,711
102710,2022-10-11,16,305,543,848
102711,2022-10-11,17,551,927,1478
102712,2022-10-11,18,427,921,1348
102713,2022-10-11,19,267,623,890
102714,2022-10-11,20,166,413,579
102715,2022-10-11,21,131,294,425
102716,2022-10-11,22,90,224,314
102717,2022-10-11,23,62,95,157
102718,2022-10-12,0,28,34,62
102719,2022-10-12,1,12,8,20
102720,2022-10-12,2,8,5,13
102721,2022-10-12,3,4,8,12
102722,2022-10-12,4,3,8,11
102723,2022-10-12,5,26,69,95
102724,2022-10-12,6,61,168,229
102725,2022-10-12,7,150,493,643
102726,2022-10-12,8,257,875,1132
102727,2022-10-12,9,195,474,669
102728,2022-10-12,10,137,244,381
102729,2022-10-12,11,168,273,441
102730,2022-10-12,12,181,365,546
102731,2022-10-12,13,237,327,564
102732,2022-10-12,14,261,345,606
102733,2022-10-12,15,286,453,739
102734,2022-10-12,16,366,572,938
102735,2022-10-12,17,543,1062,1605
102736,2022-10-12,18,511,972,1483
102737,2022-10-12,19,278,593,871
102738,2022-10-12,20,200,406,606
102739,2022-10-12,21,163,304,467
102740,2022-10-12,22,147,228,375
102741,2022-10-12,23,96,124,220
102742,2022-10-13,0,33,58,91
102743,2022-10-13,1,14,13,27
102744,2022-10-13,2,10,12,22
102745,2022-10-13,3,6,4,10
102746,2022-10-13,4,6,11,17
102747,2022-10-13,5,7,39,46
102748,2022-10-13,6,47,110,157
102749,2022-10-13,7,38,195,233
102750,2022-10-13,8,53,225,278
102751,2022-10-13,9,56,183,239
102752,2022-10-13,10,77,179,256
102753,2022-10-13,11,41,141,182
102754,2022-10-13,12,39,166,205
102755,2022-10-13,13,86,239,325
102756,2022-10-13,14,146,245,391
102757,2022-10-13,15,197,334,531
102758,2022-10-13,16,232,434,666
102759,2022-10-13,17,355,778,1133
102760,2022-10-13,18,343,733,1076
102761,2022-10-13,19,198,470,668
102762,2022-10-13,20,77,196,273
102763,2022-10-13,21,67,179,246
102764,2022-10-13,22,65,148,213
102765,2022-10-13,23,35,75,110
102766,2022-10-14,0,28,66,94
102767,2022-10-14,1,16,23,39
102768,2022-10-14,2,10,12,22
102769,2022-10-14,3,6,12,18
102770,2022-10-14,4,9,17,26
102771,2022-10-14,5,15,49,64
102772,2022-10-14,6,56,158,214
102773,2022-10-14,7,101,322,423
102774,2022-10-14,8,168,558,726
102775,2022-10-14,9,191,431,622
102776,2022-10-14,10,195,313,508
102777,2022-10-14,11,281,330,611
102778,2022-10-14,12,296,400,696
102779,2022-10-14,13,337,393,730
102780,2022-10-14,14,353,421,774
102781,2022-10-14,15,374,527,901
102782,2022-10-14,16,456,629,1085
102783,2022-10-14,17,535,835,1370
102784,2022-10-14,18,499,740,1239
102785,2022-10-14,19,338,583,921
102786,2022-10-14,20,246,354,600
102787,2022-10-14,21,178,298,476
102788,2022-10-14,22,155,229,384
102789,2022-10-14,23,131,195,326
102790,2022-10-15,0,81,121,202
102791,2022-10-15,1,81,91,172
102792,2022-10-15,2,58,60,118
102793,2022-10-15,3,29,26,55
102794,2022-10-15,4,12,9,21
102795,2022-10-15,5,15,19,34
102796,2022-10-15,6,29,47,76
102797,2022-10-15,7,71,123,194
102798,2022-10-15,8,157,248,405
102799,2022-10-15,9,262,336,598
102800,2022-10-15,10,434,407,841
102801,2022-10-15,11,515,479,994
102802,2022-10-15,12,637,528,1165
102803,2022-10-15,13,719,494,1213
102804,2022-10-15,14,756,555,1311
102805,2022-10-15,15,803,579,1382
102806,2022-10-15,16,671,502,1173
102807,2022-10-15,17,650,554,1204
102808,2022-10-15,18,441,492,933
102809,2022-10-15,19,310,362,672
102810,2022-10-15,20,190,262,452
102811,2022-10-15,21,168,228,396
102812,2022-10-15,22,174,219,393
102813,2022-10-15,23,186,204,390
102814,2022-10-16,0,121,113,234
102815,2022-10-16,1,102,100,202
102816,2022-10-16,2,59,57,116
102817,2022-10-16,3,44,30,74
102818,2022-10-16,4,9,20,29
102819,2022-10-16,5,10,17,27
102820,2022-10-16,6,18,38,56
102821,2022-10-16,7,44,62,106
102822,2022-10-16,8,122,187,309
102823,2022-10-16,9,220,304,524
102824,2022-10-16,10,402,422,824
102825,2022-10-16,11,487,454,941
102826,2022-10-16,12,545,474,1019
102827,2022-10-16,13,612,547,1159
102828,2022-10-16,14,580,556,1136
102829,2022-10-16,15,569,515,1084
102830,2022-10-16,16,539,519,1058
102831,2022-10-16,17,476,433,909
102832,2022-10-16,18,320,402,722
102833,2022-10-16,19,209,303,512
102834,2022-10-16,20,134,222,356
102835,2022-10-16,21,99,185,284
102836,2022-10-16,22,74,121,195
102837,2022-10-16,23,50,65,115
102838,2022-10-17,0,17,32,49
102839,2022-10-17,1,9,11,20
102840,2022-10-17,2,3,9,12
102841,2022-10-17,3,4,7,11
102842,2022-10-17,4,6,9,15
102843,2022-10-17,5,26,60,86
102844,2022-10-17,6,52,163,215
102845,2022-10-17,7,116,401,517
102846,2022-10-17,8,182,633,815
102847,2022-10-17,9,154,405,559
102848,2022-10-17,10,185,232,417
102849,2022-10-17,11,179,291,470
102850,2022-10-17,12,210,323,533
102851,2022-10-17,13,208,368,576
102852,2022-10-17,14,275,331,606
102853,2022-10-17,15,261,440,701
102854,2022-10-17,16,295,500,795
102855,2022-10-17,17,371,853,1224
102856,2022-10-17,18,356,823,1179
102857,2022-10-17,19,221,471,692
102858,2022-10-17,20,124,342,466
102859,2022-10-17,21,120,257,377
102860,2022-10-17,22,107,147,254
102861,2022-10-17,23,52,84,136
102862,2022-10-18,0,9,27,36
102863,2022-10-18,1,3,8,11
102864,2022-10-18,2,3,3,6
102865,2022-10-18,3,1,10,11
102866,2022-10-18,4,2,14,16
102867,2022-10-18,5,22,60,82
102868,2022-10-18,6,53,162,215
102869,2022-10-18,7,126,448,574
102870,2022-10-18,8,196,851,1047
102871,2022-10-18,9,153,364,517
102872,2022-10-18,10,129,223,352
102873,2022-10-18,11,141,240,381
102874,2022-10-18,12,192,298,490
102875,2022-10-18,13,175,292,467
102876,2022-10-18,14,160,297,457
102877,2022-10-18,15,219,358,577
102878,2022-10-18,16,282,542,824
102879,2022-10-18,17,376,919,1295
102880,2022-10-18,18,325,797,1122
102881,2022-10-18,19,161,509,670
102882,2022-10-18,20,139,331,470
102883,2022-10-18,21,102,239,341
102884,2022-10-18,22,86,175,261
102885,2022-10-18,23,47,79,126
102886,2022-10-19,0,21,33,54
102887,2022-10-19,1,6,10,16
102888,2022-10-19,2,3,9,12
102889,2022-10-19,3,2,7,9
102890,2022-10-19,4,7,11,18
102891,2022-10-19,5,16,46,62
102892,2022-10-19,6,41,153,194
102893,2022-10-19,7,130,419,549
102894,2022-10-19,8,222,780,1002
102895,2022-10-19,9,141,443,584
102896,2022-10-19,10,133,246,379
102897,2022-10-19,11,138,247,385
102898,2022-10-19,12,149,304,453
102899,2022-10-19,13,184,306,490
102900,2022-10-19,14,166,313,479
102901,2022-10-19,15,228,386,614
102902,2022-10-19,16,292,579,871
102903,2022-10-19,17,436,956,1392
102904,2022-10-19,18,342,808,1150
102905,2022-10-19,19,229,517,746
102906,2022-10-19,20,145,345,490
102907,2022-10-19,21,102,251,353
102908,2022-10-19,22,90,183,273
102909,2022-10-19,23,56,101,157
102910,2022-10-20,0,33,49,82
102911,2022-10-20,1,9,15,24
102912,2022-10-20,2,6,10,16
102913,2022-10-20,3,2,9,11
102914,2022-10-20,4,3,9,12
102915,2022-10-20,5,16,49,65
102916,2022-10-20,6,46,142,188
102917,2022-10-20,7,116,376,492
102918,2022-10-20,8,205,714,919
102919,2022-10-20,9,150,445,595
102920,2022-10-20,10,140,283,423
102921,2022-10-20,11,159,273,432
102922,2022-10-20,12,205,368,573
102923,2022-10-20,13,239,332,571
102924,2022-10-20,14,223,337,560
102925,2022-10-20,15,258,420,678
102926,2022-10-20,16,356,573,929
102927,2022-10-20,17,499,940,1439
102928,2022-10-20,18,399,807,1206
102929,2022-10-20,19,247,530,777
102930,2022-10-20,20,191,343,534
102931,2022-10-20,21,145,292,437
102932,2022-10-20,22,113,220,333
102933,2022-10-20,23,80,119,199
102934,2022-10-21,0,43,61,104
102935,2022-10-21,1,23,40,63
102936,2022-10-21,2,13,11,24
102937,2022-10-21,3,5,8,13
102938,2022-10-21,4,3,11,14
102939,2022-10-21,5,14,38,52
102940,2022-10-21,6,40,137,177
102941,2022-10-21,7,91,314,405
102942,2022-10-21,8,168,508,676
102943,2022-10-21,9,195,366,561
102944,2022-10-21,10,230,308,538
102945,2022-10-21,11,266,305,571
102946,2022-10-21,12,268,362,630
102947,2022-10-21,13,289,408,697
102948,2022-10-21,14,315,360,675
102949,2022-10-21,15,367,503,870
102950,2022-10-21,16,422,620,1042
102951,2022-10-21,17,596,816,1412
102952,2022-10-21,18,417,666,1083
102953,2022-10-21,19,313,445,758
102954,2022-10-21,20,200,286,486
102955,2022-10-21,21,180,224,404
102956,2022-10-21,22,131,217,348
102957,2022-10-21,23,169,215,384
102958,2022-10-22,0,104,147,251
102959,2022-10-22,1,73,104,177
102960,2022-10-22,2,78,54,132
102961,2022-10-22,3,26,29,55
102962,2022-10-22,4,5,19,24
102963,2022-10-22,5,14,26,40
102964,2022-10-22,6,28,41,69
102965,2022-10-22,7,57,100,157
102966,2022-10-22,8,135,205,340
102967,2022-10-22,9,262,324,586
102968,2022-10-22,10,419,394,813
102969,2022-10-22,11,584,463,1047
102970,2022-10-22,12,687,521,1208
102971,2022-10-22,13,643,500,1143
102972,2022-10-22,14,745,572,1317
102973,2022-10-22,15,676,523,1199
102974,2022-10-22,16,660,564,1224
102975,2022-10-22,17,590,537,1127
102976,2022-10-22,18,562,481,1043
102977,2022-10-22,19,353,397,750
102978,2022-10-22,20,236,262,498
102979,2022-10-22,21,187,217,404
102980,2022-10-22,22,182,201,383
102981,2022-10-22,23,185,196,381
102982,2022-10-23,0,175,138,313
102983,2022-10-23,1,136,99,235
102984,2022-10-23,2,88,66,154
102985,2022-10-23,3,43,26,69
102986,2022-10-23,4,16,10,26
102987,2022-10-23,5,9,15,24
102988,2022-10-23,6,24,27,51
102989,2022-10-23,7,43,58,101
102990,2022-10-23,8,98,142,240
102991,2022-10-23,9,201,272,473
102992,2022-10-23,10,359,387,746
102993,2022-10-23,11,353,379,732
102994,2022-10-23,12,409,470,879
102995,2022-10-23,13,501,432,933
102996,2022-10-23,14,459,491,950
102997,2022-10-23,15,432,453,885
102998,2022-10-23,16,403,477,880
102999,2022-10-23,17,374,379,753
103000,2022-10-23,18,128,214,342
103001,2022-10-23,19,50,110,160
103002,2022-10-23,20,35,83,118
103003,2022-10-23,21,31,79,110
103004,2022-10-23,22,38,83,121
103005,2022-10-23,23,44,62,106
103006,2022-10-24,0,15,16,31
103007,2022-10-24,1,2,13,15
103008,2022-10-24,2,7,12,19
103009,2022-10-24,3,3,5,8
103010,2022-10-24,4,7,9,16
103011,2022-10-24,5,14,63,77
103012,2022-10-24,6,51,153,204
103013,2022-10-24,7,101,347,448
103014,2022-10-24,8,169,580,749
103015,2022-10-24,9,138,354,492
103016,2022-10-24,10,153,223,376
103017,2022-10-24,11,209,260,469
103018,2022-10-24,12,191,314,505
103019,2022-10-24,13,203,308,511
103020,2022-10-24,14,204,293,497
103021,2022-10-24,15,233,411,644
103022,2022-10-24,16,263,487,750
103023,2022-10-24,17,392,800,1192
103024,2022-10-24,18,333,696,1029
103025,2022-10-24,19,200,487,687
103026,2022-10-24,20,133,332,465
103027,2022-10-24,21,119,230,349
103028,2022-10-24,22,104,178,282
103029,2022-10-24,23,58,77,135
103030,2022-10-25,0,15,45,60
103031,2022-10-25,1,9,17,26
103032,2022-10-25,2,7,7,14
103033,2022-10-25,3,1,7,8
103034,2022-10-25,4,3,17,20
103035,2022-10-25,5,20,57,77
103036,2022-10-25,6,56,184,240
103037,2022-10-25,7,123,468,591
103038,2022-10-25,8,235,801,1036
103039,2022-10-25,9,157,461,618
103040,2022-10-25,10,142,222,364
103041,2022-10-25,11,121,273,394
103042,2022-10-25,12,156,306,462
103043,2022-10-25,13,177,313,490
103044,2022-10-25,14,206,305,511
103045,2022-10-25,15,252,423,675
103046,2022-10-25,16,286,589,875
103047,2022-10-25,17,382,959,1341
103048,2022-10-25,18,368,794,1162
103049,2022-10-25,19,228,517,745
103050,2022-10-25,20,156,339,495
103051,2022-10-25,21,162,330,492
103052,2022-10-25,22,117,226,343
103053,2022-10-25,23,63,86,149
103054,2022-10-26,0,29,45,74
103055,2022-10-26,1,7,17,24
103056,2022-10-26,2,8,7,15
103057,2022-10-26,3,4,6,10
103058,2022-10-26,4,6,10,16
103059,2022-10-26,5,19,67,86
103060,2022-10-26,6,51,210,261
103061,2022-10-26,7,118,452,570
103062,2022-10-26,8,230,780,1010
103063,2022-10-26,9,141,445,586
103064,2022-10-26,10,157,233,390
103065,2022-10-26,11,131,278,409
103066,2022-10-26,12,161,278,439
103067,2022-10-26,13,158,332,490
103068,2022-10-26,14,216,340,556
103069,2022-10-26,15,260,431,691
103070,2022-10-26,16,304,572,876
103071,2022-10-26,17,420,995,1415
103072,2022-10-26,18,427,928,1355
103073,2022-10-26,19,284,543,827
103074,2022-10-26,20,190,389,579
103075,2022-10-26,21,147,288,435
103076,2022-10-26,22,105,215,320
103077,2022-10-26,23,73,100,173
103078,2022-10-27,0,24,41,65
103079,2022-10-27,1,18,14,32
103080,2022-10-27,2,8,8,16
103081,2022-10-27,3,4,7,11
103082,2022-10-27,4,4,12,16
103083,2022-10-27,5,25,60,85
103084,2022-10-27,6,39,179,218
103085,2022-10-27,7,123,456,579
103086,2022-10-27,8,245,782,1027
103087,2022-10-27,9,196,419,615
103088,2022-10-27,10,156,270,426
103089,2022-10-27,11,186,308,494
103090,2022-10-27,12,186,374,560
103091,2022-10-27,13,211,342,553
103092,2022-10-27,14,260,308,568
103093,2022-10-27,15,312,460,772
103094,2022-10-27,16,359,586,945
103095,2022-10-27,17,494,908,1402
103096,2022-10-27,18,449,834,1283
103097,2022-10-27,19,247,554,801
103098,2022-10-27,20,184,387,571
103099,2022-10-27,21,139,318,457
103100,2022-10-27,22,118,225,343
103101,2022-10-27,23,113,161,274
103102,2022-10-28,0,49,56,105
103103,2022-10-28,1,31,29,60
103104,2022-10-28,2,16,19,35
103105,2022-10-28,3,12,12,24
103106,2022-10-28,4,6,12,18
103107,2022-10-28,5,18,60,78
103108,2022-10-28,6,45,129,174
103109,2022-10-28,7,80,333,413
103110,2022-10-28,8,170,518,688
103111,2022-10-28,9,192,379,571
103112,2022-10-28,10,161,258,419
103113,2022-10-28,11,201,288,489
103114,2022-10-28,12,278,376,654
103115,2022-10-28,13,270,424,694
103116,2022-10-28,14,292,412,704
103117,2022-10-28,15,349,472,821
103118,2022-10-28,16,365,591,956
103119,2022-10-28,17,436,737,1173
103120,2022-10-28,18,352,626,978
103121,2022-10-28,19,240,441,681
103122,2022-10-28,20,177,277,454
103123,2022-10-28,21,124,225,349
103124,2022-10-28,22,133,189,322
103125,2022-10-28,23,144,189,333
103126,2022-10-29,0,108,160,268
103127,2022-10-29,1,111,127,238
103128,2022-10-29,2,75,78,153
103129,2022-10-29,3,35,24,59
103130,2022-10-29,4,8,11,19
103131,2022-10-29,5,5,19,24
103132,2022-10-29,6,17,37,54
103133,2022-10-29,7,38,103,141
103134,2022-10-29,8,81,194,275
103135,2022-10-29,9,197,304,501
103136,2022-10-29,10,379,385,764
103137,2022-10-29,11,461,465,926
103138,2022-10-29,12,513,457,970
103139,2022-10-29,13,621,521,1142
103140,2022-10-29,14,629,475,1104
103141,2022-10-29,15,624,562,1186
103142,2022-10-29,16,621,550,1171
103143,2022-10-29,17,462,455,917
103144,2022-10-29,18,319,402,721
103145,2022-10-29,19,214,355,569
103146,2022-10-29,20,187,281,468
103147,2022-10-29,21,155,195,350
103148,2022-10-29,22,157,186,343
103149,2022-10-29,23,182,181,363
103150,2022-10-30,0,167,176,343
103151,2022-10-30,1,132,143,275
103152,2022-10-30,2,107,102,209
103153,2022-10-30,3,39,42,81
103154,2022-10-30,4,15,16,31
103155,2022-10-30,5,19,28,47
103156,2022-10-30,6,43,48,91
103157,2022-10-30,7,77,68,145
103158,2022-10-30,8,164,140,304
103159,2022-10-30,9,269,250,519
103160,2022-10-30,10,461,390,851
103161,2022-10-30,11,429,392,821
103162,2022-10-30,12,518,497,1015
103163,2022-10-30,13,530,465,995
103164,2022-10-30,14,557,456,1013
103165,2022-10-30,15,491,542,1033
103166,2022-10-30,16,475,513,988
103167,2022-10-30,17,386,462,848
103168,2022-10-30,18,266,394,660
103169,2022-10-30,19,178,291,469
103170,2022-10-30,20,110,202,312
103171,2022-10-30,21,91,144,235
103172,2022-10-30,22,63,137,200
103173,2022-10-30,23,44,52,96
103174,2022-10-31,0,24,26,50
103175,2022-10-31,1,12,12,24
103176,2022-10-31,2,12,6,18
103177,2022-10-31,3,3,3,6
103178,2022-10-31,4,9,7,16
103179,2022-10-31,5,20,63,83
103180,2022-10-31,6,55,143,198
103181,2022-10-31,7,75,359,434
103182,2022-10-31,8,144,575,719
103183,2022-10-31,9,137,355,492
103184,2022-10-31,10,71,144,215
103185,2022-10-31,11,108,229,337
103186,2022-10-31,12,130,268,398
103187,2022-10-31,13,154,330,484
103188,2022-10-31,14,142,340,482
103189,2022-10-31,15,165,435,600
103190,2022-10-31,16,116,287,403
103191,2022-10-31,17,160,504,664
103192,2022-10-31,18,137,430,567
103193,2022-10-31,19,78,267,345
103194,2022-10-31,20,66,203,269
103195,2022-10-31,21,41,155,196
103196,2022-10-31,22,42,111,153
103197,2022-10-31,23,35,58,93
103198,2022-11-01,0,14,44,58
103199,2022-11-01,1,5,15,20
103200,2022-11-01,2,10,14,24
103201,2022-11-01,3,4,8,12
103202,2022-11-01,4,6,8,14
103203,2022-11-01,5,20,66,86
103204,2022-11-01,6,44,173,217
103205,2022-11-01,7,111,450,561
103206,2022-11-01,8,198,727,925
103207,2022-11-01,9,145,429,574
103208,2022-11-01,10,121,213,334
103209,2022-11-01,11,130,241,371
103210,2022-11-01,12,160,341,501
103211,2022-11-01,13,162,365,527
103212,2022-11-01,14,193,316,509
103213,2022-11-01,15,195,455,650
103214,2022-11-01,16,316,571,887
103215,2022-11-01,17,419,1021,1440
103216,2022-11-01,18,398,879,1277
103217,2022-11-01,19,239,563,802
103218,2022-11-01,20,158,395,553
103219,2022-11-01,21,153,301,454
103220,2022-11-01,22,108,178,286
103221,2022-11-01,23,47,95,142
103222,2022-11-02,0,27,43,70
103223,2022-11-02,1,10,13,23
103224,2022-11-02,2,1,11,12
103225,2022-11-02,3,5,7,12
103226,2022-11-02,4,4,10,14
103227,2022-11-02,5,25,65,90
103228,2022-11-02,6,51,191,242
103229,2022-11-02,7,137,516,653
103230,2022-11-02,8,211,837,1048
103231,2022-11-02,9,188,465,653
103232,2022-11-02,10,127,245,372
103233,2022-11-02,11,165,300,465
103234,2022-11-02,12,180,378,558
103235,2022-11-02,13,204,343,547
103236,2022-11-02,14,190,337,527
103237,2022-11-02,15,237,417,654
103238,2022-11-02,16,291,593,884
103239,2022-11-02,17,403,1010,1413
103240,2022-11-02,18,350,818,1168
103241,2022-11-02,19,256,566,822
103242,2022-11-02,20,165,391,556
103243,2022-11-02,21,152,279,431
103244,2022-11-02,22,110,196,306
103245,2022-11-02,23,74,105,179
103246,2022-11-03,0,30,41,71
103247,2022-11-03,1,10,20,30
103248,2022-11-03,2,5,12,17
103249,2022-11-03,3,2,5,7
103250,2022-11-03,4,5,20,25
103251,2022-11-03,5,20,83,103
103252,2022-11-03,6,54,168,222
103253,2022-11-03,7,111,435,546
103254,2022-11-03,8,247,782,1029
103255,2022-11-03,9,186,478,664
103256,2022-11-03,10,177,274,451
103257,2022-11-03,11,177,289,466
103258,2022-11-03,12,200,375,575
103259,2022-11-03,13,202,348,550
103260,2022-11-03,14,214,389,603
103261,2022-11-03,15,289,461,750
103262,2022-11-03,16,381,609,990
103263,2022-11-03,17,519,1014,1533
103264,2022-11-03,18,434,834,1268
103265,2022-11-03,19,268,554,822
103266,2022-11-03,20,167,335,502
103267,2022-11-03,21,155,323,478
103268,2022-11-03,22,121,213,334
103269,2022-11-03,23,84,133,217
103270,2022-11-04,0,45,75,120
103271,2022-11-04,1,24,34,58
103272,2022-11-04,2,11,11,22
103273,2022-11-04,3,5,11,16
103274,2022-11-04,4,3,15,18
103275,2022-11-04,5,15,57,72
103276,2022-11-04,6,47,135,182
103277,2022-11-04,7,80,352,432
103278,2022-11-04,8,175,552,727
103279,2022-11-04,9,197,381,578
103280,2022-11-04,10,225,274,499
103281,2022-11-04,11,203,377,580
103282,2022-11-04,12,238,402,640
103283,2022-11-04,13,328,407,735
103284,2022-11-04,14,366,395,761
103285,2022-11-04,15,439,533,972
103286,2022-11-04,16,489,628,1117
103287,2022-11-04,17,494,788,1282
103288,2022-11-04,18,449,676,1125
103289,2022-11-04,19,268,478,746
103290,2022-11-04,20,211,304,515
103291,2022-11-04,21,214,296,510
103292,2022-11-04,22,184,211,395
103293,2022-11-04,23,141,186,327
103294,2022-11-05,0,100,125,225
103295,2022-11-05,1,95,107,202
103296,2022-11-05,2,68,57,125
103297,2022-11-05,3,25,21,46
103298,2022-11-05,4,13,12,25
103299,2022-11-05,5,12,28,40
103300,2022-11-05,6,16,47,63
103301,2022-11-05,7,43,116,159
103302,2022-11-05,8,149,235,384
103303,2022-11-05,9,259,370,629
103304,2022-11-05,10,432,453,885
103305,2022-11-05,11,595,623,1218
103306,2022-11-05,12,661,580,1241
103307,2022-11-05,13,683,562,1245
103308,2022-11-05,14,836,604,1440
103309,2022-11-05,15,867,577,1444
103310,2022-11-05,16,729,588,1317
103311,2022-11-05,17,674,510,1184
103312,2022-11-05,18,467,483,950
103313,2022-11-05,19,296,353,649
103314,2022-11-05,20,269,290,559
103315,2022-11-05,21,200,242,442
103316,2022-11-05,22,190,221,411
103317,2022-11-05,23,161,186,347
103318,2022-11-06,0,133,165,298
103319,2022-11-06,1,182,163,345
103320,2022-11-06,2,36,46,82
103321,2022-11-06,3,12,18,30
103322,2022-11-06,4,8,7,15
103323,2022-11-06,5,9,11,20
103324,2022-11-06,6,34,42,76
103325,2022-11-06,7,54,116,170
103326,2022-11-06,8,85,143,228
103327,2022-11-06,9,237,268,505
103328,2022-11-06,10,379,392,771
103329,2022-11-06,11,456,477,933
103330,2022-11-06,12,560,528,1088
103331,2022-11-06,13,523,506,1029
103332,2022-11-06,14,494,468,962
103333,2022-11-06,15,468,456,924
103334,2022-11-06,16,466,445,911
103335,2022-11-06,17,313,408,721
103336,2022-11-06,18,198,315,513
103337,2022-11-06,19,143,241,384
103338,2022-11-06,20,107,218,325
103339,2022-11-06,21,109,157,266
103340,2022-11-06,22,88,104,192
103341,2022-11-06,23,43,71,114
103342,2022-11-07,0,22,30,52
103343,2022-11-07,1,8,14,22
103344,2022-11-07,2,12,10,22
103345,2022-11-07,3,11,10,21
103346,2022-11-07,4,10,11,21
103347,2022-11-07,5,22,70,92
103348,2022-11-07,6,54,206,260
103349,2022-11-07,7,107,487,594
103350,2022-11-07,8,220,671,891
103351,2022-11-07,9,183,356,539
103352,2022-11-07,10,192,236,428
103353,2022-11-07,11,229,299,528
103354,2022-11-07,12,211,374,585
103355,2022-11-07,13,252,360,612
103356,2022-11-07,14,296,386,682
103357,2022-11-07,15,355,475,830
103358,2022-11-07,16,372,638,1010
103359,2022-11-07,17,369,901,1270
103360,2022-11-07,18,279,747,1026
103361,2022-11-07,19,234,508,742
103362,2022-11-07,20,189,328,517
103363,2022-11-07,21,110,258,368
103364,2022-11-07,22,98,175,273
103365,2022-11-07,23,68,89,157
103366,2022-11-08,0,17,32,49
103367,2022-11-08,1,7,15,22
103368,2022-11-08,2,2,7,9
103369,2022-11-08,3,2,7,9
103370,2022-11-08,4,5,17,22
103371,2022-11-08,5,32,84,116
103372,2022-11-08,6,57,203,260
103373,2022-11-08,7,136,466,602
103374,2022-11-08,8,241,774,1015
103375,2022-11-08,9,180,434,614
103376,2022-11-08,10,146,260,406
103377,2022-11-08,11,186,263,449
103378,2022-11-08,12,189,369,558
103379,2022-11-08,13,226,373,599
103380,2022-11-08,14,208,340,548
103381,2022-11-08,15,274,459,733
103382,2022-11-08,16,292,583,875
103383,2022-11-08,17,344,881,1225
103384,2022-11-08,18,299,678,977
103385,2022-11-08,19,216,482,698
103386,2022-11-08,20,136,353,489
103387,2022-11-08,21,105,262,367
103388,2022-11-08,22,107,171,278
103389,2022-11-08,23,70,131,201
103390,2022-11-09,0,27,57,84
103391,2022-11-09,1,10,25,35
103392,2022-11-09,2,7,9,16
103393,2022-11-09,3,4,11,15
103394,2022-11-09,4,2,12,14
103395,2022-11-09,5,21,65,86
103396,2022-11-09,6,52,206,258
103397,2022-11-09,7,117,500,617
103398,2022-11-09,8,234,817,1051
103399,2022-11-09,9,170,461,631
103400,2022-11-09,10,142,272,414
103401,2022-11-09,11,132,291,423
103402,2022-11-09,12,176,322,498
103403,2022-11-09,13,189,323,512
103404,2022-11-09,14,195,304,499
103405,2022-11-09,15,246,428,674
103406,2022-11-09,16,271,620,891
103407,2022-11-09,17,343,912,1255
103408,2022-11-09,18,273,681,954
103409,2022-11-09,19,228,497,725
103410,2022-11-09,20,134,341,475
103411,2022-11-09,21,120,241,361
103412,2022-11-09,22,136,206,342
103413,2022-11-09,23,55,115,170
103414,2022-11-10,0,22,50,72
103415,2022-11-10,1,10,17,27
103416,2022-11-10,2,10,6,16
103417,2022-11-10,3,4,6,10
103418,2022-11-10,4,2,12,14
103419,2022-11-10,5,17,55,72
103420,2022-11-10,6,51,184,235
103421,2022-11-10,7,109,438,547
103422,2022-11-10,8,233,749,982
103423,2022-11-10,9,189,449,638
103424,2022-11-10,10,149,282,431
103425,2022-11-10,11,184,319,503
103426,2022-11-10,12,243,383,626
103427,2022-11-10,13,239,400,639
103428,2022-11-10,14,263,376,639
103429,2022-11-10,15,320,453,773
103430,2022-11-10,16,333,638,971
103431,2022-11-10,17,386,837,1223
103432,2022-11-10,18,373,736,1109
103433,2022-11-10,19,230,480,710
103434,2022-11-10,20,185,371,556
103435,2022-11-10,21,177,311,488
103436,2022-11-10,22,160,264,424
103437,2022-11-10,23,114,178,292
103438,2022-11-11,0,66,79,145
103439,2022-11-11,1,34,45,79
103440,2022-11-11,2,28,41,69
103441,2022-11-11,3,18,20,38
103442,2022-11-11,4,7,24,31
103443,2022-11-11,5,9,33,42
103444,2022-11-11,6,14,61,75
103445,2022-11-11,7,24,91,115
103446,2022-11-11,8,44,134,178
103447,2022-11-11,9,25,120,145
103448,2022-11-11,10,30,82,112
103449,2022-11-11,11,51,129,180
103450,2022-11-11,12,99,234,333
103451,2022-11-11,13,154,241,395
103452,2022-11-11,14,181,279,460
103453,2022-11-11,15,99,184,283
103454,2022-11-11,16,167,301,468
103455,2022-11-11,17,175,383,558
103456,2022-11-11,18,203,395,598
103457,2022-11-11,19,158,299,457
103458,2022-11-11,20,128,214,342
103459,2022-11-11,21,123,190,313
103460,2022-11-11,22,110,155,265
103461,2022-11-11,23,58,89,147
103462,2022-11-12,0,77,101,178
103463,2022-11-12,1,51,55,106
103464,2022-11-12,2,49,37,86
103465,2022-11-12,3,21,18,39
103466,2022-11-12,4,8,12,20
103467,2022-11-12,5,18,19,37
103468,2022-11-12,6,26,51,77
103469,2022-11-12,7,66,126,192
103470,2022-11-12,8,131,228,359
103471,2022-11-12,9,327,337,664
103472,2022-11-12,10,531,449,980
103473,2022-11-12,11,663,539,1202
103474,2022-11-12,12,727,546,1273
103475,2022-11-12,13,845,610,1455
103476,2022-11-12,14,785,608,1393
103477,2022-11-12,15,784,582,1366
103478,2022-11-12,16,690,580,1270
103479,2022-11-12,17,468,456,924
103480,2022-11-12,18,329,367,696
103481,2022-11-12,19,236,319,555
103482,2022-11-12,20,231,270,501
103483,2022-11-12,21,153,194,347
103484,2022-11-12,22,119,171,290
103485,2022-11-12,23,60,100,160
103486,2022-11-13,0,91,108,199
103487,2022-11-13,1,71,89,160
103488,2022-11-13,2,47,65,112
103489,2022-11-13,3,21,30,51
103490,2022-11-13,4,9,10,19
103491,2022-11-13,5,8,14,22
103492,2022-11-13,6,21,40,61
103493,2022-11-13,7,20,74,94
103494,2022-11-13,8,78,127,205
103495,2022-11-13,9,165,244,409
103496,2022-11-13,10,263,331,594
103497,2022-11-13,11,342,322,664
103498,2022-11-13,12,359,390,749
103499,2022-11-13,13,276,420,696
103500,2022-11-13,14,297,349,646
103501,2022-11-13,15,243,360,603
103502,2022-11-13,16,215,346,561
103503,2022-11-13,17,176,330,506
103504,2022-11-13,18,124,246,370
103505,2022-11-13,19,66,167,233
103506,2022-11-13,20,70,150,220
103507,2022-11-13,21,56,100,156
103508,2022-11-13,22,44,78,122
103509,2022-11-13,23,27,54,81
103510,2022-11-14,0,15,24,39
103511,2022-11-14,1,1,15,16
103512,2022-11-14,2,2,11,13
103513,2022-11-14,3,1,9,10
103514,2022-11-14,4,6,14,20
103515,2022-11-14,5,14,53,67
103516,2022-11-14,6,39,152,191
103517,2022-11-14,7,84,356,440
103518,2022-11-14,8,113,567,680
103519,2022-11-14,9,110,280,390
103520,2022-11-14,10,101,204,305
103521,2022-11-14,11,139,222,361
103522,2022-11-14,12,136,285,421
103523,2022-11-14,13,154,258,412
103524,2022-11-14,14,134,263,397
103525,2022-11-14,15,164,380,544
103526,2022-11-14,16,184,444,628
103527,2022-11-14,17,206,731,937
103528,2022-11-14,18,174,573,747
103529,2022-11-14,19,117,411,528
103530,2022-11-14,20,79,301,380
103531,2022-11-14,21,59,166,225
103532,2022-11-14,22,56,125,181
103533,2022-11-14,23,34,55,89
103534,2022-11-15,0,14,21,35
103535,2022-11-15,1,3,7,10
103536,2022-11-15,2,2,5,7
103537,2022-11-15,3,2,4,6
103538,2022-11-15,4,8,13,21
103539,2022-11-15,5,20,54,74
103540,2022-11-15,6,39,165,204
103541,2022-11-15,7,102,469,571
103542,2022-11-15,8,178,748,926
103543,2022-11-15,9,132,388,520
103544,2022-11-15,10,77,242,319
103545,2022-11-15,11,69,213,282
103546,2022-11-15,12,41,164,205
103547,2022-11-15,13,44,164,208
103548,2022-11-15,14,43,158,201
103549,2022-11-15,15,65,185,250
103550,2022-11-15,16,47,176,223
103551,2022-11-15,17,38,182,220
103552,2022-11-15,18,28,126,154
103553,2022-11-15,19,19,90,109
103554,2022-11-15,20,10,42,52
103555,2022-11-15,21,10,51,61
103556,2022-11-15,22,14,39,53
103557,2022-11-15,23,23,44,67
103558,2022-11-16,0,6,22,28
103559,2022-11-16,1,5,7,12
103560,2022-11-16,2,4,4,8
103561,2022-11-16,3,1,2,3
103562,2022-11-16,4,6,10,16
103563,2022-11-16,5,15,60,75
103564,2022-11-16,6,39,145,184
103565,2022-11-16,7,76,401,477
103566,2022-11-16,8,164,616,780
103567,2022-11-16,9,95,338,433
103568,2022-11-16,10,70,229,299
103569,2022-11-16,11,108,240,348
103570,2022-11-16,12,99,293,392
103571,2022-11-16,13,111,260,371
103572,2022-11-16,14,110,243,353
103573,2022-11-16,15,143,328,471
103574,2022-11-16,16,191,443,634
103575,2022-11-16,17,247,695,942
103576,2022-11-16,18,192,661,853
103577,2022-11-16,19,134,456,590
103578,2022-11-16,20,90,279,369
103579,2022-11-16,21,74,202,276
103580,2022-11-16,22,74,139,213
103581,2022-11-16,23,43,101,144
103582,2022-11-17,0,16,47,63
103583,2022-11-17,1,9,11,20
103584,2022-11-17,2,5,9,14
103585,2022-11-17,3,3,4,7
103586,2022-11-17,4,4,9,13
103587,2022-11-17,5,9,70,79
103588,2022-11-17,6,39,174,213
103589,2022-11-17,7,81,412,493
103590,2022-11-17,8,180,648,828
103591,2022-11-17,9,98,347,445
103592,2022-11-17,10,74,233,307
103593,2022-11-17,11,72,229,301
103594,2022-11-17,12,99,281,380
103595,2022-11-17,13,83,254,337
103596,2022-11-17,14,108,260,368
103597,2022-11-17,15,128,307,435
103598,2022-11-17,16,163,439,602
103599,2022-11-17,17,215,622,837
103600,2022-11-17,18,182,540,722
103601,2022-11-17,19,108,363,471
103602,2022-11-17,20,78,244,322
103603,2022-11-17,21,66,194,260
103604,2022-11-17,22,55,124,179
103605,2022-11-17,23,45,102,147
103606,2022-11-18,0,23,39,62
103607,2022-11-18,1,13,17,30
103608,2022-11-18,2,5,10,15
103609,2022-11-18,3,7,5,12
103610,2022-11-18,4,4,10,14
103611,2022-11-18,5,22,50,72
103612,2022-11-18,6,35,118,153
103613,2022-11-18,7,52,316,368
103614,2022-11-18,8,118,450,568
103615,2022-11-18,9,81,303,384
103616,2022-11-18,10,90,266,356
103617,2022-11-18,11,104,257,361
103618,2022-11-18,12,164,295,459
103619,2022-11-18,13,142,266,408
103620,2022-11-18,14,163,336,499
103621,2022-11-18,15,209,407,616
103622,2022-11-18,16,224,473,697
103623,2022-11-18,17,204,534,738
103624,2022-11-18,18,129,428,557
103625,2022-11-18,19,113,318,431
103626,2022-11-18,20,82,209,291
103627,2022-11-18,21,66,181,247
103628,2022-11-18,22,51,147,198
103629,2022-11-18,23,67,117,184
103630,2022-11-19,0,53,83,136
103631,2022-11-19,1,39,53,92
103632,2022-11-19,2,28,21,49
103633,2022-11-19,3,6,10,16
103634,2022-11-19,4,3,14,17
103635,2022-11-19,5,4,11,15
103636,2022-11-19,6,18,30,48
103637,2022-11-19,7,25,65,90
103638,2022-11-19,8,59,141,200
103639,2022-11-19,9,117,271,388
103640,2022-11-19,10,204,354,558
103641,2022-11-19,11,219,363,582
103642,2022-11-19,12,246,424,670
103643,2022-11-19,13,281,430,711
103644,2022-11-19,14,290,378,668
103645,2022-11-19,15,325,425,750
103646,2022-11-19,16,249,383,632
103647,2022-11-19,17,178,351,529
103648,2022-11-19,18,116,238,354
103649,2022-11-19,19,83,186,269
103650,2022-11-19,20,66,161,227
103651,2022-11-19,21,61,114,175
103652,2022-11-19,22,65,114,179
103653,2022-11-19,23,76,111,187
103654,2022-11-20,0,61,89,150
103655,2022-11-20,1,55,68,123
103656,2022-11-20,2,33,33,66
103657,2022-11-20,3,20,13,33
103658,2022-11-20,4,6,12,18
103659,2022-11-20,5,3,11,14
103660,2022-11-20,6,16,15,31
103661,2022-11-20,7,13,54,67
103662,2022-11-20,8,43,87,130
103663,2022-11-20,9,64,159,223
103664,2022-11-20,10,144,216,360
103665,2022-11-20,11,130,205,335
103666,2022-11-20,12,156,238,394
103667,2022-11-20,13,162,277,439
103668,2022-11-20,14,143,265,408
103669,2022-11-20,15,150,258,408
103670,2022-11-20,16,134,257,391
103671,2022-11-20,17,100,202,302
103672,2022-11-20,18,58,181,239
103673,2022-11-20,19,48,107,155
103674,2022-11-20,20,39,89,128
103675,2022-11-20,21,38,70,108
103676,2022-11-20,22,36,53,89
103677,2022-11-20,23,11,22,33
103678,2022-11-21,0,11,13,24
103679,2022-11-21,1,4,4,8
103680,2022-11-21,2,3,5,8
103681,2022-11-21,3,1,4,5
103682,2022-11-21,4,2,7,9
103683,2022-11-21,5,12,42,54
103684,2022-11-21,6,28,110,138
103685,2022-11-21,7,45,270,315
103686,2022-11-21,8,87,414,501
103687,2022-11-21,9,64,256,320
103688,2022-11-21,10,84,187,271
103689,2022-11-21,11,84,211,295
103690,2022-11-21,12,117,231,348
103691,2022-11-21,13,194,277,471
103692,2022-11-21,14,116,265,381
103693,2022-11-21,15,164,327,491
103694,2022-11-21,16,220,427,647
103695,2022-11-21,17,170,522,692
103696,2022-11-21,18,109,384,493
103697,2022-11-21,19,103,298,401
103698,2022-11-21,20,49,212,261
103699,2022-11-21,21,53,136,189
103700,2022-11-21,22,41,97,138
103701,2022-11-21,23,17,45,62
103702,2022-11-22,0,11,21,32
103703,2022-11-22,1,6,8,14
103704,2022-11-22,2,2,4,6
103705,2022-11-22,3,2,4,6
103706,2022-11-22,4,7,8,15
103707,2022-11-22,5,11,51,62
103708,2022-11-22,6,21,106,127
103709,2022-11-22,7,53,301,354
103710,2022-11-22,8,101,437,538
103711,2022-11-22,9,105,314,419
103712,2022-11-22,10,142,191,333
103713,2022-11-22,11,147,200,347
103714,2022-11-22,12,182,288,470
103715,2022-11-22,13,160,287,447
103716,2022-11-22,14,157,295,452
103717,2022-11-22,15,219,366,585
103718,2022-11-22,16,233,446,679
103719,2022-11-22,17,209,544,753
103720,2022-11-22,18,128,364,492
103721,2022-11-22,19,119,285,404
103722,2022-11-22,20,58,225,283
103723,2022-11-22,21,51,147,198
103724,2022-11-22,22,69,99,168
103725,2022-11-22,23,37,61,98
103726,2022-11-23,0,21,33,54
103727,2022-11-23,1,5,10,15
103728,2022-11-23,2,4,8,12
103729,2022-11-23,3,4,6,10
103730,2022-11-23,4,3,10,13
103731,2022-11-23,5,9,36,45
103732,2022-11-23,6,28,93,121
103733,2022-11-23,7,40,177,217
103734,2022-11-23,8,62,261,323
103735,2022-11-23,9,103,222,325
103736,2022-11-23,10,142,189,331
103737,2022-11-23,11,181,262,443
103738,2022-11-23,12,267,321,588
103739,2022-11-23,13,296,356,652
103740,2022-11-23,14,278,428,706
103741,2022-11-23,15,305,349,654
103742,2022-11-23,16,331,487,818
103743,2022-11-23,17,193,388,581
103744,2022-11-23,18,110,306,416
103745,2022-11-23,19,109,227,336
103746,2022-11-23,20,81,145,226
103747,2022-11-23,21,47,108,155
103748,2022-11-23,22,61,118,179
103749,2022-11-23,23,52,72,124
103750,2022-11-24,0,23,52,75
103751,2022-11-24,1,26,21,47
103752,2022-11-24,2,18,18,36
103753,2022-11-24,3,9,14,23
103754,2022-11-24,4,6,8,14
103755,2022-11-24,5,4,14,18
103756,2022-11-24,6,12,23,35
103757,2022-11-24,7,23,66,89
103758,2022-11-24,8,81,111,192
103759,2022-11-24,9,118,124,242
103760,2022-11-24,10,181,158,339
103761,2022-11-24,11,225,208,433
103762,2022-11-24,12,190,209,399
103763,2022-11-24,13,238,212,450
103764,2022-11-24,14,253,179,432
103765,2022-11-24,15,255,152,407
103766,2022-11-24,16,245,149,394
103767,2022-11-24,17,141,111,252
103768,2022-11-24,18,61,90,151
103769,2022-11-24,19,59,61,120
103770,2022-11-24,20,34,34,68
103771,2022-11-24,21,44,83,127
103772,2022-11-24,22,39,63,102
103773,2022-11-24,23,17,35,52
103774,2022-11-25,0,6,26,32
103775,2022-11-25,1,15,21,36
103776,2022-11-25,2,11,5,16
103777,2022-11-25,3,8,3,11
103778,2022-11-25,4,1,7,8
103779,2022-11-25,5,6,10,16
103780,2022-11-25,6,4,13,17
103781,2022-11-25,7,8,33,41
103782,2022-11-25,8,13,52,65
103783,2022-11-25,9,37,53,90
103784,2022-11-25,10,80,106,186
103785,2022-11-25,11,106,143,249
103786,2022-11-25,12,203,219,422
103787,2022-11-25,13,307,313,620
103788,2022-11-25,14,261,244,505
103789,2022-11-25,15,292,227,519
103790,2022-11-25,16,256,290,546
103791,2022-11-25,17,168,241,409
103792,2022-11-25,18,105,175,280
103793,2022-11-25,19,93,176,269
103794,2022-11-25,20,76,107,183
103795,2022-11-25,21,64,113,177
103796,2022-11-25,22,60,74,134
103797,2022-11-25,23,60,67,127
103798,2022-11-26,0,33,42,75
103799,2022-11-26,1,27,33,60
103800,2022-11-26,2,22,20,42
103801,2022-11-26,3,12,10,22
103802,2022-11-26,4,3,5,8
103803,2022-11-26,5,5,13,18
103804,2022-11-26,6,25,17,42
103805,2022-11-26,7,21,55,76
103806,2022-11-26,8,65,126,191
103807,2022-11-26,9,129,188,317
103808,2022-11-26,10,258,235,493
103809,2022-11-26,11,300,254,554
103810,2022-11-26,12,388,311,699
103811,2022-11-26,13,436,353,789
103812,2022-11-26,14,441,317,758
103813,2022-11-26,15,403,367,770
103814,2022-11-26,16,415,384,799
103815,2022-11-26,17,220,280,500
103816,2022-11-26,18,119,186,305
103817,2022-11-26,19,131,182,313
103818,2022-11-26,20,93,120,213
103819,2022-11-26,21,74,117,191
103820,2022-11-26,22,66,106,172
103821,2022-11-26,23,41,83,124
103822,2022-11-27,0,43,59,102
103823,2022-11-27,1,42,42,84
103824,2022-11-27,2,24,28,52
103825,2022-11-27,3,25,18,43
103826,2022-11-27,4,7,8,15
103827,2022-11-27,5,9,11,20
103828,2022-11-27,6,15,18,33
103829,2022-11-27,7,21,49,70
103830,2022-11-27,8,36,80,116
103831,2022-11-27,9,58,135,193
103832,2022-11-27,10,83,151,234
103833,2022-11-27,11,25,96,121
103834,2022-11-27,12,23,80,103
103835,2022-11-27,13,50,112,162
103836,2022-11-27,14,45,120,165
103837,2022-11-27,15,58,142,200
103838,2022-11-27,16,76,182,258
103839,2022-11-27,17,79,173,252
103840,2022-11-27,18,57,167,224
103841,2022-11-27,19,69,157,226
103842,2022-11-27,20,47,105,152
103843,2022-11-27,21,37,100,137
103844,2022-11-27,22,31,97,128
103845,2022-11-27,23,31,45,76
103846,2022-11-28,0,4,25,29
103847,2022-11-28,1,10,15,25
103848,2022-11-28,2,5,5,10
103849,2022-11-28,3,8,12,20
103850,2022-11-28,4,3,13,16
103851,2022-11-28,5,13,46,59
103852,2022-11-28,6,31,128,159
103853,2022-11-28,7,76,317,393
103854,2022-11-28,8,142,574,716
103855,2022-11-28,9,102,357,459
103856,2022-11-28,10,97,219,316
103857,2022-11-28,11,86,235,321
103858,2022-11-28,12,120,308,428
103859,2022-11-28,13,153,287,440
103860,2022-11-28,14,157,253,410
103861,2022-11-28,15,152,331,483
103862,2022-11-28,16,153,449,602
103863,2022-11-28,17,209,624,833
103864,2022-11-28,18,158,481,639
103865,2022-11-28,19,114,369,483
103866,2022-11-28,20,68,268,336
103867,2022-11-28,21,59,183,242
103868,2022-11-28,22,53,106,159
103869,2022-11-28,23,30,59,89
103870,2022-11-29,0,8,25,33
103871,2022-11-29,1,1,12,13
103872,2022-11-29,2,3,5,8
103873,2022-11-29,3,2,7,9
103874,2022-11-29,4,3,10,13
103875,2022-11-29,5,18,62,80
103876,2022-11-29,6,40,147,187
103877,2022-11-29,7,82,427,509
103878,2022-11-29,8,179,700,879
103879,2022-11-29,9,112,423,535
103880,2022-11-29,10,92,242,334
103881,2022-11-29,11,86,248,334
103882,2022-11-29,12,133,289,422
103883,2022-11-29,13,133,394,527
103884,2022-11-29,14,135,290,425
103885,2022-11-29,15,143,316,459
103886,2022-11-29,16,192,548,740
103887,2022-11-29,17,213,716,929
103888,2022-11-29,18,197,572,769
103889,2022-11-29,19,115,399,514
103890,2022-11-29,20,82,267,349
103891,2022-11-29,21,69,183,252
103892,2022-11-29,22,67,151,218
103893,2022-11-29,23,44,74,118
103894,2022-11-30,0,14,36,50
103895,2022-11-30,1,11,9,20
103896,2022-11-30,2,8,2,10
103897,2022-11-30,3,7,4,11
103898,2022-11-30,4,2,11,13
103899,2022-11-30,5,13,31,44
103900,2022-11-30,6,12,68,80
103901,2022-11-30,7,25,147,172
103902,2022-11-30,8,57,287,344
103903,2022-11-30,9,40,169,209
103904,2022-11-30,10,46,124,170
103905,2022-11-30,11,48,170,218
103906,2022-11-30,12,79,252,331
103907,2022-11-30,13,76,242,318
103908,2022-11-30,14,97,263,360
103909,2022-11-30,15,97,258,355
103910,2022-11-30,16,130,407,537
103911,2022-11-30,17,182,681,863
103912,2022-11-30,18,163,611,774
103913,2022-11-30,19,120,428,548
103914,2022-11-30,20,70,277,347
103915,2022-11-30,21,68,186,254
103916,2022-11-30,22,52,143,195
103917,2022-11-30,23,40,66,106
103918,2022-12-01,0,20,33,53
103919,2022-12-01,1,10,10,20
103920,2022-12-01,2,4,7,11
103921,2022-12-01,3,2,4,6
103922,2022-12-01,4,3,16,19
103923,2022-12-01,5,17,53,70
103924,2022-12-01,6,42,147,189
103925,2022-12-01,7,92,420,512
103926,2022-12-01,8,159,634,793
103927,2022-12-01,9,106,376,482
103928,2022-12-01,10,88,240,328
103929,2022-12-01,11,97,225,322
103930,2022-12-01,12,73,253,326
103931,2022-12-01,13,96,285,381
103932,2022-12-01,14,107,282,389
103933,2022-12-01,15,131,317,448
103934,2022-12-01,16,182,466,648
103935,2022-12-01,17,206,660,866
103936,2022-12-01,18,195,592,787
103937,2022-12-01,19,122,398,520
103938,2022-12-01,20,101,264,365
103939,2022-12-01,21,68,218,286
103940,2022-12-01,22,68,123,191
103941,2022-12-01,23,36,83,119
103942,2022-12-02,0,20,49,69
103943,2022-12-02,1,10,23,33
103944,2022-12-02,2,3,10,13
103945,2022-12-02,3,5,3,8
103946,2022-12-02,4,1,10,11
103947,2022-12-02,5,18,40,58
103948,2022-12-02,6,30,119,149
103949,2022-12-02,7,56,287,343
103950,2022-12-02,8,126,495,621
103951,2022-12-02,9,134,332,466
103952,2022-12-02,10,99,241,340
103953,2022-12-02,11,98,283,381
103954,2022-12-02,12,140,339,479
103955,2022-12-02,13,166,376,542
103956,2022-12-02,14,158,334,492
103957,2022-12-02,15,203,415,618
103958,2022-12-02,16,232,498,730
103959,2022-12-02,17,248,555,803
103960,2022-12-02,18,179,489,668
103961,2022-12-02,19,143,337,480
103962,2022-12-02,20,109,226,335
103963,2022-12-02,21,112,201,313
103964,2022-12-02,22,84,164,248
103965,2022-12-02,23,85,134,219
103966,2022-12-03,0,71,99,170
103967,2022-12-03,1,52,66,118
103968,2022-12-03,2,21,41,62
103969,2022-12-03,3,9,11,20
103970,2022-12-03,4,3,8,11
103971,2022-12-03,5,8,11,19
103972,2022-12-03,6,19,24,43
103973,2022-12-03,7,11,59,70
103974,2022-12-03,8,20,80,100
103975,2022-12-03,9,77,163,240
103976,2022-12-03,10,53,150,203
103977,2022-12-03,11,97,218,315
103978,2022-12-03,12,198,382,580
103979,2022-12-03,13,283,419,702
103980,2022-12-03,14,293,423,716
103981,2022-12-03,15,308,442,750
103982,2022-12-03,16,346,445,791
103983,2022-12-03,17,254,409,663
103984,2022-12-03,18,257,375,632
103985,2022-12-03,19,163,291,454
103986,2022-12-03,20,189,269,458
103987,2022-12-03,21,125,183,308
103988,2022-12-03,22,89,193,282
103989,2022-12-03,23,105,181,286
103990,2022-12-04,0,65,106,171
103991,2022-12-04,1,62,88,150
103992,2022-12-04,2,40,53,93
103993,2022-12-04,3,15,19,34
103994,2022-12-04,4,6,11,17
103995,2022-12-04,5,9,8,17
103996,2022-12-04,6,11,30,41
103997,2022-12-04,7,20,56,76
103998,2022-12-04,8,50,137,187
103999,2022-12-04,9,129,223,352
104000,2022-12-04,10,161,309,470
104001,2022-12-04,11,198,334,532
104002,2022-12-04,12,267,436,703
104003,2022-12-04,13,261,389,650
104004,2022-12-04,14,248,404,652
104005,2022-12-04,15,231,419,650
104006,2022-12-04,16,235,423,658
104007,2022-12-04,17,153,332,485
104008,2022-12-04,18,93,253,346
104009,2022-12-04,19,105,175,280
104010,2022-12-04,20,60,137,197
104011,2022-12-04,21,41,121,162
104012,2022-12-04,22,44,111,155
104013,2022-12-04,23,25,56,81
104014,2022-12-05,0,8,24,32
104015,2022-12-05,1,6,7,13
104016,2022-12-05,2,2,1,3
104017,2022-12-05,3,3,6,9
104018,2022-12-05,4,5,7,12
104019,2022-12-05,5,14,48,62
104020,2022-12-05,6,29,139,168
104021,2022-12-05,7,57,318,375
104022,2022-12-05,8,130,496,626
104023,2022-12-05,9,103,350,453
104024,2022-12-05,10,84,182,266
104025,2022-12-05,11,82,221,303
104026,2022-12-05,12,87,242,329
104027,2022-12-05,13,119,297,416
104028,2022-12-05,14,119,248,367
104029,2022-12-05,15,139,333,472
104030,2022-12-05,16,148,434,582
104031,2022-12-05,17,166,592,758
104032,2022-12-05,18,129,528,657
104033,2022-12-05,19,105,345,450
104034,2022-12-05,20,64,265,329
104035,2022-12-05,21,59,181,240
104036,2022-12-05,22,33,121,154
104037,2022-12-05,23,31,66,97
104038,2022-12-06,0,13,17,30
104039,2022-12-06,1,4,8,12
104040,2022-12-06,2,8,3,11
104041,2022-12-06,3,1,5,6
104042,2022-12-06,4,1,13,14
104043,2022-12-06,5,17,51,68
104044,2022-12-06,6,38,149,187
104045,2022-12-06,7,87,362,449
104046,2022-12-06,8,92,325,417
104047,2022-12-06,9,49,188,237
104048,2022-12-06,10,45,164,209
104049,2022-12-06,11,58,187,245
104050,2022-12-06,12,55,172,227
104051,2022-12-06,13,55,200,255
104052,2022-12-06,14,72,187,259
104053,2022-12-06,15,96,246,342
104054,2022-12-06,16,96,344,440
104055,2022-12-06,17,105,328,433
104056,2022-12-06,18,120,409,529
104057,2022-12-06,19,101,341,442
104058,2022-12-06,20,51,231,282
104059,2022-12-06,21,55,170,225
104060,2022-12-06,22,44,134,178
104061,2022-12-06,23,39,63,102
104062,2022-12-07,0,16,29,45
104063,2022-12-07,1,4,11,15
104064,2022-12-07,2,8,2,10
104065,2022-12-07,3,2,2,4
104066,2022-12-07,4,3,8,11
104067,2022-12-07,5,21,53,74
104068,2022-12-07,6,36,153,189
104069,2022-12-07,7,87,373,460
104070,2022-12-07,8,155,549,704
104071,2022-12-07,9,61,271,332
104072,2022-12-07,10,54,147,201
104073,2022-12-07,11,61,203,264
104074,2022-12-07,12,105,252,357
104075,2022-12-07,13,106,259,365
104076,2022-12-07,14,125,237,362
104077,2022-12-07,15,161,323,484
104078,2022-12-07,16,132,454,586
104079,2022-12-07,17,235,633,868
104080,2022-12-07,18,220,634,854
104081,2022-12-07,19,190,465,655
104082,2022-12-07,20,104,307,411
104083,2022-12-07,21,114,262,376
104084,2022-12-07,22,92,186,278
104085,2022-12-07,23,67,103,170
104086,2022-12-08,0,29,41,70
104087,2022-12-08,1,9,18,27
104088,2022-12-08,2,7,7,14
104089,2022-12-08,3,4,7,11
104090,2022-12-08,4,7,12,19
104091,2022-12-08,5,16,51,67
104092,2022-12-08,6,32,143,175
104093,2022-12-08,7,107,364,471
104094,2022-12-08,8,209,736,945
104095,2022-12-08,9,120,398,518
104096,2022-12-08,10,108,245,353
104097,2022-12-08,11,104,269,373
104098,2022-12-08,12,125,323,448
104099,2022-12-08,13,130,323,453
104100,2022-12-08,14,154,264,418
104101,2022-12-08,15,179,352,531
104102,2022-12-08,16,195,527,722
104103,2022-12-08,17,260,660,920
104104,2022-12-08,18,217,586,803
104105,2022-12-08,19,150,442,592
104106,2022-12-08,20,130,305,435
104107,2022-12-08,21,104,249,353
104108,2022-12-08,22,95,208,303
104109,2022-12-08,23,81,143,224
104110,2022-12-09,0,35,62,97
104111,2022-12-09,1,13,35,48
104112,2022-12-09,2,6,11,17
104113,2022-12-09,3,4,8,12
104114,2022-12-09,4,6,5,11
104115,2022-12-09,5,11,41,52
104116,2022-12-09,6,46,118,164
104117,2022-12-09,7,65,276,341
104118,2022-12-09,8,147,459,606
104119,2022-12-09,9,109,360,469
104120,2022-12-09,10,128,254,382
104121,2022-12-09,11,114,276,390
104122,2022-12-09,12,169,345,514
104123,2022-12-09,13,213,353,566
104124,2022-12-09,14,190,385,575
104125,2022-12-09,15,204,397,601
104126,2022-12-09,16,177,425,602
104127,2022-12-09,17,235,569,804
104128,2022-12-09,18,161,497,658
104129,2022-12-09,19,171,381,552
104130,2022-12-09,20,100,234,334
104131,2022-12-09,21,78,195,273
104132,2022-12-09,22,82,149,231
104133,2022-12-09,23,93,152,245
104134,2022-12-10,0,56,119,175
104135,2022-12-10,1,37,87,124
104136,2022-12-10,2,34,46,80
104137,2022-12-10,3,12,16,28
104138,2022-12-10,4,5,6,11
104139,2022-12-10,5,5,10,15
104140,2022-12-10,6,24,26,50
104141,2022-12-10,7,21,75,96
104142,2022-12-10,8,76,156,232
104143,2022-12-10,9,110,217,327
104144,2022-12-10,10,148,298,446
104145,2022-12-10,11,185,345,530
104146,2022-12-10,12,231,392,623
104147,2022-12-10,13,300,404,704
104148,2022-12-10,14,244,369,613
104149,2022-12-10,15,219,320,539
104150,2022-12-10,16,221,414,635
104151,2022-12-10,17,141,353,494
104152,2022-12-10,18,173,293,466
104153,2022-12-10,19,120,219,339
104154,2022-12-10,20,63,186,249
104155,2022-12-10,21,61,132,193
104156,2022-12-10,22,105,158,263
104157,2022-12-10,23,69,112,181
104158,2022-12-11,0,94,107,201
104159,2022-12-11,1,52,72,124
104160,2022-12-11,2,47,62,109
104161,2022-12-11,3,20,20,40
104162,2022-12-11,4,7,12,19
104163,2022-12-11,5,9,16,25
104164,2022-12-11,6,14,20,34
104165,2022-12-11,7,23,81,104
104166,2022-12-11,8,39,106,145
104167,2022-12-11,9,74,179,253
104168,2022-12-11,10,154,287,441
104169,2022-12-11,11,153,314,467
104170,2022-12-11,12,207,376,583
104171,2022-12-11,13,207,357,564
104172,2022-12-11,14,187,326,513
104173,2022-12-11,15,226,359,585
104174,2022-12-11,16,222,393,615
104175,2022-12-11,17,145,340,485
104176,2022-12-11,18,136,269,405
104177,2022-12-11,19,69,214,283
104178,2022-12-11,20,65,144,209
104179,2022-12-11,21,65,137,202
104180,2022-12-11,22,52,103,155
104181,2022-12-11,23,31,64,95
104182,2022-12-12,0,24,26,50
104183,2022-12-12,1,10,11,21
104184,2022-12-12,2,6,3,9
104185,2022-12-12,3,4,4,8
104186,2022-12-12,4,8,10,18
104187,2022-12-12,5,8,43,51
104188,2022-12-12,6,36,135,171
104189,2022-12-12,7,58,319,377
104190,2022-12-12,8,118,492,610
104191,2022-12-12,9,81,288,369
104192,2022-12-12,10,63,156,219
104193,2022-12-12,11,78,193,271
104194,2022-12-12,12,75,207,282
104195,2022-12-12,13,77,198,275
104196,2022-12-12,14,97,194,291
104197,2022-12-12,15,97,268,365
104198,2022-12-12,16,152,363,515
104199,2022-12-12,17,176,584,760
104200,2022-12-12,18,146,494,640
104201,2022-12-12,19,95,340,435
104202,2022-12-12,20,69,224,293
104203,2022-12-12,21,59,211,270
104204,2022-12-12,22,41,105,146
104205,2022-12-12,23,37,65,102
104206,2022-12-13,0,23,32,55
104207,2022-12-13,1,1,8,9
104208,2022-12-13,2,3,8,11
104209,2022-12-13,3,0,7,7
104210,2022-12-13,4,2,12,14
104211,2022-12-13,5,17,50,67
104212,2022-12-13,6,34,144,178
104213,2022-12-13,7,80,343,423
104214,2022-12-13,8,149,574,723
104215,2022-12-13,9,83,308,391
104216,2022-12-13,10,52,184,236
104217,2022-12-13,11,90,186,276
104218,2022-12-13,12,97,224,321
104219,2022-12-13,13,101,237,338
104220,2022-12-13,14,101,209,310
104221,2022-12-13,15,112,278,390
104222,2022-12-13,16,178,441,619
104223,2022-12-13,17,227,615,842
104224,2022-12-13,18,214,557,771
104225,2022-12-13,19,110,383,493
104226,2022-12-13,20,78,245,323
104227,2022-12-13,21,70,176,246
104228,2022-12-13,22,51,141,192
104229,2022-12-13,23,52,79,131
104230,2022-12-14,0,16,31,47
104231,2022-12-14,1,5,14,19
104232,2022-12-14,2,2,2,4
104233,2022-12-14,3,3,1,4
104234,2022-12-14,4,4,10,14
104235,2022-12-14,5,13,51,64
104236,2022-12-14,6,26,128,154
104237,2022-12-14,7,77,342,419
104238,2022-12-14,8,164,587,751
104239,2022-12-14,9,119,353,472
104240,2022-12-14,10,69,209,278
104241,2022-12-14,11,70,233,303
104242,2022-12-14,12,90,251,341
104243,2022-12-14,13,114,272,386
104244,2022-12-14,14,117,235,352
104245,2022-12-14,15,159,292,451
104246,2022-12-14,16,183,443,626
104247,2022-12-14,17,221,606,827
104248,2022-12-14,18,188,526,714
104249,2022-12-14,19,129,383,512
104250,2022-12-14,20,85,250,335
104251,2022-12-14,21,79,177,256
104252,2022-12-14,22,54,151,205
104253,2022-12-14,23,42,74,116
104254,2022-12-15,0,8,49,57
104255,2022-12-15,1,5,24,29
104256,2022-12-15,2,2,11,13
104257,2022-12-15,3,1,6,7
104258,2022-12-15,4,0,5,5
104259,2022-12-15,5,7,14,21
104260,2022-12-15,6,6,33,39
104261,2022-12-15,7,7,48,55
104262,2022-12-15,8,23,110,133
104263,2022-12-15,9,19,91,110
104264,2022-12-15,10,17,52,69
104265,2022-12-15,11,9,53,62
104266,2022-12-15,12,11,57,68
104267,2022-12-15,13,14,50,64
104268,2022-12-15,14,14,42,56
104269,2022-12-15,15,29,101,130
104270,2022-12-15,16,21,73,94
104271,2022-12-15,17,33,138,171
104272,2022-12-15,18,63,232,295
104273,2022-12-15,19,39,156,195
104274,2022-12-15,20,20,101,121
104275,2022-12-15,21,25,86,111
104276,2022-12-15,22,22,78,100
104277,2022-12-15,23,35,62,97
104278,2022-12-16,0,12,25,37
104279,2022-12-16,1,14,21,35
104280,2022-12-16,2,7,6,13
104281,2022-12-16,3,7,6,13
104282,2022-12-16,4,5,16,21
104283,2022-12-16,5,10,27,37
104284,2022-12-16,6,24,114,138
104285,2022-12-16,7,54,236,290
104286,2022-12-16,8,107,381,488
104287,2022-12-16,9,82,285,367
104288,2022-12-16,10,104,220,324
104289,2022-12-16,11,135,265,400
104290,2022-12-16,12,155,279,434
104291,2022-12-16,13,154,321,475
104292,2022-12-16,14,154,329,483
104293,2022-12-16,15,189,377,566
104294,2022-12-16,16,206,441,647
104295,2022-12-16,17,213,504,717
104296,2022-12-16,18,168,435,603
104297,2022-12-16,19,150,305,455
104298,2022-12-16,20,89,233,322
104299,2022-12-16,21,66,162,228
104300,2022-12-16,22,89,128,217
104301,2022-12-16,23,87,127,214
104302,2022-12-17,0,57,111,168
104303,2022-12-17,1,57,70,127
104304,2022-12-17,2,45,53,98
104305,2022-12-17,3,19,10,29
104306,2022-12-17,4,4,10,14
104307,2022-12-17,5,5,10,15
104308,2022-12-17,6,13,19,32
104309,2022-12-17,7,21,52,73
104310,2022-12-17,8,62,123,185
104311,2022-12-17,9,96,232,328
104312,2022-12-17,10,150,257,407
104313,2022-12-17,11,177,336,513
104314,2022-12-17,12,199,325,524
104315,2022-12-17,13,231,356,587
104316,2022-12-17,14,219,416,635
104317,2022-12-17,15,210,382,592
104318,2022-12-17,16,224,337,561
104319,2022-12-17,17,123,329,452
104320,2022-12-17,18,122,279,401
104321,2022-12-17,19,113,235,348
104322,2022-12-17,20,70,155,225
104323,2022-12-17,21,62,119,181
104324,2022-12-17,22,64,123,187
104325,2022-12-17,23,72,112,184
104326,2022-12-18,0,59,71,130
104327,2022-12-18,1,49,61,110
104328,2022-12-18,2,27,49,76
104329,2022-12-18,3,23,26,49
104330,2022-12-18,4,3,14,17
104331,2022-12-18,5,3,12,15
104332,2022-12-18,6,10,14,24
104333,2022-12-18,7,19,48,67
104334,2022-12-18,8,45,131,176
104335,2022-12-18,9,168,280,448
104336,2022-12-18,10,100,189,289
104337,2022-12-18,11,101,199,300
104338,2022-12-18,12,112,192,304
104339,2022-12-18,13,208,348,556
104340,2022-12-18,14,158,273,431
104341,2022-12-18,15,136,280,416
104342,2022-12-18,16,122,316,438
104343,2022-12-18,17,107,233,340
104344,2022-12-18,18,52,183,235
104345,2022-12-18,19,49,134,183
104346,2022-12-18,20,43,85,128
104347,2022-12-18,21,39,64,103
104348,2022-12-18,22,31,61,92
104349,2022-12-18,23,19,43,62
104350,2022-12-19,0,12,20,32
104351,2022-12-19,1,4,10,14
104352,2022-12-19,2,5,7,12
104353,2022-12-19,3,1,5,6
104354,2022-12-19,4,2,10,12
104355,2022-12-19,5,13,36,49
104356,2022-12-19,6,17,96,113
104357,2022-12-19,7,39,221,260
104358,2022-12-19,8,69,366,435
104359,2022-12-19,9,66,231,297
104360,2022-12-19,10,72,138,210
104361,2022-12-19,11,66,162,228
104362,2022-12-19,12,83,207,290
104363,2022-12-19,13,63,178,241
104364,2022-12-19,14,79,195,274
104365,2022-12-19,15,100,275,375
104366,2022-12-19,16,113,343,456
104367,2022-12-19,17,132,458,590
104368,2022-12-19,18,107,347,454
104369,2022-12-19,19,59,262,321
104370,2022-12-19,20,48,160,208
104371,2022-12-19,21,39,97,136
104372,2022-12-19,22,33,70,103
104373,2022-12-19,23,11,51,62
104374,2022-12-20,0,11,17,28
104375,2022-12-20,1,2,11,13
104376,2022-12-20,2,2,5,7
104377,2022-12-20,3,3,5,8
104378,2022-12-20,4,2,13,15
104379,2022-12-20,5,10,33,43
104380,2022-12-20,6,21,115,136
104381,2022-12-20,7,52,238,290
104382,2022-12-20,8,86,404,490
104383,2022-12-20,9,91,276,367
104384,2022-12-20,10,62,165,227
104385,2022-12-20,11,68,185,253
104386,2022-12-20,12,93,218,311
104387,2022-12-20,13,83,218,301
104388,2022-12-20,14,94,228,322
104389,2022-12-20,15,152,248,400
104390,2022-12-20,16,150,339,489
104391,2022-12-20,17,151,472,623
104392,2022-12-20,18,135,376,511
104393,2022-12-20,19,97,236,333
104394,2022-12-20,20,48,165,213
104395,2022-12-20,21,59,130,189
104396,2022-12-20,22,28,68,96
104397,2022-12-20,23,25,36,61
104398,2022-12-21,0,13,19,32
104399,2022-12-21,1,4,12,16
104400,2022-12-21,2,2,4,6
104401,2022-12-21,3,4,5,9
104402,2022-12-21,4,4,13,17
104403,2022-12-21,5,9,36,45
104404,2022-12-21,6,21,110,131
104405,2022-12-21,7,38,203,241
104406,2022-12-21,8,66,329,395
104407,2022-12-21,9,57,223,280
104408,2022-12-21,10,72,134,206
104409,2022-12-21,11,77,186,263
104410,2022-12-21,12,110,242,352
104411,2022-12-21,13,127,240,367
104412,2022-12-21,14,125,239,364
104413,2022-12-21,15,168,311,479
104414,2022-12-21,16,149,352,501
104415,2022-12-21,17,144,387,531
104416,2022-12-21,18,114,315,429
104417,2022-12-21,19,92,174,266
104418,2022-12-21,20,56,139,195
104419,2022-12-21,21,45,109,154
104420,2022-12-21,22,43,82,125
104421,2022-12-21,23,21,43,64
104422,2022-12-22,0,20,19,39
104423,2022-12-22,1,7,10,17
104424,2022-12-22,2,2,12,14
104425,2022-12-22,3,2,3,5
104426,2022-12-22,4,2,15,17
104427,2022-12-22,5,12,19,31
104428,2022-12-22,6,10,60,70
104429,2022-12-22,7,35,140,175
104430,2022-12-22,8,20,136,156
104431,2022-12-22,9,22,100,122
104432,2022-12-22,10,9,57,66
104433,2022-12-22,11,13,60,73
104434,2022-12-22,12,5,57,62
104435,2022-12-22,13,16,42,58
104436,2022-12-22,14,18,29,47
104437,2022-12-22,15,16,49,65
104438,2022-12-22,16,15,60,75
104439,2022-12-22,17,21,78,99
104440,2022-12-22,18,26,133,159
104441,2022-12-22,19,21,61,82
104442,2022-12-22,20,10,49,59
104443,2022-12-22,21,7,25,32
104444,2022-12-22,22,12,26,38
104445,2022-12-22,23,12,31,43
104446,2022-12-23,0,15,15,30
104447,2022-12-23,1,9,18,27
104448,2022-12-23,2,5,9,14
104449,2022-12-23,3,1,6,7
104450,2022-12-23,4,2,5,7
104451,2022-12-23,5,4,16,20
104452,2022-12-23,6,14,25,39
104453,2022-12-23,7,11,64,75
104454,2022-12-23,8,12,40,52
104455,2022-12-23,9,10,50,60
104456,2022-12-23,10,21,45,66
104457,2022-12-23,11,23,96,119
104458,2022-12-23,12,36,116,152
104459,2022-12-23,13,53,108,161
104460,2022-12-23,14,50,116,166
104461,2022-12-23,15,46,122,168
104462,2022-12-23,16,28,104,132
104463,2022-12-23,17,36,78,114
104464,2022-12-23,18,23,72,95
104465,2022-12-23,19,15,55,70
104466,2022-12-23,20,6,38,44
104467,2022-12-23,21,6,27,33
104468,2022-12-23,22,13,24,37
104469,2022-12-23,23,7,20,27
104470,2022-12-24,0,3,6,9
104471,2022-12-24,1,6,5,11
104472,2022-12-24,2,3,6,9
104473,2022-12-24,3,3,5,8
104474,2022-12-24,4,2,12,14
104475,2022-12-24,5,4,12,16
104476,2022-12-24,6,6,10,16
104477,2022-12-24,7,6,24,30
104478,2022-12-24,8,3,31,34
104479,2022-12-24,9,14,46,60
104480,2022-12-24,10,16,58,74
104481,2022-12-24,11,26,64,90
104482,2022-12-24,12,18,72,90
104483,2022-12-24,13,23,70,93
104484,2022-12-24,14,31,70,101
104485,2022-12-24,15,39,79,118
104486,2022-12-24,16,18,55,73
104487,2022-12-24,17,21,55,76
104488,2022-12-24,18,28,41,69
104489,2022-12-24,19,5,23,28
104490,2022-12-24,20,11,16,27
104491,2022-12-24,21,14,12,26
104492,2022-12-24,22,6,7,13
104493,2022-12-24,23,9,17,26
104494,2022-12-25,0,2,13,15
104495,2022-12-25,1,3,4,7
104496,2022-12-25,2,0,2,2
104497,2022-12-25,3,2,5,7
104498,2022-12-25,4,3,3,6
104499,2022-12-25,5,1,1,2
104500,2022-12-25,6,5,9,14
104501,2022-12-25,7,2,6,8
104502,2022-12-25,8,4,12,16
104503,2022-12-25,9,11,30,41
104504,2022-12-25,10,14,26,40
104505,2022-12-25,11,12,23,35
104506,2022-12-25,12,37,29,66
104507,2022-12-25,13,31,45,76
104508,2022-12-25,14,48,45,93
104509,2022-12-25,15,62,52,114
104510,2022-12-25,16,40,60,100
104511,2022-12-25,17,32,59,91
104512,2022-12-25,18,18,51,69
104513,2022-12-25,19,9,24,33
104514,2022-12-25,20,10,32,42
104515,2022-12-25,21,12,13,25
104516,2022-12-25,22,8,16,24
104517,2022-12-25,23,7,10,17
104518,2022-12-26,0,8,17,25
104519,2022-12-26,1,4,4,8
104520,2022-12-26,2,1,4,5
104521,2022-12-26,3,4,4,8
104522,2022-12-26,4,1,4,5
104523,2022-12-26,5,1,6,7
104524,2022-12-26,6,6,12,18
104525,2022-12-26,7,5,23,28
104526,2022-12-26,8,11,54,65
104527,2022-12-26,9,16,42,58
104528,2022-12-26,10,24,47,71
104529,2022-12-26,11,43,72,115
104530,2022-12-26,12,53,97,150
104531,2022-12-26,13,67,81,148
104532,2022-12-26,14,47,116,163
104533,2022-12-26,15,65,118,183
104534,2022-12-26,16,68,123,191
104535,2022-12-26,17,54,101,155
104536,2022-12-26,18,32,99,131
104537,2022-12-26,19,38,80,118
104538,2022-12-26,20,13,44,57
104539,2022-12-26,21,18,40,58
104540,2022-12-26,22,17,34,51
104541,2022-12-26,23,13,18,31
104542,2022-12-27,0,9,15,24
104543,2022-12-27,1,6,6,12
104544,2022-12-27,2,1,3,4
104545,2022-12-27,3,4,2,6
104546,2022-12-27,4,2,6,8
104547,2022-12-27,5,2,28,30
104548,2022-12-27,6,15,44,59
104549,2022-12-27,7,21,92,113
104550,2022-12-27,8,19,120,139
104551,2022-12-27,9,49,105,154
104552,2022-12-27,10,64,81,145
104553,2022-12-27,11,92,123,215
104554,2022-12-27,12,92,168,260
104555,2022-12-27,13,106,159,265
104556,2022-12-27,14,126,172,298
104557,2022-12-27,15,140,178,318
104558,2022-12-27,16,125,218,343
104559,2022-12-27,17,120,236,356
104560,2022-12-27,18,67,174,241
104561,2022-12-27,19,46,129,175
104562,2022-12-27,20,39,76,115
104563,2022-12-27,21,31,71,102
104564,2022-12-27,22,27,52,79
104565,2022-12-27,23,18,34,52
104566,2022-12-28,0,8,17,25
104567,2022-12-28,1,3,10,13
104568,2022-12-28,2,3,4,7
104569,2022-12-28,3,4,0,4
104570,2022-12-28,4,2,11,13
104571,2022-12-28,5,11,27,38
104572,2022-12-28,6,9,68,77
104573,2022-12-28,7,18,102,120
104574,2022-12-28,8,37,164,201
104575,2022-12-28,9,90,136,226
104576,2022-12-28,10,108,137,245
104577,2022-12-28,11,119,157,276
104578,2022-12-28,12,160,161,321
104579,2022-12-28,13,193,190,383
104580,2022-12-28,14,203,188,391
104581,2022-12-28,15,235,225,460
104582,2022-12-28,16,190,257,447
104583,2022-12-28,17,177,247,424
104584,2022-12-28,18,74,218,292
104585,2022-12-28,19,75,131,206
104586,2022-12-28,20,45,89,134
104587,2022-12-28,21,59,67,126
104588,2022-12-28,22,28,61,89
104589,2022-12-28,23,21,46,67
104590,2022-12-29,0,7,24,31
104591,2022-12-29,1,4,6,10
104592,2022-12-29,2,1,3,4
104593,2022-12-29,3,3,2,5
104594,2022-12-29,4,4,6,10
104595,2022-12-29,5,7,23,30
104596,2022-12-29,6,10,64,74
104597,2022-12-29,7,40,104,144
104598,2022-12-29,8,48,171,219
104599,2022-12-29,9,59,133,192
104600,2022-12-29,10,145,157,302
104601,2022-12-29,11,181,182,363
104602,2022-12-29,12,230,195,425
104603,2022-12-29,13,260,202,462
104604,2022-12-29,14,281,255,536
104605,2022-12-29,15,333,249,582
104606,2022-12-29,16,217,284,501
104607,2022-12-29,17,186,313,499
104608,2022-12-29,18,123,233,356
104609,2022-12-29,19,112,176,288
104610,2022-12-29,20,82,124,206
104611,2022-12-29,21,64,114,178
104612,2022-12-29,22,46,86,132
104613,2022-12-29,23,32,45,77
104614,2022-12-30,0,21,28,49
104615,2022-12-30,1,20,28,48
104616,2022-12-30,2,8,22,30
104617,2022-12-30,3,4,9,13
104618,2022-12-30,4,1,5,6
104619,2022-12-30,5,7,32,39
104620,2022-12-30,6,12,67,79
104621,2022-12-30,7,23,101,124
104622,2022-12-30,8,47,174,221
104623,2022-12-30,9,91,140,231
104624,2022-12-30,10,138,178,316
104625,2022-12-30,11,193,216,409
104626,2022-12-30,12,271,261,532
104627,2022-12-30,13,304,280,584
104628,2022-12-30,14,379,332,711
104629,2022-12-30,15,395,334,729
104630,2022-12-30,16,340,359,699
104631,2022-12-30,17,260,330,590
104632,2022-12-30,18,141,241,382
104633,2022-12-30,19,134,212,346
104634,2022-12-30,20,76,148,224
104635,2022-12-30,21,70,88,158
104636,2022-12-30,22,55,102,157
104637,2022-12-30,23,66,78,144
104638,2022-12-31,0,35,57,92
104639,2022-12-31,1,32,20,52
104640,2022-12-31,2,40,16,56
104641,2022-12-31,3,13,12,25
104642,2022-12-31,4,4,8,12
104643,2022-12-31,5,5,17,22
104644,2022-12-31,6,9,44,53
104645,2022-12-31,7,22,67,89
104646,2022-12-31,8,43,100,143
104647,2022-12-31,9,80,126,206
104648,2022-12-31,10,162,188,350
104649,2022-12-31,11,150,216,366
104650,2022-12-31,12,191,241,432
104651,2022-12-31,13,162,215,377
104652,2022-12-31,14,149,175,324
104653,2022-12-31,15,83,122,205
104654,2022-12-31,16,76,97,173
104655,2022-12-31,17,38,75,113
104656,2022-12-31,18,32,72,104
104657,2022-12-31,19,17,53,70
104658,2022-12-31,20,32,56,88
104659,2022-12-31,21,18,65,83
104660,2022-12-31,22,37,57,94
104661,2022-12-31,23,51,57,108
104662,2023-01-01,0,57,77,134
104663,2023-01-01,1,96,100,196
104664,2023-01-01,2,107,74,181
104665,2023-01-01,3,46,34,80
104666,2023-01-01,4,11,15,26
104667,2023-01-01,5,4,17,21
104668,2023-01-01,6,15,23,38
104669,2023-01-01,7,14,31,45
104670,2023-01-01,8,33,59,92
104671,2023-01-01,9,68,122,190
104672,2023-01-01,10,145,164,309
104673,2023-01-01,11,206,214,420
104674,2023-01-01,12,321,226,547
104675,2023-01-01,13,403,285,688
104676,2023-01-01,14,423,256,679
104677,2023-01-01,15,439,338,777
104678,2023-01-01,16,416,344,760
104679,2023-01-01,17,272,234,506
104680,2023-01-01,18,144,191,335
104681,2023-01-01,19,146,124,270
104682,2023-01-01,20,75,81,156
104683,2023-01-01,21,54,89,143
104684,2023-01-01,22,47,65,112
104685,2023-01-01,23,30,51,81
104686,2023-01-02,0,26,33,59
104687,2023-01-02,1,8,9,17
104688,2023-01-02,2,3,9,12
104689,2023-01-02,3,7,4,11
104690,2023-01-02,4,3,5,8
104691,2023-01-02,5,13,15,28
104692,2023-01-02,6,13,28,41
104693,2023-01-02,7,26,52,78
104694,2023-01-02,8,45,93,138
104695,2023-01-02,9,95,154,249
104696,2023-01-02,10,141,219,360
104697,2023-01-02,11,276,318,594
104698,2023-01-02,12,389,343,732
104699,2023-01-02,13,390,353,743
104700,2023-01-02,14,400,344,744
104701,2023-01-02,15,425,385,810
104702,2023-01-02,16,404,366,770
104703,2023-01-02,17,251,326,577
104704,2023-01-02,18,165,236,401
104705,2023-01-02,19,111,178,289
104706,2023-01-02,20,83,136,219
104707,2023-01-02,21,73,86,159
104708,2023-01-02,22,65,80,145
104709,2023-01-02,23,21,35,56
104710,2023-01-03,0,16,11,27
104711,2023-01-03,1,7,7,14
104712,2023-01-03,2,2,7,9
104713,2023-01-03,3,0,4,4
104714,2023-01-03,4,7,15,22
104715,2023-01-03,5,20,60,80
104716,2023-01-03,6,29,146,175
104717,2023-01-03,7,69,346,415
104718,2023-01-03,8,123,543,666
104719,2023-01-03,9,116,248,364
104720,2023-01-03,10,83,160,243
104721,2023-01-03,11,122,188,310
104722,2023-01-03,12,132,153,285
104723,2023-01-03,13,154,187,341
104724,2023-01-03,14,238,237,475
104725,2023-01-03,15,244,266,510
104726,2023-01-03,16,315,421,736
104727,2023-01-03,17,310,618,928
104728,2023-01-03,18,200,496,696
104729,2023-01-03,19,167,299,466
104730,2023-01-03,20,114,194,308
104731,2023-01-03,21,69,159,228
104732,2023-01-03,22,56,109,165
104733,2023-01-03,23,42,50,92
104734,2023-01-04,0,26,21,47
104735,2023-01-04,1,22,9,31
104736,2023-01-04,2,4,8,12
104737,2023-01-04,3,3,4,7
104738,2023-01-04,4,2,14,16
104739,2023-01-04,5,22,56,78
104740,2023-01-04,6,35,166,201
104741,2023-01-04,7,78,399,477
104742,2023-01-04,8,179,664,843
104743,2023-01-04,9,128,326,454
104744,2023-01-04,10,143,202,345
104745,2023-01-04,11,126,180,306
104746,2023-01-04,12,148,231,379
104747,2023-01-04,13,117,150,267
104748,2023-01-04,14,139,205,344
104749,2023-01-04,15,170,274,444
104750,2023-01-04,16,212,398,610
104751,2023-01-04,17,295,643,938
104752,2023-01-04,18,216,487,703
104753,2023-01-04,19,141,336,477
104754,2023-01-04,20,96,233,329
104755,2023-01-04,21,80,156,236
104756,2023-01-04,22,70,95,165
104757,2023-01-04,23,35,45,80
104758,2023-01-05,0,15,12,27
104759,2023-01-05,1,11,13,24
104760,2023-01-05,2,2,5,7
104761,2023-01-05,3,6,4,10
104762,2023-01-05,4,7,9,16
104763,2023-01-05,5,14,54,68
104764,2023-01-05,6,34,152,186
104765,2023-01-05,7,100,334,434
104766,2023-01-05,8,167,576,743
104767,2023-01-05,9,138,317,455
104768,2023-01-05,10,115,175,290
104769,2023-01-05,11,150,174,324
104770,2023-01-05,12,156,241,397
104771,2023-01-05,13,161,240,401
104772,2023-01-05,14,253,254,507
104773,2023-01-05,15,296,304,600
104774,2023-01-05,16,299,467,766
104775,2023-01-05,17,338,672,1010
104776,2023-01-05,18,234,564,798
104777,2023-01-05,19,143,328,471
104778,2023-01-05,20,116,239,355
104779,2023-01-05,21,72,149,221
104780,2023-01-05,22,85,115,200
104781,2023-01-05,23,41,57,98
104782,2023-01-06,0,18,18,36
104783,2023-01-06,1,4,12,16
104784,2023-01-06,2,5,6,11
104785,2023-01-06,3,8,4,12
104786,2023-01-06,4,6,12,18
104787,2023-01-06,5,14,45,59
104788,2023-01-06,6,44,129,173
104789,2023-01-06,7,69,263,332
104790,2023-01-06,8,114,395,509
104791,2023-01-06,9,88,270,358
104792,2023-01-06,10,89,183,272
104793,2023-01-06,11,106,205,311
104794,2023-01-06,12,142,223,365
104795,2023-01-06,13,145,206,351
104796,2023-01-06,14,131,231,362
104797,2023-01-06,15,156,308,464
104798,2023-01-06,16,222,408,630
104799,2023-01-06,17,232,524,756
104800,2023-01-06,18,154,399,553
104801,2023-01-06,19,133,276,409
104802,2023-01-06,20,65,152,217
104803,2023-01-06,21,77,130,207
104804,2023-01-06,22,46,88,134
104805,2023-01-06,23,50,113,163
104806,2023-01-07,0,45,77,122
104807,2023-01-07,1,48,47,95
104808,2023-01-07,2,30,31,61
104809,2023-01-07,3,10,17,27
104810,2023-01-07,4,2,6,8
104811,2023-01-07,5,4,14,18
104812,2023-01-07,6,8,33,41
104813,2023-01-07,7,19,70,89
104814,2023-01-07,8,59,146,205
104815,2023-01-07,9,116,239,355
104816,2023-01-07,10,133,289,422
104817,2023-01-07,11,218,315,533
104818,2023-01-07,12,270,352,622
104819,2023-01-07,13,328,345,673
104820,2023-01-07,14,320,353,673
104821,2023-01-07,15,300,359,659
104822,2023-01-07,16,289,387,676
104823,2023-01-07,17,197,333,530
104824,2023-01-07,18,134,236,370
104825,2023-01-07,19,95,200,295
104826,2023-01-07,20,68,132,200
104827,2023-01-07,21,56,110,166
104828,2023-01-07,22,63,86,149
104829,2023-01-07,23,50,83,133
104830,2023-01-08,0,45,81,126
104831,2023-01-08,1,52,39,91
104832,2023-01-08,2,41,51,92
104833,2023-01-08,3,16,16,32
104834,2023-01-08,4,6,6,12
104835,2023-01-08,5,3,11,14
104836,2023-01-08,6,9,14,23
104837,2023-01-08,7,13,50,63
104838,2023-01-08,8,35,86,121
104839,2023-01-08,9,68,191,259
104840,2023-01-08,10,135,214,349
104841,2023-01-08,11,147,281,428
104842,2023-01-08,12,188,322,510
104843,2023-01-08,13,170,282,452
104844,2023-01-08,14,164,301,465
104845,2023-01-08,15,195,285,480
104846,2023-01-08,16,149,278,427
104847,2023-01-08,17,105,225,330
104848,2023-01-08,18,80,218,298
104849,2023-01-08,19,61,163,224
104850,2023-01-08,20,47,93,140
104851,2023-01-08,21,35,72,107
104852,2023-01-08,22,32,42,74
104853,2023-01-08,23,22,37,59
104854,2023-01-09,0,4,11,15
104855,2023-01-09,1,3,8,11
104856,2023-01-09,2,5,3,8
104857,2023-01-09,3,2,5,7
104858,2023-01-09,4,0,7,7
104859,2023-01-09,5,10,39,49
104860,2023-01-09,6,37,135,172
104861,2023-01-09,7,76,298,374
104862,2023-01-09,8,108,468,576
104863,2023-01-09,9,78,269,347
104864,2023-01-09,10,44,159,203
104865,2023-01-09,11,88,154,242
104866,2023-01-09,12,117,217,334
104867,2023-01-09,13,118,195,313
104868,2023-01-09,14,122,226,348
104869,2023-01-09,15,139,302,441
104870,2023-01-09,16,150,381,531
104871,2023-01-09,17,168,565,733
104872,2023-01-09,18,162,493,655
104873,2023-01-09,19,113,362,475
104874,2023-01-09,20,78,165,243
104875,2023-01-09,21,51,171,222
104876,2023-01-09,22,58,85,143
104877,2023-01-09,23,23,48,71
104878,2023-01-10,0,10,18,28
104879,2023-01-10,1,5,11,16
104880,2023-01-10,2,3,5,8
104881,2023-01-10,3,0,4,4
104882,2023-01-10,4,1,7,8
104883,2023-01-10,5,18,60,78
104884,2023-01-10,6,35,148,183
104885,2023-01-10,7,73,368,441
104886,2023-01-10,8,160,593,753
104887,2023-01-10,9,98,311,409
104888,2023-01-10,10,74,177,251
104889,2023-01-10,11,78,189,267
104890,2023-01-10,12,89,232,321
104891,2023-01-10,13,85,209,294
104892,2023-01-10,14,101,219,320
104893,2023-01-10,15,129,299,428
104894,2023-01-10,16,179,419,598
104895,2023-01-10,17,203,685,888
104896,2023-01-10,18,168,536,704
104897,2023-01-10,19,131,369,500
104898,2023-01-10,20,68,243,311
104899,2023-01-10,21,56,176,232
104900,2023-01-10,22,62,109,171
104901,2023-01-10,23,37,53,90
104902,2023-01-11,0,13,23,36
104903,2023-01-11,1,3,3,6
104904,2023-01-11,2,1,3,4
104905,2023-01-11,3,3,3,6
104906,2023-01-11,4,1,8,9
104907,2023-01-11,5,18,53,71
104908,2023-01-11,6,34,151,185
104909,2023-01-11,7,87,327,414
104910,2023-01-11,8,155,623,778
104911,2023-01-11,9,102,350,452
104912,2023-01-11,10,80,178,258
104913,2023-01-11,11,64,173,237
104914,2023-01-11,12,82,236,318
104915,2023-01-11,13,81,222,303
104916,2023-01-11,14,98,227,325
104917,2023-01-11,15,118,279,397
104918,2023-01-11,16,134,407,541
104919,2023-01-11,17,212,646,858
104920,2023-01-11,18,178,557,735
104921,2023-01-11,19,153,335,488
104922,2023-01-11,20,77,211,288
104923,2023-01-11,21,68,191,259
104924,2023-01-11,22,46,66,112
104925,2023-01-11,23,24,51,75
104926,2023-01-12,0,11,19,30
104927,2023-01-12,1,4,8,12
104928,2023-01-12,2,4,6,10
104929,2023-01-12,3,6,5,11
104930,2023-01-12,4,2,10,12
104931,2023-01-12,5,16,48,64
104932,2023-01-12,6,34,123,157
104933,2023-01-12,7,72,312,384
104934,2023-01-12,8,142,552,694
104935,2023-01-12,9,111,310,421
104936,2023-01-12,10,56,168,224
104937,2023-01-12,11,67,236,303
104938,2023-01-12,12,133,217,350
104939,2023-01-12,13,132,250,382
104940,2023-01-12,14,93,205,298
104941,2023-01-12,15,108,248,356
104942,2023-01-12,16,125,372,497
104943,2023-01-12,17,191,619,810
104944,2023-01-12,18,159,462,621
104945,2023-01-12,19,130,319,449
104946,2023-01-12,20,79,194,273
104947,2023-01-12,21,37,125,162
104948,2023-01-12,22,22,58,80
104949,2023-01-12,23,12,43,55
104950,2023-01-13,0,5,20,25
104951,2023-01-13,1,8,21,29
104952,2023-01-13,2,3,5,8
104953,2023-01-13,3,2,8,10
104954,2023-01-13,4,2,9,11
104955,2023-01-13,5,12,26,38
104956,2023-01-13,6,17,61,78
104957,2023-01-13,7,37,203,240
104958,2023-01-13,8,85,342,427
104959,2023-01-13,9,110,272,382
104960,2023-01-13,10,96,173,269
104961,2023-01-13,11,121,210,331
104962,2023-01-13,12,164,292,456
104963,2023-01-13,13,114,291,405
104964,2023-01-13,14,187,283,470
104965,2023-01-13,15,162,350,512
104966,2023-01-13,16,158,388,546
104967,2023-01-13,17,167,445,612
104968,2023-01-13,18,142,381,523
104969,2023-01-13,19,104,289,393
104970,2023-01-13,20,72,165,237
104971,2023-01-13,21,63,121,184
104972,2023-01-13,22,44,101,145
104973,2023-01-13,23,50,109,159
104974,2023-01-14,0,35,84,119
104975,2023-01-14,1,24,49,73
104976,2023-01-14,2,19,34,53
104977,2023-01-14,3,8,14,22
104978,2023-01-14,4,2,10,12
104979,2023-01-14,5,6,10,16
104980,2023-01-14,6,10,28,38
104981,2023-01-14,7,25,71,96
104982,2023-01-14,8,46,117,163
104983,2023-01-14,9,92,179,271
104984,2023-01-14,10,114,225,339
104985,2023-01-14,11,113,241,354
104986,2023-01-14,12,119,305,424
104987,2023-01-14,13,129,248,377
104988,2023-01-14,14,132,287,419
104989,2023-01-14,15,129,284,413
104990,2023-01-14,16,119,243,362
104991,2023-01-14,17,94,196,290
104992,2023-01-14,18,79,187,266
104993,2023-01-14,19,54,167,221
104994,2023-01-14,20,40,134,174
104995,2023-01-14,21,39,90,129
104996,2023-01-14,22,41,77,118
104997,2023-01-14,23,33,88,121
104998,2023-01-15,0,27,61,88
104999,2023-01-15,1,29,39,68
105000,2023-01-15,2,20,30,50
105001,2023-01-15,3,10,11,21
105002,2023-01-15,4,5,6,11
105003,2023-01-15,5,5,10,15
105004,2023-01-15,6,9,12,21
105005,2023-01-15,7,15,45,60
105006,2023-01-15,8,38,85,123
105007,2023-01-15,9,78,151,229
105008,2023-01-15,10,140,238,378
105009,2023-01-15,11,148,263,411
105010,2023-01-15,12,186,310,496
105011,2023-01-15,13,196,260,456
105012,2023-01-15,14,217,259,476
105013,2023-01-15,15,220,319,539
105014,2023-01-15,16,170,293,463
105015,2023-01-15,17,113,259,372
105016,2023-01-15,18,82,212,294
105017,2023-01-15,19,57,156,213
105018,2023-01-15,20,49,129,178
105019,2023-01-15,21,46,89,135
105020,2023-01-15,22,40,66,106
105021,2023-01-15,23,49,56,105
105022,2023-01-16,0,22,28,50
105023,2023-01-16,1,10,22,32
105024,2023-01-16,2,5,7,12
105025,2023-01-16,3,2,4,6
105026,2023-01-16,4,1,6,7
105027,2023-01-16,5,6,23,29
105028,2023-01-16,6,16,38,54
105029,2023-01-16,7,21,75,96
105030,2023-01-16,8,29,118,147
105031,2023-01-16,9,70,154,224
105032,2023-01-16,10,132,223,355
105033,2023-01-16,11,156,302,458
105034,2023-01-16,12,219,333,552
105035,2023-01-16,13,225,346,571
105036,2023-01-16,14,289,389,678
105037,2023-01-16,15,283,357,640
105038,2023-01-16,16,244,430,674
105039,2023-01-16,17,188,386,574
105040,2023-01-16,18,109,273,382
105041,2023-01-16,19,83,239,322
105042,2023-01-16,20,58,153,211
105043,2023-01-16,21,49,114,163
105044,2023-01-16,22,45,69,114
105045,2023-01-16,23,29,41,70
105046,2023-01-17,0,10,16,26
105047,2023-01-17,1,2,8,10
105048,2023-01-17,2,0,10,10
105049,2023-01-17,3,1,4,5
105050,2023-01-17,4,1,11,12
105051,2023-01-17,5,16,46,62
105052,2023-01-17,6,32,136,168
105053,2023-01-17,7,51,276,327
105054,2023-01-17,8,81,394,475
105055,2023-01-17,9,49,203,252
105056,2023-01-17,10,24,114,138
105057,2023-01-17,11,21,101,122
105058,2023-01-17,12,37,120,157
105059,2023-01-17,13,54,169,223
105060,2023-01-17,14,59,166,225
105061,2023-01-17,15,92,260,352
105062,2023-01-17,16,132,412,544
105063,2023-01-17,17,170,639,809
105064,2023-01-17,18,156,546,702
105065,2023-01-17,19,105,389,494
105066,2023-01-17,20,62,231,293
105067,2023-01-17,21,67,213,280
105068,2023-01-17,22,48,113,161
105069,2023-01-17,23,25,45,70
105070,2023-01-18,0,12,18,30
105071,2023-01-18,1,4,6,10
105072,2023-01-18,2,2,5,7
105073,2023-01-18,3,3,3,6
105074,2023-01-18,4,1,16,17
105075,2023-01-18,5,21,49,70
105076,2023-01-18,6,31,159,190
105077,2023-01-18,7,73,412,485
105078,2023-01-18,8,143,622,765
105079,2023-01-18,9,101,332,433
105080,2023-01-18,10,84,202,286
105081,2023-01-18,11,77,201,278
105082,2023-01-18,12,104,274,378
105083,2023-01-18,13,104,271,375
105084,2023-01-18,14,123,275,398
105085,2023-01-18,15,156,336,492
105086,2023-01-18,16,198,481,679
105087,2023-01-18,17,242,734,976
105088,2023-01-18,18,188,646,834
105089,2023-01-18,19,159,431,590
105090,2023-01-18,20,95,260,355
105091,2023-01-18,21,61,210,271
105092,2023-01-18,22,58,136,194
105093,2023-01-18,23,17,49,66
105094,2023-01-19,0,16,34,50
105095,2023-01-19,1,8,9,17
105096,2023-01-19,2,4,7,11
105097,2023-01-19,3,2,4,6
105098,2023-01-19,4,2,11,13
105099,2023-01-19,5,17,57,74
105100,2023-01-19,6,29,150,179
105101,2023-01-19,7,73,285,358
105102,2023-01-19,8,102,514,616
105103,2023-01-19,9,84,339,423
105104,2023-01-19,10,56,194,250
105105,2023-01-19,11,53,201,254
105106,2023-01-19,12,75,205,280
105107,2023-01-19,13,83,180,263
105108,2023-01-19,14,53,152,205
105109,2023-01-19,15,94,202,296
105110,2023-01-19,16,99,297,396
105111,2023-01-19,17,136,498,634
105112,2023-01-19,18,81,328,409
105113,2023-01-19,19,55,277,332
105114,2023-01-19,20,62,218,280
105115,2023-01-19,21,72,173,245
105116,2023-01-19,22,51,133,184
105117,2023-01-19,23,13,68,81
105118,2023-01-20,0,30,32,62
105119,2023-01-20,1,16,21,37
105120,2023-01-20,2,4,11,15
105121,2023-01-20,3,3,9,12
105122,2023-01-20,4,3,16,19
105123,2023-01-20,5,15,44,59
105124,2023-01-20,6,29,117,146
105125,2023-01-20,7,57,304,361
105126,2023-01-20,8,109,469,578
105127,2023-01-20,9,116,276,392
105128,2023-01-20,10,78,208,286
105129,2023-01-20,11,122,239,361
105130,2023-01-20,12,131,298,429
105131,2023-01-20,13,114,255,369
105132,2023-01-20,14,160,276,436
105133,2023-01-20,15,143,365,508
105134,2023-01-20,16,175,430,605
105135,2023-01-20,17,236,526,762
105136,2023-01-20,18,161,461,622
105137,2023-01-20,19,119,339,458
105138,2023-01-20,20,57,210,267
105139,2023-01-20,21,62,147,209
105140,2023-01-20,22,79,138,217
105141,2023-01-20,23,53,131,184
105142,2023-01-21,0,41,73,114
105143,2023-01-21,1,54,60,114
105144,2023-01-21,2,11,32,43
105145,2023-01-21,3,4,16,20
105146,2023-01-21,4,2,8,10
105147,2023-01-21,5,7,8,15
105148,2023-01-21,6,19,31,50
105149,2023-01-21,7,28,75,103
105150,2023-01-21,8,64,138,202
105151,2023-01-21,9,111,235,346
105152,2023-01-21,10,133,336,469
105153,2023-01-21,11,163,364,527
105154,2023-01-21,12,212,428,640
105155,2023-01-21,13,186,403,589
105156,2023-01-21,14,206,376,582
105157,2023-01-21,15,224,399,623
105158,2023-01-21,16,221,313,534
105159,2023-01-21,17,164,327,491
105160,2023-01-21,18,106,240,346
105161,2023-01-21,19,105,233,338
105162,2023-01-21,20,68,177,245
105163,2023-01-21,21,74,116,190
105164,2023-01-21,22,72,120,192
105165,2023-01-21,23,64,114,178
105166,2023-01-22,0,65,94,159
105167,2023-01-22,1,46,66,112
105168,2023-01-22,2,32,36,68
105169,2023-01-22,3,18,20,38
105170,2023-01-22,4,2,8,10
105171,2023-01-22,5,3,13,16
105172,2023-01-22,6,11,15,26
105173,2023-01-22,7,8,56,64
105174,2023-01-22,8,33,89,122
105175,2023-01-22,9,77,181,258
105176,2023-01-22,10,133,257,390
105177,2023-01-22,11,124,237,361
105178,2023-01-22,12,120,263,383
105179,2023-01-22,13,137,253,390
105180,2023-01-22,14,149,233,382
105181,2023-01-22,15,120,233,353
105182,2023-01-22,16,77,185,262
105183,2023-01-22,17,51,152,203
105184,2023-01-22,18,16,79,95
105185,2023-01-22,19,17,71,88
105186,2023-01-22,20,12,42,54
105187,2023-01-22,21,14,55,69
105188,2023-01-22,22,12,51,63
105189,2023-01-22,23,12,23,35
105190,2023-01-23,0,8,14,22
105191,2023-01-23,1,1,6,7
105192,2023-01-23,2,2,2,4
105193,2023-01-23,3,0,5,5
105194,2023-01-23,4,3,10,13
105195,2023-01-23,5,8,28,36
105196,2023-01-23,6,12,86,98
105197,2023-01-23,7,29,193,222
105198,2023-01-23,8,68,398,466
105199,2023-01-23,9,52,242,294
105200,2023-01-23,10,60,173,233
105201,2023-01-23,11,56,179,235
105202,2023-01-23,12,68,221,289
105203,2023-01-23,13,83,218,301
105204,2023-01-23,14,79,201,280
105205,2023-01-23,15,100,251,351
105206,2023-01-23,16,106,373,479
105207,2023-01-23,17,141,527,668
105208,2023-01-23,18,121,504,625
105209,2023-01-23,19,73,353,426
105210,2023-01-23,20,70,244,314
105211,2023-01-23,21,35,150,185
105212,2023-01-23,22,29,86,115
105213,2023-01-23,23,15,39,54
105214,2023-01-24,0,8,13,21
105215,2023-01-24,1,1,3,4
105216,2023-01-24,2,0,4,4
105217,2023-01-24,3,2,2,4
105218,2023-01-24,4,3,9,12
105219,2023-01-24,5,14,64,78
105220,2023-01-24,6,28,158,186
105221,2023-01-24,7,65,404,469
105222,2023-01-24,8,151,689,840
105223,2023-01-24,9,73,321,394
105224,2023-01-24,10,58,173,231
105225,2023-01-24,11,83,184,267
105226,2023-01-24,12,92,262,354
105227,2023-01-24,13,100,245,345
105228,2023-01-24,14,103,210,313
105229,2023-01-24,15,120,297,417
105230,2023-01-24,16,158,507,665
105231,2023-01-24,17,239,737,976
105232,2023-01-24,18,184,623,807
105233,2023-01-24,19,115,399,514
105234,2023-01-24,20,72,277,349
105235,2023-01-24,21,71,209,280
105236,2023-01-24,22,34,122,156
105237,2023-01-24,23,27,52,79
105238,2023-01-25,0,7,22,29
105239,2023-01-25,1,0,10,10
105240,2023-01-25,2,4,4,8
105241,2023-01-25,3,3,8,11
105242,2023-01-25,4,4,7,11
105243,2023-01-25,5,11,45,56
105244,2023-01-25,6,31,157,188
105245,2023-01-25,7,79,349,428
105246,2023-01-25,8,143,614,757
105247,2023-01-25,9,91,382,473
105248,2023-01-25,10,42,180,222
105249,2023-01-25,11,40,158,198
105250,2023-01-25,12,21,127,148
105251,2023-01-25,13,14,49,63
105252,2023-01-25,14,8,49,57
105253,2023-01-25,15,22,103,125
105254,2023-01-25,16,29,138,167
105255,2023-01-25,17,64,275,339
105256,2023-01-25,18,55,264,319
105257,2023-01-25,19,54,234,288
105258,2023-01-25,20,35,166,201
105259,2023-01-25,21,30,100,130
105260,2023-01-25,22,42,86,128
105261,2023-01-25,23,18,52,70
105262,2023-01-26,0,12,21,33
105263,2023-01-26,1,3,10,13
105264,2023-01-26,2,4,4,8
105265,2023-01-26,3,3,3,6
105266,2023-01-26,4,3,5,8
105267,2023-01-26,5,20,58,78
105268,2023-01-26,6,36,136,172
105269,2023-01-26,7,66,355,421
105270,2023-01-26,8,141,601,742
105271,2023-01-26,9,98,349,447
105272,2023-01-26,10,69,224,293
105273,2023-01-26,11,85,217,302
105274,2023-01-26,12,81,233,314
105275,2023-01-26,13,89,224,313
105276,2023-01-26,14,97,230,327
105277,2023-01-26,15,99,284,383
105278,2023-01-26,16,147,429,576
105279,2023-01-26,17,189,708,897
105280,2023-01-26,18,174,566,740
105281,2023-01-26,19,117,404,521
105282,2023-01-26,20,79,269,348
105283,2023-01-26,21,81,220,301
105284,2023-01-26,22,65,120,185
105285,2023-01-26,23,32,85,117
105286,2023-01-27,0,27,51,78
105287,2023-01-27,1,6,11,17
105288,2023-01-27,2,3,12,15
105289,2023-01-27,3,2,7,9
105290,2023-01-27,4,0,13,13
105291,2023-01-27,5,10,49,59
105292,2023-01-27,6,21,116,137
105293,2023-01-27,7,60,291,351
105294,2023-01-27,8,93,412,505
105295,2023-01-27,9,75,270,345
105296,2023-01-27,10,67,202,269
105297,2023-01-27,11,80,222,302
105298,2023-01-27,12,100,260,360
105299,2023-01-27,13,103,286,389
105300,2023-01-27,14,141,291,432
105301,2023-01-27,15,155,310,465
105302,2023-01-27,16,154,405,559
105303,2023-01-27,17,176,549,725
105304,2023-01-27,18,138,399,537
105305,2023-01-27,19,121,332,453
105306,2023-01-27,20,79,197,276
105307,2023-01-27,21,50,164,214
105308,2023-01-27,22,44,106,150
105309,2023-01-27,23,48,106,154
105310,2023-01-28,0,40,75,115
105311,2023-01-28,1,51,50,101
105312,2023-01-28,2,29,33,62
105313,2023-01-28,3,7,11,18
105314,2023-01-28,4,2,11,13
105315,2023-01-28,5,5,12,17
105316,2023-01-28,6,15,27,42
105317,2023-01-28,7,39,71,110
105318,2023-01-28,8,67,159,226
105319,2023-01-28,9,95,276,371
105320,2023-01-28,10,163,316,479
105321,2023-01-28,11,260,407,667
105322,2023-01-28,12,333,436,769
105323,2023-01-28,13,358,442,800
105324,2023-01-28,14,401,424,825
105325,2023-01-28,15,424,430,854
105326,2023-01-28,16,399,439,838
105327,2023-01-28,17,293,373,666
105328,2023-01-28,18,163,310,473
105329,2023-01-28,19,130,259,389
105330,2023-01-28,20,104,192,296
105331,2023-01-28,21,92,133,225
105332,2023-01-28,22,67,116,183
105333,2023-01-28,23,74,98,172
105334,2023-01-29,0,81,101,182
105335,2023-01-29,1,54,74,128
105336,2023-01-29,2,33,28,61
105337,2023-01-29,3,13,13,26
105338,2023-01-29,4,5,10,15
105339,2023-01-29,5,5,13,18
105340,2023-01-29,6,15,18,33
105341,2023-01-29,7,16,59,75
105342,2023-01-29,8,33,109,142
105343,2023-01-29,9,117,191,308
105344,2023-01-29,10,160,259,419
105345,2023-01-29,11,164,312,476
105346,2023-01-29,12,80,209,289
105347,2023-01-29,13,95,226,321
105348,2023-01-29,14,68,194,262
105349,2023-01-29,15,86,208,294
105350,2023-01-29,16,86,250,336
105351,2023-01-29,17,124,234,358
105352,2023-01-29,18,78,248,326
105353,2023-01-29,19,65,156,221
105354,2023-01-29,20,44,140,184
105355,2023-01-29,21,26,78,104
105356,2023-01-29,22,40,87,127
105357,2023-01-29,23,25,40,65
105358,2023-01-30,0,15,10,25
105359,2023-01-30,1,6,17,23
105360,2023-01-30,2,0,2,2
105361,2023-01-30,3,4,5,9
105362,2023-01-30,4,3,7,10
105363,2023-01-30,5,12,48,60
105364,2023-01-30,6,33,156,189
105365,2023-01-30,7,53,296,349
105366,2023-01-30,8,124,521,645
105367,2023-01-30,9,73,297,370
105368,2023-01-30,10,51,161,212
105369,2023-01-30,11,82,217,299
105370,2023-01-30,12,88,236,324
105371,2023-01-30,13,112,241,353
105372,2023-01-30,14,135,232,367
105373,2023-01-30,15,187,360,547
105374,2023-01-30,16,184,474,658
105375,2023-01-30,17,240,729,969
105376,2023-01-30,18,196,582,778
105377,2023-01-30,19,151,455,606
105378,2023-01-30,20,79,301,380
105379,2023-01-30,21,66,208,274
105380,2023-01-30,22,55,120,175
105381,2023-01-30,23,22,40,62
105382,2023-01-31,0,14,17,31
105383,2023-01-31,1,3,4,7
105384,2023-01-31,2,4,10,14
105385,2023-01-31,3,2,5,7
105386,2023-01-31,4,5,9,14
105387,2023-01-31,5,11,65,76
105388,2023-01-31,6,35,159,194
105389,2023-01-31,7,82,337,419
105390,2023-01-31,8,63,294,357
105391,2023-01-31,9,32,173,205
105392,2023-01-31,10,30,107,137
105393,2023-01-31,11,27,90,117
105394,2023-01-31,12,31,121,152
105395,2023-01-31,13,21,111,132
105396,2023-01-31,14,33,107,140
105397,2023-01-31,15,53,198,251
105398,2023-01-31,16,60,281,341
105399,2023-01-31,17,112,491,603
105400,2023-01-31,18,93,421,514
105401,2023-01-31,19,75,290,365
105402,2023-01-31,20,55,234,289
105403,2023-01-31,21,39,154,193
105404,2023-01-31,22,38,124,162
105405,2023-01-31,23,23,53,76
105406,2023-02-01,0,6,22,28
105407,2023-02-01,1,0,8,8
105408,2023-02-01,2,2,2,4
105409,2023-02-01,3,4,6,10
105410,2023-02-01,4,3,10,13
105411,2023-02-01,5,12,47,59
105412,2023-02-01,6,22,133,155
105413,2023-02-01,7,65,329,394
105414,2023-02-01,8,87,548,635
105415,2023-02-01,9,80,345,425
105416,2023-02-01,10,58,188,246
105417,2023-02-01,11,70,193,263
105418,2023-02-01,12,49,259,308
105419,2023-02-01,13,73,260,333
105420,2023-02-01,14,82,232,314
105421,2023-02-01,15,111,329,440
105422,2023-02-01,16,125,405,530
105423,2023-02-01,17,203,632,835
105424,2023-02-01,18,145,512,657
105425,2023-02-01,19,95,355,450
105426,2023-02-01,20,65,244,309
105427,2023-02-01,21,53,181,234
105428,2023-02-01,22,37,125,162
105429,2023-02-01,23,30,44,74
105430,2023-02-02,0,11,16,27
105431,2023-02-02,1,2,14,16
105432,2023-02-02,2,4,3,7
105433,2023-02-02,3,3,5,8
105434,2023-02-02,4,3,8,11
105435,2023-02-02,5,13,47,60
105436,2023-02-02,6,21,125,146
105437,2023-02-02,7,53,321,374
105438,2023-02-02,8,130,581,711
105439,2023-02-02,9,85,314,399
105440,2023-02-02,10,53,172,225
105441,2023-02-02,11,63,203,266
105442,2023-02-02,12,79,252,331
105443,2023-02-02,13,76,244,320
105444,2023-02-02,14,78,220,298
105445,2023-02-02,15,95,300,395
105446,2023-02-02,16,117,385,502
105447,2023-02-02,17,150,610,760
105448,2023-02-02,18,145,519,664
105449,2023-02-02,19,96,350,446
105450,2023-02-02,20,68,249,317
105451,2023-02-02,21,53,195,248
105452,2023-02-02,22,47,113,160
105453,2023-02-02,23,32,66,98
105454,2023-02-03,0,23,35,58
105455,2023-02-03,1,13,25,38
105456,2023-02-03,2,2,4,6
105457,2023-02-03,3,6,5,11
105458,2023-02-03,4,0,9,9
105459,2023-02-03,5,11,37,48
105460,2023-02-03,6,23,114,137
105461,2023-02-03,7,34,235,269
105462,2023-02-03,8,79,366,445
105463,2023-02-03,9,56,225,281
105464,2023-02-03,10,39,174,213
105465,2023-02-03,11,48,172,220
105466,2023-02-03,12,60,194,254
105467,2023-02-03,13,58,242,300
105468,2023-02-03,14,70,175,245
105469,2023-02-03,15,71,228,299
105470,2023-02-03,16,83,292,375
105471,2023-02-03,17,92,345,437
105472,2023-02-03,18,57,272,329
105473,2023-02-03,19,58,210,268
105474,2023-02-03,20,27,102,129
105475,2023-02-03,21,16,92,108
105476,2023-02-03,22,20,74,94
105477,2023-02-03,23,19,68,87
105478,2023-02-04,0,19,41,60
105479,2023-02-04,1,8,26,34
105480,2023-02-04,2,8,11,19
105481,2023-02-04,3,1,4,5
105482,2023-02-04,4,4,5,9
105483,2023-02-04,5,6,10,16
105484,2023-02-04,6,10,25,35
105485,2023-02-04,7,14,44,58
105486,2023-02-04,8,35,78,113
105487,2023-02-04,9,46,154,200
105488,2023-02-04,10,55,193,248
105489,2023-02-04,11,99,209,308
105490,2023-02-04,12,114,208,322
105491,2023-02-04,13,119,207,326
105492,2023-02-04,14,109,236,345
105493,2023-02-04,15,121,244,365
105494,2023-02-04,16,77,262,339
105495,2023-02-04,17,73,242,315
105496,2023-02-04,18,68,166,234
105497,2023-02-04,19,50,116,166
105498,2023-02-04,20,41,90,131
105499,2023-02-04,21,33,88,121
105500,2023-02-04,22,40,90,130
105501,2023-02-04,23,27,89,116
105502,2023-02-05,0,26,67,93
105503,2023-02-05,1,20,44,64
105504,2023-02-05,2,21,30,51
105505,2023-02-05,3,8,19,27
105506,2023-02-05,4,1,3,4
105507,2023-02-05,5,5,9,14
105508,2023-02-05,6,10,25,35
105509,2023-02-05,7,9,51,60
105510,2023-02-05,8,31,96,127
105511,2023-02-05,9,77,175,252
105512,2023-02-05,10,112,262,374
105513,2023-02-05,11,135,319,454
105514,2023-02-05,12,163,345,508
105515,2023-02-05,13,216,394,610
105516,2023-02-05,14,254,380,634
105517,2023-02-05,15,313,379,692
105518,2023-02-05,16,240,389,629
105519,2023-02-05,17,200,380,580
105520,2023-02-05,18,126,254,380
105521,2023-02-05,19,73,193,266
105522,2023-02-05,20,78,140,218
105523,2023-02-05,21,66,99,165
105524,2023-02-05,22,37,76,113
105525,2023-02-05,23,23,38,61
105526,2023-02-06,0,12,14,26
105527,2023-02-06,1,0,8,8
105528,2023-02-06,2,0,2,2
105529,2023-02-06,3,4,3,7
105530,2023-02-06,4,4,11,15
105531,2023-02-06,5,11,53,64
105532,2023-02-06,6,37,146,183
105533,2023-02-06,7,62,351,413
105534,2023-02-06,8,112,566,678
105535,2023-02-06,9,86,332,418
105536,2023-02-06,10,61,170,231
105537,2023-02-06,11,69,194,263
105538,2023-02-06,12,84,250,334
105539,2023-02-06,13,78,221,299
105540,2023-02-06,14,72,223,295
105541,2023-02-06,15,110,263,373
105542,2023-02-06,16,119,377,496
105543,2023-02-06,17,168,587,755
105544,2023-02-06,18,127,515,642
105545,2023-02-06,19,96,367,463
105546,2023-02-06,20,69,251,320
105547,2023-02-06,21,48,165,213
105548,2023-02-06,22,38,100,138
105549,2023-02-06,23,17,58,75
105550,2023-02-07,0,6,14,20
105551,2023-02-07,1,5,6,11
105552,2023-02-07,2,1,4,5
105553,2023-02-07,3,1,2,3
105554,2023-02-07,4,2,7,9
105555,2023-02-07,5,21,62,83
105556,2023-02-07,6,21,149,170
105557,2023-02-07,7,77,388,465
105558,2023-02-07,8,149,677,826
105559,2023-02-07,9,88,361,449
105560,2023-02-07,10,48,173,221
105561,2023-02-07,11,71,216,287
105562,2023-02-07,12,66,231,297
105563,2023-02-07,13,88,262,350
105564,2023-02-07,14,97,238,335
105565,2023-02-07,15,101,305,406
105566,2023-02-07,16,132,462,594
105567,2023-02-07,17,214,681,895
105568,2023-02-07,18,179,577,756
105569,2023-02-07,19,108,457,565
105570,2023-02-07,20,100,289,389
105571,2023-02-07,21,68,180,248
105572,2023-02-07,22,51,130,181
105573,2023-02-07,23,38,88,126
105574,2023-02-08,0,13,28,41
105575,2023-02-08,1,5,11,16
105576,2023-02-08,2,2,9,11
105577,2023-02-08,3,6,1,7
105578,2023-02-08,4,2,12,14
105579,2023-02-08,5,16,49,65
105580,2023-02-08,6,33,161,194
105581,2023-02-08,7,80,435,515
105582,2023-02-08,8,160,694,854
105583,2023-02-08,9,114,411,525
105584,2023-02-08,10,80,234,314
105585,2023-02-08,11,101,244,345
105586,2023-02-08,12,117,320,437
105587,2023-02-08,13,140,309,449
105588,2023-02-08,14,156,312,468
105589,2023-02-08,15,181,393,574
105590,2023-02-08,16,226,554,780
105591,2023-02-08,17,334,795,1129
105592,2023-02-08,18,242,731,973
105593,2023-02-08,19,222,499,721
105594,2023-02-08,20,105,342,447
105595,2023-02-08,21,102,290,392
105596,2023-02-08,22,77,140,217
105597,2023-02-08,23,37,67,104
105598,2023-02-09,0,19,39,58
105599,2023-02-09,1,2,15,17
105600,2023-02-09,2,4,10,14
105601,2023-02-09,3,5,2,7
105602,2023-02-09,4,2,9,11
105603,2023-02-09,5,14,61,75
105604,2023-02-09,6,30,149,179
105605,2023-02-09,7,88,409,497
105606,2023-02-09,8,182,673,855
105607,2023-02-09,9,113,417,530
105608,2023-02-09,10,72,230,302
105609,2023-02-09,11,81,252,333
105610,2023-02-09,12,127,290,417
105611,2023-02-09,13,118,282,400
105612,2023-02-09,14,124,266,390
105613,2023-02-09,15,173,349,522
105614,2023-02-09,16,229,525,754
105615,2023-02-09,17,284,814,1098
105616,2023-02-09,18,240,637,877
105617,2023-02-09,19,185,502,687
105618,2023-02-09,20,111,332,443
105619,2023-02-09,21,134,276,410
105620,2023-02-09,22,93,174,267
105621,2023-02-09,23,74,86,160
105622,2023-02-10,0,41,67,108
105623,2023-02-10,1,26,28,54
105624,2023-02-10,2,2,13,15
105625,2023-02-10,3,4,8,12
105626,2023-02-10,4,2,5,7
105627,2023-02-10,5,13,41,54
105628,2023-02-10,6,45,150,195
105629,2023-02-10,7,67,338,405
105630,2023-02-10,8,152,523,675
105631,2023-02-10,9,124,356,480
105632,2023-02-10,10,135,231,366
105633,2023-02-10,11,142,268,410
105634,2023-02-10,12,213,366,579
105635,2023-02-10,13,175,365,540
105636,2023-02-10,14,207,344,551
105637,2023-02-10,15,255,434,689
105638,2023-02-10,16,273,534,807
105639,2023-02-10,17,305,696,1001
105640,2023-02-10,18,249,488,737
105641,2023-02-10,19,188,383,571
105642,2023-02-10,20,121,225,346
105643,2023-02-10,21,88,149,237
105644,2023-02-10,22,51,129,180
105645,2023-02-10,23,66,124,190
105646,2023-02-11,0,52,108,160
105647,2023-02-11,1,34,63,97
105648,2023-02-11,2,18,34,52
105649,2023-02-11,3,14,26,40
105650,2023-02-11,4,3,4,7
105651,2023-02-11,5,3,18,21
105652,2023-02-11,6,14,38,52
105653,2023-02-11,7,24,74,98
105654,2023-02-11,8,58,178,236
105655,2023-02-11,9,124,273,397
105656,2023-02-11,10,183,306,489
105657,2023-02-11,11,215,370,585
105658,2023-02-11,12,287,400,687
105659,2023-02-11,13,317,397,714
105660,2023-02-11,14,393,465,858
105661,2023-02-11,15,352,406,758
105662,2023-02-11,16,346,392,738
105663,2023-02-11,17,244,367,611
105664,2023-02-11,18,160,327,487
105665,2023-02-11,19,126,239,365
105666,2023-02-11,20,97,174,271
105667,2023-02-11,21,83,137,220
105668,2023-02-11,22,54,114,168
105669,2023-02-11,23,63,97,160
105670,2023-02-12,0,55,81,136
105671,2023-02-12,1,44,67,111
105672,2023-02-12,2,36,63,99
105673,2023-02-12,3,11,23,34
105674,2023-02-12,4,3,8,11
105675,2023-02-12,5,10,12,22
105676,2023-02-12,6,8,26,34
105677,2023-02-12,7,13,52,65
105678,2023-02-12,8,21,69,90
105679,2023-02-12,9,32,96,128
105680,2023-02-12,10,57,173,230
105681,2023-02-12,11,40,118,158
105682,2023-02-12,12,46,139,185
105683,2023-02-12,13,39,100,139
105684,2023-02-12,14,33,94,127
105685,2023-02-12,15,18,49,67
105686,2023-02-12,16,22,98,120
105687,2023-02-12,17,33,115,148
105688,2023-02-12,18,33,84,117
105689,2023-02-12,19,14,38,52
105690,2023-02-12,20,12,25,37
105691,2023-02-12,21,10,35,45
105692,2023-02-12,22,42,100,142
105693,2023-02-12,23,24,48,72
105694,2023-02-13,0,7,17,24
105695,2023-02-13,1,3,10,13
105696,2023-02-13,2,0,5,5
105697,2023-02-13,3,2,6,8
105698,2023-02-13,4,1,10,11
105699,2023-02-13,5,14,49,63
105700,2023-02-13,6,26,129,155
105701,2023-02-13,7,56,323,379
105702,2023-02-13,8,125,544,669
105703,2023-02-13,9,116,341,457
105704,2023-02-13,10,82,216,298
105705,2023-02-13,11,95,237,332
105706,2023-02-13,12,136,256,392
105707,2023-02-13,13,127,250,377
105708,2023-02-13,14,111,255,366
105709,2023-02-13,15,135,341,476
105710,2023-02-13,16,162,444,606
105711,2023-02-13,17,214,677,891
105712,2023-02-13,18,178,597,775
105713,2023-02-13,19,111,398,509
105714,2023-02-13,20,65,243,308
105715,2023-02-13,21,60,226,286
105716,2023-02-13,22,33,107,140
105717,2023-02-13,23,51,77,128
105718,2023-02-14,0,3,15,18
105719,2023-02-14,1,4,5,9
105720,2023-02-14,2,1,5,6
105721,2023-02-14,3,0,3,3
105722,2023-02-14,4,4,8,12
105723,2023-02-14,5,22,56,78
105724,2023-02-14,6,32,163,195
105725,2023-02-14,7,88,433,521
105726,2023-02-14,8,181,696,877
105727,2023-02-14,9,107,444,551
105728,2023-02-14,10,78,220,298
105729,2023-02-14,11,98,220,318
105730,2023-02-14,12,125,311,436
105731,2023-02-14,13,126,309,435
105732,2023-02-14,14,176,319,495
105733,2023-02-14,15,181,389,570
105734,2023-02-14,16,227,534,761
105735,2023-02-14,17,323,893,1216
105736,2023-02-14,18,250,651,901
105737,2023-02-14,19,145,402,547
105738,2023-02-14,20,74,274,348
105739,2023-02-14,21,77,166,243
105740,2023-02-14,22,56,157,213
105741,2023-02-14,23,66,101,167
105742,2023-02-15,0,20,35,55
105743,2023-02-15,1,2,18,20
105744,2023-02-15,2,3,5,8
105745,2023-02-15,3,6,7,13
105746,2023-02-15,4,6,12,18
105747,2023-02-15,5,24,59,83
105748,2023-02-15,6,30,194,224
105749,2023-02-15,7,88,331,419
105750,2023-02-15,8,170,627,797
105751,2023-02-15,9,119,393,512
105752,2023-02-15,10,76,213,289
105753,2023-02-15,11,100,233,333
105754,2023-02-15,12,118,341,459
105755,2023-02-15,13,127,295,422
105756,2023-02-15,14,141,316,457
105757,2023-02-15,15,190,358,548
105758,2023-02-15,16,210,534,744
105759,2023-02-15,17,312,861,1173
105760,2023-02-15,18,236,660,896
105761,2023-02-15,19,168,475,643
105762,2023-02-15,20,111,368,479
105763,2023-02-15,21,109,243,352
105764,2023-02-15,22,69,174,243
105765,2023-02-15,23,45,96,141
105766,2023-02-16,0,23,32,55
105767,2023-02-16,1,8,16,24
105768,2023-02-16,2,6,5,11
105769,2023-02-16,3,4,4,8
105770,2023-02-16,4,4,11,15
105771,2023-02-16,5,26,61,87
105772,2023-02-16,6,36,151,187
105773,2023-02-16,7,90,384,474
105774,2023-02-16,8,169,665,834
105775,2023-02-16,9,140,399,539
105776,2023-02-16,10,90,236,326
105777,2023-02-16,11,90,225,315
105778,2023-02-16,12,32,91,123
105779,2023-02-16,13,32,106,138
105780,2023-02-16,14,33,99,132
105781,2023-02-16,15,68,253,321
105782,2023-02-16,16,109,374,483
105783,2023-02-16,17,161,570,731
105784,2023-02-16,18,159,469,628
105785,2023-02-16,19,108,394,502
105786,2023-02-16,20,85,292,377
105787,2023-02-16,21,81,219,300
105788,2023-02-16,22,72,125,197
105789,2023-02-16,23,48,84,132
105790,2023-02-17,0,19,58,77
105791,2023-02-17,1,25,19,44
105792,2023-02-17,2,11,8,19
105793,2023-02-17,3,7,11,18
105794,2023-02-17,4,1,8,9
105795,2023-02-17,5,3,19,22
105796,2023-02-17,6,9,54,63
105797,2023-02-17,7,11,75,86
105798,2023-02-17,8,43,138,181
105799,2023-02-17,9,42,150,192
105800,2023-02-17,10,57,141,198
105801,2023-02-17,11,54,179,233
105802,2023-02-17,12,90,197,287
105803,2023-02-17,13,79,231,310
105804,2023-02-17,14,105,271,376
105805,2023-02-17,15,130,300,430
105806,2023-02-17,16,121,350,471
105807,2023-02-17,17,176,435,611
105808,2023-02-17,18,129,323,452
105809,2023-02-17,19,71,247,318
105810,2023-02-17,20,66,155,221
105811,2023-02-17,21,43,110,153
105812,2023-02-17,22,35,86,121
105813,2023-02-17,23,52,82,134
105814,2023-02-18,0,29,54,83
105815,2023-02-18,1,24,44,68
105816,2023-02-18,2,27,23,50
105817,2023-02-18,3,8,5,13
105818,2023-02-18,4,4,12,16
105819,2023-02-18,5,10,13,23
105820,2023-02-18,6,13,29,42
105821,2023-02-18,7,35,89,124
105822,2023-02-18,8,44,125,169
105823,2023-02-18,9,89,221,310
105824,2023-02-18,10,136,259,395
105825,2023-02-18,11,198,294,492
105826,2023-02-18,12,269,315,584
105827,2023-02-18,13,277,329,606
105828,2023-02-18,14,335,348,683
105829,2023-02-18,15,312,350,662
105830,2023-02-18,16,323,351,674
105831,2023-02-18,17,262,331,593
105832,2023-02-18,18,127,241,368
105833,2023-02-18,19,108,210,318
105834,2023-02-18,20,71,154,225
105835,2023-02-18,21,75,122,197
105836,2023-02-18,22,53,123,176
105837,2023-02-18,23,42,93,135
105838,2023-02-19,0,49,92,141
105839,2023-02-19,1,43,50,93
105840,2023-02-19,2,21,35,56
105841,2023-02-19,3,15,18,33
105842,2023-02-19,4,3,12,15
105843,2023-02-19,5,6,9,15
105844,2023-02-19,6,6,29,35
105845,2023-02-19,7,17,47,64
105846,2023-02-19,8,45,100,145
105847,2023-02-19,9,146,175,321
105848,2023-02-19,10,215,272,487
105849,2023-02-19,11,295,273,568
105850,2023-02-19,12,344,351,695
105851,2023-02-19,13,410,383,793
105852,2023-02-19,14,527,362,889
105853,2023-02-19,15,504,412,916
105854,2023-02-19,16,477,410,887
105855,2023-02-19,17,448,373,821
105856,2023-02-19,18,255,307,562
105857,2023-02-19,19,151,217,368
105858,2023-02-19,20,94,144,238
105859,2023-02-19,21,66,154,220
105860,2023-02-19,22,75,138,213
105861,2023-02-19,23,54,89,143
105862,2023-02-20,0,39,53,92
105863,2023-02-20,1,13,20,33
105864,2023-02-20,2,6,13,19
105865,2023-02-20,3,6,7,13
105866,2023-02-20,4,1,8,9
105867,2023-02-20,5,13,20,33
105868,2023-02-20,6,18,61,79
105869,2023-02-20,7,41,112,153
105870,2023-02-20,8,65,201,266
105871,2023-02-20,9,102,238,340
105872,2023-02-20,10,176,259,435
105873,2023-02-20,11,219,343,562
105874,2023-02-20,12,269,311,580
105875,2023-02-20,13,271,378,649
105876,2023-02-20,14,324,370,694
105877,2023-02-20,15,304,397,701
105878,2023-02-20,16,299,402,701
105879,2023-02-20,17,263,435,698
105880,2023-02-20,18,172,385,557
105881,2023-02-20,19,125,271,396
105882,2023-02-20,20,87,174,261
105883,2023-02-20,21,44,141,185
105884,2023-02-20,22,40,88,128
105885,2023-02-20,23,23,42,65
105886,2023-02-21,0,10,15,25
105887,2023-02-21,1,8,8,16
105888,2023-02-21,2,1,3,4
105889,2023-02-21,3,2,3,5
105890,2023-02-21,4,5,12,17
105891,2023-02-21,5,17,48,65
105892,2023-02-21,6,40,170,210
105893,2023-02-21,7,82,377,459
105894,2023-02-21,8,165,637,802
105895,2023-02-21,9,121,305,426
105896,2023-02-21,10,113,199,312
105897,2023-02-21,11,119,217,336
105898,2023-02-21,12,143,277,420
105899,2023-02-21,13,155,258,413
105900,2023-02-21,14,162,261,423
105901,2023-02-21,15,167,353,520
105902,2023-02-21,16,231,485,716
105903,2023-02-21,17,318,832,1150
105904,2023-02-21,18,239,640,879
105905,2023-02-21,19,137,412,549
105906,2023-02-21,20,101,280,381
105907,2023-02-21,21,103,246,349
105908,2023-02-21,22,72,129,201
105909,2023-02-21,23,31,65,96
105910,2023-02-22,0,9,21,30
105911,2023-02-22,1,4,8,12
105912,2023-02-22,2,6,5,11
105913,2023-02-22,3,2,3,5
105914,2023-02-22,4,2,12,14
105915,2023-02-22,5,22,67,89
105916,2023-02-22,6,36,182,218
105917,2023-02-22,7,84,385,469
105918,2023-02-22,8,128,629,757
105919,2023-02-22,9,46,210,256
105920,2023-02-22,10,43,186,229
105921,2023-02-22,11,70,223,293
105922,2023-02-22,12,91,256,347
105923,2023-02-22,13,95,280,375
105924,2023-02-22,14,113,251,364
105925,2023-02-22,15,137,318,455
105926,2023-02-22,16,173,400,573
105927,2023-02-22,17,245,709,954
105928,2023-02-22,18,226,602,828
105929,2023-02-22,19,152,427,579
105930,2023-02-22,20,98,318,416
105931,2023-02-22,21,75,241,316
105932,2023-02-22,22,73,125,198
105933,2023-02-22,23,36,76,112
105934,2023-02-23,0,7,35,42
105935,2023-02-23,1,5,12,17
105936,2023-02-23,2,2,5,7
105937,2023-02-23,3,4,15,19
105938,2023-02-23,4,1,12,13
105939,2023-02-23,5,17,45,62
105940,2023-02-23,6,35,157,192
105941,2023-02-23,7,94,393,487
105942,2023-02-23,8,194,693,887
105943,2023-02-23,9,123,371,494
105944,2023-02-23,10,127,234,361
105945,2023-02-23,11,158,289,447
105946,2023-02-23,12,200,301,501
105947,2023-02-23,13,210,342,552
105948,2023-02-23,14,267,374,641
105949,2023-02-23,15,334,473,807
105950,2023-02-23,16,417,609,1026
105951,2023-02-23,17,621,1017,1638
105952,2023-02-23,18,396,761,1157
105953,2023-02-23,19,235,479,714
105954,2023-02-23,20,181,351,532
105955,2023-02-23,21,197,321,518
105956,2023-02-23,22,140,208,348
105957,2023-02-23,23,54,111,165
105958,2023-02-24,0,46,51,97
105959,2023-02-24,1,25,22,47
105960,2023-02-24,2,9,15,24
105961,2023-02-24,3,11,8,19
105962,2023-02-24,4,5,14,19
105963,2023-02-24,5,15,41,56
105964,2023-02-24,6,42,152,194
105965,2023-02-24,7,87,297,384
105966,2023-02-24,8,146,427,573
105967,2023-02-24,9,121,313,434
105968,2023-02-24,10,113,231,344
105969,2023-02-24,11,155,252,407
105970,2023-02-24,12,172,319,491
105971,2023-02-24,13,209,301,510
105972,2023-02-24,14,222,315,537
105973,2023-02-24,15,197,372,569
105974,2023-02-24,16,222,420,642
105975,2023-02-24,17,274,581,855
105976,2023-02-24,18,191,488,679
105977,2023-02-24,19,129,354,483
105978,2023-02-24,20,75,227,302
105979,2023-02-24,21,84,147,231
105980,2023-02-24,22,73,131,204
105981,2023-02-24,23,46,121,167
105982,2023-02-25,0,32,93,125
105983,2023-02-25,1,28,76,104
105984,2023-02-25,2,28,24,52
105985,2023-02-25,3,8,21,29
105986,2023-02-25,4,6,7,13
105987,2023-02-25,5,5,12,17
105988,2023-02-25,6,18,24,42
105989,2023-02-25,7,21,73,94
105990,2023-02-25,8,46,174,220
105991,2023-02-25,9,90,231,321
105992,2023-02-25,10,138,265,403
105993,2023-02-25,11,93,237,330
105994,2023-02-25,12,62,170,232
105995,2023-02-25,13,83,178,261
105996,2023-02-25,14,75,174,249
105997,2023-02-25,15,110,247,357
105998,2023-02-25,16,142,234,376
105999,2023-02-25,17,119,287,406
106000,2023-02-25,18,103,252,355
106001,2023-02-25,19,79,225,304
106002,2023-02-25,20,62,129,191
106003,2023-02-25,21,74,100,174
106004,2023-02-25,22,60,139,199
106005,2023-02-25,23,60,141,201
106006,2023-02-26,0,53,95,148
106007,2023-02-26,1,42,55,97
106008,2023-02-26,2,39,42,81
106009,2023-02-26,3,10,25,35
106010,2023-02-26,4,7,3,10
106011,2023-02-26,5,6,8,14
106012,2023-02-26,6,9,26,35
106013,2023-02-26,7,16,55,71
106014,2023-02-26,8,37,111,148
106015,2023-02-26,9,104,227,331
106016,2023-02-26,10,166,285,451
106017,2023-02-26,11,201,366,567
106018,2023-02-26,12,275,359,634
106019,2023-02-26,13,355,400,755
106020,2023-02-26,14,340,366,706
106021,2023-02-26,15,430,429,859
106022,2023-02-26,16,379,471,850
106023,2023-02-26,17,269,425,694
106024,2023-02-26,18,165,314,479
106025,2023-02-26,19,99,224,323
106026,2023-02-26,20,53,159,212
106027,2023-02-26,21,57,129,186
106028,2023-02-26,22,46,102,148
106029,2023-02-26,23,28,66,94
106030,2023-02-27,0,12,17,29
106031,2023-02-27,1,4,8,12
106032,2023-02-27,2,3,7,10
106033,2023-02-27,3,2,6,8
106034,2023-02-27,4,2,12,14
106035,2023-02-27,5,13,59,72
106036,2023-02-27,6,39,170,209
106037,2023-02-27,7,63,345,408
106038,2023-02-27,8,112,532,644
106039,2023-02-27,9,95,307,402
106040,2023-02-27,10,59,183,242
106041,2023-02-27,11,112,205,317
106042,2023-02-27,12,104,224,328
106043,2023-02-27,13,57,174,231
106044,2023-02-27,14,92,195,287
106045,2023-02-27,15,118,299,417
106046,2023-02-27,16,122,426,548
106047,2023-02-27,17,81,374,455
106048,2023-02-27,18,52,335,387
106049,2023-02-27,19,42,197,239
106050,2023-02-27,20,22,145,167
106051,2023-02-27,21,31,119,150
106052,2023-02-27,22,26,68,94
106053,2023-02-27,23,11,23,34
106054,2023-02-28,0,5,11,16
106055,2023-02-28,1,1,5,6
106056,2023-02-28,2,2,2,4
106057,2023-02-28,3,3,6,9
106058,2023-02-28,4,4,13,17
106059,2023-02-28,5,16,55,71
106060,2023-02-28,6,30,174,204
106061,2023-02-28,7,94,398,492
106062,2023-02-28,8,166,690,856
106063,2023-02-28,9,88,360,448
106064,2023-02-28,10,79,215,294
106065,2023-02-28,11,79,227,306
106066,2023-02-28,12,86,268,354
106067,2023-02-28,13,127,264,391
106068,2023-02-28,14,137,256,393
106069,2023-02-28,15,188,352,540
106070,2023-02-28,16,221,557,778
106071,2023-02-28,17,363,853,1216
106072,2023-02-28,18,222,705,927
106073,2023-02-28,19,141,416,557
106074,2023-02-28,20,112,306,418
106075,2023-02-28,21,67,189,256
106076,2023-02-28,22,58,153,211
106077,2023-02-28,23,39,67,106
